sample,station,tx_total_pkts,tx_total_bytes,tx_ucast_pkts,tx_ucast_bytes,tx_mcast_bcast_pkts,tx_mcast_bcast_bytes,tx_failures,rx_data_pkts,rx_data_bytes,rx_ucast_pkts,rx_ucast_bytes,rx_mcast_bcast_pkts,rx_mcast_bcast_bytes,rx_decrypt_succeeds,tx_data_pkts_retried,tx_total_pkts_sent,tx_pkts_retries,tx_pkts_retry_exhausted,rx_total_pkts_retried,rate_last_tx_pkt_min,rate_last_tx_pkt_max,per_antenna_rssi_last_rx_data_frame_1,per_antenna_rssi_last_rx_data_frame_2,per_antenna_rssi_last_rx_data_frame_3,per_antenna_rssi_last_rx_data_frame_4,per_antenna_avg_rssi_rx_data_frames_1,per_antenna_avg_rssi_rx_data_frames_2,per_antenna_avg_rssi_rx_data_frames_3,per_antenna_avg_rssi_rx_data_frames_4,per_antenna_noise_floor_1,per_antenna_noise_floor_2,per_antenna_noise_floor_3,per_antenna_noise_floor_4,sinr_per_antenna_1,sinr_per_antenna_2,sinr_per_antenna_3,sinr_per_antenna_4,attack
1,F8:59:71:5A:E0:3D,3263202,477967519,54161,72635532,3209041,405331987,0,51659,31337419,46897,30768411,4762,569008,29905,16,56873,1419,0,475,144444.0,43333.0,-67.0,-75.0,-65.0,-70.0,-67.0,-74.0,-65.0,-70.0,-88.0,-91.0,-87.0,-91.0,21.0,16.0,22.0,21.0,1
2,CC:2F:71:3E:C5:1F,3220375,406718398,11334,1386411,3209041,405331987,6,48441,4055847,40040,3060461,8401,995386,11949,34,16298,186,6,818,130000.0,39000.0,-69.0,-69.0,-68.0,-61.0,-70.0,-70.0,-68.0,-62.0,-88.0,-91.0,-87.0,-91.0,19.0,22.0,19.0,30.0,1
3,CC:2F:71:3F:1F:24,7304093,6645786428,4095052,6240454441,3209041,405331987,78,917490,540705408,908999,539685630,8491,1019778,867138,618,4099770,403296,78,5352,130000.0,43333.0,-68.0,-64.0,-74.0,-70.0,-68.0,-64.0,-74.0,-69.0,-88.0,-91.0,-87.0,-91.0,20.0,27.0,13.0,21.0,1
4,F8:59:71:5A:E0:3D,3263268,478070083,54227,72738096,3209041,405331987,0,51724,31437519,46962,30868511,4762,569008,29970,16,56938,1425,0,475,144444.0,43333.0,-67.0,-75.0,-65.0,-70.0,-66.0,-74.0,-65.0,-69.0,-88.0,-91.0,-87.0,-91.0,21.0,16.0,22.0,21.0,1
5,CC:2F:71:3E:C5:1F,3220377,406718600,11334,1386411,3209043,405332189,6,48441,4055847,40040,3060461,8401,995386,11949,34,16298,186,6,818,130000.0,39000.0,-69.0,-69.0,-68.0,-61.0,-70.0,-70.0,-68.0,-62.0,-88.0,-91.0,-87.0,-91.0,19.0,22.0,19.0,30.0,1
6,CC:2F:71:3F:1F:24,7304261,6646001034,4095217,6240668785,3209044,405332249,78,917641,540912038,909150,539892260,8491,1019778,867287,618,4099935,403302,78,5352,130000.0,43333.0,-69.0,-64.0,-75.0,-70.0,-69.0,-64.0,-74.0,-70.0,-88.0,-91.0,-87.0,-91.0,19.0,27.0,12.0,21.0,1
7,F8:59:71:5A:E0:3D,3263338,478168651,54290,72835998,3209048,405332653,0,51788,31536079,47026,30967071,4762,569008,30034,16,57002,1427,0,475,144444.0,43333.0,-67.0,-74.0,-65.0,-70.0,-66.0,-74.0,-65.0,-69.0,-88.0,-91.0,-87.0,-91.0,21.0,17.0,22.0,21.0,1
8,CC:2F:71:3E:C5:1F,3220384,406719266,11334,1386411,3209050,405332855,6,48441,4055847,40040,3060461,8401,995386,11949,34,16298,186,6,818,130000.0,39000.0,-69.0,-69.0,-68.0,-61.0,-70.0,-70.0,-68.0,-62.0,-88.0,-91.0,-87.0,-91.0,19.0,22.0,19.0,30.0,1
9,CC:2F:71:3F:1F:24,7304424,6646206186,4095374,6240873331,3209050,405332855,78,917784,541107698,909293,540087920,8491,1019778,867430,618,4100092,403308,78,5352,144444.0,43333.0,-69.0,-65.0,-74.0,-70.0,-69.0,-64.0,-73.0,-70.0,-88.0,-91.0,-87.0,-91.0,19.0,26.0,13.0,21.0,1
10,F8:59:71:5A:E0:3D,3263405,478268425,54355,72935570,3209050,405332855,0,51852,31634639,47090,31065631,4762,569008,30098,16,57067,1433,0,475,144444.0,43333.0,-67.0,-74.0,-65.0,-70.0,-67.0,-74.0,-65.0,-69.0,-88.0,-91.0,-87.0,-91.0,21.0,17.0,22.0,21.0,1
11,CC:2F:71:3E:C5:1F,3220385,406719382,11335,1386527,3209050,405332855,6,48443,4055987,40042,3060601,8401,995386,11949,34,16299,186,6,818,130000.0,39000.0,-69.0,-69.0,-68.0,-61.0,-70.0,-70.0,-68.0,-62.0,-88.0,-91.0,-87.0,-91.0,19.0,22.0,19.0,30.0,1
12,CC:2F:71:3F:1F:24,7304584,6646414124,4095534,6241081269,3209050,405332855,78,917930,541307978,909439,540288200,8491,1019778,867576,618,4100252,403314,78,5352,144444.0,43333.0,-69.0,-64.0,-74.0,-70.0,-68.0,-64.0,-73.0,-70.0,-88.0,-91.0,-87.0,-91.0,19.0,27.0,13.0,21.0,1
13,F8:59:71:5A:E0:3D,3263475,478365501,54417,73031918,3209058,405333583,0,51917,31733373,47154,31164247,4763,569126,30161,16,57129,1434,0,475,144444.0,43333.0,-67.0,-74.0,-65.0,-70.0,-67.0,-74.0,-65.0,-70.0,-88.0,-91.0,-87.0,-91.0,21.0,17.0,22.0,21.0,1
14,CC:2F:71:3E:C5:1F,3220393,406720110,11335,1386527,3209058,405333583,6,48443,4055987,40042,3060601,8401,995386,11949,34,16299,186,6,818,130000.0,39000.0,-69.0,-69.0,-68.0,-61.0,-70.0,-70.0,-68.0,-62.0,-88.0,-91.0,-87.0,-91.0,19.0,22.0,19.0,30.0,1
15,CC:2F:71:3F:1F:24,7304758,6646627289,4095700,6241293706,3209058,405333583,78,918083,541512480,909592,540492702,8491,1019778,867727,618,4100418,403337,78,5352,130000.0,43333.0,-68.0,-65.0,-73.0,-70.0,-68.0,-64.0,-73.0,-69.0,-88.0,-91.0,-87.0,-91.0,20.0,26.0,14.0,21.0,1
16,F8:59:71:5A:E0:3D,3263541,478465159,54481,73131374,3209060,405333785,0,51981,31831933,47218,31262807,4763,569126,30225,16,57193,1440,0,475,144444.0,43333.0,-67.0,-74.0,-65.0,-69.0,-67.0,-74.0,-65.0,-69.0,-88.0,-91.0,-87.0,-92.0,21.0,17.0,22.0,23.0,1
17,CC:2F:71:3E:C5:1F,3220395,406720312,11335,1386527,3209060,405333785,6,48443,4055987,40042,3060601,8401,995386,11949,34,16299,186,6,818,130000.0,39000.0,-69.0,-69.0,-68.0,-61.0,-70.0,-70.0,-68.0,-62.0,-88.0,-91.0,-87.0,-92.0,19.0,22.0,19.0,31.0,1
18,CC:2F:71:3F:1F:24,7304917,6646832205,4095857,6241498420,3209060,405333785,78,918226,541711002,909735,540691224,8491,1019778,867869,618,4100575,403347,78,5352,130000.0,43333.0,-68.0,-64.0,-73.0,-70.0,-68.0,-64.0,-73.0,-70.0,-88.0,-91.0,-87.0,-92.0,20.0,27.0,14.0,22.0,1
19,F8:59:71:5A:E0:3D,3263611,478563729,54544,73229276,3209067,405334453,0,52044,31928953,47281,31359827,4763,569126,30288,16,57256,1441,0,475,144444.0,43333.0,-67.0,-74.0,-65.0,-70.0,-67.0,-74.0,-65.0,-69.0,-88.0,-91.0,-87.0,-92.0,21.0,17.0,22.0,22.0,1
20,CC:2F:71:3E:C5:1F,3220402,406720980,11335,1386527,3209067,405334453,6,48445,4056175,40043,3060671,8402,995504,11950,34,16299,186,6,818,130000.0,39000.0,-69.0,-69.0,-69.0,-61.0,-69.0,-69.0,-68.0,-61.0,-88.0,-91.0,-87.0,-92.0,19.0,22.0,18.0,31.0,1
21,CC:2F:71:3F:1F:24,7305083,6647040527,4096016,6241706074,3209067,405334453,78,918371,541908332,909880,540888554,8491,1019778,868013,618,4100734,403368,78,5352,144444.0,43333.0,-68.0,-64.0,-72.0,-70.0,-68.0,-64.0,-72.0,-69.0,-88.0,-91.0,-87.0,-92.0,20.0,27.0,15.0,22.0,1
22,F8:59:71:5A:E0:3D,3263677,478661893,54607,73327178,3209070,405334715,0,52107,32025973,47344,31456847,4763,569126,30351,16,57319,1443,0,475,144444.0,43333.0,-67.0,-74.0,-66.0,-70.0,-67.0,-74.0,-65.0,-69.0,-88.0,-91.0,-87.0,-92.0,21.0,17.0,21.0,22.0,1
23,CC:2F:71:3E:C5:1F,3220405,406721242,11335,1386527,3209070,405334715,6,48445,4056175,40043,3060671,8402,995504,11950,34,16299,186,6,818,130000.0,39000.0,-69.0,-69.0,-69.0,-61.0,-69.0,-69.0,-68.0,-61.0,-88.0,-91.0,-87.0,-92.0,19.0,22.0,18.0,31.0,1
24,CC:2F:71:3F:1F:24,7305243,6647244023,4096173,6241909308,3209070,405334715,78,918513,542102620,910022,541082842,8491,1019778,868155,618,4100891,403397,78,5352,130000.0,43333.0,-69.0,-65.0,-73.0,-71.0,-68.0,-65.0,-73.0,-70.0,-88.0,-91.0,-87.0,-92.0,19.0,26.0,14.0,21.0,1
25,F8:59:71:5A:E0:3D,3263747,478760463,54670,73425080,3209077,405335383,0,52170,32122993,47407,31553867,4763,569126,30414,16,57382,1445,0,475,144444.0,43333.0,-67.0,-74.0,-65.0,-70.0,-66.0,-74.0,-65.0,-69.0,-88.0,-91.0,-87.0,-92.0,21.0,17.0,22.0,22.0,1
26,CC:2F:71:3E:C5:1F,3220412,406721910,11335,1386527,3209077,405335383,6,48445,4056175,40043,3060671,8402,995504,11950,34,16299,186,6,818,130000.0,39000.0,-69.0,-69.0,-69.0,-61.0,-69.0,-69.0,-68.0,-61.0,-88.0,-91.0,-87.0,-92.0,19.0,22.0,18.0,31.0,1
27,CC:2F:71:3F:1F:24,7305417,6647456116,4096340,6242120733,3209077,405335383,78,918667,542304393,910174,541284379,8493,1020014,868308,618,4101057,403404,78,5354,130000.0,43333.0,-68.0,-64.0,-73.0,-70.0,-68.0,-64.0,-73.0,-70.0,-88.0,-91.0,-87.0,-92.0,20.0,27.0,14.0,22.0,1
28,F8:59:71:5A:E0:3D,3263811,478856957,54732,73521372,3209079,405335585,0,52232,32218473,47469,31649347,4763,569126,30476,16,57444,1445,0,475,130000.0,39000.0,-67.0,-74.0,-65.0,-69.0,-67.0,-74.0,-65.0,-69.0,-88.0,-91.0,-88.0,-92.0,21.0,17.0,23.0,23.0,1
29,CC:2F:71:3E:C5:1F,3220414,406722112,11335,1386527,3209079,405335585,6,48445,4056175,40043,3060671,8402,995504,11950,34,16299,186,6,818,130000.0,39000.0,-69.0,-69.0,-69.0,-61.0,-69.0,-69.0,-68.0,-61.0,-88.0,-91.0,-88.0,-92.0,19.0,22.0,19.0,31.0,1
30,CC:2F:71:3F:1F:24,7305576,6647660864,4096497,6242325279,3209079,405335585,78,918818,542509775,910325,541489761,8493,1020014,868452,618,4101215,403408,78,5354,144444.0,43333.0,-69.0,-65.0,-74.0,-70.0,-68.0,-64.0,-73.0,-69.0,-88.0,-91.0,-88.0,-92.0,19.0,26.0,14.0,22.0,1
31,F8:59:71:5A:E0:3D,3263883,478961427,54799,73625378,3209084,405336049,0,52299,32321653,47536,31752527,4763,569126,30543,16,57510,1446,0,475,144444.0,43333.0,-67.0,-74.0,-65.0,-70.0,-67.0,-74.0,-65.0,-70.0,-88.0,-91.0,-88.0,-92.0,21.0,17.0,23.0,22.0,1
32,CC:2F:71:3E:C5:1F,3220421,406722778,11335,1386527,3209086,405336251,6,48445,4056175,40043,3060671,8402,995504,11950,34,16299,186,6,818,130000.0,39000.0,-69.0,-69.0,-69.0,-61.0,-69.0,-69.0,-68.0,-61.0,-88.0,-91.0,-88.0,-92.0,19.0,22.0,19.0,31.0,1
33,CC:2F:71:3F:1F:24,7305745,6647873734,4096659,6242537483,3209086,405336251,78,918970,542719365,910477,541699351,8493,1020014,868603,618,4101377,403423,78,5354,130000.0,43333.0,-69.0,-65.0,-75.0,-71.0,-68.0,-64.0,-73.0,-70.0,-88.0,-91.0,-88.0,-92.0,19.0,26.0,13.0,21.0,1
34,F8:59:71:5A:E0:3D,3263951,479060006,54862,73723280,3209089,405336726,0,52360,32415593,47597,31846467,4763,569126,30604,16,57574,1449,0,475,144444.0,43333.0,-67.0,-74.0,-65.0,-70.0,-67.0,-74.0,-65.0,-70.0,-88.0,-91.0,-88.0,-92.0,21.0,17.0,23.0,22.0,1
35,CC:2F:71:3E:C5:1F,3220424,406723253,11335,1386527,3209089,405336726,6,48445,4056175,40043,3060671,8402,995504,11950,34,16299,186,6,818,130000.0,39000.0,-69.0,-69.0,-69.0,-61.0,-69.0,-69.0,-68.0,-61.0,-88.0,-91.0,-88.0,-92.0,19.0,22.0,19.0,31.0,1
36,CC:2F:71:3F:1F:24,7305908,6648083417,4096819,6242746691,3209089,405336726,78,919119,542924335,910626,541904321,8493,1020014,868747,618,4101536,403438,78,5354,144444.0,43333.0,-69.0,-65.0,-75.0,-71.0,-68.0,-64.0,-73.0,-70.0,-88.0,-91.0,-88.0,-92.0,19.0,26.0,13.0,21.0,1
37,F8:59:71:5A:E0:3D,3264016,479158110,54925,73821182,3209091,405336928,0,52428,32517387,47665,31948261,4763,569126,30669,16,57637,1450,0,475,144444.0,43333.0,-67.0,-75.0,-66.0,-70.0,-66.0,-74.0,-65.0,-70.0,-88.0,-91.0,-88.0,-92.0,21.0,16.0,22.0,22.0,1
38,CC:2F:71:3E:C5:1F,3220426,406723455,11335,1386527,3209091,405336928,6,48445,4056175,40043,3060671,8402,995504,11950,34,16299,186,6,818,130000.0,39000.0,-69.0,-69.0,-69.0,-61.0,-69.0,-69.0,-68.0,-61.0,-88.0,-91.0,-88.0,-92.0,19.0,22.0,19.0,31.0,1
39,CC:2F:71:3F:1F:24,7306522,6648852096,4097430,6243515034,3209092,405337062,78,919472,543159734,910979,542139720,8493,1020014,869097,618,4102148,403513,78,5356,130000.0,43333.0,-68.0,-65.0,-74.0,-71.0,-68.0,-64.0,-73.0,-71.0,-88.0,-91.0,-88.0,-92.0,20.0,26.0,14.0,21.0,1
40,F8:59:71:5A:E0:3D,3264086,479256678,54988,73919084,3209098,405337594,0,52490,32612867,47727,32043741,4763,569126,30731,16,57700,1450,0,475,144444.0,43333.0,-67.0,-75.0,-66.0,-70.0,-67.0,-74.0,-65.0,-70.0,-88.0,-91.0,-88.0,-92.0,21.0,16.0,22.0,22.0,1
41,CC:2F:71:3E:C5:1F,3220433,406724121,11335,1386527,3209098,405337594,6,48445,4056175,40043,3060671,8402,995504,11950,34,16299,186,6,818,130000.0,39000.0,-69.0,-69.0,-69.0,-61.0,-69.0,-69.0,-68.0,-61.0,-88.0,-91.0,-88.0,-92.0,19.0,22.0,19.0,31.0,1
42,CC:2F:71:3F:1F:24,7306882,6649309080,4097784,6243971486,3209098,405337594,78,919711,543376566,911218,542356552,8493,1020014,869332,618,4102502,403520,78,5357,130000.0,43333.0,-69.0,-65.0,-75.0,-71.0,-68.0,-64.0,-73.0,-70.0,-88.0,-91.0,-88.0,-92.0,19.0,26.0,13.0,21.0,1
43,F8:59:71:5A:E0:3D,3264150,479356134,55052,74018540,3209098,405337594,0,52556,32714521,47793,32145395,4763,569126,30796,16,57764,1451,0,475,144444.0,43333.0,-67.0,-74.0,-65.0,-70.0,-66.0,-74.0,-65.0,-69.0,-88.0,-91.0,-88.0,-92.0,21.0,17.0,23.0,22.0,1
44,CC:2F:71:3E:C5:1F,3220435,406724323,11335,1386527,3209100,405337796,6,48445,4056175,40043,3060671,8402,995504,11950,34,16299,186,6,818,130000.0,39000.0,-69.0,-69.0,-69.0,-61.0,-69.0,-69.0,-68.0,-61.0,-88.0,-91.0,-88.0,-92.0,19.0,22.0,19.0,31.0,1
45,CC:2F:71:3F:1F:24,7307234,6649759402,4098134,6244421606,3209100,405337796,78,919950,543596108,911457,542576094,8493,1020014,869562,618,4102852,403564,78,5357,117000.0,39000.0,-69.0,-65.0,-74.0,-70.0,-69.0,-64.0,-74.0,-70.0,-88.0,-91.0,-88.0,-92.0,19.0,26.0,14.0,22.0,1
46,F8:59:71:5A:E0:3D,3264222,479456398,55116,74117996,3209106,405338402,0,52621,32814635,47858,32245509,4763,569126,30860,16,57828,1453,0,475,144444.0,43333.0,-67.0,-74.0,-66.0,-70.0,-67.0,-74.0,-65.0,-70.0,-88.0,-91.0,-88.0,-92.0,21.0,17.0,22.0,22.0,1
47,CC:2F:71:3E:C5:1F,3220441,406724929,11335,1386527,3209106,405338402,6,48445,4056175,40043,3060671,8402,995504,11950,34,16299,186,6,818,130000.0,39000.0,-69.0,-69.0,-69.0,-61.0,-69.0,-69.0,-68.0,-61.0,-88.0,-91.0,-88.0,-92.0,19.0,22.0,19.0,31.0,1
48,CC:2F:71:3F:1F:24,7307594,6650217143,4098488,6244878741,3209106,405338402,78,920194,543811445,911701,542791431,8493,1020014,869796,618,4103206,403711,78,5358,104000.0,26000.0,-68.0,-65.0,-73.0,-68.0,-68.0,-65.0,-73.0,-68.0,-88.0,-91.0,-88.0,-92.0,20.0,26.0,15.0,24.0,1
49,F8:59:71:5A:E0:3D,3264287,479555914,55180,74217452,3209107,405338462,0,52685,32913195,47922,32344069,4763,569126,30924,16,57892,1454,0,475,144444.0,43333.0,-67.0,-75.0,-66.0,-70.0,-67.0,-74.0,-66.0,-70.0,-88.0,-91.0,-88.0,-92.0,21.0,16.0,22.0,22.0,1
50,CC:2F:71:3E:C5:1F,3220442,406724989,11335,1386527,3209107,405338462,6,48445,4056175,40043,3060671,8402,995504,11950,34,16299,186,6,818,130000.0,39000.0,-69.0,-69.0,-69.0,-61.0,-69.0,-69.0,-68.0,-61.0,-89.0,-92.0,-88.0,-92.0,20.0,23.0,19.0,31.0,1
51,CC:2F:71:3F:1F:24,7307947,6650670381,4098840,6245331919,3209107,405338462,78,920426,544021518,911933,543001504,8493,1020014,870026,618,4103558,403714,78,5359,104000.0,26000.0,-69.0,-65.0,-74.0,-69.0,-69.0,-65.0,-73.0,-68.0,-89.0,-92.0,-88.0,-92.0,20.0,27.0,14.0,23.0,1
52,F8:59:71:5A:E0:3D,3264355,479652868,55242,74313800,3209113,405339068,0,52747,33008675,47984,32439549,4763,569126,30986,16,57954,1454,0,475,144444.0,43333.0,-67.0,-75.0,-66.0,-70.0,-66.0,-74.0,-66.0,-70.0,-89.0,-92.0,-88.0,-92.0,22.0,17.0,22.0,22.0,1
53,CC:2F:71:3E:C5:1F,3220448,406725595,11335,1386527,3209113,405339068,6,48445,4056175,40043,3060671,8402,995504,11950,34,16299,186,6,818,130000.0,39000.0,-69.0,-69.0,-69.0,-61.0,-69.0,-69.0,-68.0,-61.0,-89.0,-92.0,-88.0,-92.0,20.0,23.0,19.0,31.0,1
54,CC:2F:71:3F:1F:24,7308305,6651119891,4099190,6245780621,3209115,405339270,78,920657,544235747,912164,543215733,8493,1020014,870252,618,4103908,403717,78,5359,115556.0,28889.0,-69.0,-65.0,-74.0,-69.0,-68.0,-65.0,-74.0,-68.0,-89.0,-92.0,-88.0,-92.0,20.0,27.0,14.0,23.0,1
55,F8:59:71:5A:E0:3D,3264421,479751088,55306,74411818,3209115,405339270,0,52811,33105801,48048,32536675,4763,569126,31050,16,58018,1456,0,475,144444.0,43333.0,-67.0,-74.0,-66.0,-70.0,-67.0,-74.0,-66.0,-70.0,-88.0,-92.0,-88.0,-92.0,21.0,18.0,22.0,22.0,1
56,CC:2F:71:3E:C5:1F,3220450,406725797,11335,1386527,3209115,405339270,6,48445,4056175,40043,3060671,8402,995504,11950,34,16299,186,6,818,130000.0,39000.0,-69.0,-69.0,-69.0,-61.0,-69.0,-69.0,-68.0,-61.0,-88.0,-92.0,-88.0,-92.0,19.0,23.0,19.0,31.0,1
57,CC:2F:71:3F:1F:24,7308804,6651777968,4099689,6246438698,3209115,405339270,78,920950,544457287,912457,543437273,8493,1020014,870544,618,4104407,403740,78,5360,130000.0,43333.0,-69.0,-65.0,-73.0,-69.0,-69.0,-65.0,-73.0,-69.0,-88.0,-92.0,-88.0,-92.0,19.0,27.0,15.0,23.0,1
58,F8:59:71:5A:E0:3D,3264490,479848102,55368,74508166,3209122,405339936,0,52873,33201281,48110,32632155,4763,569126,31112,16,58080,1456,0,475,144444.0,43333.0,-67.0,-75.0,-66.0,-70.0,-66.0,-74.0,-66.0,-70.0,-88.0,-92.0,-88.0,-92.0,21.0,17.0,22.0,22.0,1
59,CC:2F:71:3E:C5:1F,3220457,406726463,11335,1386527,3209122,405339936,6,48445,4056175,40043,3060671,8402,995504,11950,34,16299,186,6,818,130000.0,39000.0,-69.0,-69.0,-69.0,-61.0,-69.0,-69.0,-68.0,-61.0,-88.0,-92.0,-88.0,-92.0,19.0,23.0,19.0,31.0,1
60,CC:2F:71:3F:1F:24,7309205,6652270972,4100083,6246931036,3209122,405339936,78,921210,544672217,912717,543652203,8493,1020014,870801,618,4104801,403748,78,5360,130000.0,43333.0,-69.0,-65.0,-74.0,-69.0,-69.0,-65.0,-73.0,-68.0,-88.0,-92.0,-88.0,-92.0,19.0,27.0,14.0,23.0,1
61,F8:59:71:5A:E0:3D,3264556,479947760,55432,74607622,3209124,405340138,0,52937,33299841,48174,32730715,4763,569126,31176,16,58143,1459,0,475,144444.0,43333.0,-66.0,-74.0,-66.0,-69.0,-66.0,-74.0,-66.0,-70.0,-88.0,-92.0,-88.0,-92.0,22.0,18.0,22.0,23.0,1
62,CC:2F:71:3E:C5:1F,3220459,406726665,11335,1386527,3209124,405340138,6,48445,4056175,40043,3060671,8402,995504,11950,34,16299,186,6,818,130000.0,39000.0,-69.0,-69.0,-69.0,-61.0,-69.0,-69.0,-68.0,-61.0,-88.0,-92.0,-88.0,-92.0,19.0,23.0,19.0,31.0,1
63,CC:2F:71:3F:1F:24,7309702,6652929744,4100578,6247589606,3209124,405340138,78,921488,544888084,912995,543868070,8493,1020014,871078,618,4105296,403776,78,5360,130000.0,43333.0,-69.0,-65.0,-73.0,-69.0,-69.0,-65.0,-73.0,-68.0,-88.0,-92.0,-88.0,-92.0,19.0,27.0,15.0,23.0,1
64,F8:59:71:5A:E0:3D,3264620,480044310,55494,74703970,3209126,405340340,0,52999,33395321,48236,32826195,4763,569126,31238,16,58206,1460,0,475,144444.0,43333.0,-67.0,-74.0,-66.0,-70.0,-67.0,-74.0,-66.0,-70.0,-88.0,-91.0,-87.0,-91.0,21.0,17.0,21.0,21.0,1
65,CC:2F:71:3E:C5:1F,3220463,406727069,11335,1386527,3209128,405340542,6,48445,4056175,40043,3060671,8402,995504,11950,34,16299,186,6,818,130000.0,39000.0,-69.0,-69.0,-69.0,-61.0,-69.0,-69.0,-68.0,-61.0,-88.0,-91.0,-87.0,-91.0,19.0,22.0,18.0,30.0,1
66,CC:2F:71:3F:1F:24,7310113,6653418402,4100982,6248077598,3209131,405340804,78,921768,545106267,913275,544086253,8493,1020014,871354,618,4105700,403791,78,5360,130000.0,43333.0,-69.0,-65.0,-74.0,-69.0,-69.0,-65.0,-74.0,-69.0,-88.0,-91.0,-87.0,-91.0,19.0,26.0,13.0,22.0,1
67,F8:59:71:5A:E0:3D,3264690,480142878,55557,74801872,3209133,405341006,0,53062,33492341,48299,32923215,4763,569126,31301,16,58269,1465,0,475,144444.0,43333.0,-67.0,-75.0,-66.0,-70.0,-67.0,-74.0,-65.0,-70.0,-87.0,-91.0,-87.0,-91.0,20.0,16.0,21.0,21.0,1
68,CC:2F:71:3E:C5:1F,3220468,406727533,11335,1386527,3209133,405341006,6,48445,4056175,40043,3060671,8402,995504,11950,34,16299,186,6,818,130000.0,39000.0,-69.0,-69.0,-69.0,-61.0,-69.0,-69.0,-68.0,-61.0,-87.0,-91.0,-87.0,-91.0,18.0,22.0,18.0,30.0,1
69,CC:2F:71:3F:1F:24,7310274,6653624722,4101141,6248283716,3209133,405341006,78,921921,545313209,913428,544293195,8493,1020014,871498,618,4105859,403824,78,5360,130000.0,39000.0,-70.0,-65.0,-73.0,-71.0,-70.0,-65.0,-74.0,-70.0,-87.0,-91.0,-87.0,-91.0,17.0,26.0,14.0,20.0,1
70,F8:59:71:5A:E0:3D,3264754,480239428,55619,74898220,3209135,405341208,0,53125,33589375,48362,33020249,4763,569126,31363,16,58331,1465,0,475,144444.0,43333.0,-67.0,-74.0,-65.0,-70.0,-66.0,-74.0,-65.0,-70.0,-87.0,-91.0,-87.0,-91.0,20.0,17.0,22.0,21.0,1
71,CC:2F:71:3E:C5:1F,3220470,406727735,11335,1386527,3209135,405341208,6,48445,4056175,40043,3060671,8402,995504,11950,34,16299,186,6,818,130000.0,39000.0,-69.0,-69.0,-69.0,-61.0,-69.0,-69.0,-68.0,-61.0,-87.0,-91.0,-87.0,-91.0,18.0,22.0,18.0,30.0,1
72,CC:2F:71:3F:1F:24,7310431,6653827898,4101296,6248486690,3209135,405341208,78,922067,545510745,913574,544490731,8493,1020014,871640,618,4106014,403826,78,5360,130000.0,43333.0,-69.0,-64.0,-74.0,-69.0,-69.0,-64.0,-73.0,-69.0,-87.0,-91.0,-87.0,-91.0,18.0,27.0,13.0,22.0,1
73,F8:59:71:5A:E0:3D,3264823,480337936,55682,74996122,3209141,405341814,0,53189,33687949,48426,33118823,4763,569126,31426,16,58394,1467,0,475,144444.0,43333.0,-67.0,-74.0,-66.0,-70.0,-66.0,-74.0,-65.0,-70.0,-87.0,-91.0,-87.0,-91.0,20.0,17.0,21.0,21.0,1
74,CC:2F:71:3E:C5:1F,3220477,406728401,11335,1386527,3209142,405341874,6,48445,4056175,40043,3060671,8402,995504,11950,34,16299,186,6,818,130000.0,39000.0,-69.0,-69.0,-69.0,-61.0,-69.0,-69.0,-68.0,-61.0,-87.0,-91.0,-87.0,-91.0,18.0,22.0,18.0,30.0,1
75,CC:2F:71:3F:1F:24,7310595,6654034422,4101453,6248692548,3209142,405341874,78,922215,545714429,913722,544694415,8493,1020014,871783,618,4106171,403834,78,5360,130000.0,43333.0,-69.0,-64.0,-74.0,-69.0,-69.0,-64.0,-73.0,-69.0,-87.0,-91.0,-87.0,-91.0,18.0,27.0,13.0,22.0,1
76,F8:59:71:5A:E0:3D,3264886,480434344,55744,75092470,3209142,405341874,0,53251,33783429,48488,33214303,4763,569126,31488,16,58456,1467,0,475,144444.0,43333.0,-67.0,-75.0,-66.0,-70.0,-67.0,-74.0,-65.0,-70.0,-88.0,-92.0,-87.0,-91.0,21.0,17.0,21.0,21.0,1
77,CC:2F:71:3E:C5:1F,3220479,406728603,11335,1386527,3209144,405342076,6,48445,4056175,40043,3060671,8402,995504,11950,34,16299,186,6,818,130000.0,39000.0,-69.0,-69.0,-69.0,-61.0,-69.0,-69.0,-68.0,-61.0,-88.0,-92.0,-87.0,-91.0,19.0,23.0,18.0,30.0,1
78,CC:2F:71:3F:1F:24,7310756,6654240686,4101612,6248898610,3209144,405342076,78,922367,545918351,913874,544898337,8493,1020014,871931,618,4106330,403858,78,5360,130000.0,43333.0,-69.0,-64.0,-74.0,-69.0,-68.0,-64.0,-73.0,-69.0,-88.0,-92.0,-87.0,-91.0,19.0,28.0,13.0,22.0,1
79,F8:59:71:5A:E0:3D,3264959,480534881,55808,75191926,3209151,405342955,0,53315,33882003,48552,33312877,4763,569126,31551,16,58519,1468,0,475,144444.0,43333.0,-67.0,-75.0,-65.0,-70.0,-67.0,-74.0,-65.0,-70.0,-88.0,-92.0,-87.0,-91.0,21.0,17.0,22.0,21.0,1
80,CC:2F:71:3E:C5:1F,3220486,406729482,11335,1386527,3209151,405342955,6,48445,4056175,40043,3060671,8402,995504,11950,34,16299,186,6,818,130000.0,39000.0,-69.0,-69.0,-69.0,-61.0,-69.0,-69.0,-68.0,-61.0,-88.0,-92.0,-87.0,-91.0,19.0,23.0,18.0,30.0,1
81,CC:2F:71:3F:1F:24,7310926,6654449340,4101775,6249106385,3209151,405342955,78,922520,546118552,914027,545098538,8493,1020014,872081,618,4106493,403871,78,5360,130000.0,43333.0,-68.0,-64.0,-73.0,-69.0,-68.0,-64.0,-72.0,-69.0,-88.0,-92.0,-87.0,-91.0,20.0,28.0,14.0,22.0,1
82,F8:59:71:5A:E0:3D,3265021,480629735,55869,75286720,3209152,405343015,0,53378,33979023,48615,33409897,4763,569126,31614,16,58581,1469,0,475,144444.0,43333.0,-66.0,-74.0,-65.0,-69.0,-66.0,-74.0,-65.0,-69.0,-88.0,-92.0,-87.0,-91.0,22.0,18.0,22.0,22.0,1
83,CC:2F:71:3E:C5:1F,3220487,406729542,11335,1386527,3209152,405343015,6,48445,4056175,40043,3060671,8402,995504,11950,34,16299,186,6,818,130000.0,39000.0,-69.0,-69.0,-69.0,-61.0,-69.0,-69.0,-68.0,-61.0,-88.0,-92.0,-87.0,-91.0,19.0,23.0,18.0,30.0,1
84,CC:2F:71:3F:1F:24,7311087,6654660200,4101935,6249317185,3209152,405343015,78,922675,546331380,914182,545311366,8493,1020014,872228,618,4106653,403876,78,5360,130000.0,43333.0,-68.0,-64.0,-71.0,-69.0,-68.0,-64.0,-72.0,-69.0,-88.0,-92.0,-87.0,-91.0,20.0,28.0,16.0,22.0,1
85,F8:59:71:5A:E0:3D,3265094,480731553,55934,75387730,3209160,405343823,0,53442,34077583,48679,33508457,4763,569126,31678,16,58646,1469,0,475,144444.0,43333.0,-66.0,-73.0,-65.0,-69.0,-66.0,-73.0,-65.0,-69.0,-87.0,-91.0,-87.0,-91.0,21.0,18.0,22.0,22.0,1
86,CC:2F:71:3E:C5:1F,3220495,406730350,11335,1386527,3209160,405343823,6,48445,4056175,40043,3060671,8402,995504,11950,34,16299,186,6,818,130000.0,39000.0,-69.0,-69.0,-69.0,-61.0,-69.0,-69.0,-68.0,-61.0,-87.0,-91.0,-87.0,-91.0,18.0,22.0,18.0,30.0,1
87,CC:2F:71:3F:1F:24,7311252,6654866922,4102092,6249523099,3209160,405343823,78,922822,546534708,914329,545514694,8493,1020014,872371,618,4106810,403881,78,5360,130000.0,43333.0,-67.0,-64.0,-70.0,-69.0,-68.0,-64.0,-72.0,-69.0,-87.0,-91.0,-87.0,-91.0,20.0,27.0,17.0,22.0,1
88,F8:59:71:5A:E0:3D,3265163,480838779,56003,75494956,3209160,405343823,0,53508,34179587,48745,33610461,4763,569126,31739,16,58715,1470,0,477,144444.0,43333.0,-66.0,-74.0,-64.0,-70.0,-65.0,-73.0,-64.0,-69.0,-87.0,-91.0,-86.0,-91.0,21.0,17.0,22.0,21.0,1
89,CC:2F:71:3E:C5:1F,3220497,406730552,11335,1386527,3209162,405344025,6,48445,4056175,40043,3060671,8402,995504,11950,34,16299,186,6,818,130000.0,39000.0,-69.0,-69.0,-69.0,-61.0,-69.0,-69.0,-68.0,-61.0,-87.0,-91.0,-86.0,-91.0,18.0,22.0,17.0,30.0,1
90,CC:2F:71:3F:1F:24,7311474,6655163421,4102312,6249819396,3209162,405344025,78,923043,546843961,914550,545823947,8493,1020014,872583,618,4107029,403909,78,5365,117000.0,39000.0,-67.0,-64.0,-68.0,-69.0,-68.0,-64.0,-71.0,-69.0,-87.0,-91.0,-86.0,-91.0,20.0,27.0,18.0,22.0,1
91,F8:59:71:5A:E0:3D,3265260,480976399,56091,75631708,3209169,405344691,0,53601,34322989,48838,33753863,4763,569126,31831,16,58803,1474,0,478,144444.0,43333.0,-66.0,-74.0,-65.0,-70.0,-66.0,-73.0,-64.0,-69.0,-87.0,-91.0,-86.0,-91.0,21.0,17.0,21.0,21.0,1
92,CC:2F:71:3E:C5:1F,3220504,406731218,11335,1386527,3209169,405344691,6,48445,4056175,40043,3060671,8402,995504,11950,34,16299,186,6,818,130000.0,39000.0,-69.0,-69.0,-69.0,-61.0,-69.0,-69.0,-68.0,-61.0,-87.0,-91.0,-86.0,-91.0,18.0,22.0,17.0,30.0,1
93,CC:2F:71:3F:1F:24,7311644,6655378013,4102475,6250033322,3209169,405344691,78,923197,547052401,914704,546032387,8493,1020014,872735,618,4107193,403915,78,5366,130000.0,43333.0,-69.0,-64.0,-75.0,-71.0,-68.0,-64.0,-72.0,-70.0,-87.0,-91.0,-86.0,-91.0,18.0,27.0,11.0,20.0,1
94,F8:59:71:5A:E0:3D,3265329,481079447,56158,75734388,3209171,405345059,0,53666,34423089,48903,33853963,4763,569126,31896,16,58869,1477,0,478,144444.0,43333.0,-66.0,-72.0,-65.0,-69.0,-65.0,-73.0,-64.0,-69.0,-87.0,-91.0,-86.0,-91.0,21.0,19.0,21.0,22.0,1
95,CC:2F:71:3E:C5:1F,3220509,406731904,11336,1386643,3209173,405345261,6,48446,4056245,40044,3060741,8402,995504,11950,34,16300,186,6,818,130000.0,39000.0,-68.0,-70.0,-66.0,-61.0,-68.0,-69.0,-67.0,-61.0,-87.0,-91.0,-86.0,-91.0,19.0,21.0,20.0,30.0,1
96,CC:2F:71:3F:1F:24,7311912,6655738780,4102739,6250393519,3209173,405345261,78,923389,547266469,914896,546246455,8493,1020014,872923,618,4107438,403937,78,5366,130000.0,39000.0,-69.0,-64.0,-75.0,-71.0,-67.0,-64.0,-71.0,-70.0,-87.0,-91.0,-86.0,-91.0,18.0,27.0,11.0,20.0,1
97,F8:59:71:5A:E0:3D,3265401,481179543,56222,75833676,3209179,405345867,0,53731,34523203,48968,33954077,4763,569126,31960,16,58934,1478,0,478,144444.0,43333.0,-65.0,-72.0,-64.0,-70.0,-65.0,-73.0,-64.0,-69.0,-87.0,-91.0,-86.0,-91.0,22.0,19.0,22.0,21.0,1
98,CC:2F:71:3E:C5:1F,3220515,406732510,11336,1386643,3209179,405345867,6,48447,4056315,40045,3060811,8402,995504,11950,34,16300,186,6,818,130000.0,39000.0,-68.0,-70.0,-68.0,-61.0,-68.0,-69.0,-67.0,-61.0,-87.0,-91.0,-86.0,-91.0,19.0,21.0,18.0,30.0,1
99,CC:2F:71:3F:1F:24,7312165,6656043893,4102985,6250697966,3209180,405345927,78,923584,547475506,915091,546455492,8493,1020014,873114,618,4107703,403961,78,5366,144444.0,43333.0,-67.0,-64.0,-68.0,-70.0,-68.0,-64.0,-74.0,-70.0,-87.0,-91.0,-86.0,-91.0,20.0,27.0,18.0,21.0,1
100,F8:59:71:5A:E0:3D,3265468,481280729,56288,75934802,3209180,405345927,0,53797,34623409,49034,34054283,4763,569126,32026,16,59000,1481,0,478,144444.0,43333.0,-66.0,-73.0,-63.0,-69.0,-66.0,-73.0,-64.0,-69.0,-86.0,-91.0,-86.0,-90.0,20.0,18.0,23.0,21.0,1
101,CC:2F:71:3E:C5:1F,3220517,406732632,11336,1386643,3209181,405345989,6,48447,4056315,40045,3060811,8402,995504,11950,34,16300,186,6,818,130000.0,39000.0,-68.0,-70.0,-68.0,-61.0,-68.0,-69.0,-67.0,-61.0,-86.0,-91.0,-86.0,-90.0,18.0,21.0,18.0,29.0,1
102,CC:2F:71:3F:1F:24,7312522,6656504853,4103339,6251158662,3209183,405346191,78,923835,547708113,915341,546687981,8494,1020132,873352,618,4108057,403999,78,5366,144444.0,43333.0,-69.0,-64.0,-75.0,-71.0,-67.0,-64.0,-70.0,-70.0,-86.0,-91.0,-86.0,-90.0,17.0,27.0,11.0,19.0,1
103,F8:59:71:5A:E0:3D,3265542,481382609,56353,76035812,3209189,405346797,0,53861,34721969,49098,34152843,4763,569126,32090,16,59065,1484,0,478,144444.0,43333.0,-65.0,-73.0,-64.0,-68.0,-66.0,-73.0,-64.0,-69.0,-86.0,-91.0,-86.0,-90.0,21.0,18.0,22.0,22.0,1
104,CC:2F:71:3E:C5:1F,3220525,406733440,11336,1386643,3209189,405346797,6,48447,4056315,40045,3060811,8402,995504,11950,34,16300,186,6,818,130000.0,39000.0,-68.0,-70.0,-68.0,-61.0,-68.0,-69.0,-67.0,-61.0,-86.0,-91.0,-86.0,-90.0,18.0,21.0,18.0,29.0,1
105,CC:2F:71:3F:1F:24,7312878,6656960007,4103689,6251613210,3209189,405346797,78,924074,547923434,915580,546903302,8494,1020132,873588,618,4108407,404014,78,5367,144444.0,43333.0,-67.0,-64.0,-68.0,-70.0,-68.0,-64.0,-72.0,-70.0,-86.0,-91.0,-86.0,-90.0,19.0,27.0,18.0,20.0,1
106,F8:59:71:5A:E0:3D,3265607,481482013,56417,76135156,3209190,405346857,0,53926,34822069,49163,34252943,4763,569126,32155,16,59129,1487,0,478,144444.0,43333.0,-67.0,-74.0,-65.0,-70.0,-65.0,-73.0,-64.0,-69.0,-86.0,-91.0,-86.0,-90.0,19.0,17.0,21.0,20.0,1
107,CC:2F:71:3E:C5:1F,3220526,406733500,11336,1386643,3209190,405346857,6,48447,4056315,40045,3060811,8402,995504,11950,34,16300,186,6,818,130000.0,39000.0,-68.0,-70.0,-68.0,-61.0,-68.0,-69.0,-67.0,-61.0,-86.0,-91.0,-86.0,-90.0,18.0,21.0,18.0,29.0,1
108,CC:2F:71:3F:1F:24,7313229,6657421593,4104039,6252074736,3209190,405346857,78,924305,548147768,915811,547127636,8494,1020132,873816,618,4108756,404039,78,5367,144444.0,43333.0,-69.0,-64.0,-74.0,-71.0,-67.0,-64.0,-70.0,-70.0,-86.0,-91.0,-86.0,-90.0,17.0,27.0,12.0,19.0,1
109,F8:59:71:5A:E0:3D,3265679,481585183,56483,76237720,3209196,405347463,0,53992,34923737,49229,34354611,4763,569126,32221,16,59195,1489,0,479,144444.0,43333.0,-67.0,-75.0,-66.0,-70.0,-66.0,-74.0,-65.0,-69.0,-86.0,-90.0,-85.0,-90.0,19.0,15.0,19.0,20.0,1
110,CC:2F:71:3E:C5:1F,3220534,406734308,11336,1386643,3209198,405347665,6,48447,4056315,40045,3060811,8402,995504,11950,34,16300,186,6,818,130000.0,39000.0,-68.0,-70.0,-68.0,-61.0,-68.0,-69.0,-67.0,-61.0,-86.0,-90.0,-85.0,-90.0,18.0,20.0,17.0,29.0,1
111,CC:2F:71:3F:1F:24,7313598,6657916021,4104400,6252568356,3209198,405347665,78,924551,548409818,916057,547389686,8494,1020132,874060,618,4109105,404111,78,5368,144444.0,43333.0,-69.0,-64.0,-75.0,-71.0,-67.0,-64.0,-71.0,-70.0,-86.0,-90.0,-85.0,-90.0,17.0,26.0,10.0,19.0,1
112,F8:59:71:5A:E0:3D,3265773,481715191,56563,76362040,3209210,405353151,0,54072,35046965,49309,34477839,4763,569126,32301,16,59275,1493,0,480,144444.0,43333.0,-67.0,-75.0,-66.0,-70.0,-66.0,-73.0,-65.0,-69.0,-86.0,-90.0,-85.0,-90.0,19.0,15.0,19.0,20.0,1
113,CC:2F:71:3E:C5:1F,3220546,406739794,11336,1386643,3209210,405353151,6,48449,4056503,40046,3060881,8403,995622,11951,34,16300,186,6,818,130000.0,39000.0,-69.0,-70.0,-69.0,-61.0,-68.0,-69.0,-68.0,-61.0,-86.0,-90.0,-85.0,-90.0,17.0,20.0,16.0,29.0,1
114,CC:2F:71:3F:1F:24,7313982,6658409276,4104770,6253055923,3209212,405353353,78,924800,548646149,916306,547626017,8494,1020132,874308,618,4109487,404145,78,5368,144444.0,43333.0,-67.0,-64.0,-69.0,-70.0,-67.0,-64.0,-70.0,-70.0,-86.0,-90.0,-85.0,-90.0,19.0,26.0,16.0,20.0,1
115,F8:59:71:5A:E0:3D,3265862,481831503,56634,76472262,3209228,405359241,0,54143,35156501,49380,34587375,4763,569126,32372,16,59346,1498,0,480,144444.0,43333.0,-67.0,-74.0,-66.0,-70.0,-66.0,-74.0,-65.0,-70.0,-86.0,-90.0,-85.0,-90.0,19.0,16.0,19.0,20.0,1
116,CC:2F:71:3E:C5:1F,3220564,406745884,11336,1386643,3209228,405359241,6,48449,4056503,40046,3060881,8403,995622,11951,34,16300,186,6,818,130000.0,39000.0,-69.0,-70.0,-69.0,-61.0,-68.0,-69.0,-68.0,-61.0,-86.0,-90.0,-86.0,-90.0,17.0,20.0,17.0,29.0,1
117,CC:2F:71:3F:1F:24,7314341,6658865856,4105111,6253506413,3209230,405359443,78,925022,548856710,916528,547836578,8494,1020132,874529,618,4109829,404167,78,5369,144444.0,43333.0,-69.0,-64.0,-75.0,-71.0,-68.0,-64.0,-71.0,-70.0,-86.0,-90.0,-86.0,-90.0,17.0,26.0,11.0,19.0,1
118,F8:59:71:5A:E0:3D,3265927,481928326,56696,76568610,3209231,405359716,0,54205,35251981,49442,34682855,4763,569126,32434,16,59408,1499,0,480,144444.0,43333.0,-66.0,-74.0,-64.0,-69.0,-66.0,-74.0,-64.0,-69.0,-86.0,-90.0,-86.0,-90.0,20.0,16.0,22.0,21.0,1
119,CC:2F:71:3E:C5:1F,3220567,406746359,11336,1386643,3209231,405359716,6,48449,4056503,40046,3060881,8403,995622,11951,34,16300,186,6,818,130000.0,39000.0,-69.0,-70.0,-69.0,-61.0,-68.0,-69.0,-68.0,-61.0,-86.0,-90.0,-86.0,-90.0,17.0,20.0,17.0,29.0,1
120,CC:2F:71:3F:1F:24,7314690,6659322565,4105459,6253962849,3209231,405359716,78,925254,549073997,916760,548053865,8494,1020132,874756,618,4110176,404226,78,5369,144444.0,43333.0,-66.0,-64.0,-69.0,-70.0,-67.0,-64.0,-70.0,-69.0,-86.0,-90.0,-86.0,-90.0,20.0,26.0,17.0,20.0,1
121,F8:59:71:5A:E0:3D,3265998,482029942,56761,76669620,3209237,405360322,0,54272,35355217,49509,34786091,4763,569126,32497,16,59473,1503,0,480,144444.0,43333.0,-66.0,-73.0,-65.0,-70.0,-65.0,-73.0,-64.0,-70.0,-86.0,-90.0,-86.0,-90.0,20.0,17.0,21.0,20.0,1
122,CC:2F:71:3E:C5:1F,3220573,406746965,11336,1386643,3209237,405360322,6,48449,4056503,40046,3060881,8403,995622,11951,34,16300,186,6,818,130000.0,39000.0,-69.0,-70.0,-69.0,-61.0,-68.0,-69.0,-68.0,-61.0,-86.0,-90.0,-86.0,-90.0,17.0,20.0,17.0,29.0,1
123,CC:2F:71:3F:1F:24,7314858,6659535615,4105621,6254175293,3209237,405360322,78,925408,549285297,916914,548265165,8494,1020132,874905,618,4110339,404255,78,5369,144444.0,43333.0,-69.0,-64.0,-75.0,-70.0,-67.0,-64.0,-69.0,-69.0,-86.0,-90.0,-86.0,-90.0,17.0,26.0,11.0,20.0,1
124,F8:59:71:5A:E0:3D,3266066,482129722,56825,76769076,3209241,405360646,0,54340,35458599,49576,34889355,4764,569244,32564,16,59537,1506,0,481,144444.0,43333.0,-66.0,-74.0,-64.0,-70.0,-66.0,-74.0,-65.0,-70.0,-86.0,-90.0,-86.0,-90.0,20.0,16.0,22.0,20.0,1
125,CC:2F:71:3E:C5:1F,3220577,406747289,11336,1386643,3209241,405360646,6,48449,4056503,40046,3060881,8403,995622,11951,34,16300,186,6,818,130000.0,39000.0,-69.0,-70.0,-69.0,-61.0,-68.0,-69.0,-68.0,-61.0,-86.0,-90.0,-86.0,-90.0,17.0,20.0,17.0,29.0,1
126,CC:2F:71:3F:1F:24,7315101,6659854220,4105860,6254493574,3209241,405360646,78,925571,549491339,917077,548471207,8494,1020132,875063,618,4110577,404313,78,5369,144444.0,43333.0,-68.0,-64.0,-74.0,-70.0,-66.0,-64.0,-70.0,-69.0,-86.0,-90.0,-86.0,-90.0,18.0,26.0,12.0,20.0,1
127,F8:59:71:5A:E0:3D,3266136,482228901,56889,76867649,3209247,405361252,0,54406,35558877,49642,34989633,4764,569244,32628,16,59601,1512,0,481,144444.0,43333.0,-67.0,-74.0,-65.0,-70.0,-65.0,-73.0,-64.0,-69.0,-86.0,-90.0,-86.0,-90.0,19.0,16.0,21.0,20.0,1
128,CC:2F:71:3E:C5:1F,3220583,406747895,11336,1386643,3209247,405361252,6,48449,4056503,40046,3060881,8403,995622,11951,34,16300,186,6,818,130000.0,39000.0,-69.0,-70.0,-69.0,-61.0,-68.0,-69.0,-68.0,-61.0,-86.0,-90.0,-86.0,-90.0,17.0,20.0,17.0,29.0,1
129,CC:2F:71:3F:1F:24,7315269,6660060672,4106022,6254699420,3209247,405361252,78,925727,549697264,917233,548677132,8494,1020132,875215,618,4110739,404354,78,5370,144444.0,43333.0,-67.0,-64.0,-70.0,-70.0,-67.0,-64.0,-69.0,-69.0,-86.0,-90.0,-86.0,-90.0,19.0,26.0,16.0,20.0,1
130,F8:59:71:5A:E0:3D,3266200,482325451,56951,76963997,3209249,405361454,0,54469,35655911,49705,35086667,4764,569244,32690,16,59663,1514,0,481,144444.0,43333.0,-66.0,-74.0,-65.0,-70.0,-66.0,-73.0,-65.0,-70.0,-86.0,-90.0,-86.0,-90.0,20.0,16.0,21.0,20.0,1
131,CC:2F:71:3E:C5:1F,3220586,406748157,11336,1386643,3209250,405361514,6,48449,4056503,40046,3060881,8403,995622,11951,34,16300,186,6,818,130000.0,39000.0,-69.0,-70.0,-69.0,-61.0,-68.0,-69.0,-68.0,-61.0,-86.0,-90.0,-86.0,-90.0,17.0,20.0,17.0,29.0,1
132,CC:2F:71:3F:1F:24,7315432,6660265751,4106182,6254904237,3209250,405361514,78,925880,549899141,917386,548879009,8494,1020132,875361,618,4110900,404372,78,5371,144444.0,43333.0,-69.0,-64.0,-74.0,-70.0,-68.0,-64.0,-73.0,-70.0,-86.0,-90.0,-86.0,-90.0,17.0,26.0,12.0,20.0,1
133,F8:59:71:5A:E0:3D,3266265,482420641,57012,77058791,3209253,405361850,0,54531,35751391,49767,35182147,4764,569244,32752,16,59724,1514,0,481,144444.0,43333.0,-67.0,-74.0,-66.0,-70.0,-67.0,-74.0,-65.0,-69.0,-85.0,-90.0,-85.0,-90.0,18.0,16.0,19.0,20.0,1
134,CC:2F:71:3E:C5:1F,3220590,406748561,11336,1386643,3209254,405361918,6,48449,4056503,40046,3060881,8403,995622,11951,34,16300,186,6,818,130000.0,39000.0,-69.0,-70.0,-69.0,-61.0,-68.0,-69.0,-68.0,-61.0,-85.0,-90.0,-85.0,-90.0,16.0,20.0,16.0,29.0,1
135,CC:2F:71:3F:1F:24,7315596,6660472625,4106340,6255110505,3209256,405362120,78,926029,550101569,917535,549081437,8494,1020132,875505,618,4111058,404394,78,5371,144444.0,43333.0,-69.0,-64.0,-74.0,-70.0,-68.0,-64.0,-73.0,-70.0,-85.0,-90.0,-85.0,-90.0,16.0,26.0,11.0,20.0,1
136,F8:59:71:5A:E0:3D,3266333,482519015,57075,77156693,3209258,405362322,0,54596,35851519,49832,35282275,4764,569244,32815,16,59787,1514,0,481,144444.0,43333.0,-67.0,-74.0,-65.0,-70.0,-67.0,-74.0,-65.0,-70.0,-85.0,-90.0,-85.0,-90.0,18.0,16.0,20.0,20.0,1
137,CC:2F:71:3E:C5:1F,3220594,406748965,11336,1386643,3209258,405362322,6,48449,4056503,40046,3060881,8403,995622,11951,34,16300,186,6,818,130000.0,39000.0,-69.0,-70.0,-69.0,-61.0,-68.0,-69.0,-68.0,-61.0,-85.0,-90.0,-85.0,-90.0,16.0,20.0,16.0,29.0,1
138,CC:2F:71:3F:1F:24,7315754,6660675987,4106496,6255313665,3209258,405362322,78,926178,550303677,917684,549283545,8494,1020132,875650,618,4111214,404411,78,5371,144444.0,43333.0,-69.0,-64.0,-73.0,-70.0,-68.0,-64.0,-73.0,-70.0,-85.0,-90.0,-85.0,-90.0,16.0,26.0,12.0,20.0,1
139,F8:59:71:5A:E0:3D,3266397,482616977,57138,77254595,3209259,405362382,0,54659,35948553,49895,35379309,4764,569244,32877,16,59850,1517,0,481,144444.0,43333.0,-67.0,-74.0,-65.0,-70.0,-67.0,-74.0,-65.0,-70.0,-85.0,-90.0,-85.0,-90.0,18.0,16.0,20.0,20.0,1
140,CC:2F:71:3E:C5:1F,3220597,406749227,11336,1386643,3209261,405362584,6,48449,4056503,40046,3060881,8403,995622,11951,34,16300,186,6,818,130000.0,39000.0,-69.0,-70.0,-69.0,-61.0,-68.0,-69.0,-68.0,-61.0,-85.0,-90.0,-85.0,-90.0,16.0,20.0,16.0,29.0,1
141,CC:2F:71:3F:1F:24,7315980,6660974667,4106719,6255612083,3209261,405362584,78,926357,550511987,917863,549491855,8494,1020132,875826,618,4111437,404451,78,5371,144444.0,43333.0,-69.0,-64.0,-75.0,-70.0,-68.0,-64.0,-74.0,-70.0,-85.0,-90.0,-85.0,-90.0,16.0,26.0,10.0,20.0,1
142,F8:59:71:5A:E0:3D,3266467,482717039,57202,77354051,3209265,405362988,0,54724,36048667,49960,35479423,4764,569244,32941,16,59914,1518,0,481,144444.0,43333.0,-67.0,-75.0,-66.0,-70.0,-66.0,-74.0,-65.0,-70.0,-85.0,-90.0,-85.0,-89.0,18.0,15.0,19.0,19.0,1
143,CC:2F:71:3E:C5:1F,3220603,406749833,11336,1386643,3209267,405363190,6,48449,4056503,40046,3060881,8403,995622,11951,34,16300,186,6,818,130000.0,39000.0,-69.0,-70.0,-69.0,-61.0,-68.0,-69.0,-68.0,-61.0,-85.0,-90.0,-85.0,-89.0,16.0,20.0,16.0,28.0,1
144,CC:2F:71:3F:1F:24,7316273,6661336857,4107006,6255973667,3209267,405363190,78,926566,550721200,918072,549701068,8494,1020132,876029,618,4111723,404493,78,5371,144444.0,43333.0,-69.0,-64.0,-75.0,-71.0,-68.0,-64.0,-73.0,-70.0,-85.0,-90.0,-85.0,-89.0,16.0,26.0,10.0,18.0,1
145,F8:59:71:5A:E0:3D,3266532,482815143,57265,77451953,3209267,405363190,0,54787,36145687,50023,35576443,4764,569244,33004,16,59977,1521,0,481,144444.0,43333.0,-67.0,-75.0,-66.0,-70.0,-67.0,-74.0,-65.0,-70.0,-85.0,-90.0,-85.0,-89.0,18.0,15.0,19.0,19.0,1
146,CC:2F:71:3E:C5:1F,3220603,406749833,11336,1386643,3209267,405363190,6,48449,4056503,40046,3060881,8403,995622,11951,34,16300,186,6,818,130000.0,39000.0,-69.0,-70.0,-69.0,-61.0,-68.0,-69.0,-68.0,-61.0,-85.0,-90.0,-85.0,-89.0,16.0,20.0,16.0,28.0,1
147,CC:2F:71:3F:1F:24,7316625,6661787355,4107358,6256424165,3209267,405363190,78,926804,550937650,918310,549917518,8494,1020132,876261,618,4112076,404528,78,5371,144444.0,43333.0,-69.0,-64.0,-75.0,-70.0,-68.0,-64.0,-73.0,-70.0,-85.0,-90.0,-85.0,-89.0,16.0,26.0,10.0,19.0,1
148,F8:59:71:5A:E0:3D,3266601,482912157,57327,77548301,3209274,405363856,0,54849,36241167,50085,35671923,4764,569244,33066,16,60039,1521,0,481,144444.0,43333.0,-67.0,-75.0,-65.0,-70.0,-67.0,-74.0,-65.0,-70.0,-85.0,-90.0,-85.0,-89.0,18.0,15.0,20.0,19.0,1
149,CC:2F:71:3E:C5:1F,3220610,406750499,11336,1386643,3209274,405363856,6,48449,4056503,40046,3060881,8403,995622,11951,34,16300,186,6,818,130000.0,39000.0,-69.0,-70.0,-69.0,-61.0,-68.0,-69.0,-68.0,-61.0,-85.0,-90.0,-85.0,-89.0,16.0,20.0,16.0,28.0,1
150,CC:2F:71:3F:1F:24,7316984,6662241365,4107710,6256877509,3209274,405363856,78,927044,551155750,918550,550135618,8494,1020132,876496,618,4112428,404572,78,5371,144444.0,43333.0,-69.0,-64.0,-73.0,-70.0,-68.0,-64.0,-73.0,-70.0,-85.0,-90.0,-85.0,-89.0,16.0,26.0,12.0,19.0,1
151,F8:59:71:5A:E0:3D,3266668,483010493,57392,77646435,3209276,405364058,0,54914,36338399,50150,35769155,4764,569244,33131,16,60104,1523,0,481,144444.0,43333.0,-66.0,-74.0,-66.0,-70.0,-66.0,-74.0,-65.0,-70.0,-84.0,-89.0,-84.0,-89.0,18.0,15.0,18.0,19.0,1
152,CC:2F:71:3E:C5:1F,3220612,406750701,11336,1386643,3209276,405364058,6,48449,4056503,40046,3060881,8403,995622,11951,34,16300,186,6,818,130000.0,39000.0,-69.0,-70.0,-69.0,-61.0,-68.0,-69.0,-68.0,-61.0,-84.0,-89.0,-84.0,-89.0,15.0,19.0,15.0,28.0,1
153,CC:2F:71:3F:1F:24,7317337,6662691933,4108061,6257327875,3209276,405364058,78,927274,551364068,918780,550343936,8494,1020132,876726,618,4112779,404626,78,5371,144444.0,43333.0,-69.0,-64.0,-75.0,-70.0,-68.0,-64.0,-74.0,-70.0,-84.0,-89.0,-84.0,-89.0,15.0,25.0,9.0,19.0,1
154,F8:59:71:5A:E0:3D,3266737,483109001,57455,77744337,3209282,405364664,0,54977,36435419,50213,35866175,4764,569244,33194,16,60167,1525,0,481,144444.0,43333.0,-67.0,-74.0,-66.0,-70.0,-66.0,-74.0,-65.0,-70.0,-84.0,-89.0,-84.0,-89.0,17.0,15.0,18.0,19.0,1
155,CC:2F:71:3E:C5:1F,3220618,406751307,11336,1386643,3209282,405364664,6,48449,4056503,40046,3060881,8403,995622,11951,34,16300,186,6,818,130000.0,39000.0,-69.0,-70.0,-69.0,-61.0,-68.0,-69.0,-68.0,-61.0,-84.0,-89.0,-84.0,-89.0,15.0,19.0,15.0,28.0,1
156,CC:2F:71:3F:1F:24,7317695,6663147195,4108413,6257782531,3209282,405364664,78,927507,551578619,919013,550558487,8494,1020132,876957,618,4113131,404703,78,5371,144444.0,43333.0,-69.0,-64.0,-73.0,-70.0,-69.0,-64.0,-73.0,-70.0,-84.0,-89.0,-84.0,-89.0,15.0,25.0,11.0,19.0,1
157,F8:59:71:5A:E0:3D,3266805,483208939,57519,77843793,3209286,405365146,0,55042,36535519,50278,35966275,4764,569244,33259,16,60231,1526,0,481,144444.0,43333.0,-67.0,-74.0,-66.0,-70.0,-66.0,-74.0,-65.0,-70.0,-84.0,-89.0,-84.0,-89.0,17.0,15.0,18.0,19.0,1
158,CC:2F:71:3E:C5:1F,3220622,406751789,11336,1386643,3209286,405365146,6,48449,4056503,40046,3060881,8403,995622,11951,34,16300,186,6,818,130000.0,39000.0,-69.0,-70.0,-69.0,-61.0,-68.0,-69.0,-68.0,-61.0,-84.0,-89.0,-84.0,-89.0,15.0,19.0,15.0,28.0,1
159,CC:2F:71:3F:1F:24,7318057,6663615411,4108771,6258250265,3209286,405365146,78,927749,551807327,919255,550787195,8494,1020132,877194,618,4113489,404794,78,5371,144444.0,43333.0,-69.0,-64.0,-73.0,-70.0,-68.0,-64.0,-73.0,-70.0,-84.0,-89.0,-84.0,-89.0,15.0,25.0,11.0,19.0,1
160,F8:59:71:5A:E0:3D,3266878,483315288,57587,77949465,3209291,405365823,0,55109,36638727,50345,36069483,4764,569244,33326,16,60299,1526,0,481,144444.0,43333.0,-66.0,-74.0,-65.0,-71.0,-66.0,-74.0,-65.0,-70.0,-84.0,-89.0,-84.0,-89.0,18.0,15.0,19.0,18.0,1
161,CC:2F:71:3E:C5:1F,3220629,406752668,11336,1386643,3209293,405366025,6,48449,4056503,40046,3060881,8403,995622,11951,34,16300,186,6,818,130000.0,39000.0,-69.0,-70.0,-69.0,-61.0,-68.0,-69.0,-68.0,-61.0,-84.0,-89.0,-84.0,-89.0,15.0,19.0,15.0,28.0,1
162,CC:2F:71:3F:1F:24,7318414,6664066358,4109121,6258700333,3209293,405366025,78,927982,552019012,919488,550998880,8494,1020132,877422,618,4113839,404866,78,5371,144444.0,43333.0,-69.0,-64.0,-75.0,-70.0,-68.0,-64.0,-73.0,-70.0,-84.0,-89.0,-84.0,-89.0,15.0,25.0,9.0,19.0,1
163,F8:59:71:5A:E0:3D,3266946,483415092,57651,78048865,3209295,405366227,0,55172,36735747,50408,36166503,4764,569244,33389,16,60363,1526,0,481,130000.0,39000.0,-67.0,-74.0,-65.0,-70.0,-67.0,-74.0,-65.0,-70.0,-84.0,-89.0,-84.0,-89.0,17.0,15.0,19.0,19.0,1
164,CC:2F:71:3E:C5:1F,3220631,406752870,11336,1386643,3209295,405366227,6,48449,4056503,40046,3060881,8403,995622,11951,34,16300,186,6,818,130000.0,39000.0,-69.0,-70.0,-69.0,-61.0,-68.0,-69.0,-68.0,-61.0,-84.0,-89.0,-84.0,-89.0,15.0,19.0,15.0,28.0,1
165,CC:2F:71:3F:1F:24,7318912,6664728189,4109617,6259361962,3209295,405366227,78,928293,552244836,919799,551224704,8494,1020132,877724,618,4114334,404947,78,5372,144444.0,43333.0,-69.0,-64.0,-75.0,-70.0,-68.0,-64.0,-73.0,-70.0,-84.0,-89.0,-84.0,-89.0,15.0,25.0,9.0,19.0,1
166,F8:59:71:5A:E0:3D,3267015,483514900,57715,78148209,3209300,405366691,0,55237,36835847,50473,36266603,4764,569244,33454,16,60427,1530,0,481,144444.0,43333.0,-68.0,-75.0,-65.0,-71.0,-67.0,-74.0,-65.0,-70.0,-84.0,-89.0,-84.0,-89.0,16.0,14.0,19.0,18.0,1
167,CC:2F:71:3E:C5:1F,3220636,406753334,11336,1386643,3209300,405366691,6,48449,4056503,40046,3060881,8403,995622,11951,34,16300,186,6,818,130000.0,39000.0,-69.0,-70.0,-69.0,-61.0,-68.0,-69.0,-68.0,-61.0,-84.0,-89.0,-84.0,-89.0,15.0,19.0,15.0,28.0,1
168,CC:2F:71:3F:1F:24,7319341,6665230097,4110039,6259863204,3209302,405366893,78,928586,552470813,920092,551450681,8494,1020132,878016,618,4114757,405053,78,5373,130000.0,43333.0,-68.0,-64.0,-73.0,-71.0,-68.0,-64.0,-73.0,-70.0,-84.0,-89.0,-84.0,-89.0,16.0,25.0,11.0,18.0,1
169,F8:59:71:5A:E0:3D,3267081,483611652,57777,78244557,3209304,405367095,0,55300,36932867,50536,36363623,4764,569244,33517,16,60489,1532,0,481,144444.0,43333.0,-67.0,-74.0,-65.0,-70.0,-67.0,-74.0,-65.0,-70.0,-84.0,-89.0,-84.0,-89.0,17.0,15.0,19.0,19.0,1
170,CC:2F:71:3E:C5:1F,3220640,406753738,11336,1386643,3209304,405367095,6,48449,4056503,40046,3060881,8403,995622,11951,34,16300,186,6,818,130000.0,39000.0,-69.0,-70.0,-69.0,-61.0,-68.0,-69.0,-68.0,-61.0,-84.0,-89.0,-84.0,-89.0,15.0,19.0,15.0,28.0,1
171,CC:2F:71:3F:1F:24,7319501,6665436567,4110197,6260069472,3209304,405367095,78,928743,552685387,920249,551665255,8494,1020132,878162,618,4114915,405060,78,5373,130000.0,43333.0,-68.0,-64.0,-73.0,-70.0,-68.0,-64.0,-73.0,-70.0,-84.0,-89.0,-84.0,-89.0,16.0,25.0,11.0,19.0,1
172,F8:59:71:5A:E0:3D,3267145,483711108,57841,78344013,3209304,405367095,0,55364,37031441,50600,36462197,4764,569244,33580,16,60553,1535,0,481,144444.0,43333.0,-68.0,-75.0,-66.0,-71.0,-67.0,-74.0,-66.0,-70.0,-83.0,-89.0,-83.0,-89.0,15.0,14.0,17.0,18.0,1
173,CC:2F:71:3E:C5:1F,3220642,406753940,11336,1386643,3209306,405367297,6,48449,4056503,40046,3060881,8403,995622,11951,34,16300,186,6,818,130000.0,39000.0,-69.0,-70.0,-69.0,-61.0,-68.0,-69.0,-68.0,-61.0,-83.0,-89.0,-83.0,-89.0,14.0,19.0,14.0,28.0,1
174,CC:2F:71:3F:1F:24,7319661,6665642813,4110355,6260275516,3209306,405367297,78,928890,552887389,920396,551867257,8494,1020132,878306,618,4115073,405083,78,5374,130000.0,43333.0,-68.0,-64.0,-73.0,-70.0,-68.0,-64.0,-73.0,-70.0,-83.0,-89.0,-83.0,-89.0,15.0,25.0,10.0,19.0,1
175,F8:59:71:5A:E0:3D,3267218,483811432,57905,78443469,3209313,405367963,0,55428,37130001,50664,36560757,4764,569244,33644,16,60617,1539,0,481,144444.0,43333.0,-67.0,-74.0,-66.0,-70.0,-67.0,-74.0,-65.0,-70.0,-83.0,-89.0,-83.0,-89.0,16.0,15.0,17.0,19.0,1
176,CC:2F:71:3E:C5:1F,3220649,406754606,11336,1386643,3209313,405367963,6,48449,4056503,40046,3060881,8403,995622,11951,34,16300,186,6,818,130000.0,39000.0,-69.0,-70.0,-69.0,-61.0,-68.0,-69.0,-68.0,-61.0,-83.0,-89.0,-83.0,-89.0,14.0,19.0,14.0,28.0,1
177,CC:2F:71:3F:1F:24,7319830,6665855571,4110517,6260487608,3209313,405367963,78,929046,553103181,920552,552083049,8494,1020132,878454,618,4115235,405107,78,5374,144444.0,43333.0,-69.0,-64.0,-74.0,-71.0,-68.0,-64.0,-74.0,-71.0,-83.0,-89.0,-83.0,-89.0,14.0,25.0,9.0,18.0,1
178,F8:59:71:5A:E0:3D,3267282,483910888,57969,78542925,3209313,405367963,0,55492,37228561,50728,36659317,4764,569244,33708,16,60681,1545,0,481,144444.0,43333.0,-67.0,-74.0,-66.0,-70.0,-67.0,-74.0,-65.0,-70.0,-83.0,-89.0,-83.0,-89.0,16.0,15.0,17.0,19.0,1
179,CC:2F:71:3E:C5:1F,3220649,406754606,11336,1386643,3209313,405367963,6,48449,4056503,40046,3060881,8403,995622,11951,34,16300,186,6,818,130000.0,39000.0,-69.0,-70.0,-69.0,-61.0,-68.0,-69.0,-68.0,-61.0,-83.0,-89.0,-83.0,-89.0,14.0,19.0,14.0,28.0,1
180,CC:2F:71:3F:1F:24,7319990,6666061971,4110675,6260693806,3209315,405368165,78,929189,553300321,920695,552280189,8494,1020132,878596,618,4115393,405123,78,5375,130000.0,43333.0,-68.0,-64.0,-73.0,-71.0,-68.0,-64.0,-73.0,-70.0,-83.0,-89.0,-83.0,-89.0,15.0,25.0,10.0,18.0,1
181,F8:59:71:5A:E0:3D,3267357,484017282,58038,78648713,3209319,405368569,0,55561,37334835,50797,36765591,4764,569244,33776,16,60750,1546,0,481,144444.0,43333.0,-67.0,-74.0,-65.0,-70.0,-67.0,-74.0,-65.0,-70.0,-83.0,-89.0,-82.0,-88.0,16.0,15.0,17.0,18.0,1
182,CC:2F:71:3E:C5:1F,3220657,406755388,11337,1386759,3209320,405368629,6,48451,4056643,40048,3061021,8403,995622,11951,34,16301,186,6,818,130000.0,39000.0,-68.0,-70.0,-68.0,-61.0,-68.0,-69.0,-68.0,-61.0,-83.0,-89.0,-82.0,-88.0,15.0,19.0,14.0,27.0,1
183,CC:2F:71:3F:1F:24,7320170,6666285550,4110849,6260916787,3209321,405368763,78,929350,553514446,920856,552494314,8494,1020132,878756,618,4115567,405130,78,5375,130000.0,43333.0,-69.0,-64.0,-73.0,-70.0,-68.0,-64.0,-73.0,-70.0,-83.0,-89.0,-82.0,-88.0,14.0,25.0,9.0,18.0,1
184,F8:59:71:5A:E0:3D,3267422,484113892,58100,78745061,3209322,405368831,0,55623,37430315,50859,36861071,4764,569244,33838,16,60812,1548,0,481,144444.0,43333.0,-67.0,-75.0,-66.0,-70.0,-67.0,-74.0,-65.0,-70.0,-83.0,-89.0,-82.0,-88.0,16.0,14.0,16.0,18.0,1
185,CC:2F:71:3E:C5:1F,3220659,406755590,11337,1386759,3209322,405368831,6,48451,4056643,40048,3061021,8403,995622,11951,34,16301,186,6,818,130000.0,39000.0,-68.0,-70.0,-68.0,-61.0,-68.0,-69.0,-68.0,-61.0,-83.0,-89.0,-82.0,-88.0,15.0,19.0,14.0,27.0,1
186,CC:2F:71:3F:1F:24,7320337,6666492702,4111015,6261123871,3209322,405368831,78,929509,553716668,921015,552696536,8494,1020132,878912,618,4115733,405147,78,5375,130000.0,43333.0,-68.0,-64.0,-73.0,-71.0,-68.0,-64.0,-73.0,-70.0,-83.0,-89.0,-82.0,-88.0,15.0,25.0,9.0,17.0,1
187,F8:59:71:5A:E0:3D,3267493,484212849,58163,78842963,3209330,405369886,0,55686,37527335,50922,36958091,4764,569244,33901,16,60875,1551,0,481,144444.0,43333.0,-67.0,-74.0,-66.0,-70.0,-67.0,-74.0,-65.0,-69.0,-83.0,-89.0,-82.0,-88.0,16.0,15.0,16.0,18.0,1
188,CC:2F:71:3E:C5:1F,3220667,406756645,11337,1386759,3209330,405369886,6,48451,4056643,40048,3061021,8403,995622,11951,34,16301,186,6,818,130000.0,39000.0,-68.0,-70.0,-68.0,-61.0,-68.0,-69.0,-68.0,-61.0,-83.0,-89.0,-82.0,-88.0,15.0,19.0,14.0,27.0,1
189,CC:2F:71:3F:1F:24,7320500,6666695363,4111170,6261325477,3209330,405369886,78,929659,553920344,921165,552900212,8494,1020132,879056,618,4115887,405153,78,5375,130000.0,43333.0,-69.0,-65.0,-76.0,-71.0,-68.0,-65.0,-74.0,-71.0,-83.0,-89.0,-82.0,-88.0,14.0,24.0,6.0,17.0,1
190,F8:59:71:5A:E0:3D,3267556,484307845,58224,78937757,3209332,405370088,0,55747,37621275,50983,37052031,4764,569244,33962,16,60936,1554,0,481,144444.0,43333.0,-67.0,-74.0,-65.0,-70.0,-67.0,-74.0,-65.0,-70.0,-82.0,-89.0,-82.0,-88.0,15.0,15.0,17.0,18.0,1
191,CC:2F:71:3E:C5:1F,3220670,406756907,11337,1386759,3209333,405370148,6,48451,4056643,40048,3061021,8403,995622,11951,34,16301,186,6,818,130000.0,39000.0,-68.0,-70.0,-68.0,-61.0,-68.0,-69.0,-68.0,-61.0,-82.0,-89.0,-82.0,-88.0,14.0,19.0,14.0,27.0,1
192,CC:2F:71:3F:1F:24,7320660,6666900339,4111327,6261530191,3209333,405370148,78,929811,554127190,921317,553107058,8494,1020132,879199,618,4116045,405158,78,5375,130000.0,43333.0,-69.0,-65.0,-74.0,-71.0,-69.0,-64.0,-74.0,-70.0,-82.0,-89.0,-82.0,-88.0,13.0,24.0,8.0,17.0,1
193,F8:59:71:5A:E0:3D,3267628,484406862,58287,79035659,3209341,405371203,0,55811,37719835,51047,37150591,4764,569244,34026,16,60999,1555,0,481,144444.0,43333.0,-67.0,-75.0,-66.0,-70.0,-67.0,-74.0,-65.0,-70.0,-82.0,-89.0,-82.0,-88.0,15.0,14.0,16.0,18.0,1
194,CC:2F:71:3E:C5:1F,3220682,406758675,11341,1387472,3209341,405371203,6,48457,4057458,40054,3061836,8403,995622,11956,34,16305,186,6,819,130000.0,39000.0,-68.0,-70.0,-68.0,-61.0,-69.0,-71.0,-69.0,-62.0,-82.0,-89.0,-82.0,-88.0,14.0,19.0,14.0,27.0,1
195,CC:2F:71:3F:1F:24,7320833,6667110797,4111492,6261739594,3209341,405371203,78,929967,554327908,921473,553307776,8494,1020132,879351,618,4116210,405171,78,5376,117000.0,39000.0,-69.0,-65.0,-74.0,-71.0,-69.0,-65.0,-74.0,-71.0,-82.0,-89.0,-82.0,-88.0,13.0,24.0,8.0,17.0,1
196,F8:59:71:5A:E0:3D,3267695,484503988,58349,79132007,3209346,405371981,0,55873,37815315,51109,37246071,4764,569244,34088,16,61061,1561,0,481,144444.0,43333.0,-67.0,-75.0,-66.0,-70.0,-67.0,-74.0,-65.0,-70.0,-82.0,-89.0,-82.0,-88.0,15.0,14.0,16.0,18.0,1
197,CC:2F:71:3E:C5:1F,3220687,406759453,11341,1387472,3209346,405371981,6,48457,4057458,40054,3061836,8403,995622,11956,34,16305,186,6,819,130000.0,39000.0,-68.0,-70.0,-68.0,-61.0,-69.0,-71.0,-69.0,-62.0,-82.0,-89.0,-82.0,-88.0,14.0,19.0,14.0,27.0,1
198,CC:2F:71:3F:1F:24,7321191,6667569097,4111845,6262197116,3209346,405371981,78,930202,554548338,921708,553528206,8494,1020132,879582,618,4116563,405183,78,5376,130000.0,43333.0,-69.0,-65.0,-74.0,-72.0,-68.0,-64.0,-74.0,-71.0,-82.0,-89.0,-82.0,-88.0,13.0,24.0,8.0,16.0,1
199,F8:59:71:5A:E0:3D,3267766,484608430,58416,79236125,3209350,405372305,0,55939,37916955,51175,37347711,4764,569244,34154,16,61127,1563,0,481,144444.0,43333.0,-67.0,-74.0,-65.0,-70.0,-67.0,-74.0,-65.0,-70.0,-82.0,-89.0,-82.0,-88.0,15.0,15.0,17.0,18.0,1
200,CC:2F:71:3E:C5:1F,3220695,406760181,11341,1387472,3209354,405372709,6,48459,4057646,40055,3061906,8404,995740,11957,34,16305,186,6,819,130000.0,39000.0,-69.0,-70.0,-68.0,-61.0,-69.0,-71.0,-69.0,-62.0,-82.0,-89.0,-82.0,-88.0,13.0,19.0,14.0,27.0,1
201,CC:2F:71:3F:1F:24,7321558,6668025505,4112204,6262652796,3209354,405372709,78,930454,554768075,921960,553747943,8494,1020132,879826,618,4116922,405234,78,5376,130000.0,43333.0,-69.0,-64.0,-75.0,-70.0,-68.0,-64.0,-74.0,-70.0,-82.0,-89.0,-82.0,-88.0,13.0,25.0,7.0,18.0,1
202,F8:59:71:5A:E0:3D,3267837,484707387,58479,79334027,3209358,405373360,0,56002,38014101,51238,37444857,4764,569244,34217,16,61191,1566,0,481,144444.0,43333.0,-67.0,-75.0,-66.0,-71.0,-66.0,-74.0,-66.0,-70.0,-82.0,-89.0,-82.0,-88.0,15.0,14.0,16.0,17.0,1
203,CC:2F:71:3E:C5:1F,3220699,406760832,11341,1387472,3209358,405373360,6,48459,4057646,40055,3061906,8404,995740,11957,34,16305,186,6,819,130000.0,39000.0,-69.0,-70.0,-68.0,-61.0,-69.0,-71.0,-69.0,-62.0,-82.0,-89.0,-82.0,-88.0,13.0,19.0,14.0,27.0,1
204,CC:2F:71:3F:1F:24,7321719,6668229309,4112360,6262855676,3209359,405373633,78,930600,554968507,922106,553948375,8494,1020132,879968,618,4117078,405253,78,5376,130000.0,43333.0,-69.0,-64.0,-75.0,-71.0,-68.0,-64.0,-74.0,-70.0,-82.0,-89.0,-82.0,-88.0,13.0,25.0,7.0,17.0,1
205,F8:59:71:5A:E0:3D,3267904,484807318,58543,79433483,3209361,405373835,0,56066,38112661,51302,37543417,4764,569244,34281,16,61255,1566,0,481,144444.0,43333.0,-67.0,-74.0,-65.0,-70.0,-67.0,-74.0,-65.0,-70.0,-82.0,-89.0,-82.0,-88.0,15.0,15.0,17.0,18.0,1
206,CC:2F:71:3E:C5:1F,3220702,406761307,11341,1387472,3209361,405373835,6,48459,4057646,40055,3061906,8404,995740,11957,34,16305,186,6,819,130000.0,39000.0,-69.0,-70.0,-68.0,-61.0,-69.0,-71.0,-69.0,-62.0,-82.0,-89.0,-82.0,-88.0,13.0,19.0,14.0,27.0,1
207,CC:2F:71:3F:1F:24,7321884,6668439039,4112520,6263064940,3209364,405374099,78,930749,555173435,922255,554153303,8494,1020132,880115,618,4117238,405259,78,5376,117000.0,39000.0,-69.0,-64.0,-72.0,-67.0,-69.0,-64.0,-72.0,-67.0,-82.0,-89.0,-82.0,-88.0,13.0,25.0,10.0,21.0,1
208,F8:59:71:5A:E0:3D,3267975,484905948,58606,79531385,3209369,405374563,0,56130,38209799,51365,37640437,4765,569362,34345,16,61318,1567,0,481,144444.0,43333.0,-67.0,-74.0,-66.0,-70.0,-67.0,-74.0,-65.0,-70.0,-82.0,-89.0,-82.0,-88.0,15.0,15.0,16.0,18.0,1
209,CC:2F:71:3E:C5:1F,3220710,406762035,11341,1387472,3209369,405374563,6,48459,4057646,40055,3061906,8404,995740,11957,34,16305,186,6,819,130000.0,39000.0,-69.0,-70.0,-68.0,-61.0,-69.0,-71.0,-69.0,-62.0,-82.0,-89.0,-82.0,-88.0,13.0,19.0,14.0,27.0,1
210,CC:2F:71:3F:1F:24,7322048,6668646989,4112679,6263272426,3209369,405374563,78,930897,555375441,922403,554355309,8494,1020132,880260,618,4117396,405265,78,5376,130000.0,43333.0,-69.0,-65.0,-72.0,-68.0,-69.0,-65.0,-71.0,-68.0,-82.0,-89.0,-82.0,-88.0,13.0,24.0,10.0,20.0,1
211,F8:59:71:5A:E0:3D,3268041,485002676,58669,79627849,3209372,405374827,0,56193,38305385,51428,37736023,4765,569362,34408,16,61381,1569,0,481,144444.0,43333.0,-67.0,-75.0,-66.0,-71.0,-67.0,-74.0,-65.0,-70.0,-82.0,-89.0,-82.0,-88.0,15.0,14.0,16.0,17.0,1
212,CC:2F:71:3E:C5:1F,3220713,406762299,11341,1387472,3209372,405374827,6,48459,4057646,40055,3061906,8404,995740,11957,34,16305,186,6,819,130000.0,39000.0,-69.0,-70.0,-68.0,-61.0,-69.0,-71.0,-69.0,-62.0,-82.0,-89.0,-82.0,-88.0,13.0,19.0,14.0,27.0,1
213,CC:2F:71:3F:1F:24,7322212,6668855307,4112840,6263480480,3209372,405374827,78,931050,555580857,922555,554560607,8495,1020250,880408,618,4117558,405268,78,5376,130000.0,43333.0,-69.0,-64.0,-73.0,-68.0,-69.0,-64.0,-72.0,-68.0,-82.0,-89.0,-82.0,-88.0,13.0,25.0,9.0,20.0,1
214,F8:59:71:5A:E0:3D,3268110,485104090,58734,79728859,3209376,405375231,0,56258,38405485,51493,37836123,4765,569362,34473,16,61446,1570,0,481,144444.0,43333.0,-67.0,-74.0,-66.0,-70.0,-67.0,-74.0,-65.0,-70.0,-82.0,-88.0,-81.0,-88.0,15.0,14.0,15.0,18.0,1
215,CC:2F:71:3E:C5:1F,3220720,406763021,11342,1387588,3209378,405375433,6,48461,4057822,40057,3062082,8404,995740,11958,34,16306,186,6,819,130000.0,39000.0,-69.0,-70.0,-67.0,-61.0,-69.0,-71.0,-68.0,-62.0,-82.0,-88.0,-81.0,-88.0,13.0,18.0,14.0,27.0,1
216,CC:2F:71:3F:1F:24,7322383,6669065430,4113005,6263689997,3209378,405375433,78,931206,555787129,922711,554766879,8495,1020250,880559,618,4117723,405277,78,5376,130000.0,43333.0,-69.0,-65.0,-72.0,-68.0,-69.0,-64.0,-72.0,-67.0,-82.0,-88.0,-81.0,-88.0,13.0,23.0,9.0,20.0,1
217,F8:59:71:5A:E0:3D,3268175,485200700,58796,79825207,3209379,405375493,0,56320,38500965,51555,37931603,4765,569362,34535,16,61508,1570,0,481,144444.0,43333.0,-68.0,-75.0,-66.0,-71.0,-67.0,-74.0,-65.0,-70.0,-82.0,-88.0,-81.0,-88.0,14.0,13.0,15.0,17.0,1
218,CC:2F:71:3E:C5:1F,3220724,406763399,11343,1387704,3209381,405375695,6,48464,4058068,40060,3062328,8404,995740,11959,34,16307,186,6,819,130000.0,39000.0,-69.0,-70.0,-67.0,-61.0,-68.0,-69.0,-66.0,-60.0,-82.0,-88.0,-81.0,-88.0,13.0,18.0,14.0,27.0,1
219,CC:2F:71:3F:1F:24,7322557,6669290866,4113176,6263915171,3209381,405375695,78,931372,556014215,922877,554993965,8495,1020250,880719,618,4117894,405280,78,5377,130000.0,43333.0,-69.0,-64.0,-74.0,-69.0,-69.0,-64.0,-73.0,-68.0,-82.0,-88.0,-81.0,-88.0,13.0,24.0,7.0,19.0,1
220,F8:59:71:5A:E0:3D,3268253,485310454,58866,79933987,3209387,405376467,0,56391,38610319,51626,38040957,4765,569362,34605,16,61578,1577,0,481,144444.0,43333.0,-67.0,-75.0,-66.0,-71.0,-67.0,-74.0,-66.0,-70.0,-82.0,-88.0,-81.0,-88.0,15.0,13.0,15.0,17.0,1
221,CC:2F:71:3E:C5:1F,3220730,406764171,11343,1387704,3209387,405376467,6,48464,4058068,40060,3062328,8404,995740,11959,34,16307,186,6,819,130000.0,39000.0,-69.0,-70.0,-67.0,-61.0,-68.0,-69.0,-66.0,-60.0,-82.0,-88.0,-81.0,-88.0,13.0,18.0,14.0,27.0,1
222,CC:2F:71:3F:1F:24,7322722,6669496162,4113333,6264119493,3209389,405376669,78,931522,556220957,923027,555200707,8495,1020250,880860,618,4118051,405300,78,5377,130000.0,43333.0,-69.0,-64.0,-74.0,-70.0,-68.0,-64.0,-73.0,-70.0,-82.0,-88.0,-81.0,-88.0,13.0,24.0,7.0,18.0,1
223,F8:59:71:5A:E0:3D,3268316,485405450,58927,80028781,3209389,405376669,0,56454,38707353,51689,38137991,4765,569362,34667,16,61639,1580,0,481,144444.0,43333.0,-67.0,-75.0,-66.0,-70.0,-67.0,-75.0,-66.0,-70.0,-83.0,-89.0,-82.0,-88.0,16.0,14.0,16.0,18.0,1
224,CC:2F:71:3E:C5:1F,3220732,406764373,11343,1387704,3209389,405376669,6,48464,4058068,40060,3062328,8404,995740,11959,34,16307,186,6,819,130000.0,39000.0,-69.0,-70.0,-67.0,-61.0,-68.0,-69.0,-66.0,-60.0,-83.0,-89.0,-82.0,-88.0,14.0,19.0,15.0,27.0,1
225,CC:2F:71:3F:1F:24,7323056,6669918154,4113665,6264541283,3209391,405376871,78,931768,556444137,923273,555423887,8495,1020250,881084,618,4118383,405308,78,5377,130000.0,43333.0,-70.0,-65.0,-73.0,-71.0,-69.0,-65.0,-73.0,-70.0,-83.0,-89.0,-82.0,-88.0,13.0,24.0,9.0,17.0,1
226,F8:59:71:5A:E0:3D,3268386,485504018,58990,80126683,3209396,405377335,0,56517,38804387,51752,38235025,4765,569362,34729,16,61702,1583,0,481,144444.0,43333.0,-67.0,-75.0,-65.0,-70.0,-67.0,-75.0,-65.0,-70.0,-83.0,-89.0,-82.0,-88.0,16.0,14.0,17.0,18.0,1
227,CC:2F:71:3E:C5:1F,3220739,406765039,11343,1387704,3209396,405377335,6,48464,4058068,40060,3062328,8404,995740,11959,34,16307,186,6,819,130000.0,39000.0,-69.0,-70.0,-67.0,-61.0,-68.0,-69.0,-66.0,-60.0,-83.0,-89.0,-82.0,-88.0,14.0,19.0,15.0,27.0,1
228,CC:2F:71:3F:1F:24,7323396,6670367556,4114000,6264990221,3209396,405377335,78,931989,556657324,923494,555637074,8495,1020250,881297,618,4118718,405335,78,5378,117000.0,39000.0,-69.0,-64.0,-73.0,-71.0,-69.0,-64.0,-72.0,-70.0,-83.0,-89.0,-82.0,-88.0,14.0,25.0,9.0,17.0,1
229,F8:59:71:5A:E0:3D,3268452,485603564,59054,80226027,3209398,405377537,0,56581,38902947,51816,38333585,4765,569362,34793,16,61766,1584,0,481,144444.0,43333.0,-68.0,-75.0,-66.0,-71.0,-67.0,-74.0,-66.0,-70.0,-83.0,-89.0,-82.0,-88.0,15.0,14.0,16.0,17.0,1
230,CC:2F:71:3E:C5:1F,3220741,406765241,11343,1387704,3209398,405377537,6,48464,4058068,40060,3062328,8404,995740,11959,34,16307,186,6,819,130000.0,39000.0,-69.0,-70.0,-67.0,-61.0,-68.0,-69.0,-66.0,-60.0,-83.0,-89.0,-82.0,-88.0,14.0,19.0,15.0,27.0,1
231,CC:2F:71:3F:1F:24,7323748,6670816235,4114350,6265438698,3209398,405377537,78,932215,556868153,923720,555847903,8495,1020250,881522,618,4119068,405384,78,5379,130000.0,39000.0,-70.0,-65.0,-74.0,-71.0,-69.0,-65.0,-73.0,-71.0,-83.0,-89.0,-82.0,-88.0,13.0,24.0,8.0,17.0,1
232,F8:59:71:5A:E0:3D,3268522,485703458,59118,80325315,3209404,405378143,0,56643,38998455,51878,38429093,4765,569362,34855,16,61830,1584,0,482,144444.0,43333.0,-67.0,-75.0,-66.0,-70.0,-67.0,-74.0,-65.0,-70.0,-83.0,-89.0,-82.0,-88.0,16.0,14.0,16.0,18.0,1
233,CC:2F:71:3E:C5:1F,3220747,406765847,11343,1387704,3209404,405378143,6,48464,4058068,40060,3062328,8404,995740,11959,34,16307,186,6,819,130000.0,39000.0,-69.0,-70.0,-67.0,-61.0,-68.0,-69.0,-66.0,-60.0,-83.0,-89.0,-82.0,-88.0,14.0,19.0,15.0,27.0,1
234,CC:2F:71:3F:1F:24,7324109,6671274919,4114705,6265896776,3209404,405378143,78,932456,557084980,923961,556064730,8495,1020250,881762,618,4119423,405395,78,5379,130000.0,43333.0,-69.0,-65.0,-74.0,-72.0,-69.0,-65.0,-74.0,-71.0,-83.0,-89.0,-82.0,-88.0,14.0,24.0,8.0,16.0,1
235,F8:59:71:5A:E0:3D,3268590,485803302,59182,80424771,3209408,405378531,0,56708,39098597,51943,38529235,4765,569362,34920,16,61893,1586,0,482,144444.0,43333.0,-67.0,-75.0,-66.0,-70.0,-67.0,-75.0,-66.0,-70.0,-83.0,-89.0,-82.0,-89.0,16.0,14.0,16.0,19.0,1
236,CC:2F:71:3E:C5:1F,3220751,406766235,11343,1387704,3209408,405378531,6,48464,4058068,40060,3062328,8404,995740,11959,34,16307,186,6,819,130000.0,39000.0,-69.0,-70.0,-67.0,-61.0,-68.0,-69.0,-66.0,-60.0,-83.0,-89.0,-82.0,-89.0,14.0,19.0,15.0,28.0,1
237,CC:2F:71:3F:1F:24,7324491,6671736745,4115083,6266358214,3209408,405378531,78,932725,557308050,924230,556287800,8495,1020250,882027,618,4119801,405409,78,5379,130000.0,43333.0,-70.0,-65.0,-74.0,-71.0,-69.0,-65.0,-74.0,-71.0,-83.0,-89.0,-82.0,-89.0,13.0,24.0,8.0,18.0,1
238,F8:59:71:5A:E0:3D,3268655,485901406,59245,80522673,3209410,405378733,0,56772,39197157,52007,38627795,4765,569362,34984,16,61957,1588,0,482,144444.0,43333.0,-67.0,-75.0,-66.0,-70.0,-67.0,-75.0,-66.0,-70.0,-83.0,-89.0,-82.0,-89.0,16.0,14.0,16.0,19.0,1
239,CC:2F:71:3E:C5:1F,3220753,406766437,11343,1387704,3209410,405378733,6,48464,4058068,40060,3062328,8404,995740,11959,34,16307,186,6,819,130000.0,39000.0,-69.0,-70.0,-67.0,-61.0,-68.0,-69.0,-66.0,-60.0,-83.0,-89.0,-82.0,-89.0,14.0,19.0,15.0,28.0,1
240,CC:2F:71:3F:1F:24,7324878,6672222502,4115464,6266843365,3209414,405379137,78,932981,557525191,924486,556504941,8495,1020250,882279,618,4120182,405419,78,5379,130000.0,43333.0,-69.0,-64.0,-73.0,-70.0,-69.0,-64.0,-73.0,-70.0,-83.0,-89.0,-82.0,-89.0,14.0,25.0,9.0,19.0,1
241,F8:59:71:5A:E0:3D,3268726,486003022,59310,80623683,3209416,405379339,0,56837,39297257,52072,38727895,4765,569362,35049,16,62022,1588,0,482,144444.0,43333.0,-68.0,-75.0,-67.0,-71.0,-67.0,-75.0,-66.0,-70.0,-83.0,-89.0,-82.0,-89.0,15.0,14.0,15.0,18.0,1
242,CC:2F:71:3E:C5:1F,3220760,406767103,11343,1387704,3209417,405379399,6,48464,4058068,40060,3062328,8404,995740,11959,34,16307,186,6,819,130000.0,39000.0,-69.0,-70.0,-67.0,-61.0,-68.0,-69.0,-66.0,-60.0,-83.0,-89.0,-82.0,-89.0,14.0,19.0,15.0,28.0,1
243,CC:2F:71:3F:1F:24,7325235,6672679216,4115818,6267299817,3209417,405379399,78,933243,557753525,924748,556733275,8495,1020250,882524,618,4120536,405424,78,5379,130000.0,43333.0,-70.0,-65.0,-74.0,-71.0,-69.0,-65.0,-73.0,-71.0,-83.0,-89.0,-82.0,-89.0,13.0,24.0,8.0,18.0,1
244,F8:59:71:5A:E0:3D,3268792,486101186,59373,80721585,3209419,405379601,0,56900,39394277,52135,38824915,4765,569362,35112,16,62085,1594,0,482,144444.0,43333.0,-68.0,-75.0,-67.0,-71.0,-67.0,-75.0,-66.0,-70.0,-83.0,-89.0,-83.0,-89.0,15.0,14.0,16.0,18.0,1
245,CC:2F:71:3E:C5:1F,3220762,406767305,11343,1387704,3209419,405379601,6,48464,4058068,40060,3062328,8404,995740,11959,34,16307,186,6,819,130000.0,39000.0,-69.0,-70.0,-67.0,-61.0,-68.0,-69.0,-66.0,-60.0,-83.0,-89.0,-83.0,-89.0,14.0,19.0,16.0,28.0,1
246,CC:2F:71:3F:1F:24,7325605,6673148757,4116186,6267769156,3209419,405379601,78,933491,557967255,924996,556947005,8495,1020250,882766,618,4120901,405462,78,5379,130000.0,43333.0,-69.0,-64.0,-72.0,-70.0,-68.0,-64.0,-72.0,-70.0,-83.0,-89.0,-83.0,-89.0,14.0,25.0,11.0,19.0,1
247,F8:59:71:5A:E0:3D,3268860,486198327,59436,80818049,3209424,405380278,0,56963,39489863,52198,38920501,4765,569362,35175,16,62148,1595,0,482,144444.0,43333.0,-68.0,-76.0,-67.0,-71.0,-67.0,-75.0,-66.0,-70.0,-83.0,-89.0,-83.0,-89.0,15.0,13.0,16.0,18.0,1
248,CC:2F:71:3E:C5:1F,3220767,406767982,11343,1387704,3209424,405380278,6,48464,4058068,40060,3062328,8404,995740,11959,34,16307,186,6,819,130000.0,39000.0,-69.0,-70.0,-67.0,-61.0,-68.0,-69.0,-66.0,-60.0,-83.0,-89.0,-83.0,-89.0,14.0,19.0,16.0,28.0,1
249,CC:2F:71:3F:1F:24,7325951,6673588628,4116525,6268208148,3209426,405380480,78,933709,558177403,925214,557157153,8495,1020250,882982,618,4121243,405474,78,5379,130000.0,43333.0,-69.0,-64.0,-73.0,-71.0,-69.0,-64.0,-73.0,-70.0,-83.0,-89.0,-83.0,-89.0,14.0,25.0,10.0,18.0,1
250,F8:59:71:5A:E0:3D,3268929,486298247,59500,80917505,3209429,405380742,0,57027,39588423,52262,39019061,4765,569362,35239,16,62212,1596,0,482,144444.0,43333.0,-68.0,-76.0,-67.0,-71.0,-67.0,-75.0,-66.0,-70.0,-83.0,-89.0,-83.0,-89.0,15.0,13.0,16.0,18.0,1
251,CC:2F:71:3E:C5:1F,3220772,406768446,11343,1387704,3209429,405380742,6,48464,4058068,40060,3062328,8404,995740,11959,34,16307,186,6,819,130000.0,39000.0,-69.0,-70.0,-67.0,-61.0,-68.0,-69.0,-66.0,-60.0,-83.0,-89.0,-83.0,-89.0,14.0,19.0,16.0,28.0,1
252,CC:2F:71:3F:1F:24,7326112,6673795158,4116683,6268414416,3209429,405380742,78,933865,558387815,925370,557367565,8495,1020250,883126,618,4121401,405477,78,5380,130000.0,43333.0,-69.0,-64.0,-73.0,-70.0,-69.0,-64.0,-73.0,-70.0,-83.0,-89.0,-83.0,-89.0,14.0,25.0,10.0,19.0,1
253,F8:59:71:5A:E0:3D,3268996,486396553,59563,81015407,3209433,405381146,0,57090,39685443,52325,39116081,4765,569362,35302,16,62275,1597,0,482,144444.0,43333.0,-67.0,-75.0,-66.0,-70.0,-67.0,-74.0,-65.0,-70.0,-83.0,-89.0,-83.0,-89.0,16.0,14.0,17.0,19.0,1
254,CC:2F:71:3E:C5:1F,3220776,406768850,11343,1387704,3209433,405381146,6,48464,4058068,40060,3062328,8404,995740,11959,34,16307,186,6,819,130000.0,39000.0,-69.0,-70.0,-67.0,-61.0,-68.0,-69.0,-66.0,-60.0,-83.0,-89.0,-83.0,-89.0,14.0,19.0,16.0,28.0,1
255,CC:2F:71:3F:1F:24,7326272,6673998498,4116839,6268617352,3209433,405381146,78,934013,558592835,925518,557572585,8495,1020250,883268,618,4121557,405501,78,5380,130000.0,43333.0,-70.0,-64.0,-73.0,-70.0,-69.0,-64.0,-73.0,-70.0,-83.0,-89.0,-83.0,-89.0,13.0,25.0,10.0,19.0,1
256,F8:59:71:5A:E0:3D,3269062,486493305,59625,81111755,3209437,405381550,0,57153,39782463,52388,39213101,4765,569362,35365,16,62337,1598,0,482,144444.0,43333.0,-67.0,-74.0,-66.0,-70.0,-67.0,-73.0,-66.0,-70.0,-83.0,-89.0,-83.0,-89.0,16.0,15.0,17.0,19.0,1
257,CC:2F:71:3E:C5:1F,3220780,406769254,11343,1387704,3209437,405381550,6,48464,4058068,40060,3062328,8404,995740,11959,34,16307,186,6,819,130000.0,39000.0,-69.0,-70.0,-67.0,-61.0,-68.0,-69.0,-66.0,-60.0,-83.0,-89.0,-83.0,-89.0,14.0,19.0,16.0,28.0,1
258,CC:2F:71:3F:1F:24,7326489,6674218632,4117052,6268837082,3209437,405381550,78,934202,558807712,925707,557787462,8495,1020250,883454,618,4121769,405518,78,5380,130000.0,43333.0,-68.0,-64.0,-70.0,-70.0,-68.0,-64.0,-70.0,-69.0,-84.0,-90.0,-84.0,-89.0,16.0,26.0,14.0,19.0,1
259,F8:59:71:5A:E0:3D,3269131,486593225,59689,81211211,3209442,405382014,0,57217,39881037,52452,39311675,4765,569362,35428,16,62401,1598,0,482,144444.0,43333.0,-67.0,-75.0,-66.0,-70.0,-67.0,-74.0,-65.0,-70.0,-84.0,-90.0,-84.0,-89.0,17.0,15.0,18.0,19.0,1
260,CC:2F:71:3E:C5:1F,3220785,406769718,11343,1387704,3209442,405382014,6,48464,4058068,40060,3062328,8404,995740,11959,34,16307,186,6,819,130000.0,39000.0,-69.0,-70.0,-67.0,-61.0,-68.0,-69.0,-66.0,-60.0,-84.0,-90.0,-84.0,-89.0,15.0,20.0,17.0,28.0,1
261,CC:2F:71:3F:1F:24,7326681,6674437138,4117239,6269055124,3209442,405382014,78,934384,559016784,925889,557996534,8495,1020250,883635,618,4121957,405522,78,5380,130000.0,43333.0,-69.0,-64.0,-70.0,-70.0,-68.0,-64.0,-69.0,-69.0,-84.0,-90.0,-84.0,-89.0,15.0,26.0,14.0,19.0,1
262,F8:59:71:5A:E0:3D,3269195,486689775,59751,81307559,3209444,405382216,0,57279,39976517,52514,39407155,4765,569362,35490,16,62462,1598,0,482,144444.0,43333.0,-68.0,-75.0,-66.0,-71.0,-67.0,-74.0,-65.0,-70.0,-84.0,-90.0,-84.0,-89.0,16.0,15.0,18.0,18.0,1
263,CC:2F:71:3E:C5:1F,3220789,406770122,11343,1387704,3209446,405382418,6,48464,4058068,40060,3062328,8404,995740,11959,34,16307,186,6,819,130000.0,39000.0,-69.0,-70.0,-67.0,-61.0,-68.0,-69.0,-66.0,-60.0,-84.0,-90.0,-84.0,-89.0,15.0,20.0,17.0,28.0,1
264,CC:2F:71:3F:1F:24,7326893,6674660174,4117447,6269277756,3209446,405382418,78,934577,559221570,926082,558201320,8495,1020250,883827,618,4122165,405534,78,5380,130000.0,43333.0,-67.0,-63.0,-74.0,-70.0,-67.0,-63.0,-74.0,-70.0,-84.0,-90.0,-84.0,-89.0,17.0,27.0,10.0,19.0,1
265,F8:59:71:5A:E0:3D,3269260,486786441,59814,81404023,3209446,405382418,0,57341,40071997,52576,39502635,4765,569362,35552,16,62526,1605,0,482,144444.0,43333.0,-67.0,-75.0,-66.0,-71.0,-67.0,-74.0,-65.0,-70.0,-84.0,-90.0,-84.0,-89.0,17.0,15.0,18.0,18.0,1
266,CC:2F:71:3E:C5:1F,3220792,406770440,11344,1387820,3209448,405382620,6,48466,4058208,40062,3062468,8404,995740,11959,34,16308,186,6,819,130000.0,39000.0,-64.0,-61.0,-66.0,-60.0,-67.0,-68.0,-66.0,-60.0,-83.0,-90.0,-83.0,-89.0,19.0,29.0,17.0,29.0,1
267,CC:2F:71:3F:1F:24,7327144,6674905388,4117696,6269522768,3209448,405382620,78,934761,559433837,926266,558413587,8495,1020250,884010,618,4122413,405579,78,5382,144444.0,43333.0,-68.0,-64.0,-73.0,-70.0,-68.0,-64.0,-73.0,-70.0,-83.0,-90.0,-83.0,-89.0,15.0,26.0,10.0,19.0,1
268,F8:59:71:5A:E0:3D,3269330,486885009,59877,81501925,3209453,405383084,0,57405,40170571,52640,39601209,4765,569362,35615,16,62589,1605,0,482,144444.0,43333.0,-67.0,-75.0,-66.0,-71.0,-67.0,-74.0,-66.0,-70.0,-83.0,-90.0,-83.0,-89.0,16.0,15.0,17.0,18.0,1
269,CC:2F:71:3E:C5:1F,3220797,406770904,11344,1387820,3209453,405383084,6,48466,4058208,40062,3062468,8404,995740,11959,34,16308,186,6,819,130000.0,39000.0,-64.0,-61.0,-66.0,-60.0,-67.0,-68.0,-66.0,-60.0,-83.0,-90.0,-83.0,-89.0,19.0,29.0,17.0,29.0,1
270,CC:2F:71:3F:1F:24,7327499,6675203532,4118046,6269820448,3209453,405383084,78,935064,559678829,926569,558658579,8495,1020250,884313,618,4122764,405630,78,5382,130000.0,43333.0,-69.0,-64.0,-73.0,-70.0,-68.0,-64.0,-73.0,-70.0,-83.0,-90.0,-83.0,-89.0,14.0,26.0,10.0,19.0,1
271,F8:59:71:5A:E0:3D,3269396,486984667,59941,81601381,3209455,405383286,0,57467,40266051,52702,39696689,4765,569362,35677,16,62653,1610,0,482,144444.0,43333.0,-67.0,-75.0,-66.0,-71.0,-67.0,-75.0,-66.0,-71.0,-83.0,-90.0,-83.0,-89.0,16.0,15.0,17.0,18.0,1
272,CC:2F:71:3E:C5:1F,3220799,406771106,11344,1387820,3209455,405383286,6,48466,4058208,40062,3062468,8404,995740,11959,34,16308,186,6,819,130000.0,39000.0,-64.0,-61.0,-66.0,-60.0,-67.0,-68.0,-66.0,-60.0,-83.0,-90.0,-83.0,-89.0,19.0,29.0,17.0,29.0,1
273,CC:2F:71:3F:1F:24,7328696,6676497546,4119241,6271114260,3209455,405383286,78,935756,559991033,927261,558970783,8495,1020250,885004,618,4123959,405935,78,5383,144444.0,43333.0,-69.0,-64.0,-74.0,-70.0,-69.0,-64.0,-73.0,-70.0,-83.0,-90.0,-83.0,-89.0,14.0,26.0,9.0,19.0,1
274,F8:59:71:5A:E0:3D,3269469,487089391,60008,81705499,3209461,405383892,0,57536,40372353,52771,39802991,4765,569362,35743,16,62720,1613,0,482,144444.0,43333.0,-67.0,-75.0,-66.0,-71.0,-67.0,-74.0,-66.0,-70.0,-83.0,-90.0,-83.0,-89.0,16.0,15.0,17.0,18.0,1
275,CC:2F:71:3E:C5:1F,3220805,406771712,11344,1387820,3209461,405383892,6,48466,4058208,40062,3062468,8404,995740,11959,34,16308,186,6,819,130000.0,39000.0,-64.0,-61.0,-66.0,-60.0,-67.0,-68.0,-66.0,-60.0,-83.0,-90.0,-83.0,-89.0,19.0,29.0,17.0,29.0,1
276,CC:2F:71:3F:1F:24,7329616,6677171139,4120155,6271787247,3209461,405383892,80,936533,560360844,928038,559340594,8495,1020250,885770,619,4124873,406098,80,5385,130000.0,43333.0,-68.0,-64.0,-74.0,-70.0,-68.0,-64.0,-73.0,-69.0,-83.0,-90.0,-83.0,-89.0,15.0,26.0,9.0,19.0,1
277,F8:59:71:5A:E0:3D,3269545,487203095,60081,81818941,3209464,405384154,0,57612,40489491,52847,39920129,4765,569362,35819,16,62793,1614,0,482,144444.0,43333.0,-67.0,-73.0,-65.0,-70.0,-66.0,-73.0,-65.0,-69.0,-83.0,-90.0,-83.0,-89.0,16.0,17.0,18.0,19.0,1
278,CC:2F:71:3E:C5:1F,3220808,406771974,11344,1387820,3209464,405384154,6,48466,4058208,40062,3062468,8404,995740,11959,34,16308,186,6,819,130000.0,39000.0,-64.0,-61.0,-66.0,-60.0,-67.0,-68.0,-66.0,-60.0,-83.0,-90.0,-83.0,-89.0,19.0,29.0,17.0,29.0,1
279,CC:2F:71:3F:1F:24,7330261,6677626764,4120797,6272242610,3209464,405384154,80,937134,560666996,928639,559646746,8495,1020250,886361,619,4125516,406124,80,5385,130000.0,39000.0,-68.0,-63.0,-70.0,-70.0,-68.0,-64.0,-71.0,-70.0,-83.0,-90.0,-83.0,-89.0,15.0,27.0,13.0,19.0,1
280,F8:59:71:5A:E0:3D,3269616,487304711,60146,81919951,3209470,405384760,0,57677,40589591,52912,40020229,4765,569362,35884,16,62858,1614,0,482,144444.0,43333.0,-66.0,-74.0,-66.0,-70.0,-66.0,-74.0,-65.0,-70.0,-83.0,-90.0,-83.0,-89.0,17.0,16.0,17.0,19.0,1
281,CC:2F:71:3E:C5:1F,3220814,406772580,11344,1387820,3209470,405384760,6,48466,4058208,40062,3062468,8404,995740,11959,34,16308,186,6,819,130000.0,39000.0,-64.0,-61.0,-66.0,-60.0,-67.0,-68.0,-66.0,-60.0,-83.0,-90.0,-83.0,-89.0,19.0,29.0,17.0,29.0,1
282,CC:2F:71:3F:1F:24,7330602,6677930432,4121132,6272545672,3209470,405384760,80,937433,560906962,928938,559886712,8495,1020250,886650,619,4125851,406141,80,5386,130000.0,43333.0,-69.0,-64.0,-69.0,-70.0,-69.0,-64.0,-69.0,-70.0,-83.0,-90.0,-83.0,-89.0,14.0,26.0,14.0,19.0,1
283,F8:59:71:5A:E0:3D,3269688,487413693,60216,82028731,3209472,405384962,0,57747,40697391,52982,40128029,4765,569362,35954,16,62928,1616,0,482,144444.0,43333.0,-66.0,-75.0,-65.0,-70.0,-66.0,-74.0,-65.0,-70.0,-83.0,-89.0,-82.0,-89.0,17.0,14.0,17.0,19.0,1
284,CC:2F:71:3E:C5:1F,3220817,406772842,11344,1387820,3209473,405385022,6,48466,4058208,40062,3062468,8404,995740,11959,34,16308,186,6,819,130000.0,39000.0,-64.0,-61.0,-66.0,-60.0,-67.0,-68.0,-66.0,-60.0,-83.0,-89.0,-82.0,-89.0,19.0,28.0,16.0,29.0,1
285,CC:2F:71:3F:1F:24,7330805,6678165013,4121332,6272779991,3209473,405385022,80,937617,561127674,929122,560107424,8495,1020250,886823,619,4126051,406147,80,5386,130000.0,43333.0,-68.0,-63.0,-71.0,-70.0,-68.0,-63.0,-71.0,-70.0,-83.0,-89.0,-82.0,-89.0,15.0,26.0,11.0,19.0,1
286,F8:59:71:5A:E0:3D,3269765,487521647,60285,82135957,3209480,405385690,0,57816,40803651,53051,40234289,4765,569362,36023,16,62997,1616,0,482,144444.0,43333.0,-66.0,-73.0,-65.0,-69.0,-66.0,-73.0,-64.0,-69.0,-83.0,-89.0,-82.0,-89.0,17.0,16.0,17.0,20.0,1
287,CC:2F:71:3E:C5:1F,3220824,406773510,11344,1387820,3209480,405385690,6,48468,4058396,40063,3062538,8405,995858,11960,34,16308,186,6,819,130000.0,39000.0,-69.0,-69.0,-69.0,-60.0,-67.0,-68.0,-67.0,-60.0,-83.0,-89.0,-82.0,-89.0,14.0,20.0,13.0,29.0,1
288,CC:2F:71:3F:1F:24,7330995,6678396392,4121515,6273010702,3209480,405385690,80,937793,561344354,929298,560324104,8495,1020250,886988,619,4126234,406152,80,5386,130000.0,43333.0,-66.0,-64.0,-73.0,-70.0,-67.0,-65.0,-72.0,-70.0,-83.0,-89.0,-82.0,-89.0,17.0,25.0,9.0,19.0,1
289,F8:59:71:5A:E0:3D,3269836,487627794,60353,82241629,3209483,405386165,0,57884,40908371,53119,40339009,4765,569362,36091,16,63065,1616,0,482,144444.0,43333.0,-67.0,-75.0,-65.0,-70.0,-67.0,-74.0,-65.0,-70.0,-83.0,-89.0,-82.0,-89.0,16.0,14.0,17.0,19.0,1
290,CC:2F:71:3E:C5:1F,3220827,406773985,11344,1387820,3209483,405386165,6,48468,4058396,40063,3062538,8405,995858,11960,34,16308,186,6,819,130000.0,39000.0,-69.0,-69.0,-69.0,-60.0,-67.0,-68.0,-67.0,-60.0,-83.0,-89.0,-82.0,-89.0,14.0,20.0,13.0,29.0,1
291,CC:2F:71:3F:1F:24,7331199,6678624174,4121716,6273238009,3209483,405386165,80,937984,561555550,929489,560535300,8495,1020250,887170,619,4126435,406160,80,5387,130000.0,43333.0,-68.0,-63.0,-70.0,-70.0,-67.0,-63.0,-69.0,-70.0,-83.0,-90.0,-83.0,-89.0,15.0,27.0,13.0,19.0,1
292,F8:59:71:5A:E0:3D,3269910,487732578,60420,82345747,3209490,405386831,0,57952,41013105,53187,40443743,4765,569362,36158,16,63132,1616,0,482,144444.0,43333.0,-67.0,-75.0,-65.0,-70.0,-67.0,-74.0,-65.0,-70.0,-83.0,-90.0,-83.0,-89.0,16.0,15.0,18.0,19.0,1
293,CC:2F:71:3E:C5:1F,3220834,406774651,11344,1387820,3209490,405386831,6,48468,4058396,40063,3062538,8405,995858,11960,34,16308,186,6,819,130000.0,39000.0,-69.0,-69.0,-69.0,-60.0,-67.0,-68.0,-67.0,-60.0,-83.0,-90.0,-83.0,-89.0,14.0,21.0,14.0,29.0,1
294,CC:2F:71:3F:1F:24,7331430,6678863687,4121940,6273476856,3209490,405386831,80,938190,561780684,929695,560760434,8495,1020250,887364,619,4126659,406166,80,5387,130000.0,43333.0,-69.0,-64.0,-71.0,-70.0,-68.0,-64.0,-70.0,-70.0,-83.0,-90.0,-83.0,-89.0,14.0,26.0,12.0,19.0,1
295,F8:59:71:5A:E0:3D,3269982,487840068,60489,82452973,3209493,405387095,0,58022,41119483,53256,40550003,4766,569480,36228,16,63201,1616,0,482,144444.0,43333.0,-67.0,-74.0,-65.0,-70.0,-67.0,-73.0,-65.0,-69.0,-83.0,-90.0,-83.0,-89.0,16.0,16.0,18.0,19.0,1
296,CC:2F:71:3E:C5:1F,3220837,406774915,11344,1387820,3209493,405387095,6,48468,4058396,40063,3062538,8405,995858,11960,34,16308,186,6,819,130000.0,39000.0,-69.0,-69.0,-69.0,-60.0,-67.0,-68.0,-67.0,-60.0,-83.0,-90.0,-83.0,-89.0,14.0,21.0,14.0,29.0,1
297,CC:2F:71:3F:1F:24,7331699,6679159324,4122206,6273772229,3209493,405387095,80,938452,562015484,929957,560995234,8495,1020250,887614,619,4126925,406221,80,5387,130000.0,43333.0,-67.0,-64.0,-72.0,-71.0,-66.0,-63.0,-73.0,-70.0,-83.0,-90.0,-83.0,-89.0,16.0,26.0,11.0,18.0,1
298,F8:59:71:5A:E0:3D,3270054,487946088,60557,82558589,3209497,405387499,0,58092,41227353,53326,40657873,4766,569480,36297,16,63269,1621,0,482,130000.0,39000.0,-67.0,-74.0,-65.0,-70.0,-67.0,-74.0,-65.0,-70.0,-84.0,-90.0,-83.0,-89.0,17.0,16.0,18.0,19.0,1
299,CC:2F:71:3E:C5:1F,3220843,406775521,11344,1387820,3209499,405387701,6,48468,4058396,40063,3062538,8405,995858,11960,34,16308,186,6,819,130000.0,39000.0,-69.0,-69.0,-69.0,-60.0,-67.0,-68.0,-67.0,-60.0,-84.0,-90.0,-83.0,-89.0,15.0,21.0,14.0,29.0,1
300,CC:2F:71:3F:1F:24,7332267,6679888531,4122768,6274500830,3209499,405387701,80,938763,562264157,930268,561243907,8495,1020250,887913,619,4127487,406290,80,5391,144444.0,43333.0,-76.0,-71.0,-80.0,-75.0,-72.0,-67.0,-75.0,-71.0,-84.0,-90.0,-83.0,-89.0,8.0,19.0,3.0,14.0,1
301,F8:59:71:5A:E0:3D,3270125,488049004,60623,82661041,3209502,405387963,0,58157,41327453,53391,40757973,4766,569480,36362,16,63335,1623,0,482,144444.0,43333.0,-67.0,-74.0,-65.0,-70.0,-66.0,-73.0,-65.0,-70.0,-84.0,-90.0,-83.0,-89.0,17.0,16.0,18.0,19.0,1
302,CC:2F:71:3E:C5:1F,3220847,406775845,11344,1387820,3209503,405388025,6,48468,4058396,40063,3062538,8405,995858,11960,34,16308,186,6,819,130000.0,39000.0,-69.0,-69.0,-69.0,-60.0,-67.0,-68.0,-67.0,-60.0,-84.0,-90.0,-83.0,-89.0,15.0,21.0,14.0,29.0,1
303,CC:2F:71:3F:1F:24,7332943,6680741348,4123440,6275353323,3209503,405388025,80,939156,562538750,930660,561518382,8496,1020368,888295,619,4128158,406447,80,5391,130000.0,39000.0,-70.0,-65.0,-74.0,-68.0,-69.0,-65.0,-73.0,-68.0,-84.0,-90.0,-83.0,-89.0,14.0,25.0,9.0,21.0,1
304,F8:59:71:5A:E0:3D,3270209,488170750,60701,82782253,3209508,405388497,0,58235,41447629,53469,40878149,4766,569480,36440,16,63413,1624,0,482,144444.0,43333.0,-67.0,-74.0,-65.0,-70.0,-66.0,-73.0,-65.0,-69.0,-84.0,-90.0,-83.0,-89.0,17.0,16.0,18.0,19.0,1
305,CC:2F:71:3E:C5:1F,3220853,406776451,11344,1387820,3209509,405388631,6,48468,4058396,40063,3062538,8405,995858,11960,34,16308,186,6,819,130000.0,39000.0,-69.0,-69.0,-69.0,-60.0,-67.0,-68.0,-67.0,-60.0,-84.0,-90.0,-83.0,-89.0,15.0,21.0,14.0,29.0,1
306,CC:2F:71:3F:1F:24,7333245,6681019253,4123734,6275630420,3209511,405388833,80,939428,562776332,930932,561755964,8496,1020368,888555,619,4128451,406461,80,5391,130000.0,43333.0,-70.0,-65.0,-72.0,-68.0,-69.0,-64.0,-72.0,-68.0,-84.0,-90.0,-83.0,-89.0,14.0,25.0,11.0,21.0,1
307,F8:59:71:5A:E0:3D,3270274,488265940,60762,82877047,3209512,405388893,0,58298,41544663,53532,40975183,4766,569480,36502,16,63474,1625,0,482,144444.0,43333.0,-67.0,-75.0,-66.0,-70.0,-66.0,-74.0,-65.0,-70.0,-84.0,-90.0,-83.0,-89.0,17.0,15.0,17.0,19.0,1
308,CC:2F:71:3E:C5:1F,3220856,406776713,11344,1387820,3209512,405388893,6,48468,4058396,40063,3062538,8405,995858,11960,34,16308,186,6,819,130000.0,39000.0,-69.0,-69.0,-69.0,-60.0,-67.0,-68.0,-67.0,-60.0,-84.0,-90.0,-83.0,-89.0,15.0,21.0,14.0,29.0,1
309,CC:2F:71:3F:1F:24,7333597,6681293087,4124085,6275904194,3209512,405388893,80,939756,563022634,931260,562002266,8496,1020368,888867,619,4128804,406534,80,5391,130000.0,43333.0,-70.0,-65.0,-73.0,-69.0,-70.0,-64.0,-73.0,-69.0,-84.0,-90.0,-83.0,-89.0,14.0,25.0,10.0,20.0,1
310,F8:59:71:5A:E0:3D,3270345,488370462,60829,82981165,3209516,405389297,0,58365,41647885,53599,41078405,4766,569480,36568,16,63541,1625,0,482,144444.0,43333.0,-67.0,-74.0,-66.0,-70.0,-66.0,-73.0,-65.0,-70.0,-83.0,-90.0,-83.0,-89.0,16.0,16.0,17.0,19.0,1
311,CC:2F:71:3E:C5:1F,3220860,406777117,11344,1387820,3209516,405389297,6,48468,4058396,40063,3062538,8405,995858,11960,34,16308,186,6,819,130000.0,39000.0,-69.0,-69.0,-69.0,-60.0,-67.0,-68.0,-67.0,-60.0,-83.0,-90.0,-83.0,-89.0,14.0,21.0,14.0,29.0,1
312,CC:2F:71:3F:1F:24,7333974,6681610648,4124456,6276221149,3209518,405389499,80,940073,563273233,931577,562252865,8496,1020368,889182,619,4129173,406559,80,5391,130000.0,43333.0,-70.0,-64.0,-73.0,-69.0,-70.0,-64.0,-73.0,-69.0,-83.0,-90.0,-83.0,-89.0,13.0,26.0,10.0,20.0,1
313,F8:59:71:5A:E0:3D,3270413,488470322,60893,83080621,3209520,405389701,0,58430,41747985,53664,41178505,4766,569480,36633,16,63605,1632,0,482,144444.0,43333.0,-67.0,-74.0,-66.0,-70.0,-66.0,-74.0,-65.0,-70.0,-83.0,-90.0,-83.0,-89.0,16.0,16.0,17.0,19.0,1
314,CC:2F:71:3E:C5:1F,3220864,406777521,11344,1387820,3209520,405389701,6,48468,4058396,40063,3062538,8405,995858,11960,34,16308,186,6,819,130000.0,39000.0,-69.0,-69.0,-69.0,-60.0,-67.0,-68.0,-67.0,-60.0,-83.0,-90.0,-83.0,-89.0,14.0,21.0,14.0,29.0,1
315,CC:2F:71:3F:1F:24,7334345,6681989934,4124825,6276600233,3209520,405389701,80,940367,563505092,931871,562484724,8496,1020368,889476,619,4129544,406573,80,5393,130000.0,43333.0,-70.0,-64.0,-73.0,-68.0,-69.0,-64.0,-72.0,-68.0,-83.0,-90.0,-83.0,-89.0,13.0,26.0,10.0,21.0,1
316,F8:59:71:5A:E0:3D,3270482,488570242,60957,83180077,3209525,405390165,0,58493,41845005,53727,41275525,4766,569480,36696,16,63669,1636,0,482,144444.0,43333.0,-67.0,-74.0,-65.0,-70.0,-66.0,-74.0,-65.0,-70.0,-83.0,-90.0,-83.0,-89.0,16.0,16.0,18.0,19.0,1
317,CC:2F:71:3E:C5:1F,3220869,406777985,11344,1387820,3209525,405390165,6,48468,4058396,40063,3062538,8405,995858,11960,34,16308,186,6,819,130000.0,39000.0,-69.0,-69.0,-69.0,-60.0,-67.0,-68.0,-67.0,-60.0,-83.0,-90.0,-83.0,-89.0,14.0,21.0,14.0,29.0,1
318,CC:2F:71:3F:1F:24,7334680,6682249538,4125155,6276859373,3209525,405390165,80,940643,563734945,932147,562714577,8496,1020368,889752,619,4129873,406606,80,5394,130000.0,43333.0,-70.0,-64.0,-73.0,-69.0,-70.0,-64.0,-73.0,-68.0,-83.0,-90.0,-83.0,-89.0,13.0,26.0,10.0,20.0,1
319,F8:59:71:5A:E0:3D,3270548,488666994,61019,83276425,3209529,405390569,0,58554,41938945,53788,41369465,4766,569480,36757,16,63731,1638,0,482,144444.0,43333.0,-67.0,-74.0,-66.0,-70.0,-67.0,-74.0,-65.0,-70.0,-83.0,-90.0,-83.0,-89.0,16.0,16.0,17.0,19.0,1
320,CC:2F:71:3E:C5:1F,3220873,406778389,11344,1387820,3209529,405390569,6,48468,4058396,40063,3062538,8405,995858,11960,34,16308,186,6,819,130000.0,39000.0,-69.0,-69.0,-69.0,-60.0,-67.0,-68.0,-67.0,-60.0,-83.0,-90.0,-83.0,-89.0,14.0,21.0,14.0,29.0,1
321,CC:2F:71:3F:1F:24,7334880,6682473351,4125351,6277082782,3209529,405390569,80,940832,563960169,932336,562939801,8496,1020368,889939,619,4130070,406639,80,5394,130000.0,43333.0,-69.0,-64.0,-72.0,-69.0,-69.0,-64.0,-73.0,-69.0,-83.0,-90.0,-83.0,-89.0,14.0,26.0,11.0,20.0,1
322,F8:59:71:5A:E0:3D,3270623,488777732,61090,83386759,3209533,405390973,0,58626,42050091,53860,41480611,4766,569480,36829,16,63802,1638,0,485,144444.0,43333.0,-67.0,-75.0,-66.0,-70.0,-67.0,-74.0,-65.0,-70.0,-83.0,-90.0,-83.0,-89.0,16.0,15.0,17.0,19.0,1
323,CC:2F:71:3E:C5:1F,3220877,406778793,11344,1387820,3209533,405390973,6,48468,4058396,40063,3062538,8405,995858,11960,34,16308,186,6,819,130000.0,39000.0,-69.0,-69.0,-69.0,-60.0,-67.0,-68.0,-67.0,-60.0,-83.0,-90.0,-83.0,-89.0,14.0,21.0,14.0,29.0,1
324,CC:2F:71:3F:1F:24,7335053,6682696893,4125520,6277305920,3209533,405390973,80,940981,564162377,932485,563142009,8496,1020368,890086,619,4130239,406658,80,5394,130000.0,43333.0,-70.0,-64.0,-74.0,-69.0,-69.0,-64.0,-73.0,-69.0,-83.0,-90.0,-83.0,-89.0,13.0,26.0,9.0,20.0,1
325,F8:59:71:5A:E0:3D,3270690,488874544,61152,83483107,3209538,405391437,0,58688,42145571,53922,41576091,4766,569480,36891,16,63864,1639,0,485,144444.0,43333.0,-67.0,-75.0,-65.0,-70.0,-67.0,-74.0,-65.0,-70.0,-83.0,-90.0,-83.0,-89.0,16.0,15.0,18.0,19.0,1
326,CC:2F:71:3E:C5:1F,3220882,406779257,11344,1387820,3209538,405391437,6,48468,4058396,40063,3062538,8405,995858,11960,34,16308,186,6,819,130000.0,39000.0,-69.0,-69.0,-69.0,-60.0,-67.0,-68.0,-67.0,-60.0,-83.0,-90.0,-83.0,-89.0,14.0,21.0,14.0,29.0,1
327,CC:2F:71:3F:1F:24,7335227,6682905085,4125689,6277513648,3209538,405391437,80,941132,564358939,932636,563338571,8496,1020368,890235,619,4130408,406679,80,5394,130000.0,43333.0,-69.0,-64.0,-72.0,-68.0,-69.0,-64.0,-73.0,-68.0,-83.0,-90.0,-83.0,-89.0,14.0,26.0,11.0,21.0,1
328,F8:59:71:5A:E0:3D,3270756,488972921,61215,83581009,3209541,405391912,0,58751,42242591,53985,41673111,4766,569480,36954,16,63927,1641,0,485,144444.0,43333.0,-67.0,-75.0,-66.0,-70.0,-67.0,-74.0,-65.0,-70.0,-83.0,-90.0,-83.0,-89.0,16.0,15.0,17.0,19.0,1
329,CC:2F:71:3E:C5:1F,3220885,406779732,11344,1387820,3209541,405391912,6,48468,4058396,40063,3062538,8405,995858,11960,34,16308,186,6,819,130000.0,39000.0,-69.0,-69.0,-69.0,-60.0,-67.0,-68.0,-67.0,-60.0,-83.0,-90.0,-83.0,-89.0,14.0,21.0,14.0,29.0,1
330,CC:2F:71:3F:1F:24,7335390,6683112112,4125849,6277720200,3209541,405391912,80,941282,564559725,932786,563539357,8496,1020368,890382,619,4130568,406691,80,5394,130000.0,43333.0,-69.0,-64.0,-73.0,-69.0,-69.0,-64.0,-73.0,-68.0,-83.0,-90.0,-83.0,-89.0,14.0,26.0,10.0,20.0,1
331,F8:59:71:5A:E0:3D,3270833,489083861,61286,83691343,3209547,405392518,0,58822,42351973,54056,41782493,4766,569480,37025,16,63998,1641,0,485,144444.0,43333.0,-67.0,-75.0,-65.0,-71.0,-66.0,-74.0,-65.0,-70.0,-83.0,-90.0,-83.0,-89.0,16.0,15.0,18.0,18.0,1
332,CC:2F:71:3E:C5:1F,3220891,406780338,11344,1387820,3209547,405392518,6,48468,4058396,40063,3062538,8405,995858,11960,34,16308,186,6,819,130000.0,39000.0,-69.0,-69.0,-69.0,-60.0,-67.0,-68.0,-67.0,-60.0,-83.0,-90.0,-83.0,-89.0,14.0,21.0,14.0,29.0,1
333,CC:2F:71:3F:1F:24,7336559,6684867097,4127012,6279474579,3209547,405392518,80,941585,564816916,933089,563796548,8496,1020368,890683,619,4131730,407118,80,5395,130000.0,43333.0,-70.0,-65.0,-74.0,-69.0,-69.0,-64.0,-73.0,-68.0,-83.0,-90.0,-83.0,-89.0,13.0,25.0,9.0,20.0,1
334,F8:59:71:5A:E0:3D,3270906,489192903,61356,83800123,3209550,405392780,0,58893,42461369,54127,41891889,4766,569480,37095,16,64068,1643,0,486,144444.0,43333.0,-67.0,-75.0,-66.0,-70.0,-67.0,-75.0,-65.0,-70.0,-83.0,-90.0,-83.0,-89.0,16.0,15.0,17.0,19.0,1
335,CC:2F:71:3E:C5:1F,3220894,406780600,11344,1387820,3209550,405392780,6,48468,4058396,40063,3062538,8405,995858,11960,34,16308,186,6,819,130000.0,39000.0,-69.0,-69.0,-69.0,-60.0,-67.0,-68.0,-67.0,-60.0,-83.0,-90.0,-83.0,-89.0,14.0,21.0,14.0,29.0,1
336,CC:2F:71:3F:1F:24,7338468,6687811068,4128916,6282418086,3209552,405392982,80,941962,565077686,933466,564057318,8496,1020368,891060,619,4133580,408364,80,5397,130000.0,43333.0,-70.0,-65.0,-74.0,-69.0,-69.0,-65.0,-73.0,-69.0,-83.0,-90.0,-83.0,-89.0,13.0,25.0,9.0,20.0,1
337,F8:59:71:5A:E0:3D,3270986,489308505,61430,83915119,3209556,405393386,0,58967,42575329,54201,42005849,4766,569480,37169,16,64142,1647,0,486,144444.0,43333.0,-67.0,-75.0,-66.0,-70.0,-67.0,-75.0,-66.0,-70.0,-83.0,-90.0,-83.0,-89.0,16.0,15.0,17.0,19.0,1
338,CC:2F:71:3E:C5:1F,3220900,406781206,11344,1387820,3209556,405393386,6,48468,4058396,40063,3062538,8405,995858,11960,34,16308,186,6,819,130000.0,39000.0,-69.0,-69.0,-69.0,-60.0,-67.0,-68.0,-67.0,-60.0,-83.0,-90.0,-83.0,-89.0,14.0,21.0,14.0,29.0,1
339,CC:2F:71:3F:1F:24,7340526,6691000837,4130970,6285607451,3209556,405393386,80,942314,565317530,933818,564297162,8496,1020368,891412,619,4135689,409072,80,5398,130000.0,43333.0,-70.0,-65.0,-74.0,-69.0,-70.0,-65.0,-73.0,-69.0,-83.0,-90.0,-83.0,-89.0,13.0,25.0,9.0,20.0,1
340,F8:59:71:5A:E0:3D,3271054,489409777,61495,84016129,3209559,405393648,0,59032,42675429,54266,42105949,4766,569480,37234,16,64207,1648,0,486,144444.0,43333.0,-67.0,-75.0,-66.0,-70.0,-67.0,-74.0,-65.0,-70.0,-84.0,-90.0,-84.0,-90.0,17.0,15.0,18.0,20.0,1
341,CC:2F:71:3E:C5:1F,3220903,406781468,11344,1387820,3209559,405393648,6,48468,4058396,40063,3062538,8405,995858,11960,34,16308,186,6,819,130000.0,39000.0,-69.0,-69.0,-69.0,-60.0,-67.0,-68.0,-67.0,-60.0,-84.0,-90.0,-84.0,-90.0,15.0,21.0,15.0,30.0,1
342,CC:2F:71:3F:1F:24,7342353,6693828486,4132792,6288434636,3209561,405393850,80,942666,565543585,934170,564523217,8496,1020368,891764,619,4137511,409396,80,5399,130000.0,39000.0,-70.0,-65.0,-75.0,-69.0,-69.0,-65.0,-74.0,-69.0,-84.0,-90.0,-84.0,-90.0,14.0,25.0,9.0,21.0,1
343,F8:59:71:5A:E0:3D,3271127,489514389,61562,84120135,3209565,405394254,0,59100,42780149,54334,42210669,4766,569480,37302,16,64274,1652,0,486,144444.0,43333.0,-67.0,-75.0,-65.0,-70.0,-67.0,-75.0,-65.0,-70.0,-84.0,-90.0,-84.0,-90.0,17.0,15.0,19.0,20.0,1
344,CC:2F:71:3E:C5:1F,3220909,406782074,11344,1387820,3209565,405394254,6,48468,4058396,40063,3062538,8405,995858,11960,34,16308,186,6,819,130000.0,39000.0,-69.0,-69.0,-69.0,-60.0,-67.0,-68.0,-67.0,-60.0,-84.0,-90.0,-84.0,-90.0,15.0,21.0,15.0,30.0,1
345,CC:2F:71:3F:1F:24,7343615,6695750563,4134048,6290355941,3209567,405394622,80,942985,565781499,934489,564761131,8496,1020368,892075,619,4138767,410158,80,5399,117000.0,39000.0,-69.0,-65.0,-73.0,-68.0,-69.0,-64.0,-73.0,-68.0,-84.0,-90.0,-84.0,-90.0,15.0,25.0,11.0,22.0,1
346,F8:59:71:5A:E0:3D,3271197,489618991,61630,84224369,3209567,405394622,0,59166,42881789,54400,42312309,4766,569480,37368,16,64342,1656,0,486,144444.0,43333.0,-67.0,-75.0,-66.0,-70.0,-67.0,-74.0,-65.0,-70.0,-84.0,-90.0,-84.0,-90.0,17.0,15.0,18.0,20.0,1
347,CC:2F:71:3E:C5:1F,3220912,406782558,11345,1387936,3209567,405394622,6,48470,4058536,40065,3062678,8405,995858,11960,34,16309,186,6,819,130000.0,39000.0,-69.0,-69.0,-67.0,-61.0,-67.0,-68.0,-67.0,-60.0,-84.0,-91.0,-84.0,-90.0,15.0,22.0,17.0,29.0,1
348,CC:2F:71:3F:1F:24,7344950,6697811001,4135381,6292416177,3209569,405394824,80,943286,566003155,934790,564982787,8496,1020368,892368,619,4140061,410301,80,5401,130000.0,43333.0,-69.0,-65.0,-73.0,-69.0,-69.0,-64.0,-73.0,-69.0,-84.0,-91.0,-84.0,-90.0,15.0,26.0,11.0,21.0,1
349,F8:59:71:5A:E0:3D,3271271,489720869,61695,84325379,3209576,405395490,0,59233,42985039,54467,42415559,4766,569480,37433,16,64407,1657,0,486,144444.0,43333.0,-67.0,-75.0,-66.0,-70.0,-67.0,-75.0,-65.0,-70.0,-84.0,-91.0,-84.0,-90.0,17.0,16.0,18.0,20.0,1
350,CC:2F:71:3E:C5:1F,3220921,406783426,11345,1387936,3209576,405395490,6,48470,4058536,40065,3062678,8405,995858,11960,34,16309,186,6,819,130000.0,39000.0,-69.0,-69.0,-67.0,-61.0,-67.0,-68.0,-67.0,-60.0,-84.0,-91.0,-84.0,-90.0,15.0,22.0,17.0,29.0,1
351,CC:2F:71:3F:1F:24,7346217,6699747676,4136641,6294352186,3209576,405395490,80,943605,566235538,935109,565215170,8496,1020368,892685,619,4141360,410619,80,5401,130000.0,43333.0,-69.0,-64.0,-74.0,-69.0,-69.0,-64.0,-73.0,-69.0,-84.0,-91.0,-84.0,-90.0,15.0,27.0,10.0,21.0,1
352,F8:59:71:5A:E0:3D,3271337,489823433,61761,84427943,3209576,405395490,0,59299,43086679,54533,42517199,4766,569480,37499,16,64473,1659,0,486,144444.0,43333.0,-67.0,-75.0,-66.0,-70.0,-67.0,-74.0,-65.0,-70.0,-84.0,-91.0,-84.0,-90.0,17.0,16.0,18.0,20.0,1
353,CC:2F:71:3E:C5:1F,3220921,406783426,11345,1387936,3209576,405395490,6,48470,4058536,40065,3062678,8405,995858,11960,34,16309,186,6,819,130000.0,39000.0,-69.0,-69.0,-67.0,-61.0,-67.0,-68.0,-67.0,-60.0,-84.0,-91.0,-84.0,-90.0,15.0,22.0,17.0,29.0,1
354,CC:2F:71:3F:1F:24,7347759,6702125720,4138183,6296730230,3209576,405395490,80,943956,566471804,935460,565451436,8496,1020368,893031,619,4142883,411162,80,5401,130000.0,43333.0,-69.0,-65.0,-73.0,-69.0,-69.0,-65.0,-73.0,-69.0,-84.0,-91.0,-84.0,-90.0,15.0,26.0,11.0,21.0,1
355,F8:59:71:5A:E0:3D,3271411,489929711,61829,84533615,3209582,405396096,0,59367,43191399,54601,42621919,4766,569480,37567,16,64541,1663,0,486,144444.0,43333.0,-67.0,-75.0,-66.0,-71.0,-67.0,-75.0,-65.0,-70.0,-85.0,-91.0,-84.0,-90.0,18.0,16.0,18.0,19.0,1
356,CC:2F:71:3E:C5:1F,3220929,406784234,11345,1387936,3209584,405396298,6,48470,4058536,40065,3062678,8405,995858,11960,34,16309,186,6,819,130000.0,39000.0,-69.0,-69.0,-67.0,-61.0,-67.0,-68.0,-67.0,-60.0,-85.0,-91.0,-84.0,-90.0,16.0,22.0,17.0,29.0,1
357,CC:2F:71:3F:1F:24,7348879,6703826521,4139295,6298430223,3209584,405396298,80,944254,566696383,935758,565676015,8496,1020368,893325,619,4144004,411451,80,5402,130000.0,43333.0,-70.0,-65.0,-73.0,-69.0,-69.0,-65.0,-74.0,-69.0,-85.0,-91.0,-84.0,-90.0,15.0,26.0,11.0,21.0,1
358,F8:59:71:5A:E0:3D,3271479,490030983,61894,84634625,3209585,405396358,0,59433,43293053,54667,42723573,4766,569480,37632,16,64606,1666,0,486,144444.0,43333.0,-67.0,-75.0,-66.0,-71.0,-67.0,-74.0,-65.0,-70.0,-85.0,-91.0,-84.0,-90.0,18.0,16.0,18.0,19.0,1
359,CC:2F:71:3E:C5:1F,3220930,406784294,11345,1387936,3209585,405396358,6,48470,4058536,40065,3062678,8405,995858,11960,34,16309,186,6,819,130000.0,39000.0,-69.0,-69.0,-67.0,-61.0,-67.0,-68.0,-67.0,-60.0,-85.0,-91.0,-84.0,-90.0,16.0,22.0,17.0,29.0,1
360,CC:2F:71:3F:1F:24,7350099,6705688154,4140514,6300291796,3209585,405396358,80,944574,566942154,936078,565921786,8496,1020368,893628,619,4145223,411703,80,5403,117000.0,39000.0,-70.0,-65.0,-74.0,-70.0,-69.0,-64.0,-73.0,-69.0,-85.0,-91.0,-84.0,-90.0,15.0,26.0,10.0,20.0,1
361,F8:59:71:5A:E0:3D,3271550,490132599,61959,84735635,3209591,405396964,0,59498,43393153,54732,42823673,4766,569480,37697,16,64671,1668,0,486,144444.0,43333.0,-67.0,-75.0,-66.0,-70.0,-67.0,-75.0,-65.0,-70.0,-85.0,-91.0,-84.0,-90.0,18.0,16.0,18.0,20.0,1
362,CC:2F:71:3E:C5:1F,3220936,406784900,11345,1387936,3209591,405396964,6,48470,4058536,40065,3062678,8405,995858,11960,34,16309,186,6,819,130000.0,39000.0,-69.0,-69.0,-67.0,-61.0,-67.0,-68.0,-67.0,-60.0,-85.0,-91.0,-84.0,-90.0,16.0,22.0,17.0,29.0,1
363,CC:2F:71:3F:1F:24,7351578,6707817647,4141985,6302420481,3209593,405397166,80,945048,567192897,936552,566172529,8496,1020368,894095,619,4146704,411751,80,5403,130000.0,43333.0,-70.0,-65.0,-74.0,-70.0,-69.0,-65.0,-73.0,-69.0,-85.0,-91.0,-84.0,-90.0,15.0,26.0,10.0,20.0,1
364,F8:59:71:5A:E0:3D,3271641,490246217,62026,84838203,3209615,405408014,0,59562,43490349,54796,42920869,4766,569480,37761,16,64738,1668,0,486,144444.0,39000.0,-67.0,-75.0,-66.0,-71.0,-67.0,-74.0,-65.0,-70.0,-84.0,-91.0,-84.0,-90.0,17.0,16.0,18.0,19.0,1
365,CC:2F:71:3E:C5:1F,3220962,406796072,11345,1387936,3209617,405408136,6,48471,4058654,40065,3062678,8406,995976,11961,34,16309,186,6,819,130000.0,39000.0,-64.0,-68.0,-62.0,-60.0,-67.0,-68.0,-66.0,-60.0,-84.0,-91.0,-84.0,-90.0,20.0,23.0,22.0,30.0,1
366,CC:2F:71:3F:1F:24,7352853,6709745526,4143236,6304337390,3209617,405408136,80,945379,567454607,936883,566434239,8496,1020368,894423,619,4147954,411972,80,5404,130000.0,43333.0,-69.0,-65.0,-73.0,-69.0,-70.0,-65.0,-74.0,-69.0,-84.0,-91.0,-84.0,-90.0,15.0,26.0,11.0,21.0,1
367,F8:59:71:5A:E0:3D,3271725,490364993,62102,84956251,3209623,405408742,0,59641,43612065,54875,43042585,4766,569480,37840,16,64814,1669,0,488,144444.0,43333.0,-67.0,-75.0,-66.0,-71.0,-67.0,-74.0,-66.0,-70.0,-84.0,-91.0,-84.0,-90.0,17.0,16.0,18.0,19.0,1
368,CC:2F:71:3E:C5:1F,3220970,406796880,11345,1387936,3209625,405408944,6,48472,4058724,40066,3062748,8406,995976,11961,34,16309,186,6,819,130000.0,39000.0,-69.0,-70.0,-68.0,-61.0,-67.0,-68.0,-67.0,-60.0,-84.0,-91.0,-84.0,-90.0,15.0,21.0,16.0,29.0,1
369,CC:2F:71:3F:1F:24,7354560,6712340105,4144935,6306931161,3209625,405408944,80,945762,567688680,937266,566668312,8496,1020368,894802,619,4149654,412046,80,5404,130000.0,43333.0,-69.0,-65.0,-72.0,-69.0,-69.0,-65.0,-73.0,-69.0,-84.0,-91.0,-84.0,-90.0,15.0,26.0,12.0,21.0,1
370,F8:59:71:5A:E0:3D,3271793,490466478,62167,85057261,3209626,405409217,0,59706,43712207,54940,43142727,4766,569480,37905,16,64879,1673,0,488,144444.0,43333.0,-67.0,-75.0,-66.0,-71.0,-67.0,-74.0,-65.0,-70.0,-84.0,-91.0,-84.0,-90.0,17.0,16.0,18.0,19.0,1
371,CC:2F:71:3E:C5:1F,3220971,406797153,11345,1387936,3209626,405409217,6,48472,4058724,40066,3062748,8406,995976,11961,34,16309,186,6,819,130000.0,39000.0,-69.0,-70.0,-68.0,-61.0,-67.0,-68.0,-67.0,-60.0,-84.0,-91.0,-84.0,-90.0,15.0,21.0,16.0,29.0,1
372,CC:2F:71:3F:1F:24,7356408,6715162185,4146782,6309752968,3209626,405409217,80,946208,567938583,937712,566918215,8496,1020368,895225,619,4151501,412150,80,5406,130000.0,39000.0,-69.0,-65.0,-74.0,-69.0,-69.0,-65.0,-73.0,-69.0,-84.0,-91.0,-84.0,-90.0,15.0,26.0,10.0,21.0,1
373,F8:59:71:5A:E0:3D,3271866,490568216,62232,85158271,3209634,405409945,0,59772,43812425,55005,43242827,4767,569598,37971,16,64944,1674,0,489,144444.0,43333.0,-67.0,-74.0,-66.0,-71.0,-67.0,-74.0,-65.0,-71.0,-84.0,-91.0,-84.0,-90.0,17.0,17.0,18.0,19.0,1
374,CC:2F:71:3E:C5:1F,3220979,406797881,11345,1387936,3209634,405409945,6,48472,4058724,40066,3062748,8406,995976,11961,34,16309,186,6,819,130000.0,39000.0,-69.0,-70.0,-68.0,-61.0,-67.0,-68.0,-67.0,-60.0,-84.0,-91.0,-84.0,-90.0,15.0,21.0,16.0,29.0,1
375,CC:2F:71:3F:1F:24,7358086,6717756125,4148452,6312346180,3209634,405409945,80,946543,568166955,938047,567146587,8496,1020368,895547,619,4153171,412319,80,5406,130000.0,43333.0,-69.0,-65.0,-73.0,-70.0,-69.0,-65.0,-73.0,-69.0,-84.0,-91.0,-84.0,-90.0,15.0,26.0,11.0,20.0,1
376,F8:59:71:5A:E0:3D,3271933,490669428,62297,85259281,3209636,405410147,0,59837,43912525,55070,43342927,4767,569598,38036,16,65009,1675,0,489,144444.0,43333.0,-67.0,-74.0,-66.0,-71.0,-66.0,-74.0,-65.0,-70.0,-84.0,-91.0,-84.0,-90.0,17.0,17.0,18.0,19.0,1
377,CC:2F:71:3E:C5:1F,3220981,406798083,11345,1387936,3209636,405410147,6,48472,4058724,40066,3062748,8406,995976,11961,34,16309,186,6,819,130000.0,39000.0,-69.0,-70.0,-68.0,-61.0,-67.0,-68.0,-67.0,-60.0,-84.0,-91.0,-84.0,-90.0,15.0,21.0,16.0,29.0,1
378,CC:2F:71:3F:1F:24,7360012,6720748999,4150376,6315338852,3209636,405410147,80,946911,568405013,938415,567384645,8496,1020368,895907,619,4155095,412560,80,5406,130000.0,43333.0,-70.0,-65.0,-73.0,-69.0,-69.0,-65.0,-73.0,-69.0,-84.0,-91.0,-84.0,-90.0,14.0,26.0,11.0,21.0,1
379,F8:59:71:5A:E0:3D,3272003,490769490,62361,85358737,3209642,405410753,0,59900,44009545,55133,43439947,4767,569598,38099,16,65073,1677,0,489,144444.0,43333.0,-67.0,-74.0,-66.0,-71.0,-67.0,-74.0,-65.0,-70.0,-84.0,-91.0,-84.0,-90.0,17.0,17.0,18.0,19.0,1
380,CC:2F:71:3E:C5:1F,3220987,406798689,11345,1387936,3209642,405410753,6,48472,4058724,40066,3062748,8406,995976,11961,34,16309,186,6,819,130000.0,39000.0,-69.0,-70.0,-68.0,-61.0,-67.0,-68.0,-67.0,-60.0,-84.0,-91.0,-84.0,-90.0,15.0,21.0,16.0,29.0,1
381,CC:2F:71:3F:1F:24,7361495,6723036959,4151853,6317626206,3209642,405410753,80,947227,568630261,938731,567609893,8496,1020368,896219,619,4156571,412994,80,5406,130000.0,43333.0,-70.0,-65.0,-73.0,-70.0,-69.0,-64.0,-73.0,-70.0,-84.0,-91.0,-84.0,-90.0,14.0,26.0,11.0,20.0,1
382,F8:59:71:5A:E0:3D,3272073,490873758,62428,85462743,3209645,405411015,0,59968,44114265,55201,43544667,4767,569598,38167,16,65140,1684,0,489,144444.0,43333.0,-68.0,-74.0,-65.0,-71.0,-67.0,-74.0,-64.0,-70.0,-84.0,-91.0,-84.0,-90.0,16.0,17.0,19.0,19.0,1
383,CC:2F:71:3E:C5:1F,3220990,406798951,11345,1387936,3209645,405411015,6,48472,4058724,40066,3062748,8406,995976,11961,34,16309,186,6,819,130000.0,39000.0,-69.0,-70.0,-68.0,-61.0,-67.0,-68.0,-67.0,-60.0,-84.0,-91.0,-84.0,-90.0,15.0,21.0,16.0,29.0,1
384,CC:2F:71:3F:1F:24,7362926,6725239034,4153280,6319827957,3209646,405411077,80,947607,568890577,939110,567870091,8497,1020486,896585,619,4157995,413564,80,5408,104000.0,26000.0,-70.0,-64.0,-73.0,-71.0,-70.0,-63.0,-73.0,-70.0,-84.0,-91.0,-84.0,-90.0,14.0,27.0,11.0,19.0,1
385,F8:59:71:5A:E0:3D,3272152,490986314,62500,85574631,3209652,405411683,0,60041,44226797,55274,43657199,4767,569598,38239,16,65212,1684,0,490,144444.0,43333.0,-67.0,-74.0,-64.0,-70.0,-67.0,-73.0,-64.0,-70.0,-84.0,-91.0,-84.0,-90.0,17.0,17.0,20.0,20.0,1
386,CC:2F:71:3E:C5:1F,3220997,406799619,11345,1387936,3209652,405411683,6,48472,4058724,40066,3062748,8406,995976,11961,34,16309,186,6,819,130000.0,39000.0,-69.0,-70.0,-68.0,-61.0,-67.0,-68.0,-67.0,-60.0,-84.0,-91.0,-84.0,-90.0,15.0,21.0,16.0,29.0,1
387,CC:2F:71:3F:1F:24,7364464,6727612896,4154812,6322201213,3209652,405411683,80,947979,569128093,939482,568107607,8497,1020486,896947,619,4159514,414269,80,5408,86667.0,14444.0,-73.0,-65.0,-73.0,-69.0,-72.0,-64.0,-73.0,-68.0,-84.0,-91.0,-84.0,-90.0,11.0,26.0,11.0,21.0,1
388,F8:59:71:5A:E0:3D,3272219,491086088,62565,85674203,3209654,405411885,0,60107,44327171,55340,43757573,4767,569598,38305,16,65277,1684,0,493,144444.0,43333.0,-67.0,-73.0,-65.0,-69.0,-67.0,-73.0,-64.0,-69.0,-84.0,-90.0,-84.0,-90.0,17.0,17.0,19.0,21.0,1
389,CC:2F:71:3E:C5:1F,3220999,406799821,11345,1387936,3209654,405411885,6,48472,4058724,40066,3062748,8406,995976,11961,34,16309,186,6,819,130000.0,39000.0,-69.0,-70.0,-68.0,-61.0,-67.0,-68.0,-67.0,-60.0,-84.0,-90.0,-84.0,-90.0,15.0,20.0,16.0,29.0,1
390,CC:2F:71:3F:1F:24,7366129,6730190292,4156474,6324778347,3209655,405411945,80,948328,569356563,939831,568336077,8497,1020486,897294,619,4161193,414428,80,5410,144444.0,43333.0,-69.0,-64.0,-72.0,-72.0,-69.0,-64.0,-71.0,-71.0,-84.0,-90.0,-84.0,-90.0,15.0,26.0,12.0,18.0,1
391,F8:59:71:5A:E0:3D,3272293,491190872,62632,85778321,3209661,405412551,0,60174,44430365,55407,43860767,4767,569598,38371,16,65344,1684,0,493,144444.0,43333.0,-66.0,-73.0,-65.0,-70.0,-66.0,-73.0,-65.0,-69.0,-84.0,-90.0,-84.0,-90.0,18.0,17.0,19.0,20.0,1
392,CC:2F:71:3E:C5:1F,3221006,406800487,11345,1387936,3209661,405412551,6,48472,4058724,40066,3062748,8406,995976,11961,34,16309,186,6,819,130000.0,39000.0,-69.0,-70.0,-68.0,-61.0,-67.0,-68.0,-67.0,-60.0,-84.0,-90.0,-84.0,-90.0,15.0,20.0,16.0,29.0,1
393,CC:2F:71:3F:1F:24,7367504,6732309068,4157843,6326896517,3209661,405412551,80,948637,569584943,940140,568564457,8497,1020486,897593,619,4162555,414800,80,5412,115556.0,28889.0,-68.0,-64.0,-72.0,-69.0,-68.0,-64.0,-72.0,-69.0,-84.0,-90.0,-84.0,-90.0,16.0,26.0,12.0,21.0,1
394,F8:59:71:5A:E0:3D,3272360,491292084,62697,85879331,3209663,405412753,0,60238,44528925,55471,43959327,4767,569598,38435,16,65409,1687,0,493,144444.0,43333.0,-66.0,-74.0,-65.0,-70.0,-66.0,-74.0,-65.0,-70.0,-84.0,-90.0,-84.0,-90.0,18.0,16.0,19.0,20.0,1
395,CC:2F:71:3E:C5:1F,3221008,406800689,11345,1387936,3209663,405412753,6,48472,4058724,40066,3062748,8406,995976,11961,34,16309,186,6,819,130000.0,39000.0,-69.0,-70.0,-68.0,-61.0,-67.0,-68.0,-67.0,-60.0,-84.0,-90.0,-84.0,-90.0,15.0,20.0,16.0,29.0,1
396,CC:2F:71:3F:1F:24,7368717,6734163932,4159054,6328751179,3209663,405412753,80,949008,569830777,940511,568810291,8497,1020486,897939,619,4163765,415122,80,5412,115556.0,28889.0,-69.0,-63.0,-74.0,-69.0,-68.0,-63.0,-73.0,-69.0,-84.0,-90.0,-84.0,-90.0,15.0,27.0,10.0,21.0,1
397,F8:59:71:5A:E0:3D,3272433,491395314,62763,85981895,3209670,405413419,0,60306,44633659,55539,44064061,4767,569598,38502,16,65474,1689,0,493,144444.0,43333.0,-67.0,-73.0,-65.0,-70.0,-66.0,-73.0,-65.0,-70.0,-84.0,-90.0,-84.0,-90.0,17.0,17.0,19.0,20.0,1
398,CC:2F:71:3E:C5:1F,3221015,406801355,11345,1387936,3209670,405413419,6,48472,4058724,40066,3062748,8406,995976,11961,34,16309,186,6,819,130000.0,39000.0,-69.0,-70.0,-68.0,-61.0,-67.0,-68.0,-67.0,-60.0,-84.0,-90.0,-84.0,-90.0,15.0,20.0,16.0,29.0,1
399,CC:2F:71:3F:1F:24,7369622,6735529085,4159952,6330115666,3209670,405413419,80,949322,570055610,940825,569035124,8497,1020486,898253,619,4164671,415326,80,5413,115556.0,28889.0,-68.0,-64.0,-71.0,-70.0,-68.0,-64.0,-71.0,-70.0,-84.0,-90.0,-84.0,-90.0,16.0,26.0,13.0,20.0,1
400,F8:59:71:5A:E0:3D,3272500,491496526,62828,86082905,3209672,405413621,0,60372,44735313,55605,44165715,4767,569598,38567,16,65540,1693,0,493,144444.0,43333.0,-67.0,-74.0,-66.0,-71.0,-66.0,-73.0,-65.0,-71.0,-84.0,-90.0,-84.0,-90.0,17.0,16.0,18.0,19.0,1
401,CC:2F:71:3E:C5:1F,3221017,406801557,11345,1387936,3209672,405413621,6,48472,4058724,40066,3062748,8406,995976,11961,34,16309,186,6,819,130000.0,39000.0,-69.0,-70.0,-68.0,-61.0,-67.0,-68.0,-67.0,-60.0,-84.0,-90.0,-84.0,-90.0,15.0,20.0,16.0,29.0,1
402,CC:2F:71:3F:1F:24,7370683,6737148437,4161011,6331734816,3209672,405413621,80,949635,570285974,941138,569265488,8497,1020486,898548,619,4165730,415678,80,5416,115556.0,28889.0,-68.0,-64.0,-72.0,-70.0,-68.0,-64.0,-71.0,-70.0,-84.0,-90.0,-84.0,-90.0,16.0,26.0,12.0,20.0,1
403,F8:59:71:5A:E0:3D,3272564,491595982,62892,86182361,3209672,405413621,0,60437,44835427,55670,44265829,4767,569598,38631,16,65604,1696,0,493,144444.0,43333.0,-67.0,-74.0,-65.0,-71.0,-66.0,-73.0,-65.0,-71.0,-84.0,-90.0,-84.0,-90.0,17.0,16.0,19.0,19.0,1
404,CC:2F:71:3E:C5:1F,3221019,406801759,11345,1387936,3209674,405413823,6,48472,4058724,40066,3062748,8406,995976,11961,34,16309,186,6,819,130000.0,39000.0,-69.0,-70.0,-68.0,-61.0,-67.0,-68.0,-67.0,-60.0,-84.0,-90.0,-84.0,-90.0,15.0,20.0,16.0,29.0,1
405,CC:2F:71:3F:1F:24,7371780,6738827429,4162103,6333413336,3209677,405414093,80,949906,570508260,941409,569487774,8497,1020486,898811,619,4166820,415780,80,5416,117000.0,39000.0,-68.0,-64.0,-71.0,-70.0,-68.0,-64.0,-71.0,-70.0,-84.0,-91.0,-84.0,-90.0,16.0,27.0,13.0,20.0,1
406,F8:59:71:5A:E0:3D,3272639,491699414,62958,86284925,3209681,405414489,0,60503,44937067,55736,44367469,4767,569598,38697,16,65670,1697,0,493,144444.0,43333.0,-67.0,-73.0,-66.0,-71.0,-66.0,-73.0,-65.0,-71.0,-84.0,-91.0,-84.0,-90.0,17.0,18.0,18.0,19.0,1
407,CC:2F:71:3E:C5:1F,3221026,406802425,11345,1387936,3209681,405414489,6,48472,4058724,40066,3062748,8406,995976,11961,34,16309,186,6,819,130000.0,39000.0,-69.0,-70.0,-68.0,-61.0,-67.0,-68.0,-67.0,-60.0,-84.0,-91.0,-84.0,-90.0,15.0,21.0,16.0,29.0,1
408,CC:2F:71:3F:1F:24,7373315,6741199783,4163634,6335785294,3209681,405414489,80,950246,570756280,941749,569735794,8497,1020486,899144,619,4168353,415870,80,5417,115556.0,28889.0,-70.0,-65.0,-73.0,-71.0,-69.0,-65.0,-72.0,-71.0,-84.0,-91.0,-84.0,-90.0,14.0,26.0,11.0,19.0,1
409,F8:59:71:5A:E0:3D,3272708,491805359,63026,86390597,3209682,405414762,0,60571,45041787,55804,44472189,4767,569598,38765,16,65738,1700,0,493,144444.0,43333.0,-66.0,-73.0,-65.0,-71.0,-66.0,-72.0,-65.0,-70.0,-84.0,-91.0,-84.0,-90.0,18.0,18.0,19.0,19.0,1
410,CC:2F:71:3E:C5:1F,3221029,406802900,11345,1387936,3209684,405414964,6,48472,4058724,40066,3062748,8406,995976,11961,34,16309,186,6,819,130000.0,39000.0,-69.0,-70.0,-68.0,-61.0,-67.0,-68.0,-67.0,-60.0,-84.0,-91.0,-84.0,-90.0,15.0,21.0,16.0,29.0,1
411,CC:2F:71:3F:1F:24,7374810,6743500619,4165124,6338085453,3209686,405415166,80,950580,570992355,942083,569971869,8497,1020486,899470,619,4169843,415992,80,5418,115556.0,28889.0,-68.0,-64.0,-71.0,-70.0,-68.0,-64.0,-71.0,-69.0,-84.0,-91.0,-84.0,-90.0,16.0,27.0,13.0,20.0,1
412,F8:59:71:5A:E0:3D,3272782,491908731,63092,86493161,3209690,405415570,0,60637,45143427,55870,44573829,4767,569598,38831,16,65803,1702,0,493,144444.0,43333.0,-67.0,-73.0,-66.0,-71.0,-66.0,-73.0,-65.0,-70.0,-84.0,-91.0,-84.0,-90.0,17.0,18.0,18.0,19.0,1
413,CC:2F:71:3E:C5:1F,3221035,406803506,11345,1387936,3209690,405415570,6,48472,4058724,40066,3062748,8406,995976,11961,34,16309,186,6,819,130000.0,39000.0,-69.0,-70.0,-68.0,-61.0,-67.0,-68.0,-67.0,-60.0,-84.0,-91.0,-84.0,-90.0,15.0,21.0,16.0,29.0,1
414,CC:2F:71:3F:1F:24,7376094,6745477423,4166404,6340061853,3209690,405415570,80,950893,571215209,942396,570194723,8497,1020486,899776,619,4171123,416202,80,5418,104000.0,26000.0,-68.0,-64.0,-72.0,-71.0,-68.0,-64.0,-71.0,-71.0,-84.0,-91.0,-84.0,-90.0,16.0,27.0,12.0,19.0,1
415,F8:59:71:5A:E0:3D,3272847,492008247,63156,86592617,3209691,405415630,0,60701,45241987,55934,44672389,4767,569598,38895,16,65868,1703,0,493,144444.0,43333.0,-66.0,-73.0,-65.0,-70.0,-66.0,-73.0,-65.0,-70.0,-84.0,-91.0,-84.0,-90.0,18.0,18.0,19.0,20.0,1
416,CC:2F:71:3E:C5:1F,3221036,406803566,11345,1387936,3209691,405415630,6,48472,4058724,40066,3062748,8406,995976,11961,34,16309,186,6,819,130000.0,39000.0,-69.0,-70.0,-68.0,-61.0,-67.0,-68.0,-67.0,-60.0,-84.0,-91.0,-84.0,-90.0,15.0,21.0,16.0,29.0,1
417,CC:2F:71:3F:1F:24,7377421,6747526295,4167730,6342110665,3209691,405415630,80,951226,571443499,942729,570423013,8497,1020486,900097,619,4172427,416362,80,5418,115556.0,28889.0,-68.0,-64.0,-72.0,-70.0,-68.0,-63.0,-71.0,-70.0,-84.0,-91.0,-84.0,-90.0,16.0,27.0,12.0,20.0,1
418,F8:59:71:5A:E0:3D,3272918,492109863,63221,86693627,3209697,405416236,0,60767,45343627,56000,44774029,4767,569598,38961,16,65933,1704,0,493,144444.0,43333.0,-67.0,-74.0,-66.0,-71.0,-66.0,-73.0,-65.0,-70.0,-84.0,-91.0,-84.0,-90.0,17.0,17.0,18.0,19.0,1
419,CC:2F:71:3E:C5:1F,3221044,406804374,11345,1387936,3209699,405416438,6,48472,4058724,40066,3062748,8406,995976,11961,34,16309,186,6,819,130000.0,39000.0,-69.0,-70.0,-68.0,-61.0,-67.0,-68.0,-67.0,-60.0,-84.0,-91.0,-84.0,-90.0,15.0,21.0,16.0,29.0,1
420,CC:2F:71:3F:1F:24,7378392,6749004013,4168693,6343587575,3209699,405416438,80,951527,571683649,943030,570663163,8497,1020486,900376,619,4173392,416775,80,5418,115556.0,28889.0,-68.0,-63.0,-72.0,-70.0,-68.0,-63.0,-71.0,-70.0,-84.0,-91.0,-84.0,-90.0,16.0,28.0,12.0,20.0,1
421,F8:59:71:5A:E0:3D,3272985,492211075,63286,86794637,3209699,405416438,0,60833,45445281,56066,44875683,4767,569598,39026,16,65998,1707,0,493,144444.0,43333.0,-67.0,-74.0,-66.0,-71.0,-66.0,-73.0,-65.0,-70.0,-84.0,-91.0,-84.0,-90.0,17.0,17.0,18.0,19.0,1
422,CC:2F:71:3E:C5:1F,3221044,406804374,11345,1387936,3209699,405416438,6,48472,4058724,40066,3062748,8406,995976,11961,34,16309,186,6,819,130000.0,39000.0,-69.0,-70.0,-68.0,-61.0,-67.0,-68.0,-67.0,-60.0,-84.0,-91.0,-84.0,-90.0,15.0,21.0,16.0,29.0,1
423,CC:2F:71:3F:1F:24,7379545,6750772706,4169846,6345356268,3209699,405416438,80,951868,571930730,943371,570910244,8497,1020486,900702,619,4174565,417182,80,5418,115556.0,28889.0,-68.0,-64.0,-72.0,-70.0,-68.0,-63.0,-71.0,-70.0,-84.0,-91.0,-84.0,-90.0,16.0,27.0,12.0,20.0,1
424,F8:59:71:5A:E0:3D,3273058,492314305,63352,86897201,3209706,405417104,0,60899,45546935,56132,44977337,4767,569598,39091,16,66064,1709,0,493,144444.0,43333.0,-66.0,-73.0,-65.0,-70.0,-66.0,-73.0,-65.0,-70.0,-84.0,-91.0,-84.0,-90.0,18.0,18.0,19.0,20.0,1
425,CC:2F:71:3E:C5:1F,3221051,406805040,11345,1387936,3209706,405417104,6,48472,4058724,40066,3062748,8406,995976,11961,34,16309,186,6,819,130000.0,39000.0,-69.0,-70.0,-68.0,-61.0,-67.0,-68.0,-67.0,-60.0,-84.0,-90.0,-84.0,-90.0,15.0,20.0,16.0,29.0,1
426,CC:2F:71:3F:1F:24,7380575,6752341472,4170867,6346924166,3209708,405417306,80,952177,572160488,943680,571140002,8497,1020486,900997,619,4175586,417569,80,5418,130000.0,39000.0,-69.0,-64.0,-72.0,-70.0,-68.0,-64.0,-72.0,-70.0,-84.0,-90.0,-84.0,-90.0,15.0,26.0,12.0,20.0,1
427,F8:59:71:5A:E0:3D,3273128,492418741,63420,87001435,3209708,405417306,0,60966,45650115,56199,45080517,4767,569598,39158,16,66132,1711,0,493,144444.0,43333.0,-66.0,-74.0,-66.0,-71.0,-66.0,-73.0,-65.0,-70.0,-84.0,-90.0,-84.0,-90.0,18.0,16.0,18.0,19.0,1
428,CC:2F:71:3E:C5:1F,3221054,406805358,11346,1388052,3209708,405417306,6,48473,4058794,40067,3062818,8406,995976,11961,34,16310,186,6,819,144444.0,39000.0,-78.0,-84.0,-75.0,-71.0,-68.0,-70.0,-67.0,-61.0,-84.0,-90.0,-84.0,-90.0,6.0,6.0,9.0,19.0,1
429,CC:2F:71:3F:1F:24,7381725,6754110582,4172017,6348693276,3209708,405417306,80,952492,572392254,943995,571371768,8497,1020486,901301,619,4176718,418062,80,5419,130000.0,43333.0,-68.0,-64.0,-72.0,-70.0,-68.0,-63.0,-72.0,-70.0,-84.0,-90.0,-84.0,-90.0,16.0,26.0,12.0,20.0,1
430,F8:59:71:5A:E0:3D,3273199,492518695,63484,87100723,3209715,405417972,0,61031,45750229,56264,45180631,4767,569598,39222,16,66196,1713,0,493,144444.0,43333.0,-67.0,-74.0,-65.0,-71.0,-66.0,-72.0,-66.0,-70.0,-84.0,-90.0,-84.0,-90.0,17.0,16.0,19.0,19.0,1
431,CC:2F:71:3E:C5:1F,3221063,406806226,11346,1388052,3209717,405418174,6,48474,4058864,40068,3062888,8406,995976,11961,34,16310,186,6,819,144444.0,39000.0,-69.0,-70.0,-66.0,-61.0,-69.0,-71.0,-67.0,-62.0,-84.0,-90.0,-84.0,-90.0,15.0,20.0,18.0,29.0,1
432,CC:2F:71:3F:1F:24,7383115,6756244996,4173398,6350826822,3209717,405418174,80,952821,572690926,944324,571670440,8497,1020486,901617,619,4178102,418644,80,5419,130000.0,43333.0,-68.0,-64.0,-73.0,-70.0,-67.0,-63.0,-72.0,-69.0,-84.0,-90.0,-84.0,-90.0,16.0,26.0,11.0,20.0,1
433,F8:59:71:5A:E0:3D,3273292,492660311,63575,87242137,3209717,405418174,0,61123,45891923,56356,45322325,4767,569598,39313,16,66287,1714,0,493,144444.0,43333.0,-66.0,-74.0,-65.0,-70.0,-66.0,-74.0,-65.0,-70.0,-84.0,-90.0,-84.0,-90.0,18.0,16.0,19.0,20.0,1
434,CC:2F:71:3E:C5:1F,3221067,406806630,11346,1388052,3209721,405418578,6,48474,4058864,40068,3062888,8406,995976,11961,34,16310,186,6,819,144444.0,39000.0,-69.0,-70.0,-66.0,-61.0,-69.0,-71.0,-67.0,-62.0,-84.0,-90.0,-84.0,-90.0,15.0,20.0,18.0,29.0,1
435,CC:2F:71:3F:1F:24,7384061,6757663971,4174338,6352245191,3209723,405418780,80,953129,572960987,944632,571940501,8497,1020486,901911,619,4179057,419118,80,5419,115556.0,28889.0,-69.0,-64.0,-74.0,-70.0,-68.0,-63.0,-73.0,-69.0,-84.0,-90.0,-84.0,-90.0,15.0,26.0,10.0,20.0,1
436,F8:59:71:5A:E0:3D,3273382,492788547,63657,87369565,3209725,405418982,0,61205,46018203,56438,45448605,4767,569598,39395,16,66369,1715,0,493,144444.0,43333.0,-67.0,-74.0,-66.0,-71.0,-66.0,-73.0,-65.0,-70.0,-84.0,-90.0,-84.0,-90.0,17.0,16.0,18.0,19.0,1
437,CC:2F:71:3E:C5:1F,3221072,406807094,11346,1388052,3209726,405419042,6,48474,4058864,40068,3062888,8406,995976,11961,34,16310,186,6,819,144444.0,39000.0,-69.0,-70.0,-66.0,-61.0,-69.0,-71.0,-67.0,-62.0,-84.0,-90.0,-84.0,-90.0,15.0,20.0,18.0,29.0,1
438,CC:2F:71:3F:1F:24,7385154,6759338205,4175428,6353919163,3209726,405419042,80,953415,573187857,944918,572167371,8497,1020486,902189,619,4180147,419337,80,5420,115556.0,28889.0,-69.0,-64.0,-73.0,-70.0,-68.0,-64.0,-73.0,-70.0,-84.0,-90.0,-84.0,-90.0,15.0,26.0,11.0,20.0,1
439,F8:59:71:5A:E0:3D,3273451,492889769,63722,87470463,3209729,405419306,0,61272,46121397,56505,45551799,4767,569598,39461,16,66434,1719,0,493,144444.0,43333.0,-67.0,-74.0,-66.0,-71.0,-67.0,-74.0,-65.0,-70.0,-84.0,-90.0,-84.0,-90.0,17.0,16.0,18.0,19.0,1
440,CC:2F:71:3E:C5:1F,3221077,406807560,11346,1388052,3209731,405419508,6,48474,4058864,40068,3062888,8406,995976,11961,34,16310,186,6,819,144444.0,39000.0,-69.0,-70.0,-66.0,-61.0,-69.0,-71.0,-67.0,-62.0,-84.0,-90.0,-84.0,-90.0,15.0,20.0,18.0,29.0,1
441,CC:2F:71:3F:1F:24,7386380,6761215967,4176647,6355796257,3209733,405419710,80,953730,573418111,945231,572397389,8499,1020722,902497,619,4181362,419545,80,5422,117000.0,39000.0,-69.0,-64.0,-73.0,-71.0,-68.0,-64.0,-73.0,-70.0,-84.0,-90.0,-84.0,-90.0,15.0,26.0,11.0,19.0,1
442,F8:59:71:5A:E0:3D,3273523,492992939,63788,87573027,3209735,405419912,0,61337,46221497,56570,45651899,4767,569598,39526,16,66500,1719,0,493,144444.0,43333.0,-67.0,-74.0,-66.0,-71.0,-67.0,-74.0,-66.0,-70.0,-84.0,-90.0,-84.0,-90.0,17.0,16.0,18.0,19.0,1
443,CC:2F:71:3E:C5:1F,3221081,406807964,11346,1388052,3209735,405419912,6,48474,4058864,40068,3062888,8406,995976,11961,34,16310,186,6,819,144444.0,39000.0,-69.0,-70.0,-66.0,-61.0,-69.0,-71.0,-67.0,-62.0,-84.0,-90.0,-84.0,-90.0,15.0,20.0,18.0,29.0,1
444,CC:2F:71:3F:1F:24,7387788,6763382733,4178053,6357962821,3209735,405419912,80,954099,573668155,945600,572647433,8499,1020722,902828,619,4182772,419733,80,5422,115556.0,28889.0,-69.0,-64.0,-73.0,-70.0,-68.0,-64.0,-73.0,-70.0,-84.0,-90.0,-84.0,-90.0,15.0,26.0,11.0,20.0,1
445,F8:59:71:5A:E0:3D,3273592,493095765,63854,87675591,3209738,405420174,0,61403,46323137,56636,45753539,4767,569598,39592,16,66565,1719,0,493,144444.0,43333.0,-67.0,-74.0,-66.0,-71.0,-67.0,-74.0,-65.0,-71.0,-84.0,-90.0,-84.0,-90.0,17.0,16.0,18.0,19.0,1
446,CC:2F:71:3E:C5:1F,3221084,406808226,11346,1388052,3209738,405420174,6,48474,4058864,40068,3062888,8406,995976,11961,34,16310,186,6,819,144444.0,39000.0,-69.0,-70.0,-66.0,-61.0,-69.0,-71.0,-67.0,-62.0,-84.0,-90.0,-84.0,-90.0,15.0,20.0,18.0,29.0,1
447,CC:2F:71:3F:1F:24,7388829,6764967768,4179091,6359547594,3209738,405420174,80,954398,573895925,945899,572875203,8499,1020722,903116,619,4183810,419745,80,5422,115556.0,28889.0,-68.0,-64.0,-73.0,-71.0,-68.0,-64.0,-73.0,-70.0,-84.0,-90.0,-84.0,-90.0,16.0,26.0,11.0,19.0,1
448,F8:59:71:5A:E0:3D,3273665,493200489,63921,87779709,3209744,405420780,0,61473,46430979,56706,45861381,4767,569598,39659,16,66633,1724,0,493,144444.0,43333.0,-67.0,-74.0,-66.0,-71.0,-66.0,-73.0,-65.0,-70.0,-85.0,-91.0,-85.0,-90.0,18.0,17.0,19.0,19.0,1
449,CC:2F:71:3E:C5:1F,3221090,406808832,11346,1388052,3209744,405420780,6,48474,4058864,40068,3062888,8406,995976,11961,34,16310,186,6,819,144444.0,39000.0,-69.0,-70.0,-66.0,-61.0,-69.0,-71.0,-67.0,-62.0,-85.0,-91.0,-85.0,-90.0,16.0,21.0,19.0,29.0,1
450,CC:2F:71:3F:1F:24,7390033,6766815585,4180288,6361394532,3209745,405421053,80,954705,574126021,946206,573105299,8499,1020722,903406,619,4185007,419806,80,5422,115556.0,28889.0,-69.0,-65.0,-73.0,-71.0,-69.0,-65.0,-73.0,-71.0,-85.0,-91.0,-85.0,-90.0,16.0,26.0,12.0,19.0,1
451,F8:59:71:5A:E0:3D,3273728,493297110,63983,87876057,3209745,405421053,0,61534,46524919,56767,45955321,4767,569598,39720,16,66694,1725,0,493,144444.0,43333.0,-67.0,-74.0,-66.0,-71.0,-66.0,-73.0,-65.0,-70.0,-85.0,-91.0,-85.0,-90.0,18.0,17.0,19.0,19.0,1
452,CC:2F:71:3E:C5:1F,3221093,406809307,11346,1388052,3209747,405421255,6,48474,4058864,40068,3062888,8406,995976,11961,34,16310,186,6,819,144444.0,39000.0,-69.0,-70.0,-66.0,-61.0,-69.0,-71.0,-67.0,-62.0,-85.0,-91.0,-85.0,-90.0,16.0,21.0,19.0,29.0,1
453,CC:2F:71:3F:1F:24,7391081,6768424815,4181334,6363003560,3209747,405421255,80,954991,574337327,946492,573316605,8499,1020722,903680,619,4186039,419885,80,5423,115556.0,28889.0,-68.0,-64.0,-73.0,-71.0,-68.0,-64.0,-73.0,-70.0,-85.0,-91.0,-85.0,-90.0,17.0,27.0,12.0,19.0,1
454,F8:59:71:5A:E0:3D,3273802,493398988,64048,87977067,3209754,405421921,0,61600,46626559,56833,46056961,4767,569598,39786,16,66760,1726,0,493,144444.0,43333.0,-67.0,-74.0,-66.0,-70.0,-66.0,-73.0,-65.0,-70.0,-85.0,-91.0,-85.0,-90.0,18.0,17.0,19.0,20.0,1
455,CC:2F:71:3E:C5:1F,3221100,406809973,11346,1388052,3209754,405421921,6,48474,4058864,40068,3062888,8406,995976,11961,34,16310,186,6,819,144444.0,39000.0,-69.0,-70.0,-66.0,-61.0,-69.0,-71.0,-67.0,-62.0,-85.0,-91.0,-85.0,-90.0,16.0,21.0,19.0,29.0,1
456,CC:2F:71:3F:1F:24,7392111,6769997695,4182357,6364575774,3209754,405421921,80,955272,574572175,946773,573551453,8499,1020722,903956,619,4187066,420066,80,5424,117000.0,39000.0,-68.0,-64.0,-73.0,-71.0,-68.0,-63.0,-72.0,-70.0,-85.0,-91.0,-85.0,-90.0,17.0,27.0,12.0,19.0,1
457,F8:59:71:5A:E0:3D,3273867,493498506,64112,88076523,3209755,405421983,0,61666,46726791,56898,46157075,4768,569716,39851,16,66824,1726,0,493,144444.0,43333.0,-67.0,-74.0,-66.0,-71.0,-66.0,-73.0,-66.0,-70.0,-85.0,-91.0,-85.0,-90.0,18.0,17.0,19.0,19.0,1
458,CC:2F:71:3E:C5:1F,3221101,406810035,11346,1388052,3209755,405421983,6,48474,4058864,40068,3062888,8406,995976,11961,34,16310,186,6,819,144444.0,39000.0,-69.0,-70.0,-66.0,-61.0,-69.0,-71.0,-67.0,-62.0,-85.0,-91.0,-85.0,-90.0,16.0,21.0,19.0,29.0,1
459,CC:2F:71:3F:1F:24,7393059,6771439426,4183302,6366017241,3209757,405422185,80,955569,574792151,947070,573771429,8499,1020722,904241,619,4188010,420158,80,5424,130000.0,43333.0,-68.0,-63.0,-72.0,-70.0,-68.0,-63.0,-72.0,-70.0,-85.0,-91.0,-85.0,-90.0,17.0,28.0,13.0,20.0,1
460,F8:59:71:5A:E0:3D,3273940,493601738,64178,88179087,3209762,405422651,0,61732,46828431,56964,46258715,4768,569716,39917,16,66890,1726,0,493,144444.0,43333.0,-67.0,-74.0,-66.0,-71.0,-66.0,-74.0,-65.0,-70.0,-85.0,-91.0,-85.0,-90.0,18.0,17.0,19.0,19.0,1
461,CC:2F:71:3E:C5:1F,3221108,406810703,11346,1388052,3209762,405422651,6,48476,4059052,40069,3062958,8407,996094,11962,34,16310,186,6,820,144444.0,39000.0,-69.0,-69.0,-67.0,-61.0,-70.0,-72.0,-68.0,-63.0,-85.0,-91.0,-85.0,-90.0,16.0,22.0,18.0,29.0,1
462,CC:2F:71:3F:1F:24,7394309,6773360974,4184547,6367938323,3209762,405422651,80,955889,575028831,947390,574008109,8499,1020722,904548,619,4189266,420300,80,5424,130000.0,43333.0,-68.0,-63.0,-73.0,-70.0,-68.0,-63.0,-72.0,-70.0,-85.0,-91.0,-85.0,-90.0,17.0,28.0,12.0,20.0,1
463,F8:59:71:5A:E0:3D,3274011,493706178,64245,88283205,3209766,405422973,0,61799,46931611,57031,46361895,4768,569716,39984,16,66957,1729,0,493,144444.0,43333.0,-67.0,-73.0,-65.0,-70.0,-66.0,-73.0,-65.0,-70.0,-85.0,-91.0,-85.0,-90.0,18.0,18.0,20.0,20.0,1
464,CC:2F:71:3E:C5:1F,3221112,406811025,11346,1388052,3209766,405422973,6,48476,4059052,40069,3062958,8407,996094,11962,34,16310,186,6,820,144444.0,39000.0,-69.0,-69.0,-67.0,-61.0,-70.0,-72.0,-68.0,-63.0,-85.0,-91.0,-85.0,-90.0,16.0,22.0,18.0,29.0,1
465,CC:2F:71:3F:1F:24,7395214,6774739762,4185448,6369316789,3209766,405422973,80,956152,575251589,947653,574230867,8499,1020722,904806,619,4190167,420388,80,5424,130000.0,43333.0,-68.0,-63.0,-72.0,-71.0,-68.0,-63.0,-72.0,-70.0,-85.0,-91.0,-85.0,-90.0,17.0,28.0,13.0,19.0,1
466,F8:59:71:5A:E0:3D,3274083,493805114,64308,88381107,3209775,405424007,0,61862,47028673,57094,46458957,4768,569716,40047,16,67020,1731,0,493,144444.0,43333.0,-67.0,-74.0,-66.0,-71.0,-66.0,-74.0,-66.0,-71.0,-85.0,-91.0,-85.0,-90.0,18.0,17.0,19.0,19.0,1
467,CC:2F:71:3E:C5:1F,3221121,406812059,11346,1388052,3209775,405424007,6,48476,4059052,40069,3062958,8407,996094,11962,34,16310,186,6,820,144444.0,39000.0,-69.0,-69.0,-67.0,-61.0,-70.0,-72.0,-68.0,-63.0,-85.0,-91.0,-85.0,-90.0,16.0,22.0,18.0,29.0,1
468,CC:2F:71:3F:1F:24,7396346,6776469402,4186571,6371045395,3209775,405424007,80,956443,575484951,947944,574464229,8499,1020722,905081,619,4191290,420607,80,5424,130000.0,43333.0,-69.0,-63.0,-73.0,-71.0,-68.0,-63.0,-72.0,-70.0,-85.0,-91.0,-85.0,-90.0,16.0,28.0,12.0,19.0,1
469,F8:59:71:5A:E0:3D,3274153,493909494,64375,88485225,3209778,405424269,0,61929,47131853,57161,46562137,4768,569716,40114,16,67087,1732,0,493,144444.0,43333.0,-67.0,-74.0,-66.0,-71.0,-67.0,-73.0,-65.0,-70.0,-85.0,-91.0,-85.0,-90.0,18.0,17.0,19.0,19.0,1
470,CC:2F:71:3E:C5:1F,3221124,406812321,11346,1388052,3209778,405424269,6,48476,4059052,40069,3062958,8407,996094,11962,34,16310,186,6,820,144444.0,39000.0,-69.0,-69.0,-67.0,-61.0,-70.0,-72.0,-68.0,-63.0,-85.0,-91.0,-85.0,-90.0,16.0,22.0,18.0,29.0,1
471,CC:2F:71:3F:1F:24,7397703,6778561606,4187924,6373137277,3209779,405424329,80,956759,575721253,948260,574700531,8499,1020722,905376,619,4192643,420703,80,5424,130000.0,43333.0,-69.0,-64.0,-72.0,-71.0,-69.0,-64.0,-73.0,-71.0,-85.0,-91.0,-85.0,-90.0,16.0,27.0,13.0,19.0,1
472,F8:59:71:5A:E0:3D,3274225,494011170,64440,88586235,3209785,405424935,0,61994,47231953,57226,46662237,4768,569716,40179,16,67152,1732,0,493,144444.0,43333.0,-67.0,-74.0,-66.0,-71.0,-66.0,-73.0,-65.0,-70.0,-85.0,-91.0,-85.0,-90.0,18.0,17.0,19.0,19.0,1
473,CC:2F:71:3E:C5:1F,3221131,406812987,11346,1388052,3209785,405424935,6,48476,4059052,40069,3062958,8407,996094,11962,34,16310,186,6,820,144444.0,39000.0,-69.0,-69.0,-67.0,-61.0,-70.0,-72.0,-68.0,-63.0,-85.0,-91.0,-85.0,-90.0,16.0,22.0,18.0,29.0,1
474,CC:2F:71:3F:1F:24,7399057,6780624666,4189272,6375199731,3209785,405424935,80,957116,575960612,948617,574939890,8499,1020722,905710,619,4193991,420733,80,5425,117000.0,39000.0,-69.0,-64.0,-72.0,-71.0,-68.0,-64.0,-73.0,-71.0,-85.0,-91.0,-85.0,-90.0,16.0,27.0,13.0,19.0,1
475,F8:59:71:5A:E0:3D,3274291,494110828,64504,88685691,3209787,405425137,0,62059,47332165,57291,46762449,4768,569716,40244,16,67216,1732,0,494,144444.0,43333.0,-66.0,-74.0,-66.0,-71.0,-66.0,-74.0,-65.0,-71.0,-85.0,-91.0,-85.0,-90.0,19.0,17.0,19.0,19.0,1
476,CC:2F:71:3E:C5:1F,3221133,406813189,11346,1388052,3209787,405425137,6,48476,4059052,40069,3062958,8407,996094,11962,34,16310,186,6,820,144444.0,39000.0,-69.0,-69.0,-67.0,-61.0,-70.0,-72.0,-68.0,-63.0,-85.0,-91.0,-85.0,-90.0,16.0,22.0,18.0,29.0,1
477,CC:2F:71:3F:1F:24,7400308,6782552190,4190521,6377127053,3209787,405425137,80,957423,576193014,948924,575172292,8499,1020722,905997,619,4195240,420831,80,5425,130000.0,43333.0,-69.0,-64.0,-73.0,-71.0,-68.0,-63.0,-72.0,-70.0,-85.0,-91.0,-85.0,-90.0,16.0,27.0,12.0,19.0,1
478,F8:59:71:5A:E0:3D,3274362,494210950,64568,88785147,3209794,405425803,0,62121,47427645,57353,46857929,4768,569716,40306,16,67279,1733,0,494,144444.0,43333.0,-67.0,-74.0,-66.0,-71.0,-66.0,-73.0,-65.0,-70.0,-85.0,-91.0,-85.0,-90.0,18.0,17.0,19.0,19.0,1
479,CC:2F:71:3E:C5:1F,3221140,406813855,11346,1388052,3209794,405425803,6,48476,4059052,40069,3062958,8407,996094,11962,34,16310,186,6,820,144444.0,39000.0,-69.0,-69.0,-67.0,-61.0,-70.0,-72.0,-68.0,-63.0,-85.0,-91.0,-85.0,-90.0,16.0,22.0,18.0,29.0,1
480,CC:2F:71:3F:1F:24,7401980,6785125362,4192186,6379699559,3209794,405425803,80,957767,576428058,949268,575407336,8499,1020722,906322,619,4196893,421036,80,5425,130000.0,43333.0,-68.0,-63.0,-73.0,-71.0,-68.0,-63.0,-72.0,-70.0,-85.0,-91.0,-85.0,-90.0,17.0,28.0,12.0,19.0,1
481,F8:59:71:5A:E0:3D,3274430,494312288,64633,88886157,3209797,405426131,0,62186,47527745,57418,46958029,4768,569716,40371,16,67344,1734,0,494,144444.0,43333.0,-67.0,-74.0,-66.0,-71.0,-66.0,-74.0,-65.0,-71.0,-85.0,-91.0,-85.0,-91.0,18.0,17.0,19.0,20.0,1
482,CC:2F:71:3E:C5:1F,3221143,406814183,11346,1388052,3209797,405426131,6,48476,4059052,40069,3062958,8407,996094,11962,34,16310,186,6,820,144444.0,39000.0,-69.0,-69.0,-67.0,-61.0,-70.0,-72.0,-68.0,-63.0,-85.0,-91.0,-85.0,-91.0,16.0,22.0,18.0,30.0,1
483,CC:2F:71:3F:1F:24,7404193,6788565464,4194396,6383139333,3209797,405426131,80,958146,576672940,949647,575652218,8499,1020722,906685,619,4199115,421082,80,5425,130000.0,43333.0,-68.0,-64.0,-72.0,-71.0,-68.0,-63.0,-72.0,-70.0,-85.0,-91.0,-85.0,-91.0,17.0,27.0,13.0,20.0,1
484,F8:59:71:5A:E0:3D,3274501,494416810,64700,88990275,3209801,405426535,0,62254,47632465,57486,47062749,4768,569716,40439,16,67412,1735,0,494,144444.0,43333.0,-67.0,-74.0,-66.0,-71.0,-66.0,-74.0,-65.0,-71.0,-85.0,-91.0,-85.0,-91.0,18.0,17.0,19.0,20.0,1
485,CC:2F:71:3E:C5:1F,3221149,406814789,11346,1388052,3209803,405426737,6,48476,4059052,40069,3062958,8407,996094,11962,34,16310,186,6,820,144444.0,39000.0,-69.0,-69.0,-67.0,-61.0,-70.0,-72.0,-68.0,-63.0,-85.0,-91.0,-85.0,-91.0,16.0,22.0,18.0,30.0,1
486,CC:2F:71:3F:1F:24,7406163,6791607319,4196360,6386180582,3209803,405426737,80,958507,576906305,950008,575885583,8499,1020722,907040,619,4201079,421191,80,5425,130000.0,43333.0,-68.0,-63.0,-72.0,-71.0,-68.0,-63.0,-72.0,-70.0,-85.0,-91.0,-85.0,-91.0,17.0,28.0,13.0,20.0,1
487,F8:59:71:5A:E0:3D,3274577,494527608,64771,89100609,3209806,405426999,0,62325,47741805,57557,47172089,4768,569716,40510,16,67483,1739,0,494,144444.0,43333.0,-67.0,-74.0,-66.0,-71.0,-66.0,-73.0,-65.0,-71.0,-85.0,-91.0,-85.0,-91.0,18.0,17.0,19.0,20.0,1
488,CC:2F:71:3E:C5:1F,3221152,406815051,11346,1388052,3209806,405426999,6,48476,4059052,40069,3062958,8407,996094,11962,34,16310,186,6,820,144444.0,39000.0,-69.0,-69.0,-67.0,-61.0,-70.0,-72.0,-68.0,-63.0,-85.0,-91.0,-85.0,-91.0,16.0,22.0,18.0,30.0,1
489,CC:2F:71:3F:1F:24,7407663,6793922180,4197857,6388495181,3209806,405426999,80,958869,577162219,950370,576141497,8499,1020722,907383,619,4202576,421292,80,5425,130000.0,43333.0,-69.0,-64.0,-73.0,-71.0,-68.0,-63.0,-73.0,-70.0,-85.0,-91.0,-85.0,-91.0,16.0,27.0,12.0,20.0,1
490,F8:59:71:5A:E0:3D,3274644,494625914,64834,89198511,3209810,405427403,0,62389,47840393,57621,47270677,4768,569716,40574,16,67546,1742,0,495,144444.0,43333.0,-67.0,-74.0,-66.0,-71.0,-66.0,-73.0,-65.0,-71.0,-85.0,-91.0,-85.0,-91.0,18.0,17.0,19.0,20.0,1
491,CC:2F:71:3E:C5:1F,3221159,406815930,11346,1388052,3209813,405427878,6,48476,4059052,40069,3062958,8407,996094,11962,34,16310,186,6,820,144444.0,39000.0,-69.0,-69.0,-67.0,-61.0,-70.0,-72.0,-68.0,-63.0,-85.0,-91.0,-85.0,-91.0,16.0,22.0,18.0,30.0,1
492,CC:2F:71:3F:1F:24,7408688,6795487823,4198875,6390059945,3209813,405427878,80,959164,577391839,950665,576371117,8499,1020722,907664,619,4203577,421303,80,5427,130000.0,43333.0,-68.0,-63.0,-72.0,-71.0,-68.0,-63.0,-72.0,-70.0,-85.0,-91.0,-85.0,-91.0,17.0,28.0,13.0,20.0,1
493,F8:59:71:5A:E0:3D,3274712,494724381,64897,89296301,3209815,405428080,0,62451,47935873,57683,47366157,4768,569716,40636,16,67609,1742,0,495,144444.0,43333.0,-67.0,-74.0,-66.0,-71.0,-66.0,-73.0,-66.0,-71.0,-85.0,-91.0,-85.0,-91.0,18.0,17.0,19.0,20.0,1
494,CC:2F:71:3E:C5:1F,3221161,406816132,11346,1388052,3209815,405428080,6,48476,4059052,40069,3062958,8407,996094,11962,34,16310,186,6,820,144444.0,39000.0,-69.0,-69.0,-67.0,-61.0,-70.0,-72.0,-68.0,-63.0,-85.0,-91.0,-85.0,-91.0,16.0,22.0,18.0,30.0,1
495,CC:2F:71:3F:1F:24,7409764,6797138053,4199949,6391709973,3209815,405428080,80,959457,577629885,950958,576609163,8499,1020722,907943,619,4204668,421357,80,5428,130000.0,39000.0,-69.0,-64.0,-74.0,-71.0,-68.0,-63.0,-72.0,-71.0,-85.0,-91.0,-85.0,-91.0,16.0,27.0,11.0,20.0,1
496,F8:59:71:5A:E0:3D,3274789,494836565,64969,89408021,3209820,405428544,0,62523,48046921,57755,47477205,4768,569716,40708,16,67681,1742,0,496,144444.0,43333.0,-66.0,-74.0,-66.0,-71.0,-66.0,-73.0,-65.0,-71.0,-85.0,-91.0,-85.0,-91.0,19.0,17.0,19.0,20.0,1
497,CC:2F:71:3E:C5:1F,3221166,406816596,11346,1388052,3209820,405428544,6,48476,4059052,40069,3062958,8407,996094,11962,34,16310,186,6,820,144444.0,39000.0,-69.0,-69.0,-67.0,-61.0,-70.0,-72.0,-68.0,-63.0,-85.0,-91.0,-85.0,-91.0,16.0,22.0,18.0,30.0,1
498,CC:2F:71:3F:1F:24,7410965,6798970070,4201143,6393541324,3209822,405428746,80,959738,577860887,951239,576840165,8499,1020722,908218,619,4205861,421460,80,5428,130000.0,43333.0,-68.0,-63.0,-72.0,-70.0,-68.0,-63.0,-72.0,-70.0,-85.0,-91.0,-85.0,-91.0,17.0,28.0,13.0,21.0,1
499,F8:59:71:5A:E0:3D,3274858,494937979,65034,89509031,3209824,405428948,0,62589,48148561,57821,47578845,4768,569716,40774,16,67746,1743,0,496,144444.0,43333.0,-67.0,-74.0,-65.0,-71.0,-66.0,-74.0,-65.0,-71.0,-85.0,-91.0,-85.0,-91.0,18.0,17.0,20.0,20.0,1
500,CC:2F:71:3E:C5:1F,3221170,406817000,11346,1388052,3209824,405428948,6,48476,4059052,40069,3062958,8407,996094,11962,34,16310,186,6,820,144444.0,39000.0,-69.0,-69.0,-67.0,-61.0,-70.0,-72.0,-68.0,-63.0,-85.0,-91.0,-85.0,-91.0,16.0,22.0,18.0,30.0,1
501,CC:2F:71:3F:1F:24,7412207,6800883568,4202383,6395454620,3209824,405428948,80,960061,578095235,951562,577074513,8499,1020722,908530,619,4207087,421588,80,5428,130000.0,43333.0,-68.0,-63.0,-72.0,-71.0,-68.0,-63.0,-72.0,-71.0,-85.0,-91.0,-85.0,-91.0,17.0,28.0,13.0,20.0,1
502,F8:59:71:5A:E0:3D,3274931,495041989,65105,89612839,3209826,405429150,0,62660,48249528,57892,47679812,4768,569716,40845,16,67817,1744,0,496,144444.0,43333.0,-67.0,-74.0,-66.0,-71.0,-66.0,-73.0,-65.0,-71.0,-85.0,-90.0,-85.0,-90.0,18.0,16.0,19.0,19.0,1
503,CC:2F:71:3E:C5:1F,3221174,406817404,11346,1388052,3209828,405429352,6,48476,4059052,40069,3062958,8407,996094,11962,34,16310,186,6,820,144444.0,39000.0,-69.0,-69.0,-67.0,-61.0,-70.0,-72.0,-68.0,-63.0,-85.0,-90.0,-85.0,-90.0,16.0,21.0,18.0,29.0,1
504,CC:2F:71:3F:1F:24,7413717,6803211368,4203886,6397781754,3209831,405429614,80,960377,578328585,951878,577307863,8499,1020722,908836,619,4208605,421648,80,5428,130000.0,43333.0,-68.0,-64.0,-72.0,-71.0,-68.0,-63.0,-72.0,-71.0,-85.0,-90.0,-85.0,-90.0,17.0,26.0,13.0,19.0,1
505,F8:59:71:5A:E0:3D,3275003,495142371,65169,89712295,3209834,405430076,0,62725,48349628,57957,47779912,4768,569716,40910,16,67881,1745,0,496,144444.0,43333.0,-67.0,-74.0,-66.0,-71.0,-66.0,-74.0,-66.0,-71.0,-85.0,-90.0,-85.0,-90.0,18.0,16.0,19.0,19.0,1
506,CC:2F:71:3E:C5:1F,3221180,406818128,11346,1388052,3209834,405430076,6,48476,4059052,40069,3062958,8407,996094,11962,34,16310,186,6,820,144444.0,39000.0,-69.0,-69.0,-67.0,-61.0,-70.0,-72.0,-68.0,-63.0,-85.0,-90.0,-85.0,-90.0,16.0,21.0,18.0,29.0,1
507,CC:2F:71:3F:1F:24,7415015,6805212020,4205181,6399781944,3209834,405430076,80,960673,578561243,952174,577540521,8499,1020722,909122,619,4209900,421751,80,5428,130000.0,39000.0,-69.0,-64.0,-73.0,-72.0,-69.0,-64.0,-73.0,-72.0,-85.0,-90.0,-85.0,-90.0,16.0,26.0,12.0,18.0,1
508,F8:59:71:5A:E0:3D,3275073,495246807,65237,89816529,3209836,405430278,0,62792,48452822,58024,47883106,4768,569716,40976,16,67949,1748,0,496,144444.0,43333.0,-67.0,-74.0,-65.0,-71.0,-66.0,-74.0,-65.0,-71.0,-85.0,-90.0,-85.0,-90.0,18.0,16.0,20.0,19.0,1
509,CC:2F:71:3E:C5:1F,3221183,406818390,11347,1388112,3209836,405430278,6,48478,4059192,40071,3063098,8407,996094,11962,34,16311,186,6,820,144444.0,39000.0,-69.0,-69.0,-67.0,-60.0,-70.0,-72.0,-68.0,-63.0,-85.0,-90.0,-85.0,-90.0,16.0,21.0,18.0,30.0,1
510,CC:2F:71:3F:1F:24,7416440,6807394363,4206602,6401963883,3209838,405430480,80,961003,578792764,952504,577772042,8499,1020722,909443,619,4211321,421844,80,5429,144444.0,43333.0,-69.0,-64.0,-73.0,-72.0,-69.0,-64.0,-74.0,-72.0,-85.0,-90.0,-85.0,-90.0,16.0,26.0,12.0,18.0,1
511,F8:59:71:5A:E0:3D,3275145,495351389,65304,89920647,3209841,405430742,0,62860,48557570,58092,47987854,4768,569716,41044,16,68016,1748,0,496,144444.0,43333.0,-67.0,-74.0,-66.0,-71.0,-66.0,-73.0,-65.0,-71.0,-85.0,-90.0,-85.0,-90.0,18.0,16.0,19.0,19.0,1
512,CC:2F:71:3E:C5:1F,3221190,406819056,11347,1388112,3209843,405430944,6,48478,4059192,40071,3063098,8407,996094,11962,34,16311,186,6,820,144444.0,39000.0,-69.0,-69.0,-67.0,-60.0,-70.0,-72.0,-68.0,-63.0,-85.0,-90.0,-85.0,-90.0,16.0,21.0,18.0,30.0,1
513,CC:2F:71:3F:1F:24,7417536,6809050272,4207693,6403619328,3209843,405430944,80,961285,579028535,952786,578007813,8499,1020722,909715,619,4212412,421937,80,5431,144444.0,43333.0,-69.0,-63.0,-73.0,-72.0,-68.0,-63.0,-72.0,-71.0,-85.0,-90.0,-85.0,-90.0,16.0,27.0,12.0,18.0,1
514,F8:59:71:5A:E0:3D,3275215,495452919,65370,90021773,3209845,405431146,0,62924,48654752,58156,48085036,4768,569716,41108,16,68082,1749,0,496,144444.0,43333.0,-67.0,-74.0,-66.0,-71.0,-66.0,-73.0,-65.0,-71.0,-85.0,-90.0,-84.0,-90.0,18.0,16.0,18.0,19.0,1
515,CC:2F:71:3E:C5:1F,3221192,406819258,11347,1388112,3209845,405431146,6,48478,4059192,40071,3063098,8407,996094,11962,34,16311,186,6,820,144444.0,39000.0,-69.0,-69.0,-67.0,-60.0,-70.0,-72.0,-68.0,-63.0,-85.0,-90.0,-84.0,-90.0,16.0,21.0,17.0,30.0,1
516,CC:2F:71:3F:1F:24,7418819,6811027254,4208974,6405596108,3209845,405431146,80,961568,579250667,953069,578229945,8499,1020722,909994,619,4213693,422050,80,5432,144444.0,43333.0,-69.0,-64.0,-74.0,-72.0,-68.0,-63.0,-72.0,-71.0,-85.0,-90.0,-84.0,-90.0,16.0,26.0,10.0,18.0,1
517,F8:59:71:5A:E0:3D,3275284,495554333,65435,90122783,3209849,405431550,0,62990,48756392,58222,48186676,4768,569716,41174,16,68147,1750,0,496,144444.0,43333.0,-67.0,-74.0,-66.0,-71.0,-66.0,-74.0,-65.0,-71.0,-85.0,-90.0,-84.0,-90.0,18.0,16.0,18.0,19.0,1
518,CC:2F:71:3E:C5:1F,3221196,406819662,11347,1388112,3209849,405431550,6,48478,4059192,40071,3063098,8407,996094,11962,34,16311,186,6,820,144444.0,39000.0,-69.0,-69.0,-67.0,-60.0,-70.0,-72.0,-68.0,-63.0,-85.0,-90.0,-84.0,-90.0,16.0,21.0,17.0,30.0,1
519,CC:2F:71:3F:1F:24,7419911,6812672639,4210060,6407240887,3209851,405431752,80,961865,579476366,953366,578455644,8499,1020722,910278,619,4214747,422169,80,5432,144444.0,43333.0,-69.0,-64.0,-73.0,-72.0,-68.0,-64.0,-73.0,-72.0,-85.0,-90.0,-84.0,-90.0,16.0,26.0,11.0,18.0,1
520,F8:59:71:5A:E0:3D,3275354,495655807,65500,90223793,3209854,405432014,0,63055,48856492,58287,48286776,4768,569716,41239,16,68212,1751,0,496,144444.0,43333.0,-67.0,-74.0,-66.0,-71.0,-66.0,-74.0,-65.0,-70.0,-85.0,-90.0,-84.0,-90.0,18.0,16.0,18.0,19.0,1
521,CC:2F:71:3E:C5:1F,3221201,406820126,11347,1388112,3209854,405432014,6,48478,4059192,40071,3063098,8407,996094,11962,34,16311,186,6,820,144444.0,39000.0,-69.0,-69.0,-67.0,-60.0,-70.0,-72.0,-68.0,-63.0,-85.0,-90.0,-84.0,-90.0,16.0,21.0,17.0,30.0,1
522,CC:2F:71:3F:1F:24,7420863,6814103719,4211009,6408671705,3209854,405432014,80,962149,579705126,953650,578684404,8499,1020722,910552,619,4215709,422295,80,5434,144444.0,43333.0,-70.0,-64.0,-74.0,-72.0,-69.0,-64.0,-73.0,-72.0,-85.0,-90.0,-84.0,-90.0,15.0,26.0,10.0,18.0,1
523,F8:59:71:5A:E0:3D,3275425,495757453,65567,90325035,3209858,405432418,0,63122,48956804,58354,48387088,4768,569716,41306,16,68279,1751,0,496,144444.0,43333.0,-67.0,-74.0,-66.0,-71.0,-67.0,-74.0,-65.0,-71.0,-85.0,-90.0,-84.0,-90.0,18.0,16.0,18.0,19.0,1
524,CC:2F:71:3E:C5:1F,3221205,406820530,11347,1388112,3209858,405432418,6,48478,4059192,40071,3063098,8407,996094,11962,34,16311,186,6,820,144444.0,39000.0,-69.0,-69.0,-67.0,-60.0,-70.0,-72.0,-68.0,-63.0,-85.0,-90.0,-84.0,-90.0,16.0,21.0,17.0,30.0,1
525,CC:2F:71:3F:1F:24,7421929,6815725214,4212071,6410292796,3209858,405432418,80,962421,579933213,953922,578912491,8499,1020722,910818,619,4216790,422482,80,5434,144444.0,43333.0,-69.0,-64.0,-73.0,-72.0,-68.0,-64.0,-73.0,-72.0,-85.0,-90.0,-84.0,-90.0,16.0,26.0,11.0,18.0,1
526,F8:59:71:5A:E0:3D,3275504,495874407,65642,90441585,3209862,405432822,0,63197,49072332,58429,48502616,4768,569716,41381,16,68354,1751,0,496,144444.0,43333.0,-67.0,-74.0,-66.0,-71.0,-67.0,-73.0,-65.0,-71.0,-85.0,-90.0,-84.0,-90.0,18.0,16.0,18.0,19.0,1
527,CC:2F:71:3E:C5:1F,3221209,406820934,11347,1388112,3209862,405432822,6,48478,4059192,40071,3063098,8407,996094,11962,34,16311,186,6,820,144444.0,39000.0,-69.0,-69.0,-67.0,-60.0,-70.0,-72.0,-68.0,-63.0,-85.0,-90.0,-84.0,-90.0,16.0,21.0,17.0,30.0,1
528,CC:2F:71:3F:1F:24,7423211,6817690022,4213349,6412257200,3209862,405432822,80,962720,580181865,954221,579161143,8499,1020722,911113,619,4218068,422534,80,5436,130000.0,43333.0,-68.0,-63.0,-73.0,-72.0,-68.0,-63.0,-73.0,-71.0,-85.0,-90.0,-84.0,-90.0,17.0,27.0,11.0,18.0,1
529,F8:59:71:5A:E0:3D,3275572,495972773,65705,90539487,3209867,405433286,0,63260,49169352,58492,48599636,4768,569716,41444,16,68417,1751,0,496,144444.0,43333.0,-67.0,-74.0,-66.0,-71.0,-66.0,-73.0,-66.0,-71.0,-85.0,-90.0,-84.0,-90.0,18.0,16.0,18.0,19.0,1
530,CC:2F:71:3E:C5:1F,3221214,406821398,11347,1388112,3209867,405433286,6,48478,4059192,40071,3063098,8407,996094,11962,34,16311,186,6,820,144444.0,39000.0,-69.0,-69.0,-67.0,-60.0,-70.0,-72.0,-68.0,-63.0,-85.0,-90.0,-84.0,-90.0,16.0,21.0,17.0,30.0,1
531,CC:2F:71:3F:1F:24,7424422,6819545792,4214554,6414112372,3209868,405433420,80,963046,580426485,954547,579405763,8499,1020722,911422,619,4219259,422759,80,5437,130000.0,43333.0,-69.0,-63.0,-73.0,-72.0,-68.0,-63.0,-72.0,-71.0,-85.0,-90.0,-84.0,-90.0,16.0,27.0,11.0,18.0,1
532,F8:59:71:5A:E0:3D,3275645,496077684,65773,90643721,3209872,405433963,0,63326,49269572,58558,48699856,4768,569716,41510,16,68485,1753,0,497,144444.0,43333.0,-68.0,-73.0,-65.0,-71.0,-67.0,-72.0,-65.0,-70.0,-85.0,-90.0,-84.0,-90.0,17.0,17.0,19.0,19.0,1
533,CC:2F:71:3E:C5:1F,3221220,406822137,11347,1388112,3209873,405434025,6,48478,4059192,40071,3063098,8407,996094,11962,34,16311,186,6,820,144444.0,39000.0,-69.0,-69.0,-67.0,-60.0,-70.0,-72.0,-68.0,-63.0,-85.0,-90.0,-84.0,-90.0,16.0,21.0,17.0,30.0,1
534,CC:2F:71:3F:1F:24,7425757,6821582837,4215884,6416148812,3209873,405434025,80,963363,580660078,954864,579639356,8499,1020722,911727,619,4220603,422970,80,5442,144444.0,43333.0,-68.0,-63.0,-71.0,-69.0,-69.0,-63.0,-71.0,-69.0,-85.0,-90.0,-84.0,-90.0,17.0,27.0,13.0,21.0,1
535,F8:59:71:5A:E0:3D,3275715,496179160,65838,90744731,3209877,405434429,0,63394,49372884,58625,48803050,4769,569834,41578,16,68550,1754,0,499,144444.0,43333.0,-67.0,-73.0,-65.0,-70.0,-67.0,-73.0,-65.0,-70.0,-85.0,-90.0,-84.0,-90.0,18.0,17.0,19.0,20.0,1
536,CC:2F:71:3E:C5:1F,3221224,406822541,11347,1388112,3209877,405434429,6,48478,4059192,40071,3063098,8407,996094,11962,34,16311,186,6,820,144444.0,39000.0,-69.0,-69.0,-67.0,-60.0,-70.0,-72.0,-68.0,-63.0,-85.0,-90.0,-84.0,-90.0,16.0,21.0,17.0,30.0,1
537,CC:2F:71:3F:1F:24,7427119,6823681535,4217241,6418247046,3209878,405434489,80,963661,580885454,955162,579864732,8499,1020722,912016,619,4221960,423053,80,5442,130000.0,43333.0,-69.0,-64.0,-72.0,-69.0,-69.0,-64.0,-72.0,-69.0,-85.0,-90.0,-84.0,-90.0,16.0,26.0,12.0,21.0,1
538,F8:59:71:5A:E0:3D,3275789,496285358,65906,90850403,3209883,405434955,0,63463,49479186,58694,48909352,4769,569834,41647,16,68618,1755,0,499,144444.0,43333.0,-67.0,-74.0,-65.0,-69.0,-66.0,-73.0,-65.0,-69.0,-85.0,-90.0,-84.0,-90.0,18.0,16.0,19.0,21.0,1
539,CC:2F:71:3E:C5:1F,3221230,406823067,11347,1388112,3209883,405434955,6,48478,4059192,40071,3063098,8407,996094,11962,34,16311,186,6,820,144444.0,39000.0,-69.0,-69.0,-67.0,-60.0,-70.0,-72.0,-68.0,-63.0,-85.0,-91.0,-85.0,-90.0,16.0,22.0,18.0,30.0,1
540,CC:2F:71:3F:1F:24,7428912,6826460008,4219029,6421025053,3209883,405434955,80,964046,581142567,955546,580121727,8500,1020840,912374,619,4223744,423425,80,5443,130000.0,43333.0,-67.0,-64.0,-72.0,-67.0,-67.0,-64.0,-71.0,-67.0,-85.0,-91.0,-85.0,-90.0,18.0,27.0,13.0,23.0,1
541,F8:59:71:5A:E0:3D,3275858,496386772,65971,90951413,3209887,405435359,0,63527,49577788,58758,49007954,4769,569834,41711,16,68683,1755,0,499,144444.0,43333.0,-67.0,-73.0,-66.0,-70.0,-67.0,-72.0,-66.0,-70.0,-85.0,-91.0,-85.0,-90.0,18.0,18.0,19.0,20.0,1
542,CC:2F:71:3E:C5:1F,3221234,406823471,11347,1388112,3209887,405435359,6,48478,4059192,40071,3063098,8407,996094,11962,34,16311,186,6,820,144444.0,39000.0,-69.0,-69.0,-67.0,-60.0,-70.0,-72.0,-68.0,-63.0,-85.0,-91.0,-85.0,-90.0,16.0,22.0,18.0,30.0,1
543,CC:2F:71:3F:1F:24,7430498,6828911895,4220611,6423476536,3209887,405435359,80,964407,581395996,955907,580375156,8500,1020840,912708,619,4225330,423881,80,5443,115556.0,28889.0,-69.0,-63.0,-73.0,-70.0,-68.0,-63.0,-72.0,-70.0,-85.0,-91.0,-85.0,-90.0,16.0,28.0,12.0,20.0,1
544,F8:59:71:5A:E0:3D,3275927,496488106,66036,91052423,3209891,405435683,0,63593,49679428,58824,49109594,4769,569834,41777,16,68748,1755,0,499,144444.0,43333.0,-67.0,-74.0,-65.0,-70.0,-67.0,-73.0,-65.0,-70.0,-85.0,-91.0,-85.0,-90.0,18.0,17.0,20.0,20.0,1
545,CC:2F:71:3E:C5:1F,3221240,406823997,11347,1388112,3209893,405435885,6,48480,4059380,40072,3063168,8408,996212,11963,34,16311,186,6,820,144444.0,39000.0,-69.0,-70.0,-68.0,-60.0,-71.0,-73.0,-69.0,-63.0,-85.0,-91.0,-85.0,-90.0,16.0,21.0,17.0,30.0,1
546,CC:2F:71:3F:1F:24,7431386,6830249219,4221493,6424813334,3209893,405435885,80,964704,581632011,956204,580611171,8500,1020840,912995,619,4226211,423899,80,5444,115556.0,28889.0,-69.0,-64.0,-73.0,-71.0,-69.0,-64.0,-73.0,-71.0,-85.0,-91.0,-85.0,-90.0,16.0,27.0,12.0,19.0,1
547,F8:59:71:5A:E0:3D,3276004,496599046,66107,91162757,3209897,405436289,0,63664,49788782,58895,49218948,4769,569834,41847,16,68818,1760,0,499,144444.0,43333.0,-67.0,-74.0,-65.0,-70.0,-67.0,-73.0,-65.0,-70.0,-85.0,-91.0,-85.0,-90.0,18.0,17.0,20.0,20.0,1
548,CC:2F:71:3E:C5:1F,3221244,406824401,11347,1388112,3209897,405436289,6,48480,4059380,40072,3063168,8408,996212,11963,34,16311,186,6,820,144444.0,39000.0,-69.0,-70.0,-68.0,-60.0,-71.0,-73.0,-69.0,-63.0,-85.0,-91.0,-85.0,-90.0,16.0,21.0,17.0,30.0,1
549,CC:2F:71:3F:1F:24,7432321,6831675293,4222424,6426239004,3209897,405436289,80,964999,581861173,956499,580840333,8500,1020840,913287,619,4227123,424028,80,5446,115556.0,28889.0,-69.0,-64.0,-73.0,-71.0,-68.0,-64.0,-72.0,-70.0,-85.0,-91.0,-85.0,-90.0,16.0,27.0,12.0,19.0,1
550,F8:59:71:5A:E0:3D,3276080,496711226,66179,91274533,3209901,405436693,0,63736,49899662,58967,49329828,4769,569834,41919,16,68891,1764,0,499,144444.0,43333.0,-67.0,-74.0,-65.0,-70.0,-67.0,-73.0,-65.0,-70.0,-85.0,-91.0,-85.0,-90.0,18.0,17.0,20.0,20.0,1
551,CC:2F:71:3E:C5:1F,3221248,406824805,11347,1388112,3209901,405436693,6,48480,4059380,40072,3063168,8408,996212,11963,34,16311,186,6,820,144444.0,39000.0,-69.0,-70.0,-68.0,-60.0,-71.0,-73.0,-69.0,-63.0,-85.0,-90.0,-84.0,-90.0,16.0,20.0,16.0,30.0,1
552,CC:2F:71:3F:1F:24,7433094,6832827981,4223193,6427391288,3209901,405436693,80,965275,582098513,956775,581077673,8500,1020840,913560,619,4227912,424120,80,5448,130000.0,43333.0,-69.0,-64.0,-74.0,-71.0,-68.0,-64.0,-73.0,-71.0,-85.0,-90.0,-84.0,-90.0,16.0,26.0,10.0,19.0,1
553,F8:59:71:5A:E0:3D,3276148,496809592,66242,91372435,3209906,405437157,0,63799,49996682,59030,49426848,4769,569834,41982,16,68954,1764,0,499,144444.0,43333.0,-67.0,-74.0,-65.0,-70.0,-67.0,-74.0,-65.0,-70.0,-85.0,-90.0,-84.0,-90.0,18.0,16.0,19.0,20.0,1
554,CC:2F:71:3E:C5:1F,3221253,406825269,11347,1388112,3209906,405437157,6,48480,4059380,40072,3063168,8408,996212,11963,34,16311,186,6,820,144444.0,39000.0,-69.0,-70.0,-68.0,-60.0,-71.0,-73.0,-69.0,-63.0,-85.0,-90.0,-84.0,-90.0,16.0,20.0,16.0,30.0,1
555,CC:2F:71:3F:1F:24,7434238,6834556895,4224332,6429119738,3209906,405437157,80,965572,582320011,957072,581299171,8500,1020840,913857,619,4229051,424338,80,5448,130000.0,43333.0,-69.0,-64.0,-73.0,-71.0,-69.0,-64.0,-73.0,-71.0,-85.0,-90.0,-84.0,-90.0,16.0,26.0,11.0,19.0,1
556,F8:59:71:5A:E0:3D,3276217,496913912,66309,91476553,3209908,405437359,0,63867,50101402,59098,49531568,4769,569834,42050,16,69021,1768,0,499,144444.0,43333.0,-67.0,-74.0,-65.0,-70.0,-67.0,-74.0,-65.0,-70.0,-85.0,-90.0,-84.0,-90.0,18.0,16.0,19.0,20.0,1
557,CC:2F:71:3E:C5:1F,3221257,406825673,11347,1388112,3209910,405437561,6,48480,4059380,40072,3063168,8408,996212,11963,34,16311,186,6,820,144444.0,39000.0,-69.0,-70.0,-68.0,-60.0,-71.0,-73.0,-69.0,-63.0,-85.0,-90.0,-84.0,-90.0,16.0,20.0,16.0,30.0,1
558,CC:2F:71:3F:1F:24,7435511,6836516301,4225601,6431078740,3209910,405437561,80,965887,582546463,957387,581525623,8500,1020840,914171,619,4230320,424680,80,5449,130000.0,43333.0,-69.0,-64.0,-73.0,-71.0,-69.0,-64.0,-73.0,-70.0,-85.0,-90.0,-84.0,-90.0,16.0,26.0,11.0,19.0,1
559,F8:59:71:5A:E0:3D,3276288,497015472,66374,91577507,3209914,405437965,0,63931,50199962,59162,49630128,4769,569834,42114,16,69086,1769,0,499,130000.0,39000.0,-67.0,-74.0,-66.0,-70.0,-67.0,-74.0,-65.0,-70.0,-85.0,-90.0,-85.0,-90.0,18.0,16.0,19.0,20.0,1
560,CC:2F:71:3E:C5:1F,3221261,406826077,11347,1388112,3209914,405437965,6,48480,4059380,40072,3063168,8408,996212,11963,34,16311,186,6,820,144444.0,39000.0,-69.0,-70.0,-68.0,-60.0,-71.0,-73.0,-69.0,-63.0,-85.0,-90.0,-85.0,-90.0,16.0,20.0,17.0,30.0,1
561,CC:2F:71:3F:1F:24,7436608,6838179966,4226694,6432742001,3209914,405437965,80,966176,582767190,957676,581746350,8500,1020840,914459,619,4231413,424882,80,5450,130000.0,43333.0,-69.0,-64.0,-74.0,-71.0,-68.0,-64.0,-72.0,-70.0,-85.0,-90.0,-85.0,-90.0,16.0,26.0,11.0,19.0,1
562,F8:59:71:5A:E0:3D,3276354,497113524,66437,91675297,3209917,405438227,0,63994,50296982,59225,49727148,4769,569834,42177,16,69149,1773,0,499,144444.0,43333.0,-67.0,-74.0,-65.0,-70.0,-67.0,-74.0,-65.0,-70.0,-85.0,-90.0,-85.0,-90.0,18.0,16.0,20.0,20.0,1
563,CC:2F:71:3E:C5:1F,3221264,406826339,11347,1388112,3209917,405438227,6,48480,4059380,40072,3063168,8408,996212,11963,34,16311,186,6,820,144444.0,39000.0,-69.0,-70.0,-68.0,-60.0,-71.0,-73.0,-69.0,-63.0,-85.0,-90.0,-85.0,-90.0,16.0,20.0,17.0,30.0,1
564,CC:2F:71:3F:1F:24,7437712,6839861486,4227795,6434423259,3209917,405438227,80,966466,582983112,957966,581962272,8500,1020840,914749,619,4232514,424975,80,5451,130000.0,43333.0,-69.0,-64.0,-73.0,-70.0,-69.0,-64.0,-73.0,-71.0,-85.0,-90.0,-85.0,-90.0,16.0,26.0,12.0,20.0,1
565,F8:59:71:5A:E0:3D,3276421,497211718,66500,91773087,3209921,405438631,0,64057,50394002,59288,49824168,4769,569834,42240,16,69212,1784,0,499,144444.0,43333.0,-67.0,-74.0,-65.0,-70.0,-67.0,-74.0,-65.0,-70.0,-85.0,-90.0,-85.0,-90.0,18.0,16.0,20.0,20.0,1
566,CC:2F:71:3E:C5:1F,3221268,406826743,11347,1388112,3209921,405438631,6,48480,4059380,40072,3063168,8408,996212,11963,34,16311,186,6,820,144444.0,39000.0,-69.0,-70.0,-68.0,-60.0,-71.0,-73.0,-69.0,-63.0,-85.0,-90.0,-85.0,-90.0,16.0,20.0,17.0,30.0,1
567,CC:2F:71:3F:1F:24,7438622,6841241140,4228699,6435802307,3209923,405438833,80,966732,583194788,958232,582173948,8500,1020840,915015,619,4233416,425104,80,5452,130000.0,43333.0,-69.0,-64.0,-72.0,-70.0,-68.0,-64.0,-72.0,-70.0,-85.0,-90.0,-85.0,-90.0,16.0,26.0,13.0,20.0,1
568,F8:59:71:5A:E0:3D,3276489,497311578,66564,91872543,3209925,405439035,0,64121,50492604,59352,49922770,4769,569834,42304,16,69276,1787,0,499,144444.0,43333.0,-67.0,-74.0,-65.0,-70.0,-67.0,-74.0,-65.0,-70.0,-85.0,-91.0,-85.0,-90.0,18.0,17.0,20.0,20.0,1
569,CC:2F:71:3E:C5:1F,3221273,406827207,11347,1388112,3209926,405439095,6,48480,4059380,40072,3063168,8408,996212,11963,34,16311,186,6,820,144444.0,39000.0,-69.0,-70.0,-68.0,-60.0,-71.0,-73.0,-69.0,-63.0,-85.0,-91.0,-85.0,-90.0,16.0,21.0,17.0,30.0,1
570,CC:2F:71:3F:1F:24,7439811,6843061542,4229885,6437622447,3209926,405439095,80,967059,583430962,958559,582410122,8500,1020840,915336,619,4234596,425585,80,5453,130000.0,39000.0,-70.0,-64.0,-74.0,-71.0,-69.0,-64.0,-73.0,-70.0,-85.0,-91.0,-85.0,-90.0,15.0,27.0,11.0,19.0,1
571,F8:59:71:5A:E0:3D,3276564,497420830,66634,91981323,3209930,405439507,0,64191,50600418,59422,50030584,4769,569834,42373,16,69346,1789,0,499,144444.0,43333.0,-67.0,-74.0,-65.0,-70.0,-67.0,-73.0,-65.0,-69.0,-85.0,-91.0,-85.0,-90.0,18.0,17.0,20.0,20.0,1
572,CC:2F:71:3E:C5:1F,3221279,406827821,11347,1388112,3209932,405439709,6,48480,4059380,40072,3063168,8408,996212,11963,34,16311,186,6,820,144444.0,39000.0,-69.0,-70.0,-68.0,-60.0,-71.0,-73.0,-69.0,-63.0,-85.0,-91.0,-85.0,-90.0,16.0,21.0,17.0,30.0,1
573,CC:2F:71:3F:1F:24,7441026,6844914301,4231092,6439474390,3209934,405439911,80,967396,583674900,958896,582654060,8500,1020840,915661,619,4235811,425905,80,5454,130000.0,43333.0,-69.0,-64.0,-73.0,-71.0,-69.0,-64.0,-72.0,-70.0,-85.0,-91.0,-85.0,-90.0,16.0,27.0,12.0,19.0,1
574,F8:59:71:5A:E0:3D,3276639,497527381,66702,92086995,3209937,405440386,0,64263,50711382,59494,50141548,4769,569834,42442,16,69414,1791,0,500,144444.0,43333.0,-67.0,-74.0,-65.0,-70.0,-67.0,-74.0,-65.0,-70.0,-85.0,-91.0,-85.0,-90.0,18.0,17.0,20.0,20.0,1
575,CC:2F:71:3E:C5:1F,3221284,406828498,11347,1388112,3209937,405440386,6,48480,4059380,40072,3063168,8408,996212,11963,34,16311,186,6,820,144444.0,39000.0,-69.0,-70.0,-68.0,-60.0,-71.0,-73.0,-69.0,-63.0,-85.0,-91.0,-85.0,-90.0,16.0,21.0,17.0,30.0,1
576,CC:2F:71:3F:1F:24,7442124,6846593781,4232187,6441153395,3209937,405440386,80,967699,583898095,959199,582877255,8500,1020840,915961,619,4236906,426089,80,5454,130000.0,43333.0,-70.0,-64.0,-73.0,-71.0,-69.0,-64.0,-72.0,-71.0,-85.0,-91.0,-85.0,-90.0,15.0,27.0,12.0,19.0,1
577,F8:59:71:5A:E0:3D,3276705,497625545,66765,92184897,3209940,405440648,0,64327,50809956,59558,50240122,4769,569834,42505,16,69477,1794,0,500,144444.0,43333.0,-67.0,-74.0,-66.0,-70.0,-67.0,-74.0,-65.0,-70.0,-85.0,-91.0,-85.0,-90.0,18.0,17.0,19.0,20.0,1
578,CC:2F:71:3E:C5:1F,3221287,406828760,11347,1388112,3209940,405440648,6,48480,4059380,40072,3063168,8408,996212,11963,34,16311,186,6,820,144444.0,39000.0,-69.0,-70.0,-68.0,-60.0,-71.0,-73.0,-69.0,-63.0,-85.0,-91.0,-85.0,-90.0,16.0,21.0,17.0,30.0,1
579,CC:2F:71:3F:1F:24,7442806,6847619047,4232864,6442178197,3209942,405440850,80,967942,584108567,959442,583087727,8500,1020840,916202,619,4237583,426233,80,5454,130000.0,43333.0,-70.0,-64.0,-73.0,-71.0,-69.0,-64.0,-73.0,-71.0,-85.0,-91.0,-85.0,-90.0,15.0,27.0,12.0,19.0,1
580,F8:59:71:5A:E0:3D,3276773,497725405,66829,92284353,3209944,405441052,0,64393,50911624,59624,50341790,4769,569834,42569,16,69540,1795,0,500,144444.0,43333.0,-67.0,-74.0,-66.0,-70.0,-67.0,-73.0,-65.0,-69.0,-85.0,-91.0,-85.0,-90.0,18.0,17.0,19.0,20.0,1
581,CC:2F:71:3E:C5:1F,3221291,406829164,11347,1388112,3209944,405441052,6,48480,4059380,40072,3063168,8408,996212,11963,34,16311,186,6,820,144444.0,39000.0,-69.0,-70.0,-68.0,-60.0,-71.0,-73.0,-69.0,-63.0,-85.0,-91.0,-85.0,-90.0,16.0,21.0,17.0,30.0,1
582,CC:2F:71:3F:1F:24,7443729,6849026185,4233783,6443584931,3209946,405441254,80,968211,584326159,959711,583305319,8500,1020840,916463,619,4238476,426330,80,5454,130000.0,43333.0,-70.0,-64.0,-73.0,-71.0,-69.0,-64.0,-73.0,-71.0,-85.0,-91.0,-85.0,-90.0,15.0,27.0,12.0,19.0,1
583,F8:59:71:5A:E0:3D,3276842,497825765,66894,92384309,3209948,405441456,0,64459,51011888,59690,50442054,4769,569834,42634,16,69606,1797,0,500,144444.0,43333.0,-67.0,-74.0,-65.0,-70.0,-67.0,-73.0,-65.0,-70.0,-85.0,-91.0,-85.0,-90.0,18.0,17.0,20.0,20.0,1
584,CC:2F:71:3E:C5:1F,3221295,406829568,11347,1388112,3209948,405441456,6,48480,4059380,40072,3063168,8408,996212,11963,34,16311,186,6,820,144444.0,39000.0,-69.0,-70.0,-68.0,-60.0,-71.0,-73.0,-69.0,-63.0,-85.0,-91.0,-85.0,-90.0,16.0,21.0,17.0,30.0,1
585,CC:2F:71:3F:1F:24,7444971,6850933828,4235023,6445492372,3209948,405441456,80,968521,584553326,960021,583532486,8500,1020840,916764,619,4239705,426465,80,5454,130000.0,43333.0,-69.0,-64.0,-73.0,-74.0,-69.0,-64.0,-72.0,-73.0,-85.0,-91.0,-85.0,-90.0,16.0,27.0,12.0,16.0,1
586,F8:59:71:5A:E0:3D,3276912,497927239,66959,92485319,3209953,405441920,0,64526,51115082,59757,50545248,4769,569834,42700,16,69671,1798,0,500,144444.0,43333.0,-67.0,-74.0,-66.0,-70.0,-67.0,-74.0,-65.0,-70.0,-85.0,-91.0,-85.0,-90.0,18.0,17.0,19.0,20.0,1
587,CC:2F:71:3E:C5:1F,3221300,406830032,11347,1388112,3209953,405441920,6,48480,4059380,40072,3063168,8408,996212,11963,34,16311,186,6,820,144444.0,39000.0,-69.0,-70.0,-68.0,-60.0,-71.0,-73.0,-69.0,-63.0,-85.0,-91.0,-85.0,-90.0,16.0,21.0,17.0,30.0,1
588,CC:2F:71:3F:1F:24,7446114,6852685784,4236161,6447243864,3209953,405441920,80,968836,584783758,960336,583762918,8500,1020840,917063,619,4240878,426799,80,5454,86667.0,14444.0,-69.0,-63.0,-71.0,-71.0,-69.0,-63.0,-72.0,-70.0,-85.0,-91.0,-85.0,-90.0,16.0,28.0,14.0,19.0,1
589,F8:59:71:5A:E0:3D,3276983,498029021,67024,92586329,3209959,405442692,0,64591,51215196,59822,50645362,4769,569834,42764,16,69736,1800,0,500,144444.0,43333.0,-67.0,-74.0,-65.0,-69.0,-66.0,-74.0,-65.0,-69.0,-85.0,-91.0,-85.0,-90.0,18.0,17.0,20.0,21.0,1
590,CC:2F:71:3E:C5:1F,3221306,406830804,11347,1388112,3209959,405442692,6,48480,4059380,40072,3063168,8408,996212,11963,34,16311,186,6,820,144444.0,39000.0,-69.0,-70.0,-68.0,-60.0,-71.0,-73.0,-69.0,-63.0,-85.0,-91.0,-85.0,-90.0,16.0,21.0,17.0,30.0,1
591,CC:2F:71:3F:1F:24,7447306,6854501684,4237347,6449058992,3209959,405442692,80,969178,585017999,960678,583997159,8500,1020840,917399,619,4242064,426868,80,5454,86667.0,14444.0,-68.0,-63.0,-72.0,-71.0,-68.0,-63.0,-72.0,-71.0,-85.0,-91.0,-85.0,-90.0,17.0,28.0,13.0,19.0,1
592,F8:59:71:5A:E0:3D,3277054,498132105,67091,92689009,3209963,405443096,0,64658,51318390,59889,50748556,4769,569834,42830,16,69803,1800,0,500,144444.0,43333.0,-67.0,-74.0,-66.0,-70.0,-67.0,-74.0,-65.0,-70.0,-85.0,-91.0,-85.0,-90.0,18.0,17.0,19.0,20.0,1
593,CC:2F:71:3E:C5:1F,3221311,406831324,11348,1388228,3209963,405443096,6,48482,4059520,40074,3063308,8408,996212,11963,34,16312,186,6,820,144444.0,39000.0,-70.0,-70.0,-67.0,-61.0,-70.0,-71.0,-68.0,-61.0,-85.0,-91.0,-85.0,-90.0,15.0,21.0,18.0,29.0,1
594,CC:2F:71:3F:1F:24,7448727,6856692564,4238764,6451249468,3209963,405443096,80,969555,585257127,961055,584236287,8500,1020840,917762,619,4243483,427015,80,5454,115556.0,26000.0,-67.0,-63.0,-73.0,-69.0,-67.0,-63.0,-72.0,-69.0,-85.0,-91.0,-85.0,-90.0,18.0,28.0,12.0,21.0,1
595,F8:59:71:5A:E0:3D,3277125,498235133,67157,92791573,3209968,405443560,0,64724,51420030,59955,50850196,4769,569834,42896,16,69868,1801,0,500,144444.0,43333.0,-67.0,-74.0,-65.0,-70.0,-67.0,-74.0,-65.0,-69.0,-85.0,-91.0,-85.0,-90.0,18.0,17.0,20.0,20.0,1
596,CC:2F:71:3E:C5:1F,3221316,406831788,11348,1388228,3209968,405443560,6,48482,4059520,40074,3063308,8408,996212,11963,34,16312,186,6,820,144444.0,39000.0,-70.0,-70.0,-67.0,-61.0,-70.0,-71.0,-68.0,-61.0,-85.0,-91.0,-85.0,-90.0,15.0,21.0,18.0,29.0,1
597,CC:2F:71:3F:1F:24,7450117,6858825857,4240149,6453382297,3209968,405443560,80,969901,585488706,961401,584467866,8500,1020840,918101,619,4244868,427523,80,5454,115556.0,28889.0,-67.0,-63.0,-73.0,-70.0,-67.0,-63.0,-72.0,-69.0,-85.0,-91.0,-85.0,-90.0,18.0,28.0,12.0,20.0,1
598,F8:59:71:5A:E0:3D,3277192,498333439,67220,92889475,3209972,405443964,0,64793,51526360,60024,50956526,4769,569834,42960,16,69932,1804,0,500,144444.0,43333.0,-68.0,-75.0,-66.0,-70.0,-67.0,-74.0,-65.0,-70.0,-85.0,-91.0,-85.0,-90.0,17.0,16.0,19.0,20.0,1
599,CC:2F:71:3E:C5:1F,3221320,406832192,11348,1388228,3209972,405443964,6,48482,4059520,40074,3063308,8408,996212,11963,34,16312,186,6,820,144444.0,39000.0,-70.0,-70.0,-67.0,-61.0,-70.0,-71.0,-68.0,-61.0,-85.0,-91.0,-85.0,-90.0,15.0,21.0,18.0,29.0,1
600,CC:2F:71:3F:1F:24,7451673,6861216736,4241701,6455772772,3209972,405443964,80,970230,585719196,961730,584698356,8500,1020840,918419,619,4246418,427621,80,5454,115556.0,28889.0,-67.0,-63.0,-72.0,-70.0,-67.0,-63.0,-72.0,-69.0,-85.0,-91.0,-85.0,-90.0,18.0,28.0,13.0,20.0,1
601,F8:59:71:5A:E0:3D,3277261,498434853,67285,92990485,3209976,405444368,0,64859,51628028,60090,51058194,4769,569834,43024,16,69997,1804,0,500,144444.0,43333.0,-68.0,-74.0,-66.0,-70.0,-68.0,-74.0,-66.0,-70.0,-85.0,-91.0,-85.0,-90.0,17.0,17.0,19.0,20.0,1
602,CC:2F:71:3E:C5:1F,3221324,406832596,11348,1388228,3209976,405444368,6,48482,4059520,40074,3063308,8408,996212,11963,34,16312,186,6,820,144444.0,39000.0,-70.0,-70.0,-67.0,-61.0,-70.0,-71.0,-68.0,-61.0,-85.0,-91.0,-85.0,-90.0,15.0,21.0,18.0,29.0,1
603,CC:2F:71:3F:1F:24,7452804,6862950628,4242827,6457506200,3209977,405444428,80,970533,585936648,962033,584915808,8500,1020840,918715,619,4247546,427650,80,5454,130000.0,43333.0,-68.0,-63.0,-73.0,-69.0,-68.0,-63.0,-73.0,-69.0,-85.0,-91.0,-85.0,-90.0,17.0,28.0,12.0,21.0,1
604,F8:59:71:5A:E0:3D,3277330,498537679,67351,93093049,3209979,405444630,0,64928,51734330,60159,51164496,4769,569834,43090,16,70063,1804,0,500,144444.0,43333.0,-67.0,-75.0,-66.0,-70.0,-67.0,-74.0,-65.0,-70.0,-85.0,-91.0,-85.0,-90.0,18.0,16.0,19.0,20.0,1
605,CC:2F:71:3E:C5:1F,3221329,406833060,11348,1388228,3209981,405444832,6,48482,4059520,40074,3063308,8408,996212,11963,34,16312,186,6,820,144444.0,39000.0,-70.0,-70.0,-67.0,-61.0,-70.0,-71.0,-68.0,-61.0,-85.0,-91.0,-85.0,-90.0,15.0,21.0,18.0,29.0,1
606,CC:2F:71:3F:1F:24,7454169,6865042746,4244188,6459597914,3209981,405444832,80,970867,586179072,962367,585158232,8500,1020840,919037,619,4248904,427929,80,5454,86667.0,14444.0,-68.0,-64.0,-72.0,-68.0,-67.0,-64.0,-71.0,-68.0,-85.0,-91.0,-85.0,-90.0,17.0,27.0,13.0,22.0,1
607,F8:59:71:5A:E0:3D,3277402,498640849,67417,93195613,3209985,405445236,0,64996,51839078,60227,51269244,4769,569834,43156,16,70129,1808,0,500,144444.0,43333.0,-67.0,-74.0,-66.0,-70.0,-67.0,-74.0,-65.0,-69.0,-85.0,-91.0,-85.0,-90.0,18.0,17.0,19.0,20.0,1
608,CC:2F:71:3E:C5:1F,3221333,406833464,11348,1388228,3209985,405445236,6,48482,4059520,40074,3063308,8408,996212,11963,34,16312,186,6,820,144444.0,39000.0,-70.0,-70.0,-67.0,-61.0,-70.0,-71.0,-68.0,-61.0,-85.0,-91.0,-85.0,-90.0,15.0,21.0,18.0,29.0,1
609,CC:2F:71:3F:1F:24,7455198,6866613903,4245213,6461168667,3209985,405445236,80,971162,586398733,962662,585377893,8500,1020840,919329,619,4249932,427999,80,5455,86667.0,14444.0,-68.0,-65.0,-74.0,-71.0,-68.0,-64.0,-73.0,-70.0,-85.0,-91.0,-85.0,-90.0,17.0,26.0,11.0,19.0,1
610,F8:59:71:5A:E0:3D,3277505,498768773,67492,93312163,3210013,405456610,0,65073,51956418,60303,51386466,4770,569952,43232,16,70204,1809,0,500,144444.0,43333.0,-67.0,-74.0,-65.0,-70.0,-66.0,-73.0,-65.0,-69.0,-85.0,-91.0,-85.0,-90.0,18.0,17.0,20.0,20.0,1
611,CC:2F:71:3E:C5:1F,3221361,406844838,11348,1388228,3210013,405456610,6,48482,4059520,40074,3063308,8408,996212,11963,34,16312,186,6,820,144444.0,39000.0,-70.0,-70.0,-67.0,-61.0,-70.0,-71.0,-68.0,-61.0,-85.0,-91.0,-85.0,-90.0,15.0,21.0,18.0,29.0,1
612,CC:2F:71:3F:1F:24,7456259,6868187804,4246246,6462731194,3210013,405456610,80,971473,586661241,962973,585640401,8500,1020840,919625,619,4250965,428200,80,5455,130000.0,43333.0,-68.0,-64.0,-73.0,-69.0,-67.0,-64.0,-72.0,-69.0,-85.0,-91.0,-85.0,-90.0,17.0,27.0,12.0,21.0,1
613,F8:59:71:5A:E0:3D,3277573,498868633,67556,93411619,3210017,405457014,0,65140,52059626,60370,51489674,4770,569952,43297,16,70268,1810,0,500,144444.0,43333.0,-67.0,-74.0,-66.0,-70.0,-66.0,-73.0,-65.0,-70.0,-84.0,-91.0,-84.0,-90.0,17.0,17.0,18.0,20.0,1
614,CC:2F:71:3E:C5:1F,3221365,406845242,11348,1388228,3210017,405457014,6,48482,4059520,40074,3063308,8408,996212,11963,34,16312,186,6,820,144444.0,39000.0,-70.0,-70.0,-67.0,-61.0,-70.0,-71.0,-68.0,-61.0,-84.0,-91.0,-84.0,-90.0,14.0,21.0,17.0,29.0,1
615,CC:2F:71:3F:1F:24,7457269,6869717655,4247251,6464260368,3210018,405457287,80,971798,586889244,963298,585868404,8500,1020840,919937,619,4251964,428304,80,5455,130000.0,43333.0,-69.0,-64.0,-74.0,-69.0,-68.0,-64.0,-72.0,-69.0,-84.0,-91.0,-84.0,-90.0,15.0,27.0,10.0,21.0,1
616,F8:59:71:5A:E0:3D,3277642,498971672,67622,93514183,3210020,405457489,0,65205,52159726,60435,51589774,4770,569952,43362,16,70334,1811,0,500,144444.0,43333.0,-67.0,-74.0,-65.0,-70.0,-66.0,-74.0,-65.0,-70.0,-84.0,-91.0,-84.0,-90.0,17.0,17.0,19.0,20.0,1
617,CC:2F:71:3E:C5:1F,3221368,406845717,11348,1388228,3210020,405457489,6,48482,4059520,40074,3063308,8408,996212,11963,34,16312,186,6,820,144444.0,39000.0,-70.0,-70.0,-67.0,-61.0,-70.0,-71.0,-68.0,-61.0,-84.0,-91.0,-84.0,-90.0,14.0,21.0,17.0,29.0,1
618,CC:2F:71:3F:1F:24,7458447,6871530353,4248427,6466072864,3210020,405457489,80,972103,587121480,963603,586100640,8500,1020840,920231,619,4253125,428389,80,5455,130000.0,39000.0,-69.0,-64.0,-73.0,-69.0,-68.0,-64.0,-73.0,-69.0,-84.0,-91.0,-84.0,-90.0,15.0,27.0,11.0,21.0,1
619,F8:59:71:5A:E0:3D,3277715,499073410,67687,93615193,3210028,405458217,0,65274,52266042,60504,51696090,4770,569952,43427,16,70399,1812,0,500,144444.0,43333.0,-66.0,-74.0,-65.0,-70.0,-66.0,-73.0,-65.0,-69.0,-84.0,-91.0,-84.0,-90.0,18.0,17.0,19.0,20.0,1
620,CC:2F:71:3E:C5:1F,3221376,406846445,11348,1388228,3210028,405458217,6,48484,4059708,40075,3063378,8409,996330,11964,34,16312,186,6,820,144444.0,39000.0,-68.0,-69.0,-67.0,-61.0,-69.0,-69.0,-67.0,-60.0,-84.0,-91.0,-84.0,-90.0,16.0,22.0,17.0,29.0,1
621,CC:2F:71:3F:1F:24,7460121,6874103984,4250093,6468645767,3210028,405458217,80,972454,587349769,963954,586328929,8500,1020840,920565,619,4254811,428460,80,5456,130000.0,43333.0,-68.0,-64.0,-73.0,-69.0,-68.0,-64.0,-72.0,-69.0,-84.0,-91.0,-84.0,-90.0,16.0,27.0,11.0,21.0,1
622,F8:59:71:5A:E0:3D,3277778,499169820,67749,93711541,3210029,405458279,0,65337,52363076,60567,51793124,4770,569952,43489,16,70461,1813,0,500,144444.0,43333.0,-67.0,-74.0,-65.0,-70.0,-67.0,-73.0,-65.0,-69.0,-84.0,-91.0,-84.0,-90.0,17.0,17.0,19.0,20.0,1
623,CC:2F:71:3E:C5:1F,3221379,406846709,11348,1388228,3210031,405458481,6,48484,4059708,40075,3063378,8409,996330,11964,34,16312,186,6,820,144444.0,39000.0,-68.0,-69.0,-67.0,-61.0,-69.0,-69.0,-67.0,-60.0,-84.0,-91.0,-84.0,-90.0,16.0,22.0,17.0,29.0,1
624,CC:2F:71:3F:1F:24,7461514,6876242701,4251483,6470784220,3210031,405458481,80,972776,587589206,964275,586568248,8501,1020958,920871,619,4256160,428492,80,5456,130000.0,43333.0,-69.0,-64.0,-73.0,-69.0,-69.0,-64.0,-72.0,-68.0,-84.0,-91.0,-84.0,-90.0,15.0,27.0,11.0,21.0,1
625,F8:59:71:5A:E0:3D,3277847,499271234,67814,93812551,3210033,405458683,0,65406,52469392,60636,51899440,4770,569952,43554,16,70526,1814,0,500,130000.0,39000.0,-66.0,-74.0,-65.0,-70.0,-66.0,-74.0,-65.0,-70.0,-84.0,-91.0,-84.0,-90.0,18.0,17.0,19.0,20.0,1
626,CC:2F:71:3E:C5:1F,3221385,406847315,11348,1388228,3210037,405459087,6,48484,4059708,40075,3063378,8409,996330,11964,34,16312,186,6,820,144444.0,39000.0,-68.0,-69.0,-67.0,-61.0,-69.0,-69.0,-67.0,-60.0,-84.0,-91.0,-84.0,-90.0,16.0,22.0,17.0,29.0,1
627,CC:2F:71:3F:1F:24,7462772,6878163436,4252735,6472704349,3210037,405459087,80,973074,587813979,964573,586793021,8501,1020958,921159,619,4257454,428548,80,5457,130000.0,43333.0,-69.0,-64.0,-73.0,-69.0,-68.0,-64.0,-72.0,-68.0,-84.0,-91.0,-84.0,-90.0,15.0,27.0,11.0,21.0,1
628,F8:59:71:5A:E0:3D,3277916,499370986,67878,93911839,3210038,405459147,0,65472,52571060,60702,52001108,4770,569952,43618,16,70590,1814,0,500,144444.0,43333.0,-67.0,-74.0,-65.0,-70.0,-67.0,-74.0,-65.0,-70.0,-84.0,-91.0,-84.0,-90.0,17.0,17.0,19.0,20.0,1
629,CC:2F:71:3E:C5:1F,3221386,406847375,11348,1388228,3210038,405459147,6,48484,4059708,40075,3063378,8409,996330,11964,34,16312,186,6,820,144444.0,39000.0,-68.0,-69.0,-67.0,-61.0,-69.0,-69.0,-67.0,-60.0,-84.0,-91.0,-84.0,-90.0,16.0,22.0,17.0,29.0,1
630,CC:2F:71:3F:1F:24,7463996,6880037301,4253958,6474578154,3210038,405459147,80,973388,588040004,964887,587019046,8501,1020958,921458,619,4258675,428555,80,5457,130000.0,43333.0,-69.0,-64.0,-73.0,-69.0,-69.0,-64.0,-72.0,-68.0,-84.0,-91.0,-84.0,-90.0,15.0,27.0,11.0,21.0,1
631,F8:59:71:5A:E0:3D,3277984,499470846,67942,94011295,3210042,405459551,0,65538,52672728,60768,52102776,4770,569952,43682,16,70654,1816,0,500,144444.0,43333.0,-67.0,-74.0,-65.0,-70.0,-67.0,-74.0,-65.0,-70.0,-84.0,-90.0,-83.0,-90.0,17.0,16.0,18.0,20.0,1
632,CC:2F:71:3E:C5:1F,3221390,406847779,11348,1388228,3210042,405459551,6,48484,4059708,40075,3063378,8409,996330,11964,34,16312,186,6,820,144444.0,39000.0,-68.0,-69.0,-67.0,-61.0,-69.0,-69.0,-67.0,-60.0,-84.0,-90.0,-83.0,-90.0,16.0,21.0,16.0,29.0,1
633,CC:2F:71:3F:1F:24,7465407,6882210173,4255363,6476750420,3210044,405459753,80,973726,588281722,965225,587260764,8501,1020958,921763,619,4260082,428645,80,5457,130000.0,43333.0,-69.0,-64.0,-73.0,-69.0,-68.0,-64.0,-72.0,-68.0,-84.0,-90.0,-83.0,-90.0,15.0,26.0,10.0,21.0,1
634,F8:59:71:5A:E0:3D,3278049,499566044,68003,94106089,3210046,405459955,0,65602,52771316,60832,52201364,4770,569952,43744,16,70715,1816,0,500,144444.0,43333.0,-66.0,-74.0,-65.0,-70.0,-66.0,-74.0,-65.0,-70.0,-84.0,-90.0,-83.0,-90.0,18.0,16.0,18.0,20.0,1
635,CC:2F:71:3E:C5:1F,3221394,406848183,11348,1388228,3210046,405459955,6,48484,4059708,40075,3063378,8409,996330,11964,34,16312,186,6,820,144444.0,39000.0,-68.0,-69.0,-67.0,-61.0,-69.0,-69.0,-67.0,-60.0,-84.0,-90.0,-83.0,-90.0,16.0,21.0,16.0,29.0,1
636,CC:2F:71:3F:1F:24,7466471,6883821918,4256425,6478361963,3210046,405459955,80,974020,588506972,965519,587486014,8501,1020958,922035,619,4261143,428647,80,5457,130000.0,43333.0,-69.0,-64.0,-73.0,-69.0,-69.0,-64.0,-72.0,-69.0,-84.0,-90.0,-83.0,-90.0,15.0,26.0,10.0,21.0,1
637,F8:59:71:5A:E0:3D,3278118,499665964,68067,94205545,3210051,405460419,0,65666,52869890,60896,52299938,4770,569952,43807,16,70778,1817,0,500,144444.0,43333.0,-67.0,-74.0,-66.0,-70.0,-66.0,-73.0,-65.0,-69.0,-84.0,-90.0,-83.0,-90.0,17.0,16.0,17.0,20.0,1
638,CC:2F:71:3E:C5:1F,3221399,406848647,11348,1388228,3210051,405460419,6,48484,4059708,40075,3063378,8409,996330,11964,34,16312,186,6,820,144444.0,39000.0,-68.0,-69.0,-67.0,-61.0,-69.0,-69.0,-67.0,-60.0,-84.0,-90.0,-83.0,-90.0,16.0,21.0,16.0,29.0,1
639,CC:2F:71:3F:1F:24,7467296,6885059848,4257245,6479599429,3210051,405460419,80,974276,588724129,965775,587703171,8501,1020958,922278,619,4261964,428661,80,5457,130000.0,43333.0,-69.0,-64.0,-73.0,-68.0,-69.0,-64.0,-72.0,-68.0,-84.0,-90.0,-83.0,-90.0,15.0,26.0,10.0,22.0,1
640,F8:59:71:5A:E0:3D,3278184,499762716,68129,94301893,3210055,405460823,0,65733,52973126,60963,52403174,4770,569952,43870,16,70841,1817,0,500,144444.0,43333.0,-67.0,-74.0,-65.0,-70.0,-66.0,-74.0,-65.0,-70.0,-83.0,-90.0,-83.0,-90.0,16.0,16.0,18.0,20.0,1
641,CC:2F:71:3E:C5:1F,3221403,406849051,11348,1388228,3210055,405460823,6,48484,4059708,40075,3063378,8409,996330,11964,34,16312,186,6,820,144444.0,39000.0,-68.0,-69.0,-67.0,-61.0,-69.0,-69.0,-67.0,-60.0,-83.0,-90.0,-83.0,-90.0,15.0,21.0,16.0,29.0,1
642,CC:2F:71:3F:1F:24,7468412,6886757855,4258357,6481297032,3210055,405460823,80,974588,588953416,966087,587932458,8501,1020958,922574,619,4263044,428714,80,5457,130000.0,43333.0,-69.0,-64.0,-72.0,-69.0,-69.0,-63.0,-72.0,-68.0,-83.0,-90.0,-83.0,-90.0,14.0,26.0,11.0,21.0,1
643,F8:59:71:5A:E0:3D,3278252,499862576,68193,94401349,3210059,405461227,0,65802,53079456,61032,52509504,4770,569952,43934,16,70905,1819,0,500,144444.0,43333.0,-68.0,-75.0,-66.0,-71.0,-67.0,-74.0,-65.0,-70.0,-83.0,-90.0,-83.0,-90.0,15.0,15.0,17.0,19.0,1
644,CC:2F:71:3E:C5:1F,3221408,406849515,11348,1388228,3210060,405461287,6,48484,4059708,40075,3063378,8409,996330,11964,34,16312,186,6,820,144444.0,39000.0,-68.0,-69.0,-67.0,-61.0,-69.0,-69.0,-67.0,-60.0,-83.0,-90.0,-83.0,-90.0,15.0,21.0,16.0,29.0,1
645,CC:2F:71:3F:1F:24,7469927,6889084607,4259867,6483623320,3210060,405461287,80,974913,589180091,966412,588159133,8501,1020958,922891,619,4264586,428805,80,5458,130000.0,43333.0,-70.0,-64.0,-73.0,-69.0,-69.0,-64.0,-72.0,-69.0,-83.0,-90.0,-83.0,-90.0,13.0,26.0,10.0,21.0,1
646,F8:59:71:5A:E0:3D,3278322,499964050,68258,94502359,3210064,405461691,0,65871,53185786,61101,52615834,4770,569952,43998,16,70970,1819,0,500,144444.0,43333.0,-68.0,-75.0,-66.0,-71.0,-67.0,-74.0,-65.0,-70.0,-83.0,-90.0,-83.0,-90.0,15.0,15.0,17.0,19.0,1
647,CC:2F:71:3E:C5:1F,3221412,406849919,11348,1388228,3210064,405461691,6,48484,4059708,40075,3063378,8409,996330,11964,34,16312,186,6,820,144444.0,39000.0,-68.0,-69.0,-67.0,-61.0,-69.0,-69.0,-67.0,-60.0,-83.0,-90.0,-83.0,-90.0,15.0,21.0,16.0,29.0,1
648,CC:2F:71:3F:1F:24,7471819,6891990475,4261755,6486528784,3210064,405461691,80,975282,589410839,966781,588389881,8501,1020958,923249,619,4266429,428961,80,5458,130000.0,43333.0,-70.0,-64.0,-73.0,-69.0,-69.0,-64.0,-73.0,-69.0,-83.0,-90.0,-83.0,-90.0,13.0,26.0,10.0,21.0,1
649,F8:59:71:5A:E0:3D,3278389,500065262,68323,94603369,3210066,405461893,0,65937,53287524,61167,52717572,4770,569952,44063,16,71035,1820,0,500,144444.0,43333.0,-67.0,-74.0,-65.0,-70.0,-67.0,-74.0,-65.0,-70.0,-83.0,-90.0,-83.0,-90.0,16.0,16.0,18.0,20.0,1
650,CC:2F:71:3E:C5:1F,3221416,406850323,11348,1388228,3210068,405462095,6,48484,4059708,40075,3063378,8409,996330,11964,34,16312,186,6,820,144444.0,39000.0,-68.0,-69.0,-67.0,-61.0,-69.0,-69.0,-67.0,-60.0,-83.0,-90.0,-83.0,-90.0,15.0,21.0,16.0,29.0,1
651,CC:2F:71:3F:1F:24,7473342,6894341813,4263274,6488879718,3210068,405462095,80,975619,589648109,967118,588627151,8501,1020958,923569,619,4267993,429005,80,5459,130000.0,43333.0,-70.0,-64.0,-73.0,-69.0,-69.0,-64.0,-72.0,-68.0,-83.0,-90.0,-83.0,-90.0,13.0,26.0,10.0,21.0,1
652,F8:59:71:5A:E0:3D,3278460,500164050,68386,94701271,3210074,405462779,0,66000,53384586,61230,52814634,4770,569952,44125,16,71097,1821,0,500,144444.0,43333.0,-66.0,-74.0,-65.0,-70.0,-67.0,-74.0,-65.0,-70.0,-83.0,-90.0,-83.0,-90.0,17.0,16.0,18.0,20.0,1
653,CC:2F:71:3E:C5:1F,3221422,406851007,11348,1388228,3210074,405462779,6,48484,4059708,40075,3063378,8409,996330,11964,34,16312,186,6,820,144444.0,39000.0,-68.0,-69.0,-67.0,-61.0,-69.0,-69.0,-67.0,-60.0,-83.0,-90.0,-83.0,-90.0,15.0,21.0,16.0,29.0,1
654,CC:2F:71:3F:1F:24,7474533,6896148938,4264459,6490686159,3210074,405462779,80,975924,589876648,967423,588855690,8501,1020958,923864,619,4269178,429043,80,5459,130000.0,43333.0,-71.0,-64.0,-73.0,-69.0,-70.0,-64.0,-73.0,-68.0,-83.0,-90.0,-83.0,-90.0,12.0,26.0,10.0,21.0,1
655,F8:59:71:5A:E0:3D,3278522,500260398,68448,94797619,3210074,405462779,0,66066,53486338,61296,52916386,4770,569952,44189,16,71160,1821,0,500,144444.0,43333.0,-67.0,-75.0,-66.0,-71.0,-67.0,-75.0,-66.0,-70.0,-83.0,-90.0,-83.0,-90.0,16.0,15.0,17.0,19.0,1
656,CC:2F:71:3E:C5:1F,3221424,406851209,11348,1388228,3210076,405462981,6,48484,4059708,40075,3063378,8409,996330,11964,34,16312,186,6,820,144444.0,39000.0,-68.0,-69.0,-67.0,-61.0,-69.0,-69.0,-67.0,-60.0,-83.0,-90.0,-83.0,-90.0,15.0,21.0,16.0,29.0,1
657,CC:2F:71:3F:1F:24,7475366,6897396572,4265290,6491933591,3210076,405462981,80,976228,590096883,967727,589075925,8501,1020958,924158,619,4270009,429063,80,5461,130000.0,43333.0,-70.0,-64.0,-72.0,-68.0,-69.0,-63.0,-72.0,-68.0,-83.0,-90.0,-83.0,-90.0,13.0,26.0,11.0,22.0,1
658,F8:59:71:5A:E0:3D,3278593,500360733,68512,94897075,3210081,405463658,0,66132,53588020,61362,53018068,4770,569952,44252,16,71224,1821,0,500,144444.0,43333.0,-67.0,-74.0,-65.0,-70.0,-66.0,-73.0,-65.0,-69.0,-83.0,-90.0,-83.0,-90.0,16.0,16.0,18.0,20.0,1
659,CC:2F:71:3E:C5:1F,3221429,406851886,11348,1388228,3210081,405463658,6,48484,4059708,40075,3063378,8409,996330,11964,34,16312,186,6,820,144444.0,39000.0,-68.0,-69.0,-67.0,-61.0,-69.0,-69.0,-67.0,-60.0,-83.0,-90.0,-83.0,-90.0,15.0,21.0,16.0,29.0,1
660,CC:2F:71:3F:1F:24,7476267,6898746230,4266184,6493282370,3210083,405463860,80,976535,590328970,968034,589308012,8501,1020958,924446,619,4270903,429088,80,5461,130000.0,43333.0,-69.0,-64.0,-72.0,-68.0,-69.0,-64.0,-72.0,-68.0,-83.0,-90.0,-83.0,-90.0,14.0,26.0,11.0,22.0,1
661,F8:59:71:5A:E0:3D,3278659,500458897,68575,94994977,3210084,405463920,0,66195,53685054,61425,53115102,4770,569952,44314,16,71286,1823,0,500,144444.0,43333.0,-67.0,-74.0,-66.0,-70.0,-67.0,-74.0,-65.0,-70.0,-83.0,-90.0,-83.0,-90.0,16.0,16.0,17.0,20.0,1
662,CC:2F:71:3E:C5:1F,3221432,406852148,11348,1388228,3210084,405463920,6,48484,4059708,40075,3063378,8409,996330,11964,34,16312,186,6,820,144444.0,39000.0,-68.0,-69.0,-67.0,-61.0,-69.0,-69.0,-67.0,-60.0,-83.0,-90.0,-83.0,-90.0,15.0,21.0,16.0,29.0,1
663,CC:2F:71:3F:1F:24,7477355,6900402790,4267271,6494938870,3210084,405463920,80,976836,590548728,968335,589527770,8501,1020958,924734,619,4271990,429133,80,5462,130000.0,43333.0,-70.0,-64.0,-72.0,-68.0,-69.0,-63.0,-73.0,-68.0,-83.0,-90.0,-83.0,-90.0,13.0,26.0,11.0,22.0,1
664,F8:59:71:5A:E0:3D,3278727,500555851,68637,95091325,3210090,405464526,0,66260,53785168,61490,53215216,4770,569952,44378,16,71349,1824,0,500,144444.0,43333.0,-66.0,-73.0,-65.0,-70.0,-66.0,-73.0,-65.0,-70.0,-83.0,-90.0,-83.0,-90.0,17.0,17.0,18.0,20.0,1
665,CC:2F:71:3E:C5:1F,3221438,406852754,11348,1388228,3210090,405464526,6,48484,4059708,40075,3063378,8409,996330,11964,34,16312,186,6,820,144444.0,39000.0,-68.0,-69.0,-67.0,-61.0,-69.0,-69.0,-67.0,-60.0,-83.0,-90.0,-83.0,-90.0,15.0,21.0,16.0,29.0,1
666,CC:2F:71:3F:1F:24,7478597,6902298493,4268507,6496833967,3210090,405464526,80,977129,590767169,968628,589746211,8501,1020958,925020,619,4273226,429166,80,5462,130000.0,43333.0,-70.0,-64.0,-73.0,-68.0,-70.0,-63.0,-72.0,-68.0,-83.0,-90.0,-83.0,-90.0,13.0,26.0,10.0,22.0,1
667,F8:59:71:5A:E0:3D,3278794,500655625,68702,95190897,3210092,405464728,0,66326,53885402,61556,53315450,4770,569952,44442,16,71413,1826,0,500,144444.0,43333.0,-67.0,-74.0,-66.0,-70.0,-66.0,-73.0,-65.0,-70.0,-83.0,-90.0,-83.0,-90.0,16.0,16.0,17.0,20.0,1
668,CC:2F:71:3E:C5:1F,3221440,406852956,11348,1388228,3210092,405464728,6,48484,4059708,40075,3063378,8409,996330,11964,34,16312,186,6,820,144444.0,39000.0,-68.0,-69.0,-67.0,-61.0,-69.0,-69.0,-67.0,-60.0,-83.0,-90.0,-83.0,-90.0,15.0,21.0,16.0,29.0,1
669,CC:2F:71:3F:1F:24,7480210,6904782734,4270118,6499318006,3210092,405464728,80,977450,590998861,968949,589977903,8501,1020958,925331,619,4274837,429233,80,5462,130000.0,43333.0,-69.0,-64.0,-72.0,-69.0,-69.0,-64.0,-72.0,-68.0,-83.0,-90.0,-83.0,-90.0,14.0,26.0,11.0,21.0,1
670,F8:59:71:5A:E0:3D,3278862,500753991,68765,95288799,3210097,405465192,0,66391,53985530,61621,53415578,4770,569952,44505,16,71477,1828,0,500,144444.0,43333.0,-67.0,-74.0,-65.0,-70.0,-66.0,-74.0,-65.0,-70.0,-83.0,-90.0,-83.0,-90.0,16.0,16.0,18.0,20.0,1
671,CC:2F:71:3E:C5:1F,3221447,406853622,11348,1388228,3210099,405465394,6,48484,4059708,40075,3063378,8409,996330,11964,34,16312,186,6,820,144444.0,39000.0,-68.0,-69.0,-67.0,-61.0,-69.0,-69.0,-67.0,-60.0,-83.0,-90.0,-83.0,-90.0,15.0,21.0,16.0,29.0,1
672,CC:2F:71:3F:1F:24,7481651,6906989695,4271552,6501524301,3210099,405465394,80,977782,591243613,969281,590222655,8501,1020958,925648,619,4276270,429276,80,5462,130000.0,43333.0,-70.0,-64.0,-73.0,-69.0,-70.0,-64.0,-72.0,-68.0,-83.0,-90.0,-83.0,-90.0,13.0,26.0,10.0,21.0,1
673,F8:59:71:5A:E0:3D,3278935,500861621,68834,95396025,3210101,405465596,0,66465,54099560,61695,53529608,4770,569952,44574,16,71546,1828,0,500,144444.0,43333.0,-67.0,-74.0,-66.0,-70.0,-66.0,-74.0,-65.0,-70.0,-83.0,-90.0,-83.0,-90.0,16.0,16.0,17.0,20.0,1
674,CC:2F:71:3E:C5:1F,3221449,406853824,11348,1388228,3210101,405465596,6,48484,4059708,40075,3063378,8409,996330,11964,34,16312,186,6,820,144444.0,39000.0,-68.0,-69.0,-67.0,-61.0,-69.0,-69.0,-67.0,-60.0,-83.0,-90.0,-83.0,-90.0,15.0,21.0,16.0,29.0,1
675,CC:2F:71:3F:1F:24,7482643,6908502761,4272542,6503037165,3210101,405465596,80,978073,591465817,969572,590444859,8501,1020958,925928,619,4277261,429319,80,5463,130000.0,43333.0,-70.0,-64.0,-73.0,-69.0,-70.0,-64.0,-73.0,-69.0,-83.0,-90.0,-83.0,-90.0,13.0,26.0,10.0,21.0,1
676,F8:59:71:5A:E0:3D,3279003,500958605,68898,95492605,3210105,405466000,0,66529,54196700,61759,53626748,4770,569952,44637,16,71610,1830,0,500,144444.0,43333.0,-67.0,-74.0,-65.0,-70.0,-66.0,-73.0,-65.0,-70.0,-83.0,-90.0,-83.0,-90.0,16.0,16.0,18.0,20.0,1
677,CC:2F:71:3E:C5:1F,3221454,406854344,11349,1388344,3210105,405466000,6,48486,4059848,40077,3063518,8409,996330,11964,34,16313,186,6,820,144444.0,39000.0,-68.0,-70.0,-68.0,-61.0,-68.0,-69.0,-67.0,-60.0,-83.0,-90.0,-83.0,-90.0,15.0,20.0,15.0,29.0,1
678,CC:2F:71:3F:1F:24,7483604,6909950664,4273497,6504484462,3210107,405466202,80,978400,591724126,969899,590703168,8501,1020958,926233,619,4278216,429361,80,5463,130000.0,43333.0,-71.0,-64.0,-73.0,-69.0,-70.0,-64.0,-73.0,-68.0,-83.0,-90.0,-83.0,-90.0,12.0,26.0,10.0,21.0,1
679,F8:59:71:5A:E0:3D,3279081,501072511,68971,95606047,3210110,405466464,0,66605,54313782,61835,53743830,4770,569952,44710,16,71683,1830,0,500,144444.0,43333.0,-66.0,-73.0,-65.0,-69.0,-66.0,-73.0,-65.0,-69.0,-83.0,-90.0,-83.0,-90.0,17.0,17.0,18.0,21.0,1
680,CC:2F:71:3E:C5:1F,3221459,406854808,11349,1388344,3210110,405466464,6,48486,4059848,40077,3063518,8409,996330,11964,34,16313,186,6,820,144444.0,39000.0,-68.0,-70.0,-68.0,-61.0,-68.0,-69.0,-67.0,-60.0,-83.0,-90.0,-83.0,-90.0,15.0,20.0,15.0,29.0,1
681,CC:2F:71:3F:1F:24,7484961,6912031035,4274851,6506564571,3210110,405466464,80,978695,591946955,970194,590925997,8501,1020958,926521,619,4279543,429406,80,5463,130000.0,43333.0,-70.0,-64.0,-73.0,-69.0,-69.0,-64.0,-72.0,-68.0,-83.0,-90.0,-83.0,-90.0,13.0,26.0,10.0,21.0,1
682,F8:59:71:5A:E0:3D,3279148,501170817,69034,95703949,3210114,405466868,0,66671,54415464,61901,53845512,4770,569952,44773,16,71746,1830,0,500,144444.0,43333.0,-66.0,-74.0,-65.0,-69.0,-66.0,-73.0,-65.0,-69.0,-83.0,-90.0,-83.0,-90.0,17.0,16.0,18.0,21.0,1
683,CC:2F:71:3E:C5:1F,3221463,406855212,11349,1388344,3210114,405466868,6,48486,4059848,40077,3063518,8409,996330,11964,34,16313,186,6,820,144444.0,39000.0,-68.0,-70.0,-68.0,-61.0,-68.0,-69.0,-67.0,-60.0,-83.0,-90.0,-83.0,-90.0,15.0,20.0,15.0,29.0,1
684,CC:2F:71:3F:1F:24,7485957,6913537003,4275841,6508069686,3210116,405467317,80,978978,592162720,970477,591141762,8501,1020958,926797,619,4280560,429453,80,5463,130000.0,43333.0,-71.0,-64.0,-74.0,-69.0,-70.0,-64.0,-73.0,-69.0,-83.0,-90.0,-83.0,-90.0,12.0,26.0,9.0,21.0,1
685,F8:59:71:5A:E0:3D,3279216,501268018,69096,95800297,3210120,405467721,0,66734,54512498,61964,53942546,4770,569952,44835,16,71808,1831,0,500,144444.0,43333.0,-67.0,-74.0,-65.0,-70.0,-66.0,-74.0,-65.0,-70.0,-83.0,-90.0,-83.0,-90.0,16.0,16.0,18.0,20.0,1
686,CC:2F:71:3E:C5:1F,3221469,406856065,11349,1388344,3210120,405467721,6,48486,4059848,40077,3063518,8409,996330,11964,34,16313,186,6,820,144444.0,39000.0,-68.0,-70.0,-68.0,-61.0,-68.0,-69.0,-67.0,-60.0,-83.0,-90.0,-83.0,-90.0,15.0,20.0,15.0,29.0,1
687,CC:2F:71:3F:1F:24,7487183,6915413750,4277063,6509946029,3210120,405467721,80,979277,592385783,970776,591364825,8501,1020958,927089,619,4281755,429470,80,5463,130000.0,43333.0,-70.0,-64.0,-73.0,-69.0,-70.0,-64.0,-73.0,-68.0,-83.0,-90.0,-83.0,-90.0,13.0,26.0,10.0,21.0,1
688,F8:59:71:5A:E0:3D,3279286,501369739,69161,95901307,3210125,405468432,0,66802,54617260,62032,54047308,4770,569952,44900,16,71873,1833,0,500,144444.0,43333.0,-67.0,-74.0,-66.0,-70.0,-66.0,-74.0,-65.0,-70.0,-83.0,-90.0,-83.0,-90.0,16.0,16.0,17.0,20.0,1
689,CC:2F:71:3E:C5:1F,3221476,406856978,11349,1388344,3210127,405468634,6,48486,4059848,40077,3063518,8409,996330,11964,34,16313,186,6,820,144444.0,39000.0,-68.0,-70.0,-68.0,-61.0,-68.0,-69.0,-67.0,-60.0,-83.0,-90.0,-83.0,-90.0,15.0,20.0,15.0,29.0,1
690,CC:2F:71:3F:1F:24,7488446,6917338431,4278319,6511869797,3210127,405468634,80,979595,592621609,971094,591600651,8501,1020958,927381,619,4283038,429539,80,5463,130000.0,43333.0,-70.0,-64.0,-72.0,-69.0,-70.0,-64.0,-72.0,-68.0,-83.0,-90.0,-83.0,-90.0,13.0,26.0,11.0,21.0,1
691,F8:59:71:5A:E0:3D,3279357,501468696,69224,95999209,3210133,405469487,0,66869,54720496,62099,54150544,4770,569952,44963,16,71936,1834,0,500,144444.0,43333.0,-66.0,-74.0,-66.0,-70.0,-66.0,-73.0,-65.0,-70.0,-84.0,-91.0,-84.0,-90.0,18.0,17.0,18.0,20.0,1
692,CC:2F:71:3E:C5:1F,3221482,406857831,11349,1388344,3210133,405469487,6,48486,4059848,40077,3063518,8409,996330,11964,34,16313,186,6,820,144444.0,39000.0,-68.0,-70.0,-68.0,-61.0,-68.0,-69.0,-67.0,-60.0,-84.0,-91.0,-84.0,-90.0,16.0,21.0,16.0,29.0,1
693,CC:2F:71:3F:1F:24,7489906,6919567240,4279773,6514097753,3210133,405469487,80,979934,592854082,971433,591833124,8501,1020958,927708,619,4284492,429566,80,5463,130000.0,43333.0,-69.0,-65.0,-72.0,-70.0,-69.0,-65.0,-72.0,-68.0,-84.0,-91.0,-84.0,-90.0,15.0,26.0,12.0,20.0,1
694,F8:59:71:5A:E0:3D,3279423,501568242,69288,96098553,3210135,405469689,0,66936,54823718,62166,54253766,4770,569952,45027,16,72000,1835,0,500,144444.0,39000.0,-67.0,-73.0,-66.0,-70.0,-66.0,-72.0,-65.0,-69.0,-83.0,-90.0,-83.0,-90.0,16.0,17.0,17.0,20.0,1
695,CC:2F:71:3E:C5:1F,3221485,406858093,11349,1388344,3210136,405469749,6,48486,4059848,40077,3063518,8409,996330,11964,34,16313,186,6,820,144444.0,39000.0,-68.0,-70.0,-68.0,-61.0,-68.0,-69.0,-67.0,-60.0,-83.0,-90.0,-83.0,-90.0,15.0,20.0,15.0,29.0,1
696,CC:2F:71:3F:1F:24,7491513,6922035167,4281377,6516565418,3210136,405469749,80,980318,593092067,971817,592071109,8501,1020958,928073,619,4286095,430020,80,5463,115556.0,28889.0,-70.0,-64.0,-73.0,-69.0,-69.0,-64.0,-72.0,-69.0,-83.0,-90.0,-83.0,-90.0,13.0,26.0,10.0,21.0,1
697,F8:59:71:5A:E0:3D,3279493,501667001,69351,96196399,3210142,405470602,0,67002,54925400,62232,54355448,4770,569952,45090,16,72063,1836,0,500,144444.0,43333.0,-67.0,-73.0,-65.0,-70.0,-66.0,-73.0,-65.0,-70.0,-83.0,-90.0,-83.0,-90.0,16.0,17.0,18.0,20.0,1
698,CC:2F:71:3E:C5:1F,3221492,406859080,11349,1388344,3210143,405470736,6,48486,4059848,40077,3063518,8409,996330,11964,34,16313,186,6,820,144444.0,39000.0,-68.0,-70.0,-68.0,-61.0,-68.0,-69.0,-67.0,-60.0,-83.0,-90.0,-83.0,-90.0,15.0,20.0,15.0,29.0,1
699,CC:2F:71:3F:1F:24,7492893,6924128600,4282749,6518657796,3210144,405470804,80,980658,593320799,972157,592299841,8501,1020958,928406,619,4287449,430108,80,5463,104000.0,26000.0,-70.0,-64.0,-73.0,-68.0,-69.0,-64.0,-72.0,-68.0,-83.0,-90.0,-83.0,-90.0,13.0,26.0,10.0,22.0,1
700,F8:59:71:5A:E0:3D,3279560,501766932,69415,96295855,3210145,405471077,0,67070,55030176,62300,54460224,4770,569952,45154,16,72126,1836,0,500,144444.0,43333.0,-67.0,-73.0,-66.0,-70.0,-66.0,-73.0,-65.0,-70.0,-83.0,-90.0,-83.0,-90.0,16.0,17.0,17.0,20.0,1
701,CC:2F:71:3E:C5:1F,3221496,406859623,11349,1388344,3210147,405471279,6,48486,4059848,40077,3063518,8409,996330,11964,34,16313,186,6,820,144444.0,39000.0,-68.0,-70.0,-68.0,-61.0,-68.0,-69.0,-67.0,-60.0,-83.0,-90.0,-83.0,-90.0,15.0,20.0,15.0,29.0,1
702,CC:2F:71:3F:1F:24,7494221,6926163348,4284074,6520692069,3210147,405471279,80,980997,593562266,972496,592541308,8501,1020958,928722,619,4288793,430138,80,5466,115556.0,28889.0,-69.0,-65.0,-71.0,-68.0,-69.0,-64.0,-71.0,-68.0,-83.0,-90.0,-83.0,-90.0,14.0,25.0,12.0,22.0,1
703,F8:59:71:5A:E0:3D,3279632,501868608,69480,96396865,3210152,405471743,0,67136,55131830,62366,54561878,4770,569952,45219,16,72192,1837,0,500,144444.0,43333.0,-66.0,-73.0,-65.0,-70.0,-66.0,-73.0,-65.0,-70.0,-83.0,-90.0,-83.0,-90.0,17.0,17.0,18.0,20.0,1
704,CC:2F:71:3E:C5:1F,3221501,406860087,11349,1388344,3210152,405471743,6,48486,4059848,40077,3063518,8409,996330,11964,34,16313,186,6,820,144444.0,39000.0,-68.0,-70.0,-68.0,-61.0,-68.0,-69.0,-67.0,-60.0,-83.0,-90.0,-83.0,-90.0,15.0,20.0,15.0,29.0,1
705,CC:2F:71:3F:1F:24,7495430,6928020620,4285278,6522548877,3210152,405471743,80,981307,593794986,972806,592774028,8501,1020958,929021,619,4289996,430167,80,5467,115556.0,28889.0,-68.0,-64.0,-71.0,-67.0,-68.0,-64.0,-71.0,-67.0,-83.0,-90.0,-83.0,-90.0,15.0,26.0,12.0,23.0,1
706,F8:59:71:5A:E0:3D,3279698,501968266,69544,96496321,3210154,405471945,0,67201,55231958,62431,54662006,4770,569952,45284,16,72256,1838,0,500,144444.0,43333.0,-66.0,-73.0,-65.0,-70.0,-66.0,-72.0,-65.0,-70.0,-83.0,-90.0,-83.0,-90.0,17.0,17.0,18.0,20.0,1
707,CC:2F:71:3E:C5:1F,3221503,406860289,11349,1388344,3210154,405471945,6,48486,4059848,40077,3063518,8409,996330,11964,34,16313,186,6,820,144444.0,39000.0,-68.0,-70.0,-68.0,-61.0,-68.0,-69.0,-67.0,-60.0,-83.0,-90.0,-83.0,-90.0,15.0,20.0,15.0,29.0,1
708,CC:2F:71:3F:1F:24,7496346,6929403330,4286190,6523931183,3210156,405472147,80,981592,594013760,973091,592992802,8501,1020958,929299,619,4290909,430256,80,5467,130000.0,43333.0,-70.0,-64.0,-72.0,-67.0,-69.0,-64.0,-71.0,-67.0,-83.0,-90.0,-83.0,-90.0,13.0,26.0,11.0,23.0,1
709,F8:59:71:5A:E0:3D,3279767,502065282,69606,96592669,3210161,405472613,0,67263,55326016,62492,54755946,4771,570070,45346,16,72318,1838,0,500,144444.0,43333.0,-66.0,-73.0,-66.0,-70.0,-66.0,-73.0,-65.0,-69.0,-83.0,-90.0,-83.0,-90.0,17.0,17.0,17.0,20.0,1
710,CC:2F:71:3E:C5:1F,3221510,406860957,11349,1388344,3210161,405472613,6,48486,4059848,40077,3063518,8409,996330,11964,34,16313,186,6,820,144444.0,39000.0,-68.0,-70.0,-68.0,-61.0,-68.0,-69.0,-67.0,-60.0,-83.0,-90.0,-83.0,-90.0,15.0,20.0,15.0,29.0,1
711,CC:2F:71:3F:1F:24,7497271,6930812276,4287110,6525339663,3210161,405472613,80,981912,594244770,973411,593223812,8501,1020958,929598,619,4291818,430303,80,5467,130000.0,43333.0,-69.0,-64.0,-71.0,-67.0,-69.0,-64.0,-71.0,-67.0,-83.0,-90.0,-83.0,-90.0,14.0,26.0,12.0,23.0,1
712,F8:59:71:5A:E0:3D,3279834,502164888,69670,96692013,3210164,405472875,0,67327,55424576,62556,54854506,4771,570070,45410,16,72382,1841,0,500,144444.0,43333.0,-66.0,-73.0,-65.0,-70.0,-66.0,-73.0,-65.0,-70.0,-83.0,-90.0,-83.0,-90.0,17.0,17.0,18.0,20.0,1
713,CC:2F:71:3E:C5:1F,3221513,406861219,11349,1388344,3210164,405472875,6,48486,4059848,40077,3063518,8409,996330,11964,34,16313,186,6,820,144444.0,39000.0,-68.0,-70.0,-68.0,-61.0,-68.0,-69.0,-67.0,-60.0,-83.0,-90.0,-83.0,-90.0,15.0,20.0,15.0,29.0,1
714,CC:2F:71:3F:1F:24,7498070,6932001127,4287905,6526528190,3210165,405472937,80,982187,594477272,973686,593456314,8501,1020958,929863,619,4292624,430391,80,5467,117000.0,39000.0,-69.0,-64.0,-68.0,-67.0,-68.0,-64.0,-69.0,-66.0,-83.0,-90.0,-83.0,-90.0,14.0,26.0,15.0,23.0,1
715,F8:59:71:5A:E0:3D,3279913,502273212,69739,96799239,3210174,405473973,0,67396,55530864,62625,54960794,4771,570070,45479,16,72451,1843,0,500,144444.0,43333.0,-66.0,-72.0,-65.0,-70.0,-66.0,-72.0,-65.0,-70.0,-83.0,-90.0,-83.0,-90.0,17.0,18.0,18.0,20.0,1
716,CC:2F:71:3E:C5:1F,3221523,406862317,11349,1388344,3210174,405473973,6,48488,4060036,40078,3063588,8410,996448,11965,34,16313,186,6,821,144444.0,39000.0,-68.0,-69.0,-67.0,-61.0,-68.0,-69.0,-67.0,-61.0,-83.0,-90.0,-83.0,-90.0,15.0,21.0,16.0,29.0,1
717,CC:2F:71:3F:1F:24,7499115,6933580534,4288941,6528106561,3210174,405473973,80,982476,594701340,973974,593680264,8502,1021076,930151,619,4293660,430616,80,5469,117000.0,39000.0,-71.0,-65.0,-71.0,-69.0,-70.0,-65.0,-71.0,-68.0,-83.0,-90.0,-83.0,-90.0,12.0,25.0,12.0,21.0,1
718,F8:59:71:5A:E0:3D,3279980,502374424,69804,96900249,3210176,405474175,0,67461,55630964,62690,55060894,4771,570070,45544,16,72516,1847,0,500,144444.0,43333.0,-67.0,-73.0,-65.0,-69.0,-66.0,-73.0,-65.0,-69.0,-83.0,-90.0,-83.0,-90.0,16.0,17.0,18.0,21.0,1
719,CC:2F:71:3E:C5:1F,3221525,406862519,11349,1388344,3210176,405474175,6,48488,4060036,40078,3063588,8410,996448,11965,34,16313,186,6,821,144444.0,39000.0,-68.0,-69.0,-67.0,-61.0,-68.0,-69.0,-67.0,-61.0,-83.0,-90.0,-83.0,-90.0,15.0,21.0,16.0,29.0,1
720,CC:2F:71:3F:1F:24,7500366,6935494133,4290190,6530019958,3210176,405474175,80,982787,594930627,974285,593909551,8502,1021076,930450,619,4294909,430843,80,5470,130000.0,43333.0,-69.0,-64.0,-71.0,-67.0,-69.0,-64.0,-71.0,-67.0,-83.0,-90.0,-83.0,-90.0,14.0,26.0,12.0,23.0,1
721,F8:59:71:5A:E0:3D,3280053,502475670,69868,96999705,3210185,405475965,0,67525,55729524,62754,55159454,4771,570070,45608,16,72580,1850,0,500,144444.0,43333.0,-66.0,-73.0,-65.0,-70.0,-66.0,-73.0,-65.0,-69.0,-83.0,-90.0,-83.0,-90.0,17.0,17.0,18.0,20.0,1
722,CC:2F:71:3E:C5:1F,3221534,406864309,11349,1388344,3210185,405475965,6,48488,4060036,40078,3063588,8410,996448,11965,34,16313,186,6,821,144444.0,39000.0,-68.0,-69.0,-67.0,-61.0,-68.0,-69.0,-67.0,-61.0,-83.0,-90.0,-83.0,-90.0,15.0,21.0,16.0,29.0,1
723,CC:2F:71:3F:1F:24,7501817,6937716655,4291632,6532240690,3210185,405475965,80,983117,595169186,974615,594148110,8502,1021076,930765,619,4296351,430937,80,5471,130000.0,43333.0,-69.0,-64.0,-72.0,-67.0,-68.0,-64.0,-71.0,-67.0,-83.0,-90.0,-83.0,-90.0,14.0,26.0,11.0,23.0,1
724,F8:59:71:5A:E0:3D,3280120,502576882,69933,97100715,3210187,405476167,0,67591,55831164,62820,55261094,4771,570070,45674,16,72645,1850,0,500,144444.0,43333.0,-66.0,-73.0,-66.0,-70.0,-66.0,-73.0,-65.0,-70.0,-83.0,-90.0,-83.0,-90.0,17.0,17.0,17.0,20.0,1
725,CC:2F:71:3E:C5:1F,3221536,406864511,11349,1388344,3210187,405476167,6,48488,4060036,40078,3063588,8410,996448,11965,34,16313,186,6,821,144444.0,39000.0,-68.0,-69.0,-67.0,-61.0,-68.0,-69.0,-67.0,-61.0,-83.0,-90.0,-83.0,-90.0,15.0,21.0,16.0,29.0,1
726,CC:2F:71:3F:1F:24,7503495,6940297632,4293308,6534821465,3210187,405476167,80,983466,595404425,974964,594383349,8502,1021076,931108,619,4297987,431183,80,5471,130000.0,43333.0,-69.0,-65.0,-71.0,-68.0,-69.0,-64.0,-71.0,-68.0,-83.0,-90.0,-83.0,-90.0,14.0,25.0,12.0,22.0,1
727,F8:59:71:5A:E0:3D,3280195,502682730,70000,97204833,3210195,405477897,0,67655,55929794,62884,55359724,4771,570070,45737,16,72711,1852,0,500,144444.0,43333.0,-66.0,-73.0,-65.0,-69.0,-66.0,-72.0,-65.0,-69.0,-83.0,-90.0,-83.0,-90.0,17.0,17.0,18.0,21.0,1
728,CC:2F:71:3E:C5:1F,3221544,406866241,11349,1388344,3210195,405477897,6,48488,4060036,40078,3063588,8410,996448,11965,34,16313,186,6,821,144444.0,39000.0,-68.0,-69.0,-67.0,-61.0,-68.0,-69.0,-67.0,-61.0,-83.0,-90.0,-83.0,-90.0,15.0,21.0,16.0,29.0,1
729,CC:2F:71:3F:1F:24,7504876,6942404861,4294680,6536926904,3210196,405477957,80,983778,595652758,975276,594631682,8502,1021076,931413,619,4299399,431334,80,5472,130000.0,43333.0,-68.0,-64.0,-69.0,-67.0,-68.0,-64.0,-70.0,-67.0,-83.0,-90.0,-83.0,-90.0,15.0,26.0,14.0,23.0,1
730,F8:59:71:5A:E0:3D,3280268,502790344,70069,97312059,3210199,405478285,0,67727,56040674,62956,55470604,4771,570070,45809,16,72781,1853,0,500,144444.0,43333.0,-66.0,-73.0,-65.0,-70.0,-66.0,-73.0,-65.0,-69.0,-83.0,-90.0,-83.0,-90.0,17.0,17.0,18.0,20.0,1
731,CC:2F:71:3E:C5:1F,3221548,406866629,11349,1388344,3210199,405478285,6,48488,4060036,40078,3063588,8410,996448,11965,34,16313,186,6,821,144444.0,39000.0,-68.0,-69.0,-67.0,-61.0,-68.0,-69.0,-67.0,-61.0,-83.0,-90.0,-83.0,-90.0,15.0,21.0,16.0,29.0,1
732,CC:2F:71:3F:1F:24,7506508,6944917557,4296309,6539439272,3210199,405478285,80,984148,595898392,975646,594877316,8502,1021076,931748,619,4301028,431937,80,5472,115556.0,28889.0,-68.0,-64.0,-70.0,-68.0,-68.0,-64.0,-70.0,-67.0,-83.0,-90.0,-83.0,-90.0,15.0,26.0,13.0,22.0,1
733,F8:59:71:5A:E0:3D,3280342,502894638,70135,97414623,3210207,405480015,0,67794,56143868,63023,55573798,4771,570070,45875,16,72847,1855,0,500,144444.0,43333.0,-66.0,-71.0,-65.0,-70.0,-66.0,-72.0,-65.0,-70.0,-83.0,-90.0,-83.0,-90.0,17.0,19.0,18.0,20.0,1
734,CC:2F:71:3E:C5:1F,3221556,406868359,11349,1388344,3210207,405480015,6,48488,4060036,40078,3063588,8410,996448,11965,34,16313,186,6,821,144444.0,39000.0,-68.0,-69.0,-67.0,-61.0,-68.0,-69.0,-67.0,-61.0,-83.0,-90.0,-83.0,-90.0,15.0,21.0,16.0,29.0,1
735,CC:2F:71:3F:1F:24,7508699,6948297776,4298492,6542817761,3210207,405480015,80,984585,596158217,976083,595137141,8502,1021076,932152,619,4303192,432055,80,5473,115556.0,28889.0,-70.0,-65.0,-71.0,-68.0,-69.0,-64.0,-70.0,-68.0,-83.0,-90.0,-83.0,-90.0,13.0,25.0,12.0,22.0,1
736,F8:59:71:5A:E0:3D,3280413,503000572,70203,97520295,3210210,405480277,0,67862,56248588,63091,55678518,4771,570070,45943,16,72915,1856,0,500,144444.0,43333.0,-66.0,-73.0,-65.0,-70.0,-66.0,-73.0,-65.0,-70.0,-83.0,-90.0,-83.0,-90.0,17.0,17.0,18.0,20.0,1
737,CC:2F:71:3E:C5:1F,3221559,406868621,11349,1388344,3210210,405480277,6,48488,4060036,40078,3063588,8410,996448,11965,34,16313,186,6,821,144444.0,39000.0,-68.0,-69.0,-67.0,-61.0,-68.0,-69.0,-67.0,-61.0,-83.0,-90.0,-83.0,-90.0,15.0,21.0,16.0,29.0,1
738,CC:2F:71:3F:1F:24,7510603,6951245299,4300393,6545765022,3210210,405480277,80,984937,596393444,976435,595372368,8502,1021076,932494,619,4305112,432173,80,5473,130000.0,43333.0,-71.0,-65.0,-71.0,-69.0,-71.0,-65.0,-71.0,-68.0,-83.0,-90.0,-83.0,-90.0,12.0,25.0,12.0,21.0,1
739,F8:59:71:5A:E0:3D,3280478,503098676,70266,97618197,3210212,405480479,0,67925,56345608,63154,55775538,4771,570070,46006,16,72978,1856,0,500,144444.0,43333.0,-66.0,-73.0,-65.0,-70.0,-66.0,-73.0,-65.0,-70.0,-83.0,-90.0,-83.0,-90.0,17.0,17.0,18.0,20.0,1
740,CC:2F:71:3E:C5:1F,3221563,406869025,11349,1388344,3210214,405480681,6,48488,4060036,40078,3063588,8410,996448,11965,34,16313,186,6,821,144444.0,39000.0,-68.0,-69.0,-67.0,-61.0,-68.0,-69.0,-67.0,-61.0,-83.0,-90.0,-83.0,-90.0,15.0,21.0,16.0,29.0,1
741,CC:2F:71:3F:1F:24,7511773,6953031611,4301557,6547550728,3210216,405480883,80,985255,596621512,976753,595600436,8502,1021076,932800,619,4306276,432437,80,5474,115556.0,28889.0,-71.0,-65.0,-71.0,-69.0,-70.0,-65.0,-71.0,-69.0,-83.0,-90.0,-83.0,-90.0,12.0,25.0,12.0,21.0,1
742,F8:59:71:5A:E0:3D,3280547,503198809,70330,97717653,3210217,405481156,0,67990,56445722,63219,55875652,4771,570070,46070,16,73041,1856,0,500,144444.0,43333.0,-66.0,-73.0,-65.0,-70.0,-66.0,-73.0,-65.0,-70.0,-83.0,-90.0,-83.0,-90.0,17.0,17.0,18.0,20.0,1
743,CC:2F:71:3E:C5:1F,3221566,406869500,11349,1388344,3210217,405481156,6,48488,4060036,40078,3063588,8410,996448,11965,34,16313,186,6,821,144444.0,39000.0,-68.0,-69.0,-67.0,-61.0,-68.0,-69.0,-67.0,-61.0,-83.0,-90.0,-83.0,-90.0,15.0,21.0,16.0,29.0,1
744,CC:2F:71:3F:1F:24,7512613,6954295106,4302394,6548813748,3210219,405481358,80,985535,596850075,977033,595828999,8502,1021076,933070,619,4307113,432488,80,5475,115556.0,28889.0,-70.0,-64.0,-70.0,-68.0,-70.0,-64.0,-70.0,-68.0,-83.0,-90.0,-83.0,-90.0,13.0,26.0,13.0,22.0,1
745,F8:59:71:5A:E0:3D,3280616,503298729,70394,97817109,3210222,405481620,0,68055,56545864,63284,55975794,4771,570070,46135,16,73106,1858,0,500,144444.0,43333.0,-66.0,-73.0,-65.0,-70.0,-66.0,-73.0,-65.0,-70.0,-83.0,-90.0,-83.0,-90.0,17.0,17.0,18.0,20.0,1
746,CC:2F:71:3E:C5:1F,3221571,406869964,11349,1388344,3210222,405481620,6,48488,4060036,40078,3063588,8410,996448,11965,34,16313,186,6,821,144444.0,39000.0,-68.0,-69.0,-67.0,-61.0,-68.0,-69.0,-67.0,-61.0,-83.0,-90.0,-83.0,-90.0,15.0,21.0,16.0,29.0,1
747,CC:2F:71:3F:1F:24,7513890,6956240425,4303668,6550758805,3210222,405481620,80,985890,597081820,977388,596060744,8502,1021076,933408,619,4308387,432623,80,5475,115556.0,28889.0,-71.0,-65.0,-70.0,-70.0,-71.0,-64.0,-71.0,-70.0,-83.0,-90.0,-83.0,-90.0,12.0,25.0,13.0,20.0,1
748,F8:59:71:5A:E0:3D,3280684,503398589,70458,97916565,3210226,405482024,0,68118,56642884,63347,56072814,4771,570070,46198,16,73170,1858,0,500,144444.0,43333.0,-67.0,-73.0,-65.0,-70.0,-67.0,-73.0,-65.0,-69.0,-83.0,-90.0,-83.0,-90.0,16.0,17.0,18.0,20.0,1
749,CC:2F:71:3E:C5:1F,3221575,406870368,11349,1388344,3210226,405482024,6,48488,4060036,40078,3063588,8410,996448,11965,34,16313,186,6,821,144444.0,39000.0,-68.0,-69.0,-67.0,-61.0,-68.0,-69.0,-67.0,-61.0,-83.0,-90.0,-83.0,-90.0,15.0,21.0,16.0,29.0,1
750,CC:2F:71:3F:1F:24,7515661,6958956338,4305435,6553474314,3210226,405482024,80,986265,597307779,977763,596286703,8502,1021076,933774,619,4310134,432669,80,5475,115556.0,28889.0,-69.0,-64.0,-72.0,-70.0,-69.0,-64.0,-72.0,-69.0,-83.0,-90.0,-83.0,-90.0,14.0,26.0,11.0,20.0,1
751,F8:59:71:5A:E0:3D,3280751,503499801,70523,98017575,3210228,405482226,0,68184,56744636,63413,56174566,4771,570070,46263,16,73235,1860,0,501,144444.0,43333.0,-67.0,-74.0,-66.0,-70.0,-67.0,-73.0,-65.0,-70.0,-83.0,-90.0,-83.0,-90.0,16.0,16.0,17.0,20.0,1
752,CC:2F:71:3E:C5:1F,3221579,406870772,11349,1388344,3210230,405482428,6,48488,4060036,40078,3063588,8410,996448,11965,34,16313,186,6,821,144444.0,39000.0,-68.0,-69.0,-67.0,-61.0,-68.0,-69.0,-67.0,-61.0,-83.0,-90.0,-83.0,-90.0,15.0,21.0,16.0,29.0,1
753,CC:2F:71:3F:1F:24,7517017,6961034843,4306787,6555552415,3210230,405482428,80,986618,597552918,978116,596531842,8502,1021076,934118,619,4311506,432999,80,5477,115556.0,28889.0,-69.0,-65.0,-73.0,-72.0,-68.0,-64.0,-72.0,-71.0,-83.0,-90.0,-83.0,-90.0,14.0,25.0,10.0,18.0,1
754,F8:59:71:5A:E0:3D,3280828,503609247,70593,98126355,3210235,405482892,0,68257,56857098,63486,56287028,4771,570070,46333,16,73305,1863,0,501,144444.0,43333.0,-67.0,-74.0,-66.0,-70.0,-67.0,-73.0,-65.0,-70.0,-83.0,-90.0,-83.0,-90.0,16.0,16.0,17.0,20.0,1
755,CC:2F:71:3E:C5:1F,3221584,406871236,11349,1388344,3210235,405482892,6,48488,4060036,40078,3063588,8410,996448,11965,34,16313,186,6,821,144444.0,39000.0,-68.0,-69.0,-67.0,-61.0,-68.0,-69.0,-67.0,-61.0,-83.0,-90.0,-83.0,-90.0,15.0,21.0,16.0,29.0,1
756,CC:2F:71:3F:1F:24,7518598,6963271274,4308363,6557788382,3210235,405482892,80,987146,597824798,978644,596803722,8502,1021076,934638,619,4313080,433541,80,5478,130000.0,43333.0,-69.0,-64.0,-72.0,-72.0,-69.0,-64.0,-72.0,-72.0,-83.0,-90.0,-83.0,-90.0,14.0,26.0,11.0,18.0,1
757,F8:59:71:5A:E0:3D,3280894,503708905,70657,98225811,3210237,405483094,0,68321,56955714,63550,56385644,4771,570070,46397,16,73369,1864,0,501,144444.0,43333.0,-67.0,-74.0,-65.0,-70.0,-67.0,-73.0,-65.0,-69.0,-83.0,-90.0,-83.0,-90.0,16.0,16.0,18.0,20.0,1
758,CC:2F:71:3E:C5:1F,3221586,406871438,11349,1388344,3210237,405483094,6,48488,4060036,40078,3063588,8410,996448,11965,34,16313,186,6,821,144444.0,39000.0,-68.0,-69.0,-67.0,-61.0,-68.0,-69.0,-67.0,-61.0,-83.0,-90.0,-83.0,-90.0,15.0,21.0,16.0,29.0,1
759,CC:2F:71:3F:1F:24,7519558,6964688463,4309319,6559205167,3210239,405483296,80,987478,598053033,978976,597031957,8502,1021076,934959,619,4314036,433991,80,5478,104000.0,26000.0,-69.0,-64.0,-72.0,-70.0,-69.0,-64.0,-72.0,-70.0,-83.0,-90.0,-83.0,-90.0,14.0,26.0,11.0,20.0,1
760,F8:59:71:5A:E0:3D,3280967,503810643,70723,98326881,3210244,405483762,0,68386,57055814,63615,56485744,4771,570070,46462,16,73435,1870,0,501,130000.0,39000.0,-67.0,-74.0,-65.0,-70.0,-67.0,-74.0,-65.0,-70.0,-83.0,-90.0,-83.0,-90.0,16.0,16.0,18.0,20.0,1
761,CC:2F:71:3E:C5:1F,3221594,406872222,11350,1388460,3210244,405483762,6,48490,4060176,40080,3063728,8410,996448,11965,34,16314,186,6,821,144444.0,39000.0,-66.0,-63.0,-65.0,-60.0,-68.0,-68.0,-67.0,-60.0,-83.0,-90.0,-83.0,-90.0,17.0,27.0,18.0,30.0,1
762,CC:2F:71:3F:1F:24,7520562,6966215152,4310318,6560731390,3210244,405483762,80,987775,598277324,979272,597256130,8503,1021194,935248,619,4315037,434191,80,5478,115556.0,28889.0,-70.0,-64.0,-72.0,-70.0,-69.0,-64.0,-71.0,-70.0,-83.0,-90.0,-83.0,-90.0,13.0,26.0,11.0,20.0,1
763,F8:59:71:5A:E0:3D,3281033,503908695,70786,98424671,3210247,405484024,0,68449,57152834,63678,56582764,4771,570070,46525,16,73498,1874,0,501,144444.0,43333.0,-67.0,-74.0,-65.0,-70.0,-67.0,-74.0,-65.0,-70.0,-83.0,-90.0,-83.0,-90.0,16.0,16.0,18.0,20.0,1
764,CC:2F:71:3E:C5:1F,3221597,406872484,11350,1388460,3210247,405484024,6,48490,4060176,40080,3063728,8410,996448,11965,34,16314,186,6,821,144444.0,39000.0,-66.0,-63.0,-65.0,-60.0,-68.0,-68.0,-67.0,-60.0,-83.0,-90.0,-83.0,-90.0,17.0,27.0,18.0,30.0,1
765,CC:2F:71:3F:1F:24,7521770,6968017584,4311523,6562533560,3210247,405484024,80,988152,598515342,979649,597494148,8503,1021194,935615,619,4316242,434283,80,5478,115556.0,28889.0,-70.0,-64.0,-72.0,-70.0,-69.0,-64.0,-72.0,-70.0,-83.0,-90.0,-83.0,-90.0,13.0,26.0,11.0,20.0,1
766,F8:59:71:5A:E0:3D,3281103,504008757,70850,98524127,3210253,405484630,0,68512,57249854,63741,56679784,4771,570070,46588,16,73562,1876,0,501,144444.0,43333.0,-68.0,-74.0,-65.0,-70.0,-67.0,-74.0,-65.0,-70.0,-84.0,-90.0,-83.0,-90.0,16.0,16.0,18.0,20.0,1
767,CC:2F:71:3E:C5:1F,3221603,406873090,11350,1388460,3210253,405484630,6,48490,4060176,40080,3063728,8410,996448,11965,34,16314,186,6,821,144444.0,39000.0,-66.0,-63.0,-65.0,-60.0,-68.0,-68.0,-67.0,-60.0,-84.0,-90.0,-83.0,-90.0,18.0,27.0,18.0,30.0,1
768,CC:2F:71:3F:1F:24,7523109,6970020412,4312856,6564535782,3210253,405484630,80,988521,598748925,980018,597727731,8503,1021194,935973,619,4317574,434396,80,5478,115556.0,28889.0,-69.0,-64.0,-72.0,-70.0,-69.0,-64.0,-71.0,-70.0,-84.0,-90.0,-83.0,-90.0,15.0,26.0,11.0,20.0,1
769,F8:59:71:5A:E0:3D,3281169,504108415,70914,98623583,3210255,405484832,0,68574,57345376,63803,56775306,4771,570070,46650,16,73626,1876,0,501,144444.0,43333.0,-67.0,-74.0,-65.0,-70.0,-67.0,-74.0,-65.0,-70.0,-84.0,-90.0,-83.0,-90.0,17.0,16.0,18.0,20.0,1
770,CC:2F:71:3E:C5:1F,3221606,406873352,11350,1388460,3210256,405484892,6,48490,4060176,40080,3063728,8410,996448,11965,34,16314,186,6,821,144444.0,39000.0,-66.0,-63.0,-65.0,-60.0,-68.0,-68.0,-67.0,-60.0,-84.0,-90.0,-83.0,-90.0,18.0,27.0,18.0,30.0,1
771,CC:2F:71:3F:1F:24,7524253,6971773308,4313997,6566288416,3210256,405484892,80,988853,598984325,980350,597963131,8503,1021194,936297,619,4318716,434865,80,5479,115556.0,28889.0,-69.0,-64.0,-71.0,-69.0,-69.0,-64.0,-71.0,-69.0,-84.0,-90.0,-83.0,-90.0,15.0,26.0,12.0,21.0,1
772,F8:59:71:5A:E0:3D,3281243,504213199,70981,98727701,3210262,405485498,0,68645,57454730,63874,56884660,4771,570070,46720,16,73693,1880,0,501,144444.0,43333.0,-68.0,-74.0,-65.0,-70.0,-67.0,-74.0,-65.0,-70.0,-84.0,-90.0,-83.0,-90.0,16.0,16.0,18.0,20.0,1
773,CC:2F:71:3E:C5:1F,3221612,406873958,11350,1388460,3210262,405485498,6,48490,4060176,40080,3063728,8410,996448,11965,34,16314,186,6,821,144444.0,39000.0,-66.0,-63.0,-65.0,-60.0,-68.0,-68.0,-67.0,-60.0,-84.0,-90.0,-83.0,-90.0,18.0,27.0,18.0,30.0,1
774,CC:2F:71:3F:1F:24,7525275,6973317258,4315013,6567831760,3210262,405485498,80,989206,599227572,980703,598206378,8503,1021194,936633,619,4319732,435414,80,5481,115556.0,28889.0,-70.0,-65.0,-73.0,-70.0,-69.0,-64.0,-71.0,-70.0,-84.0,-90.0,-83.0,-89.0,14.0,25.0,10.0,19.0,1
775,F8:59:71:5A:E0:3D,3281311,504315965,71047,98830265,3210264,405485700,0,68711,57556370,63940,56986300,4771,570070,46786,16,73759,1881,0,501,144444.0,43333.0,-68.0,-74.0,-65.0,-70.0,-67.0,-74.0,-65.0,-70.0,-84.0,-90.0,-83.0,-89.0,16.0,16.0,18.0,19.0,1
776,CC:2F:71:3E:C5:1F,3221614,406874160,11350,1388460,3210264,405485700,6,48490,4060176,40080,3063728,8410,996448,11965,34,16314,186,6,821,144444.0,39000.0,-66.0,-63.0,-65.0,-60.0,-68.0,-68.0,-67.0,-60.0,-84.0,-90.0,-83.0,-89.0,18.0,27.0,18.0,29.0,1
777,CC:2F:71:3F:1F:24,7526600,6975308710,4316336,6569823010,3210264,405485700,80,989601,599466295,981098,598445101,8503,1021194,937020,619,4321055,435495,80,5481,115556.0,28889.0,-70.0,-64.0,-72.0,-70.0,-69.0,-64.0,-71.0,-69.0,-84.0,-90.0,-83.0,-89.0,14.0,26.0,11.0,19.0,1
778,F8:59:71:5A:E0:3D,3281383,504417641,71112,98931275,3210271,405486366,0,68777,57658024,64006,57087954,4771,570070,46851,16,73824,1884,0,501,144444.0,43333.0,-68.0,-75.0,-66.0,-70.0,-67.0,-74.0,-65.0,-70.0,-84.0,-90.0,-83.0,-89.0,16.0,15.0,17.0,19.0,1
779,CC:2F:71:3E:C5:1F,3221621,406874826,11350,1388460,3210271,405486366,6,48490,4060176,40080,3063728,8410,996448,11965,34,16314,186,6,821,144444.0,39000.0,-66.0,-63.0,-65.0,-60.0,-68.0,-68.0,-67.0,-60.0,-84.0,-90.0,-83.0,-89.0,18.0,27.0,18.0,29.0,1
780,CC:2F:71:3F:1F:24,7527731,6977000297,4317460,6571513931,3210271,405486366,80,989949,599704682,981446,598683488,8503,1021194,937363,619,4322179,435881,80,5481,104000.0,26000.0,-69.0,-64.0,-71.0,-70.0,-69.0,-64.0,-72.0,-70.0,-84.0,-90.0,-83.0,-89.0,15.0,26.0,12.0,19.0,1
781,F8:59:71:5A:E0:3D,3281456,504528177,71183,99041609,3210273,405486568,0,68850,57770472,64079,57200402,4771,570070,46922,16,73895,1887,0,501,144444.0,43333.0,-67.0,-74.0,-65.0,-70.0,-67.0,-74.0,-65.0,-70.0,-84.0,-90.0,-83.0,-89.0,17.0,16.0,18.0,19.0,1
782,CC:2F:71:3E:C5:1F,3221625,406875363,11350,1388460,3210275,405486903,6,48491,4060294,40080,3063728,8411,996566,11966,34,16314,186,6,821,144444.0,39000.0,-68.0,-70.0,-66.0,-61.0,-68.0,-68.0,-66.0,-60.0,-84.0,-90.0,-83.0,-89.0,16.0,20.0,17.0,28.0,1
783,CC:2F:71:3F:1F:24,7528923,6978830321,4318648,6573343418,3210275,405486903,80,990304,599962747,981801,598941553,8503,1021194,937703,619,4323363,436291,80,5482,115556.0,28889.0,-69.0,-64.0,-72.0,-70.0,-69.0,-64.0,-72.0,-70.0,-84.0,-90.0,-83.0,-89.0,15.0,26.0,11.0,19.0,1
784,F8:59:71:5A:E0:3D,3281537,504642448,71256,99154939,3210281,405487509,0,68923,57882948,64152,57312878,4771,570070,46995,16,73968,1890,0,501,144444.0,43333.0,-68.0,-74.0,-65.0,-70.0,-67.0,-74.0,-65.0,-70.0,-84.0,-90.0,-83.0,-89.0,16.0,16.0,18.0,19.0,1
785,CC:2F:71:3E:C5:1F,3221631,406875969,11350,1388460,3210281,405487509,6,48492,4060364,40081,3063798,8411,996566,11966,34,16314,186,6,821,144444.0,39000.0,-68.0,-70.0,-66.0,-61.0,-68.0,-69.0,-66.0,-60.0,-84.0,-90.0,-83.0,-89.0,16.0,20.0,17.0,28.0,1
786,CC:2F:71:3F:1F:24,7530210,6980804630,4319929,6575317121,3210281,405487509,80,990648,600206588,982145,599185394,8503,1021194,938044,619,4324647,436558,80,5484,104000.0,26000.0,-69.0,-64.0,-72.0,-70.0,-69.0,-64.0,-71.0,-69.0,-84.0,-90.0,-83.0,-89.0,15.0,26.0,11.0,19.0,1
787,F8:59:71:5A:E0:3D,3281606,504745274,71322,99257503,3210284,405487771,0,68989,57984616,64218,57414546,4771,570070,47061,16,74034,1890,0,501,144444.0,43333.0,-67.0,-75.0,-65.0,-70.0,-67.0,-74.0,-65.0,-69.0,-84.0,-90.0,-83.0,-89.0,17.0,15.0,18.0,19.0,1
788,CC:2F:71:3E:C5:1F,3221634,406876231,11350,1388460,3210284,405487771,6,48492,4060364,40081,3063798,8411,996566,11966,34,16314,186,6,821,144444.0,39000.0,-68.0,-70.0,-66.0,-61.0,-68.0,-69.0,-66.0,-60.0,-84.0,-90.0,-83.0,-89.0,16.0,20.0,17.0,28.0,1
789,CC:2F:71:3F:1F:24,7531146,6982229048,4320862,6576741277,3210284,405487771,80,990923,600430624,982420,599409430,8503,1021194,938307,619,4325562,436659,80,5484,115556.0,28889.0,-69.0,-64.0,-72.0,-69.0,-69.0,-63.0,-71.0,-69.0,-84.0,-90.0,-83.0,-89.0,15.0,26.0,11.0,20.0,1
790,F8:59:71:5A:E0:3D,3281673,504843580,71385,99355405,3210288,405488175,0,69053,58083176,64282,57513106,4771,570070,47125,16,74097,1892,0,501,144444.0,43333.0,-67.0,-74.0,-65.0,-70.0,-67.0,-74.0,-65.0,-70.0,-84.0,-90.0,-83.0,-89.0,17.0,16.0,18.0,19.0,1
791,CC:2F:71:3E:C5:1F,3221640,406876837,11350,1388460,3210290,405488377,6,48492,4060364,40081,3063798,8411,996566,11966,34,16314,186,6,821,144444.0,39000.0,-68.0,-70.0,-66.0,-61.0,-68.0,-69.0,-66.0,-60.0,-84.0,-90.0,-83.0,-89.0,16.0,20.0,17.0,28.0,1
792,CC:2F:71:3F:1F:24,7532172,6983787856,4321882,6578299479,3210290,405488377,80,991256,600675150,982753,599653956,8503,1021194,938628,619,4326601,437158,80,5486,115556.0,28889.0,-70.0,-65.0,-72.0,-70.0,-69.0,-64.0,-72.0,-69.0,-84.0,-90.0,-83.0,-89.0,14.0,25.0,11.0,19.0,1
793,F8:59:71:5A:E0:3D,3281748,504954318,71456,99465739,3210292,405488579,0,69123,58190976,64352,57620906,4771,570070,47195,16,74168,1893,0,501,144444.0,43333.0,-68.0,-74.0,-65.0,-70.0,-67.0,-74.0,-65.0,-70.0,-84.0,-90.0,-83.0,-89.0,16.0,16.0,18.0,19.0,1
794,CC:2F:71:3E:C5:1F,3221642,406877039,11350,1388460,3210292,405488579,6,48492,4060364,40081,3063798,8411,996566,11966,34,16314,186,6,821,144444.0,39000.0,-68.0,-70.0,-66.0,-61.0,-68.0,-69.0,-66.0,-60.0,-84.0,-90.0,-83.0,-89.0,16.0,20.0,17.0,28.0,1
795,CC:2F:71:3F:1F:24,7533116,6985219962,4322823,6579731323,3210293,405488639,80,991564,600900572,983061,599879378,8503,1021194,938922,619,4327514,437309,80,5486,115556.0,28889.0,-69.0,-64.0,-72.0,-69.0,-69.0,-64.0,-72.0,-69.0,-84.0,-90.0,-83.0,-89.0,15.0,26.0,11.0,20.0,1
796,F8:59:71:5A:E0:3D,3281821,505058962,71523,99569857,3210298,405489105,0,69190,58292734,64418,57722546,4772,570188,47262,16,74234,1896,0,501,144444.0,43333.0,-67.0,-74.0,-66.0,-70.0,-67.0,-74.0,-65.0,-70.0,-84.0,-90.0,-83.0,-89.0,17.0,16.0,17.0,19.0,1
797,CC:2F:71:3E:C5:1F,3221650,406877767,11350,1388460,3210300,405489307,6,48492,4060364,40081,3063798,8411,996566,11966,34,16314,186,6,821,144444.0,39000.0,-68.0,-70.0,-66.0,-61.0,-68.0,-69.0,-66.0,-60.0,-84.0,-90.0,-83.0,-89.0,16.0,20.0,17.0,28.0,1
798,CC:2F:71:3F:1F:24,7534250,6986941330,4323950,6581452023,3210300,405489307,80,991928,601142504,983425,600121310,8503,1021194,939277,619,4328669,437672,80,5486,115556.0,28889.0,-70.0,-64.0,-72.0,-70.0,-70.0,-64.0,-72.0,-69.0,-84.0,-90.0,-83.0,-89.0,14.0,26.0,11.0,19.0,1
799,F8:59:71:5A:E0:3D,3281889,505158822,71587,99669313,3210302,405489509,0,69255,58392848,64483,57822660,4772,570188,47326,16,74299,1901,0,501,144444.0,43333.0,-67.0,-74.0,-65.0,-70.0,-67.0,-74.0,-65.0,-70.0,-84.0,-90.0,-83.0,-89.0,17.0,16.0,18.0,19.0,1
800,CC:2F:71:3E:C5:1F,3221652,406877969,11350,1388460,3210302,405489509,6,48492,4060364,40081,3063798,8411,996566,11966,34,16314,186,6,821,144444.0,39000.0,-68.0,-70.0,-66.0,-61.0,-68.0,-69.0,-66.0,-60.0,-84.0,-90.0,-83.0,-89.0,16.0,20.0,17.0,28.0,1
801,CC:2F:71:3F:1F:24,7535536,6988920402,4325234,6583430893,3210302,405489509,80,992262,601372098,983759,600350904,8503,1021194,939598,619,4329945,437902,80,5486,115556.0,28889.0,-69.0,-64.0,-72.0,-69.0,-69.0,-64.0,-71.0,-69.0,-84.0,-90.0,-83.0,-89.0,15.0,26.0,11.0,20.0,1
802,F8:59:71:5A:E0:3D,3281959,505260296,71652,99770323,3210307,405489973,0,69324,58499318,64552,57929130,4772,570188,47393,16,74364,1902,0,504,144444.0,43333.0,-67.0,-74.0,-65.0,-70.0,-67.0,-73.0,-65.0,-70.0,-84.0,-90.0,-83.0,-89.0,17.0,16.0,18.0,19.0,1
803,CC:2F:71:3E:C5:1F,3221657,406878433,11350,1388460,3210307,405489973,6,48492,4060364,40081,3063798,8411,996566,11966,34,16314,186,6,821,144444.0,39000.0,-68.0,-70.0,-66.0,-61.0,-68.0,-69.0,-66.0,-60.0,-84.0,-90.0,-83.0,-89.0,16.0,20.0,17.0,28.0,1
804,CC:2F:71:3F:1F:24,7536564,6990472425,4326255,6584982250,3210309,405490175,80,992601,601609116,984098,600587922,8503,1021194,939920,619,4330974,438158,80,5486,115556.0,28889.0,-70.0,-64.0,-72.0,-69.0,-69.0,-64.0,-72.0,-69.0,-84.0,-90.0,-83.0,-89.0,14.0,26.0,11.0,20.0,1
805,F8:59:71:5A:E0:3D,3282027,505360156,71716,99869779,3210311,405490377,0,69386,58594798,64614,58024610,4772,570188,47455,16,74428,1903,0,504,144444.0,43333.0,-68.0,-74.0,-66.0,-70.0,-67.0,-74.0,-65.0,-70.0,-84.0,-90.0,-83.0,-89.0,16.0,16.0,17.0,19.0,1
806,CC:2F:71:3E:C5:1F,3221661,406878837,11350,1388460,3210311,405490377,6,48492,4060364,40081,3063798,8411,996566,11966,34,16314,186,6,821,144444.0,39000.0,-68.0,-70.0,-66.0,-61.0,-68.0,-69.0,-66.0,-60.0,-84.0,-90.0,-83.0,-89.0,16.0,20.0,17.0,28.0,1
807,CC:2F:71:3F:1F:24,7537368,6991696527,4327057,6586206150,3210311,405490377,80,992875,601830236,984372,600809042,8503,1021194,940182,619,4331776,438269,80,5486,115556.0,28889.0,-70.0,-65.0,-71.0,-70.0,-70.0,-64.0,-72.0,-70.0,-84.0,-90.0,-83.0,-89.0,14.0,25.0,12.0,19.0,1
808,F8:59:71:5A:E0:3D,3282093,505459814,71780,99969235,3210313,405490579,0,69452,58696452,64680,58126264,4772,570188,47520,16,74492,1907,0,504,144444.0,43333.0,-68.0,-74.0,-66.0,-70.0,-67.0,-74.0,-65.0,-70.0,-84.0,-90.0,-83.0,-89.0,16.0,16.0,17.0,19.0,1
809,CC:2F:71:3E:C5:1F,3221665,406879241,11350,1388460,3210315,405490781,6,48492,4060364,40081,3063798,8411,996566,11966,34,16314,186,6,821,144444.0,39000.0,-68.0,-70.0,-66.0,-61.0,-68.0,-69.0,-66.0,-60.0,-84.0,-90.0,-83.0,-89.0,16.0,20.0,17.0,28.0,1
810,CC:2F:71:3F:1F:24,7538428,6993320195,4328113,6587829414,3210315,405490781,80,993172,602064632,984669,601043438,8503,1021194,940452,619,4332832,438394,80,5487,115556.0,28889.0,-70.0,-65.0,-73.0,-70.0,-70.0,-65.0,-73.0,-70.0,-84.0,-90.0,-83.0,-89.0,14.0,25.0,10.0,19.0,1
811,F8:59:71:5A:E0:3D,3282163,505561288,71845,100070245,3210318,405491043,0,69516,58795012,64744,58224824,4772,570188,47584,16,74557,1907,0,504,144444.0,43333.0,-67.0,-75.0,-66.0,-70.0,-67.0,-74.0,-65.0,-70.0,-83.0,-90.0,-83.0,-89.0,16.0,15.0,17.0,19.0,1
812,CC:2F:71:3E:C5:1F,3221670,406879705,11350,1388460,3210320,405491245,6,48492,4060364,40081,3063798,8411,996566,11966,34,16314,186,6,821,144444.0,39000.0,-68.0,-70.0,-66.0,-61.0,-68.0,-69.0,-66.0,-60.0,-83.0,-90.0,-83.0,-89.0,15.0,20.0,17.0,28.0,1
813,CC:2F:71:3F:1F:24,7539280,6994613673,4328960,6589122428,3210320,405491245,80,993437,602289352,984934,601268158,8503,1021194,940710,619,4333672,438473,80,5489,115556.0,28889.0,-70.0,-65.0,-74.0,-71.0,-69.0,-64.0,-73.0,-70.0,-83.0,-90.0,-83.0,-89.0,13.0,25.0,9.0,18.0,1
814,F8:59:71:5A:E0:3D,3282231,505661148,71909,100169701,3210322,405491447,0,69581,58895112,64809,58324924,4772,570188,47649,16,74621,1907,0,504,144444.0,43333.0,-68.0,-74.0,-66.0,-70.0,-67.0,-73.0,-65.0,-70.0,-83.0,-90.0,-83.0,-89.0,15.0,16.0,17.0,19.0,1
815,CC:2F:71:3E:C5:1F,3221672,406879907,11350,1388460,3210322,405491447,6,48492,4060364,40081,3063798,8411,996566,11966,34,16314,186,6,821,144444.0,39000.0,-68.0,-70.0,-66.0,-61.0,-68.0,-69.0,-66.0,-60.0,-83.0,-90.0,-83.0,-89.0,15.0,20.0,17.0,28.0,1
816,CC:2F:71:3F:1F:24,7540412,6996340294,4330088,6590848645,3210324,405491649,80,993724,602516766,985221,601495572,8503,1021194,940994,619,4334807,438665,80,5489,130000.0,39000.0,-69.0,-64.0,-72.0,-70.0,-69.0,-64.0,-72.0,-70.0,-83.0,-90.0,-83.0,-89.0,14.0,26.0,11.0,19.0,1
817,F8:59:71:5A:E0:3D,3282303,505767224,71977,100275373,3210326,405491851,0,69651,59003052,64879,58432864,4772,570188,47717,16,74689,1909,0,504,144444.0,43333.0,-67.0,-74.0,-65.0,-70.0,-67.0,-73.0,-65.0,-69.0,-83.0,-90.0,-83.0,-89.0,16.0,16.0,18.0,19.0,1
818,CC:2F:71:3E:C5:1F,3221676,406880311,11350,1388460,3210326,405491851,6,48492,4060364,40081,3063798,8411,996566,11966,34,16314,186,6,821,144444.0,39000.0,-68.0,-70.0,-66.0,-61.0,-68.0,-69.0,-66.0,-60.0,-83.0,-90.0,-83.0,-89.0,15.0,20.0,17.0,28.0,1
819,CC:2F:71:3F:1F:24,7541304,6997701604,4330978,6592209753,3210326,405491851,80,994048,602748110,985545,601726916,8503,1021194,941305,619,4335697,438820,80,5489,115556.0,28889.0,-69.0,-64.0,-73.0,-69.0,-69.0,-64.0,-72.0,-69.0,-83.0,-90.0,-83.0,-89.0,14.0,26.0,10.0,20.0,1
820,F8:59:71:5A:E0:3D,3282373,505870166,72044,100378053,3210329,405492113,0,69720,59107892,64948,58537704,4772,570188,47785,16,74756,1911,0,504,144444.0,43333.0,-67.0,-74.0,-65.0,-70.0,-67.0,-74.0,-65.0,-69.0,-83.0,-90.0,-82.0,-89.0,16.0,16.0,17.0,19.0,1
821,CC:2F:71:3E:C5:1F,3221681,406880775,11350,1388460,3210331,405492315,6,48492,4060364,40081,3063798,8411,996566,11966,34,16314,186,6,821,144444.0,39000.0,-68.0,-70.0,-66.0,-61.0,-68.0,-69.0,-66.0,-60.0,-83.0,-90.0,-82.0,-89.0,15.0,20.0,16.0,28.0,1
822,CC:2F:71:3F:1F:24,7542372,6999333379,4332041,6593841064,3210331,405492315,80,994342,602974577,985839,601953383,8503,1021194,941593,619,4336760,439003,80,5489,115556.0,28889.0,-69.0,-64.0,-72.0,-71.0,-69.0,-64.0,-73.0,-70.0,-83.0,-90.0,-82.0,-89.0,14.0,26.0,10.0,18.0,1
823,F8:59:71:5A:E0:3D,3282445,505972055,72109,100479063,3210336,405492992,0,69784,59206452,65012,58636264,4772,570188,47849,16,74821,1912,0,504,144444.0,43333.0,-67.0,-74.0,-65.0,-69.0,-67.0,-74.0,-65.0,-69.0,-83.0,-90.0,-82.0,-89.0,16.0,16.0,17.0,20.0,1
824,CC:2F:71:3E:C5:1F,3221686,406881452,11350,1388460,3210336,405492992,6,48492,4060364,40081,3063798,8411,996566,11966,34,16314,186,6,821,144444.0,39000.0,-68.0,-70.0,-66.0,-61.0,-68.0,-69.0,-66.0,-60.0,-83.0,-90.0,-82.0,-89.0,15.0,20.0,16.0,28.0,1
825,CC:2F:71:3F:1F:24,7543459,7000999100,4333123,6595506108,3210336,405492992,80,994612,603190831,986109,602169637,8503,1021194,941862,619,4337842,439215,80,5490,115556.0,28889.0,-70.0,-65.0,-73.0,-71.0,-69.0,-64.0,-72.0,-70.0,-83.0,-90.0,-82.0,-89.0,13.0,25.0,9.0,18.0,1
826,F8:59:71:5A:E0:3D,3282512,506073267,72174,100580073,3210338,405493194,0,69849,59306552,65077,58736364,4772,570188,47914,16,74886,1916,0,504,130000.0,39000.0,-67.0,-74.0,-65.0,-70.0,-66.0,-73.0,-65.0,-69.0,-83.0,-90.0,-82.0,-89.0,16.0,16.0,17.0,19.0,1
827,CC:2F:71:3E:C5:1F,3221688,406881654,11350,1388460,3210338,405493194,6,48492,4060364,40081,3063798,8411,996566,11966,34,16314,186,6,821,144444.0,39000.0,-68.0,-70.0,-66.0,-61.0,-68.0,-69.0,-66.0,-60.0,-83.0,-90.0,-82.0,-89.0,15.0,20.0,16.0,28.0,1
828,CC:2F:71:3F:1F:24,7544758,7002992268,4334418,6597498872,3210340,405493396,80,994948,603424110,986445,602402916,8503,1021194,942188,619,4339136,439261,80,5491,115556.0,28889.0,-69.0,-64.0,-72.0,-70.0,-69.0,-64.0,-72.0,-69.0,-83.0,-90.0,-82.0,-89.0,14.0,26.0,10.0,19.0,1
829,F8:59:71:5A:E0:3D,3282585,506176329,72240,100682469,3210345,405493860,0,69914,59406652,65142,58836464,4772,570188,47979,16,74951,1918,0,504,144444.0,43333.0,-67.0,-74.0,-65.0,-70.0,-67.0,-74.0,-65.0,-69.0,-83.0,-90.0,-82.0,-89.0,16.0,16.0,17.0,19.0,1
830,CC:2F:71:3E:C5:1F,3221695,406882320,11350,1388460,3210345,405493860,6,48492,4060364,40081,3063798,8411,996566,11966,34,16314,186,6,821,144444.0,39000.0,-68.0,-70.0,-66.0,-61.0,-68.0,-69.0,-66.0,-60.0,-83.0,-90.0,-82.0,-89.0,15.0,20.0,16.0,28.0,1
831,CC:2F:71:3F:1F:24,7546310,7005390530,4335965,6599896670,3210345,405493860,80,995319,603667872,986816,602646678,8503,1021194,942557,619,4340684,439398,80,5491,115556.0,28889.0,-69.0,-64.0,-73.0,-70.0,-68.0,-64.0,-72.0,-69.0,-83.0,-90.0,-82.0,-89.0,14.0,26.0,9.0,19.0,1
832,F8:59:71:5A:E0:3D,3282657,506285311,72310,100791249,3210347,405494062,0,69987,59519100,65215,58948912,4772,570188,48050,16,75022,1923,0,504,144444.0,43333.0,-67.0,-74.0,-65.0,-70.0,-67.0,-74.0,-65.0,-69.0,-83.0,-90.0,-82.0,-89.0,16.0,16.0,17.0,19.0,1
833,CC:2F:71:3E:C5:1F,3221697,406882522,11350,1388460,3210347,405494062,6,48492,4060364,40081,3063798,8411,996566,11966,34,16314,186,6,821,144444.0,39000.0,-68.0,-70.0,-66.0,-61.0,-68.0,-69.0,-66.0,-60.0,-83.0,-90.0,-82.0,-89.0,15.0,20.0,16.0,28.0,1
834,CC:2F:71:3F:1F:24,7547717,7007559600,4337368,6602065336,3210349,405494264,80,995655,603901164,987152,602879970,8503,1021194,942893,619,4342085,440113,80,5491,115556.0,28889.0,-70.0,-65.0,-74.0,-70.0,-69.0,-64.0,-73.0,-70.0,-83.0,-90.0,-82.0,-89.0,13.0,25.0,8.0,19.0,1
835,F8:59:71:5A:E0:3D,3282729,506386987,72375,100892259,3210354,405494728,0,70053,59620754,65281,59050566,4772,570188,48115,16,75087,1927,0,504,144444.0,43333.0,-67.0,-74.0,-65.0,-70.0,-67.0,-73.0,-65.0,-69.0,-83.0,-89.0,-82.0,-88.0,16.0,15.0,17.0,18.0,1
836,CC:2F:71:3E:C5:1F,3221704,406883188,11350,1388460,3210354,405494728,6,48492,4060364,40081,3063798,8411,996566,11966,34,16314,186,6,821,144444.0,39000.0,-68.0,-70.0,-66.0,-61.0,-68.0,-69.0,-66.0,-60.0,-83.0,-89.0,-82.0,-88.0,15.0,19.0,16.0,27.0,1
837,CC:2F:71:3F:1F:24,7548853,7009301702,4338499,6603806974,3210354,405494728,80,995947,604117404,987444,603096210,8503,1021194,943178,619,4343217,440239,80,5492,115556.0,28889.0,-70.0,-65.0,-74.0,-70.0,-69.0,-64.0,-73.0,-70.0,-83.0,-89.0,-82.0,-88.0,13.0,24.0,8.0,18.0,1
838,F8:59:71:5A:E0:3D,3282796,506488087,72440,100993157,3210356,405494930,0,70118,59720854,65346,59150666,4772,570188,48180,16,75152,1932,0,504,144444.0,43333.0,-67.0,-74.0,-65.0,-70.0,-67.0,-73.0,-65.0,-69.0,-83.0,-89.0,-82.0,-88.0,16.0,15.0,17.0,18.0,1
839,CC:2F:71:3E:C5:1F,3221706,406883390,11350,1388460,3210356,405494930,6,48492,4060364,40081,3063798,8411,996566,11966,34,16314,186,6,821,144444.0,39000.0,-68.0,-70.0,-66.0,-61.0,-68.0,-69.0,-66.0,-60.0,-83.0,-89.0,-82.0,-88.0,15.0,19.0,16.0,27.0,1
840,CC:2F:71:3F:1F:24,7550065,7011169292,4339709,6605674362,3210356,405494930,80,996257,604351280,987754,603330086,8503,1021194,943480,619,4344411,440437,80,5492,115556.0,26000.0,-70.0,-64.0,-72.0,-69.0,-70.0,-64.0,-72.0,-69.0,-83.0,-89.0,-82.0,-88.0,13.0,25.0,10.0,19.0,1
841,F8:59:71:5A:E0:3D,3282874,506594853,72510,101098949,3210364,405495904,0,70190,59830342,65418,59260154,4772,570188,48249,16,75222,1936,0,504,144444.0,43333.0,-67.0,-74.0,-65.0,-70.0,-67.0,-74.0,-65.0,-70.0,-83.0,-89.0,-82.0,-88.0,16.0,15.0,17.0,18.0,1
842,CC:2F:71:3E:C5:1F,3221715,406884480,11351,1388576,3210364,405495904,6,48494,4060504,40083,3063938,8411,996566,11966,34,16315,186,6,821,144444.0,39000.0,-76.0,-85.0,-74.0,-72.0,-69.0,-70.0,-67.0,-62.0,-83.0,-89.0,-82.0,-88.0,7.0,4.0,8.0,16.0,1
843,CC:2F:71:3F:1F:24,7551310,7013068117,4340946,6607572213,3210364,405495904,80,996600,604579411,988097,603558217,8503,1021194,943823,619,4345664,441024,80,5492,115556.0,28889.0,-69.0,-64.0,-72.0,-69.0,-69.0,-64.0,-71.0,-69.0,-83.0,-89.0,-82.0,-88.0,14.0,25.0,10.0,19.0,1
844,F8:59:71:5A:E0:3D,3282942,506694633,72574,101198405,3210368,405496228,0,70256,59930560,65483,59360254,4773,570306,48315,16,75286,1938,0,504,144444.0,43333.0,-67.0,-75.0,-65.0,-70.0,-67.0,-74.0,-65.0,-70.0,-84.0,-89.0,-83.0,-88.0,17.0,14.0,18.0,18.0,1
845,CC:2F:71:3E:C5:1F,3221719,406884804,11351,1388576,3210368,405496228,6,48494,4060504,40083,3063938,8411,996566,11966,34,16315,186,6,821,144444.0,39000.0,-76.0,-85.0,-74.0,-72.0,-69.0,-70.0,-67.0,-62.0,-84.0,-89.0,-83.0,-88.0,8.0,4.0,9.0,16.0,1
846,CC:2F:71:3F:1F:24,7552536,7014953653,4342168,6609457425,3210368,405496228,80,996907,604798785,988404,603777591,8503,1021194,944130,619,4346887,441161,80,5493,115556.0,28889.0,-70.0,-64.0,-72.0,-70.0,-69.0,-64.0,-72.0,-69.0,-84.0,-89.0,-83.0,-88.0,14.0,25.0,11.0,18.0,1
847,F8:59:71:5A:E0:3D,3283013,506794757,72638,101297861,3210375,405496896,0,70320,60029120,65547,59458814,4773,570306,48379,16,75350,1939,0,504,144444.0,43333.0,-67.0,-75.0,-66.0,-70.0,-67.0,-74.0,-65.0,-70.0,-84.0,-89.0,-83.0,-88.0,17.0,14.0,17.0,18.0,1
848,CC:2F:71:3E:C5:1F,3221727,406885534,11351,1388576,3210376,405496958,6,48496,4060692,40084,3064008,8412,996684,11967,34,16315,186,6,822,144444.0,39000.0,-68.0,-70.0,-66.0,-61.0,-69.0,-71.0,-67.0,-62.0,-84.0,-89.0,-83.0,-88.0,16.0,19.0,17.0,27.0,1
849,CC:2F:71:3F:1F:24,7553403,7016265021,4343027,6610768063,3210376,405496958,80,997167,605015341,988663,603994029,8504,1021312,944390,619,4347745,441285,80,5493,115556.0,26000.0,-70.0,-64.0,-73.0,-70.0,-69.0,-64.0,-72.0,-69.0,-84.0,-89.0,-83.0,-88.0,14.0,25.0,10.0,18.0,1
850,F8:59:71:5A:E0:3D,3283092,506913125,72714,101415965,3210378,405497160,0,70396,60146174,65623,59575868,4773,570306,48454,16,75426,1941,0,504,144444.0,43333.0,-67.0,-75.0,-66.0,-70.0,-67.0,-74.0,-66.0,-70.0,-84.0,-89.0,-83.0,-88.0,17.0,14.0,17.0,18.0,1
851,CC:2F:71:3E:C5:1F,3221729,406885736,11351,1388576,3210378,405497160,6,48496,4060692,40084,3064008,8412,996684,11967,34,16315,186,6,822,144444.0,39000.0,-68.0,-70.0,-66.0,-61.0,-69.0,-71.0,-67.0,-62.0,-84.0,-90.0,-83.0,-89.0,16.0,20.0,17.0,28.0,1
852,CC:2F:71:3F:1F:24,7554482,7017909497,4344101,6612412075,3210381,405497422,80,997517,605305898,989013,604284586,8504,1021312,944734,619,4348820,441382,80,5494,115556.0,28889.0,-69.0,-64.0,-72.0,-69.0,-69.0,-64.0,-71.0,-69.0,-84.0,-90.0,-83.0,-89.0,15.0,26.0,11.0,20.0,1
853,F8:59:71:5A:E0:3D,3283174,507030341,72789,101532515,3210385,405497826,0,70473,60264768,65700,59694462,4773,570306,48530,16,75501,1941,0,504,144444.0,43333.0,-67.0,-74.0,-65.0,-70.0,-67.0,-74.0,-65.0,-70.0,-84.0,-90.0,-83.0,-89.0,17.0,16.0,18.0,19.0,1
854,CC:2F:71:3E:C5:1F,3221736,406886402,11351,1388576,3210385,405497826,6,48496,4060692,40084,3064008,8412,996684,11967,34,16315,186,6,822,144444.0,39000.0,-68.0,-70.0,-66.0,-61.0,-69.0,-71.0,-67.0,-62.0,-84.0,-90.0,-83.0,-89.0,16.0,20.0,17.0,28.0,1
855,CC:2F:71:3F:1F:24,7555181,7018961110,4344796,6613463284,3210385,405497826,80,997758,605518576,989254,604497264,8504,1021312,944967,619,4349515,441450,80,5494,115556.0,28889.0,-70.0,-64.0,-72.0,-70.0,-70.0,-64.0,-72.0,-69.0,-84.0,-90.0,-83.0,-89.0,14.0,26.0,11.0,19.0,1
856,F8:59:71:5A:E0:3D,3283240,507129999,72853,101631971,3210387,405498028,0,70539,60366436,65766,59796130,4773,570306,48594,16,75565,1943,0,504,144444.0,43333.0,-68.0,-74.0,-65.0,-70.0,-67.0,-74.0,-65.0,-70.0,-84.0,-90.0,-83.0,-89.0,16.0,16.0,18.0,19.0,1
857,CC:2F:71:3E:C5:1F,3221738,406886604,11351,1388576,3210387,405498028,6,48496,4060692,40084,3064008,8412,996684,11967,34,16315,186,6,822,144444.0,39000.0,-68.0,-70.0,-66.0,-61.0,-69.0,-71.0,-67.0,-62.0,-84.0,-90.0,-83.0,-89.0,16.0,20.0,17.0,28.0,1
858,CC:2F:71:3F:1F:24,7556016,7020233730,4345629,6614735702,3210387,405498028,80,998012,605728798,989508,604707486,8504,1021312,945221,619,4350337,441641,80,5494,115556.0,28889.0,-71.0,-65.0,-74.0,-70.0,-70.0,-65.0,-73.0,-70.0,-84.0,-90.0,-83.0,-89.0,13.0,25.0,9.0,19.0,1
859,F8:59:71:5A:E0:3D,3283349,507265833,72933,101756291,3210416,405509542,0,70618,60488096,65845,59917790,4773,570306,48673,16,75645,1946,0,504,144444.0,43333.0,-67.0,-74.0,-66.0,-70.0,-67.0,-74.0,-65.0,-70.0,-84.0,-89.0,-83.0,-89.0,17.0,15.0,17.0,19.0,1
860,CC:2F:71:3E:C5:1F,3221767,406898118,11351,1388576,3210416,405509542,6,48496,4060692,40084,3064008,8412,996684,11967,34,16315,186,6,822,144444.0,39000.0,-68.0,-70.0,-66.0,-61.0,-69.0,-71.0,-67.0,-62.0,-84.0,-89.0,-83.0,-89.0,16.0,19.0,17.0,28.0,1
861,CC:2F:71:3F:1F:24,7557000,7021707930,4346584,6616198388,3210416,405509542,80,998344,606004020,989840,604982708,8504,1021312,945551,619,4351303,441902,80,5496,104000.0,26000.0,-72.0,-68.0,-76.0,-73.0,-70.0,-65.0,-73.0,-70.0,-84.0,-89.0,-83.0,-89.0,12.0,21.0,7.0,16.0,1
862,F8:59:71:5A:E0:3D,3283420,507373261,73002,101863517,3210418,405509744,0,70687,60594356,65914,60024050,4773,570306,48742,16,75714,1950,0,504,144444.0,43333.0,-67.0,-74.0,-66.0,-70.0,-67.0,-74.0,-66.0,-70.0,-84.0,-89.0,-83.0,-89.0,17.0,15.0,17.0,19.0,1
863,CC:2F:71:3E:C5:1F,3221772,406898795,11351,1388576,3210421,405510219,6,48496,4060692,40084,3064008,8412,996684,11967,34,16315,186,6,822,144444.0,39000.0,-68.0,-70.0,-66.0,-61.0,-69.0,-71.0,-67.0,-62.0,-84.0,-89.0,-83.0,-89.0,16.0,19.0,17.0,28.0,1
864,CC:2F:71:3F:1F:24,7558216,7023566997,4347795,6618056778,3210421,405510219,80,998660,606232125,990156,605210813,8504,1021312,945863,619,4352513,442228,80,5496,115556.0,28889.0,-70.0,-65.0,-72.0,-70.0,-70.0,-65.0,-73.0,-70.0,-84.0,-89.0,-83.0,-89.0,14.0,24.0,11.0,19.0,1
865,F8:59:71:5A:E0:3D,3283497,507482920,73072,101972297,3210425,405510623,0,70758,60703696,65985,60133390,4773,570306,48813,16,75784,1952,0,504,144444.0,43333.0,-67.0,-74.0,-65.0,-70.0,-67.0,-73.0,-65.0,-70.0,-84.0,-89.0,-83.0,-89.0,17.0,15.0,18.0,19.0,1
866,CC:2F:71:3E:C5:1F,3221776,406899199,11351,1388576,3210425,405510623,6,48496,4060692,40084,3064008,8412,996684,11967,34,16315,186,6,822,144444.0,39000.0,-68.0,-70.0,-66.0,-61.0,-69.0,-71.0,-67.0,-62.0,-84.0,-89.0,-83.0,-89.0,16.0,19.0,17.0,28.0,1
867,CC:2F:71:3F:1F:24,7559357,7025317747,4348932,6619807124,3210425,405510623,80,998964,606478313,990460,605457001,8504,1021312,946167,619,4353620,442865,80,5497,117000.0,39000.0,-69.0,-64.0,-72.0,-70.0,-69.0,-64.0,-72.0,-69.0,-84.0,-89.0,-83.0,-89.0,15.0,25.0,11.0,19.0,1
868,F8:59:71:5A:E0:3D,3283571,507590610,73141,102079523,3210430,405511087,0,70828,60811552,66055,60241246,4773,570306,48881,16,75852,1953,0,504,144444.0,43333.0,-67.0,-74.0,-65.0,-70.0,-67.0,-74.0,-65.0,-70.0,-84.0,-89.0,-83.0,-89.0,17.0,15.0,18.0,19.0,1
869,CC:2F:71:3E:C5:1F,3221781,406899663,11351,1388576,3210430,405511087,6,48496,4060692,40084,3064008,8412,996684,11967,34,16315,186,6,822,144444.0,39000.0,-68.0,-70.0,-66.0,-61.0,-69.0,-71.0,-67.0,-62.0,-84.0,-89.0,-83.0,-89.0,16.0,19.0,17.0,28.0,1
870,CC:2F:71:3F:1F:24,7560609,7027242017,4350179,6621730930,3210430,405511087,80,999278,606702515,990774,605681203,8504,1021312,946481,619,4354898,443362,80,5498,115556.0,28889.0,-69.0,-64.0,-71.0,-69.0,-69.0,-64.0,-72.0,-69.0,-84.0,-89.0,-83.0,-89.0,15.0,25.0,12.0,20.0,1
871,F8:59:71:5A:E0:3D,3283642,507695132,73208,102183641,3210434,405511491,0,70896,60916272,66123,60345966,4773,570306,48949,16,75920,1957,0,504,144444.0,43333.0,-67.0,-74.0,-65.0,-69.0,-67.0,-73.0,-64.0,-69.0,-84.0,-89.0,-83.0,-89.0,17.0,15.0,18.0,20.0,1
872,CC:2F:71:3E:C5:1F,3221785,406900067,11351,1388576,3210434,405511491,6,48496,4060692,40084,3064008,8412,996684,11967,34,16315,186,6,822,144444.0,39000.0,-68.0,-70.0,-66.0,-61.0,-69.0,-71.0,-67.0,-62.0,-84.0,-89.0,-83.0,-89.0,16.0,19.0,17.0,28.0,1
873,CC:2F:71:3F:1F:24,7562004,7029395083,4351570,6623883592,3210434,405511491,80,999607,606940071,991103,605918759,8504,1021312,946810,619,4356279,443707,80,5499,115556.0,26000.0,-69.0,-64.0,-73.0,-69.0,-69.0,-64.0,-72.0,-69.0,-84.0,-89.0,-83.0,-89.0,15.0,25.0,10.0,20.0,1
874,F8:59:71:5A:E0:3D,3283710,507797898,73274,102286205,3210436,405511693,0,70961,61016372,66188,60446066,4773,570306,49014,16,75986,1960,0,504,144444.0,43333.0,-67.0,-74.0,-65.0,-70.0,-67.0,-73.0,-64.0,-69.0,-84.0,-89.0,-83.0,-89.0,17.0,15.0,18.0,19.0,1
875,CC:2F:71:3E:C5:1F,3221790,406900531,11351,1388576,3210439,405511955,6,48496,4060692,40084,3064008,8412,996684,11967,34,16315,186,6,822,144444.0,39000.0,-68.0,-70.0,-66.0,-61.0,-69.0,-71.0,-67.0,-62.0,-84.0,-89.0,-83.0,-89.0,16.0,19.0,17.0,28.0,1
876,CC:2F:71:3F:1F:24,7563067,7031014114,4352628,6625502159,3210439,405511955,80,999893,607158833,991389,606137521,8504,1021312,947096,619,4357347,443901,80,5500,115556.0,28889.0,-69.0,-64.0,-72.0,-69.0,-69.0,-64.0,-71.0,-68.0,-84.0,-89.0,-83.0,-89.0,15.0,25.0,11.0,20.0,1
877,F8:59:71:5A:E0:3D,3283780,507899372,73339,102387215,3210441,405512157,0,71026,61116472,66253,60546166,4773,570306,49079,16,76051,1961,0,504,144444.0,43333.0,-67.0,-74.0,-65.0,-70.0,-66.0,-73.0,-65.0,-69.0,-84.0,-89.0,-83.0,-89.0,17.0,15.0,18.0,19.0,1
878,CC:2F:71:3E:C5:1F,3221792,406900733,11351,1388576,3210441,405512157,6,48496,4060692,40084,3064008,8412,996684,11967,34,16315,186,6,822,144444.0,39000.0,-68.0,-70.0,-66.0,-61.0,-69.0,-71.0,-67.0,-62.0,-84.0,-89.0,-83.0,-89.0,16.0,19.0,17.0,28.0,1
879,CC:2F:71:3F:1F:24,7564188,7032733992,4353745,6627221633,3210443,405512359,80,1000176,607376729,991672,606355417,8504,1021312,947379,619,4358464,444136,80,5500,115556.0,28889.0,-69.0,-64.0,-72.0,-69.0,-69.0,-64.0,-71.0,-69.0,-84.0,-89.0,-83.0,-89.0,15.0,25.0,11.0,20.0,1
880,F8:59:71:5A:E0:3D,3283848,507999232,73403,102486671,3210445,405512561,0,71091,61216586,66318,60646280,4773,570306,49143,16,76115,1962,0,504,144444.0,43333.0,-68.0,-74.0,-65.0,-70.0,-67.0,-73.0,-65.0,-69.0,-85.0,-90.0,-84.0,-89.0,17.0,16.0,19.0,19.0,1
881,CC:2F:71:3E:C5:1F,3221796,406901137,11351,1388576,3210445,405512561,6,48496,4060692,40084,3064008,8412,996684,11967,34,16315,186,6,822,144444.0,39000.0,-68.0,-70.0,-66.0,-61.0,-69.0,-71.0,-67.0,-62.0,-85.0,-90.0,-84.0,-89.0,17.0,20.0,18.0,28.0,1
882,CC:2F:71:3F:1F:24,7565339,7034500530,4354892,6628987767,3210447,405512763,80,1000482,607597185,991978,606575873,8504,1021312,947685,619,4359611,444478,80,5500,130000.0,39000.0,-69.0,-63.0,-74.0,-71.0,-69.0,-63.0,-73.0,-71.0,-85.0,-90.0,-84.0,-89.0,16.0,27.0,10.0,18.0,1
883,F8:59:71:5A:E0:3D,3283916,508097486,73466,102584461,3210450,405513025,0,71155,61315146,66382,60744840,4773,570306,49207,16,76178,1965,0,504,144444.0,43333.0,-67.0,-72.0,-65.0,-69.0,-66.0,-72.0,-65.0,-69.0,-85.0,-90.0,-84.0,-89.0,18.0,18.0,19.0,20.0,1
884,CC:2F:71:3E:C5:1F,3221801,406901601,11351,1388576,3210450,405513025,6,48496,4060692,40084,3064008,8412,996684,11967,34,16315,186,6,822,144444.0,39000.0,-68.0,-70.0,-66.0,-61.0,-69.0,-71.0,-67.0,-62.0,-85.0,-90.0,-84.0,-89.0,17.0,20.0,18.0,28.0,1
885,CC:2F:71:3F:1F:24,7566161,7035749622,4355711,6630236597,3210450,405513025,80,1000742,607809513,992238,606788201,8504,1021312,947945,619,4360412,444639,80,5501,115556.0,28889.0,-68.0,-63.0,-73.0,-69.0,-69.0,-63.0,-73.0,-69.0,-85.0,-90.0,-84.0,-89.0,17.0,27.0,11.0,20.0,1
886,F8:59:71:5A:E0:3D,3283984,508197346,73530,102683917,3210454,405513429,0,71218,61412166,66445,60841860,4773,570306,49270,16,76242,1966,0,504,144444.0,43333.0,-67.0,-73.0,-66.0,-70.0,-66.0,-72.0,-65.0,-69.0,-85.0,-90.0,-84.0,-89.0,18.0,17.0,18.0,19.0,1
887,CC:2F:71:3E:C5:1F,3221805,406902005,11351,1388576,3210454,405513429,6,48496,4060692,40084,3064008,8412,996684,11967,34,16315,186,6,822,144444.0,39000.0,-68.0,-70.0,-66.0,-61.0,-69.0,-71.0,-67.0,-62.0,-85.0,-90.0,-84.0,-89.0,17.0,20.0,18.0,28.0,1
888,CC:2F:71:3F:1F:24,7567259,7037433302,4356805,6631919873,3210454,405513429,80,1000996,608019515,992492,606998203,8504,1021312,948199,619,4361523,444691,80,5501,115556.0,28889.0,-69.0,-63.0,-73.0,-69.0,-69.0,-63.0,-73.0,-69.0,-85.0,-90.0,-84.0,-89.0,16.0,27.0,11.0,20.0,1
889,F8:59:71:5A:E0:3D,3284052,508297206,73594,102783373,3210458,405513833,0,71282,61510726,66509,60940420,4773,570306,49334,16,76306,1968,0,504,144444.0,43333.0,-67.0,-72.0,-65.0,-69.0,-66.0,-72.0,-65.0,-69.0,-85.0,-90.0,-84.0,-89.0,18.0,18.0,19.0,20.0,1
890,CC:2F:71:3E:C5:1F,3221809,406902409,11351,1388576,3210458,405513833,6,48496,4060692,40084,3064008,8412,996684,11967,34,16315,186,6,822,144444.0,39000.0,-68.0,-70.0,-66.0,-61.0,-69.0,-71.0,-67.0,-62.0,-85.0,-90.0,-84.0,-89.0,17.0,20.0,18.0,28.0,1
891,CC:2F:71:3F:1F:24,7568526,7039374454,4358068,6633860621,3210458,405513833,80,1001303,608249441,992799,607228129,8504,1021312,948505,619,4362787,444773,80,5504,115556.0,28889.0,-69.0,-64.0,-73.0,-70.0,-69.0,-64.0,-73.0,-69.0,-85.0,-90.0,-84.0,-89.0,16.0,26.0,11.0,19.0,1
892,F8:59:71:5A:E0:3D,3284121,508399864,73660,102885769,3210461,405514095,0,71349,61613920,66576,61043614,4773,570306,49400,16,76372,1968,0,504,144444.0,43333.0,-67.0,-73.0,-66.0,-70.0,-67.0,-73.0,-66.0,-70.0,-85.0,-90.0,-84.0,-89.0,18.0,17.0,18.0,19.0,1
893,CC:2F:71:3E:C5:1F,3221812,406902671,11351,1388576,3210461,405514095,6,48496,4060692,40084,3064008,8412,996684,11967,34,16315,186,6,822,144444.0,39000.0,-68.0,-70.0,-66.0,-61.0,-69.0,-71.0,-67.0,-62.0,-85.0,-90.0,-84.0,-89.0,17.0,20.0,18.0,28.0,1
894,CC:2F:71:3F:1F:24,7569373,7040659610,4358910,6635145313,3210463,405514297,80,1001563,608459011,993059,607437699,8504,1021312,948764,619,4363628,445065,80,5505,115556.0,28889.0,-68.0,-63.0,-75.0,-71.0,-67.0,-63.0,-74.0,-70.0,-85.0,-90.0,-84.0,-89.0,17.0,27.0,9.0,18.0,1
895,F8:59:71:5A:E0:3D,3284189,508499724,73724,102985225,3210465,405514499,0,71413,61712536,66640,61142230,4773,570306,49464,16,76436,1969,0,504,144444.0,43333.0,-67.0,-74.0,-66.0,-70.0,-67.0,-73.0,-66.0,-70.0,-85.0,-90.0,-84.0,-89.0,18.0,16.0,18.0,19.0,1
896,CC:2F:71:3E:C5:1F,3221818,406903277,11351,1388576,3210467,405514701,6,48496,4060692,40084,3064008,8412,996684,11967,34,16315,186,6,822,144444.0,39000.0,-68.0,-70.0,-66.0,-61.0,-69.0,-71.0,-67.0,-62.0,-85.0,-90.0,-84.0,-89.0,17.0,20.0,18.0,28.0,1
897,CC:2F:71:3F:1F:24,7570360,7042168108,4359893,6636653407,3210467,405514701,80,1001837,608675643,993333,607654331,8504,1021312,949037,619,4364580,445090,80,5505,115556.0,28889.0,-69.0,-63.0,-73.0,-70.0,-69.0,-63.0,-73.0,-70.0,-85.0,-90.0,-84.0,-89.0,16.0,27.0,11.0,19.0,1
898,F8:59:71:5A:E0:3D,3284256,508598030,73787,103083127,3210469,405514903,0,71477,61811110,66704,61240804,4773,570306,49527,16,76499,1969,0,504,144444.0,43333.0,-67.0,-74.0,-67.0,-70.0,-67.0,-73.0,-66.0,-69.0,-85.0,-90.0,-84.0,-89.0,18.0,16.0,17.0,19.0,1
899,CC:2F:71:3E:C5:1F,3221820,406903479,11351,1388576,3210469,405514903,6,48496,4060692,40084,3064008,8412,996684,11967,34,16315,186,6,822,144444.0,39000.0,-68.0,-70.0,-66.0,-61.0,-69.0,-71.0,-67.0,-62.0,-85.0,-90.0,-84.0,-89.0,17.0,20.0,18.0,28.0,1
900,CC:2F:71:3F:1F:24,7571892,7044539498,4361423,6639024595,3210469,405514903,80,1002189,608901451,993685,607880139,8504,1021312,949388,619,4366142,445122,80,5505,115556.0,28889.0,-69.0,-64.0,-75.0,-72.0,-69.0,-64.0,-74.0,-71.0,-85.0,-90.0,-84.0,-89.0,16.0,26.0,9.0,17.0,1
901,F8:59:71:5A:E0:3D,3284328,508702612,73854,103187245,3210474,405515367,0,71546,61917398,66773,61347092,4773,570306,49594,16,76566,1972,0,504,144444.0,43333.0,-67.0,-73.0,-66.0,-70.0,-67.0,-73.0,-66.0,-70.0,-85.0,-90.0,-84.0,-89.0,18.0,17.0,18.0,19.0,1
902,CC:2F:71:3E:C5:1F,3221825,406903943,11351,1388576,3210474,405515367,6,48496,4060692,40084,3064008,8412,996684,11967,34,16315,186,6,822,144444.0,39000.0,-68.0,-70.0,-66.0,-61.0,-69.0,-71.0,-67.0,-62.0,-85.0,-90.0,-84.0,-89.0,17.0,20.0,18.0,28.0,1
903,CC:2F:71:3F:1F:24,7573256,7046630513,4362780,6641114944,3210476,405515569,80,1002501,609128952,993997,608107640,8504,1021312,949700,619,4367499,445272,80,5505,115556.0,28889.0,-70.0,-64.0,-75.0,-70.0,-69.0,-64.0,-73.0,-69.0,-85.0,-90.0,-84.0,-89.0,15.0,26.0,9.0,19.0,1
904,F8:59:71:5A:E0:3D,3284398,508804299,73919,103288255,3210479,405516044,0,71613,62020606,66840,61450300,4773,570306,49659,16,76631,1972,0,504,144444.0,43333.0,-68.0,-74.0,-67.0,-70.0,-67.0,-73.0,-66.0,-69.0,-85.0,-90.0,-84.0,-89.0,17.0,16.0,17.0,19.0,1
905,CC:2F:71:3E:C5:1F,3221830,406904620,11351,1388576,3210479,405516044,6,48496,4060692,40084,3064008,8412,996684,11967,34,16315,186,6,822,144444.0,39000.0,-68.0,-70.0,-66.0,-61.0,-69.0,-71.0,-67.0,-62.0,-85.0,-90.0,-84.0,-89.0,17.0,20.0,18.0,28.0,1
906,CC:2F:71:3F:1F:24,7574373,7048345776,4363894,6642829732,3210479,405516044,80,1002770,609346676,994266,608325364,8504,1021312,949968,619,4368613,445327,80,5505,115556.0,28889.0,-69.0,-63.0,-74.0,-71.0,-69.0,-63.0,-73.0,-70.0,-85.0,-90.0,-84.0,-89.0,16.0,27.0,10.0,18.0,1
907,F8:59:71:5A:E0:3D,3284465,508902605,73982,103386157,3210483,405516448,0,71677,62119180,66904,61548874,4773,570306,49722,16,76694,1973,0,504,144444.0,43333.0,-67.0,-74.0,-66.0,-70.0,-66.0,-73.0,-65.0,-70.0,-85.0,-90.0,-84.0,-89.0,18.0,16.0,18.0,19.0,1
908,CC:2F:71:3E:C5:1F,3221834,406905024,11351,1388576,3210483,405516448,6,48496,4060692,40084,3064008,8412,996684,11967,34,16315,186,6,822,144444.0,39000.0,-68.0,-70.0,-66.0,-61.0,-69.0,-71.0,-67.0,-62.0,-85.0,-90.0,-84.0,-89.0,17.0,20.0,18.0,28.0,1
909,CC:2F:71:3F:1F:24,7575389,7049901236,4364906,6644384788,3210483,405516448,80,1003062,609562746,994558,608541434,8504,1021312,950258,619,4369625,445407,80,5506,115556.0,28889.0,-67.0,-63.0,-72.0,-70.0,-67.0,-63.0,-72.0,-70.0,-85.0,-90.0,-84.0,-89.0,18.0,27.0,12.0,19.0,1
910,F8:59:71:5A:E0:3D,3284533,509000971,74045,103484059,3210488,405516912,0,71745,62223970,66972,61653664,4773,570306,49785,16,76757,1975,0,504,144444.0,43333.0,-68.0,-74.0,-66.0,-71.0,-67.0,-73.0,-66.0,-70.0,-85.0,-90.0,-84.0,-89.0,17.0,16.0,18.0,18.0,1
911,CC:2F:71:3E:C5:1F,3221839,406905488,11351,1388576,3210488,405516912,6,48496,4060692,40084,3064008,8412,996684,11967,34,16315,186,6,822,144444.0,39000.0,-68.0,-70.0,-66.0,-61.0,-69.0,-71.0,-67.0,-62.0,-85.0,-90.0,-84.0,-89.0,17.0,20.0,18.0,28.0,1
912,CC:2F:71:3F:1F:24,7576284,7051263112,4365796,6645746200,3210488,405516912,80,1003303,609769890,994799,608748578,8504,1021312,950499,619,4370515,445456,80,5506,115556.0,28889.0,-69.0,-64.0,-73.0,-70.0,-68.0,-63.0,-73.0,-69.0,-85.0,-90.0,-84.0,-89.0,16.0,26.0,11.0,19.0,1
913,F8:59:71:5A:E0:3D,3284600,509099277,74108,103581961,3210492,405517316,0,71812,62327206,67039,61756900,4773,570306,49848,16,76820,1976,0,504,144444.0,43333.0,-68.0,-74.0,-67.0,-71.0,-68.0,-73.0,-66.0,-70.0,-85.0,-90.0,-84.0,-89.0,17.0,16.0,17.0,18.0,1
914,CC:2F:71:3E:C5:1F,3221843,406905892,11351,1388576,3210492,405517316,6,48496,4060692,40084,3064008,8412,996684,11967,34,16315,186,6,822,144444.0,39000.0,-68.0,-70.0,-66.0,-61.0,-69.0,-71.0,-67.0,-62.0,-85.0,-90.0,-84.0,-89.0,17.0,20.0,18.0,28.0,1
915,CC:2F:71:3F:1F:24,7577270,7052760275,4366778,6647242959,3210492,405517316,80,1003603,609995882,995099,608974570,8504,1021312,950797,619,4371496,445488,80,5506,130000.0,43333.0,-72.0,-68.0,-78.0,-74.0,-68.0,-65.0,-74.0,-71.0,-85.0,-90.0,-84.0,-89.0,13.0,22.0,6.0,15.0,1
916,F8:59:71:5A:E0:3D,3284670,509202245,74174,103684525,3210496,405517720,0,71880,62431940,67107,61861634,4773,570306,49915,16,76886,1976,0,504,144444.0,43333.0,-67.0,-73.0,-66.0,-70.0,-67.0,-73.0,-65.0,-70.0,-85.0,-90.0,-84.0,-89.0,18.0,17.0,18.0,19.0,1
917,CC:2F:71:3E:C5:1F,3221847,406906296,11351,1388576,3210496,405517720,6,48496,4060692,40084,3064008,8412,996684,11967,34,16315,186,6,822,144444.0,39000.0,-68.0,-70.0,-66.0,-61.0,-69.0,-71.0,-67.0,-62.0,-85.0,-90.0,-84.0,-89.0,17.0,20.0,18.0,28.0,1
918,CC:2F:71:3F:1F:24,7578055,7053946715,4367558,6648428935,3210497,405517780,80,1003865,610214056,995361,609192744,8504,1021312,951059,619,4372257,445723,80,5506,115556.0,28889.0,-69.0,-63.0,-74.0,-70.0,-69.0,-63.0,-74.0,-70.0,-85.0,-90.0,-84.0,-89.0,16.0,27.0,10.0,19.0,1
919,F8:59:71:5A:E0:3D,3284739,509302165,74238,103783981,3210501,405518184,0,71944,62530500,67171,61960194,4773,570306,49979,16,76950,1977,0,504,144444.0,43333.0,-68.0,-73.0,-65.0,-70.0,-67.0,-73.0,-65.0,-70.0,-85.0,-90.0,-84.0,-89.0,17.0,17.0,19.0,19.0,1
920,CC:2F:71:3E:C5:1F,3221852,406906760,11351,1388576,3210501,405518184,6,48496,4060692,40084,3064008,8412,996684,11967,34,16315,186,6,822,144444.0,39000.0,-68.0,-70.0,-66.0,-61.0,-69.0,-71.0,-67.0,-62.0,-85.0,-90.0,-84.0,-89.0,17.0,20.0,18.0,28.0,1
921,CC:2F:71:3F:1F:24,7579325,7055901811,4368824,6650383627,3210501,405518184,80,1004193,610432872,995689,609411560,8504,1021312,951387,619,4373514,445780,80,5506,115556.0,28889.0,-69.0,-63.0,-74.0,-70.0,-69.0,-63.0,-73.0,-70.0,-85.0,-90.0,-84.0,-89.0,16.0,27.0,10.0,19.0,1
922,F8:59:71:5A:E0:3D,3284807,509403493,74304,103885107,3210503,405518386,0,72008,62629060,67235,62058754,4773,570306,50043,16,77016,1978,0,504,144444.0,43333.0,-67.0,-73.0,-66.0,-70.0,-67.0,-73.0,-65.0,-69.0,-85.0,-90.0,-84.0,-89.0,18.0,17.0,18.0,19.0,1
923,CC:2F:71:3E:C5:1F,3221855,406907078,11352,1388692,3210503,405518386,6,48498,4060832,40086,3064148,8412,996684,11967,34,16316,186,6,822,144444.0,39000.0,-69.0,-71.0,-68.0,-61.0,-69.0,-72.0,-67.0,-62.0,-85.0,-90.0,-84.0,-89.0,16.0,19.0,16.0,28.0,1
924,CC:2F:71:3F:1F:24,7580773,7058135697,4370268,6652617109,3210505,405518588,80,1004544,610657186,996040,609635874,8504,1021312,951738,619,4374986,446139,80,5507,115556.0,28889.0,-69.0,-64.0,-74.0,-71.0,-69.0,-64.0,-74.0,-70.0,-85.0,-90.0,-84.0,-89.0,16.0,26.0,10.0,18.0,1
925,F8:59:71:5A:E0:3D,3284877,509500569,74366,103981455,3210511,405519114,0,72071,62726164,67298,62155858,4773,570306,50106,16,77078,1978,0,504,144444.0,43333.0,-68.0,-73.0,-66.0,-70.0,-67.0,-73.0,-65.0,-69.0,-85.0,-90.0,-84.0,-89.0,17.0,17.0,18.0,19.0,1
926,CC:2F:71:3E:C5:1F,3221863,406907806,11352,1388692,3210511,405519114,6,48500,4061020,40087,3064218,8413,996802,11968,34,16316,186,6,822,144444.0,39000.0,-69.0,-71.0,-68.0,-61.0,-69.0,-72.0,-68.0,-62.0,-85.0,-90.0,-84.0,-89.0,16.0,19.0,16.0,28.0,1
927,CC:2F:71:3F:1F:24,7581625,7059425739,4371114,6653906625,3210511,405519114,80,1004829,610872282,996325,609850970,8504,1021312,952023,619,4375829,446262,80,5507,86667.0,14444.0,-68.0,-64.0,-73.0,-70.0,-68.0,-64.0,-73.0,-70.0,-85.0,-90.0,-84.0,-89.0,17.0,26.0,11.0,19.0,1
928,F8:59:71:5A:E0:3D,3284944,509600289,74430,104080911,3210514,405519378,0,72134,62823184,67361,62252878,4773,570306,50169,16,77142,1982,0,504,144444.0,43333.0,-68.0,-73.0,-66.0,-70.0,-67.0,-73.0,-65.0,-70.0,-85.0,-90.0,-84.0,-89.0,17.0,17.0,18.0,19.0,1
929,CC:2F:71:3E:C5:1F,3221866,406908070,11352,1388692,3210514,405519378,6,48500,4061020,40087,3064218,8413,996802,11968,34,16316,186,6,822,144444.0,39000.0,-69.0,-71.0,-68.0,-61.0,-69.0,-72.0,-68.0,-62.0,-85.0,-90.0,-84.0,-89.0,16.0,19.0,16.0,28.0,1
930,CC:2F:71:3F:1F:24,7582658,7061004025,4372144,6655484647,3210514,405519378,80,1005138,611094865,996633,610073435,8505,1021430,952331,619,4376846,446299,80,5507,104000.0,26000.0,-69.0,-64.0,-74.0,-71.0,-68.0,-63.0,-73.0,-70.0,-85.0,-90.0,-84.0,-89.0,16.0,26.0,10.0,18.0,1
931,F8:59:71:5A:E0:3D,3285011,509701501,74495,104181921,3210516,405519580,0,72199,62923284,67426,62352978,4773,570306,50234,16,77207,1983,0,504,144444.0,43333.0,-67.0,-73.0,-66.0,-70.0,-67.0,-73.0,-65.0,-70.0,-85.0,-90.0,-84.0,-89.0,18.0,17.0,18.0,19.0,1
932,CC:2F:71:3E:C5:1F,3221868,406908272,11352,1388692,3210516,405519580,6,48500,4061020,40087,3064218,8413,996802,11968,34,16316,186,6,822,144444.0,39000.0,-69.0,-71.0,-68.0,-61.0,-69.0,-72.0,-68.0,-62.0,-85.0,-90.0,-84.0,-89.0,16.0,19.0,16.0,28.0,1
933,CC:2F:71:3F:1F:24,7584020,7063099135,4373500,6657579151,3210520,405519984,80,1005464,611313563,996959,610292133,8505,1021430,952657,619,4378203,446624,80,5508,115556.0,28889.0,-69.0,-64.0,-73.0,-68.0,-69.0,-64.0,-73.0,-68.0,-85.0,-90.0,-84.0,-89.0,16.0,26.0,11.0,21.0,1
934,F8:59:71:5A:E0:3D,3285080,509801421,74559,104281377,3210521,405520044,0,72264,63023384,67491,62453078,4773,570306,50299,16,77271,1987,0,504,144444.0,43333.0,-67.0,-74.0,-65.0,-70.0,-68.0,-74.0,-66.0,-70.0,-85.0,-90.0,-84.0,-89.0,18.0,16.0,19.0,19.0,1
935,CC:2F:71:3E:C5:1F,3221875,406908938,11352,1388692,3210523,405520246,6,48500,4061020,40087,3064218,8413,996802,11968,34,16316,186,6,822,144444.0,39000.0,-69.0,-71.0,-68.0,-61.0,-69.0,-72.0,-68.0,-62.0,-85.0,-90.0,-84.0,-89.0,16.0,19.0,16.0,28.0,1
936,CC:2F:71:3F:1F:24,7585194,7064905531,4374671,6659385285,3210523,405520246,80,1005755,611536871,997250,610515441,8505,1021430,952946,619,4379389,446670,80,5509,115556.0,28889.0,-69.0,-63.0,-73.0,-70.0,-69.0,-63.0,-73.0,-69.0,-85.0,-90.0,-84.0,-89.0,16.0,27.0,11.0,19.0,1
937,F8:59:71:5A:E0:3D,3285151,509904451,74625,104383941,3210526,405520510,0,72330,63123602,67556,62553178,4774,570424,50365,16,77337,1987,0,504,144444.0,43333.0,-68.0,-74.0,-66.0,-70.0,-67.0,-73.0,-65.0,-70.0,-85.0,-90.0,-84.0,-89.0,17.0,16.0,18.0,19.0,1
938,CC:2F:71:3E:C5:1F,3221878,406909202,11352,1388692,3210526,405520510,6,48500,4061020,40087,3064218,8413,996802,11968,34,16316,186,6,822,144444.0,39000.0,-69.0,-71.0,-68.0,-61.0,-69.0,-72.0,-68.0,-62.0,-85.0,-90.0,-84.0,-89.0,16.0,19.0,16.0,28.0,1
939,CC:2F:71:3F:1F:24,7586376,7066724273,4375850,6661203763,3210526,405520510,80,1006046,611757119,997541,610735689,8505,1021430,953237,619,4380554,446743,80,5509,117000.0,39000.0,-69.0,-63.0,-73.0,-70.0,-68.0,-63.0,-73.0,-70.0,-85.0,-90.0,-84.0,-89.0,16.0,27.0,11.0,19.0,1
940,F8:59:71:5A:E0:3D,3285220,510005865,74690,104484951,3210530,405520914,0,72395,63223702,67621,62653278,4774,570424,50430,16,77402,1988,0,504,144444.0,43333.0,-67.0,-74.0,-66.0,-70.0,-67.0,-73.0,-65.0,-69.0,-85.0,-90.0,-84.0,-89.0,18.0,16.0,18.0,19.0,1
941,CC:2F:71:3E:C5:1F,3221882,406909606,11352,1388692,3210530,405520914,6,48500,4061020,40087,3064218,8413,996802,11968,34,16316,186,6,822,144444.0,39000.0,-69.0,-71.0,-68.0,-61.0,-69.0,-72.0,-68.0,-62.0,-85.0,-90.0,-84.0,-89.0,16.0,19.0,16.0,28.0,1
942,CC:2F:71:3F:1F:24,7587455,7068365114,4376923,6662843998,3210532,405521116,80,1006335,611987635,997830,610966205,8505,1021430,953526,619,4381641,446938,80,5510,130000.0,39000.0,-69.0,-63.0,-73.0,-70.0,-68.0,-63.0,-72.0,-69.0,-85.0,-90.0,-84.0,-89.0,16.0,27.0,11.0,19.0,1
943,F8:59:71:5A:E0:3D,3285291,510108893,74756,104587515,3210535,405521378,0,72462,63326882,67688,62756458,4774,570424,50497,16,77468,1989,0,504,144444.0,43333.0,-67.0,-73.0,-66.0,-70.0,-67.0,-73.0,-65.0,-70.0,-85.0,-90.0,-84.0,-89.0,18.0,17.0,18.0,19.0,1
944,CC:2F:71:3E:C5:1F,3221887,406910070,11352,1388692,3210535,405521378,6,48500,4061020,40087,3064218,8413,996802,11968,34,16316,186,6,822,144444.0,39000.0,-69.0,-71.0,-68.0,-61.0,-69.0,-72.0,-68.0,-62.0,-85.0,-90.0,-84.0,-89.0,16.0,19.0,16.0,28.0,1
945,CC:2F:71:3F:1F:24,7588352,7069733972,4377817,6664212594,3210535,405521378,80,1006592,612198099,998087,611176669,8505,1021430,953783,619,4382534,447037,80,5510,115556.0,28889.0,-69.0,-63.0,-74.0,-71.0,-69.0,-63.0,-73.0,-71.0,-85.0,-90.0,-84.0,-89.0,16.0,27.0,10.0,18.0,1
946,F8:59:71:5A:E0:3D,3285359,510207472,74819,104685417,3210540,405522055,0,72524,63422362,67750,62851938,4774,570424,50559,16,77531,1990,0,504,144444.0,43333.0,-67.0,-74.0,-66.0,-70.0,-67.0,-74.0,-65.0,-69.0,-85.0,-90.0,-84.0,-89.0,18.0,16.0,18.0,19.0,1
947,CC:2F:71:3E:C5:1F,3221892,406910747,11352,1388692,3210540,405522055,6,48500,4061020,40087,3064218,8413,996802,11968,34,16316,186,6,822,144444.0,39000.0,-69.0,-71.0,-68.0,-61.0,-69.0,-72.0,-68.0,-62.0,-85.0,-90.0,-84.0,-89.0,16.0,19.0,16.0,28.0,1
948,CC:2F:71:3F:1F:24,7589139,7070926549,4378599,6665404494,3210540,405522055,80,1006891,612423499,998386,611402069,8505,1021430,954079,619,4383318,447056,80,5511,115556.0,28889.0,-71.0,-63.0,-71.0,-69.0,-70.0,-63.0,-70.0,-69.0,-85.0,-90.0,-84.0,-89.0,14.0,27.0,13.0,20.0,1
949,F8:59:71:5A:E0:3D,3285428,510308886,74884,104786427,3210544,405522459,0,72590,63524002,67816,62953578,4774,570424,50625,16,77596,1992,0,504,144444.0,43333.0,-68.0,-73.0,-65.0,-70.0,-67.0,-73.0,-65.0,-70.0,-85.0,-90.0,-85.0,-90.0,17.0,17.0,20.0,20.0,1
950,CC:2F:71:3E:C5:1F,3221896,406911151,11352,1388692,3210544,405522459,6,48500,4061020,40087,3064218,8413,996802,11968,34,16316,186,6,822,144444.0,39000.0,-69.0,-71.0,-68.0,-61.0,-69.0,-72.0,-68.0,-62.0,-85.0,-90.0,-85.0,-90.0,16.0,19.0,17.0,29.0,1
951,CC:2F:71:3F:1F:24,7589896,7072071355,4379352,6666548896,3210544,405522459,80,1007164,612640115,998659,611618685,8505,1021430,954350,619,4384071,447114,80,5511,86667.0,14444.0,-70.0,-63.0,-71.0,-69.0,-70.0,-63.0,-72.0,-69.0,-85.0,-90.0,-85.0,-90.0,15.0,27.0,14.0,21.0,1
952,F8:59:71:5A:E0:3D,3285498,510410360,74949,104887437,3210549,405522923,0,72654,63622562,67880,63052138,4774,570424,50689,16,77661,1995,0,504,144444.0,43333.0,-67.0,-73.0,-65.0,-71.0,-67.0,-73.0,-65.0,-71.0,-85.0,-90.0,-85.0,-90.0,18.0,17.0,20.0,19.0,1
953,CC:2F:71:3E:C5:1F,3221901,406911615,11352,1388692,3210549,405522923,6,48500,4061020,40087,3064218,8413,996802,11968,34,16316,186,6,822,144444.0,39000.0,-69.0,-71.0,-68.0,-61.0,-69.0,-72.0,-68.0,-62.0,-85.0,-90.0,-85.0,-90.0,16.0,19.0,17.0,29.0,1
954,CC:2F:71:3F:1F:24,7590897,7073593373,4380348,6668070450,3210549,405522923,80,1007451,612854472,998946,611833042,8505,1021430,954637,619,4385067,447190,80,5511,117000.0,39000.0,-70.0,-63.0,-73.0,-70.0,-70.0,-63.0,-72.0,-70.0,-85.0,-90.0,-85.0,-90.0,15.0,27.0,12.0,20.0,1
955,F8:59:71:5A:E0:3D,3285565,510508666,75012,104985339,3210553,405523327,0,72717,63719582,67943,63149158,4774,570424,50752,16,77724,1997,0,504,144444.0,43333.0,-68.0,-73.0,-65.0,-70.0,-68.0,-73.0,-65.0,-69.0,-85.0,-90.0,-85.0,-90.0,17.0,17.0,20.0,20.0,1
956,CC:2F:71:3E:C5:1F,3221905,406912019,11352,1388692,3210553,405523327,6,48500,4061020,40087,3064218,8413,996802,11968,34,16316,186,6,822,144444.0,39000.0,-69.0,-71.0,-68.0,-61.0,-69.0,-72.0,-68.0,-62.0,-85.0,-90.0,-85.0,-90.0,16.0,19.0,17.0,29.0,1
957,CC:2F:71:3F:1F:24,7592078,7075407349,4381525,6669884022,3210553,405523327,80,1007723,613068116,999218,612046686,8505,1021430,954909,619,4386244,447479,80,5512,115556.0,28889.0,-71.0,-65.0,-73.0,-68.0,-70.0,-65.0,-72.0,-68.0,-85.0,-90.0,-85.0,-90.0,14.0,25.0,12.0,22.0,1
958,F8:59:71:5A:E0:3D,3285632,510606972,75075,105083241,3210557,405523731,0,72780,63816602,68006,63246178,4774,570424,50815,16,77787,1998,0,504,144444.0,43333.0,-68.0,-73.0,-65.0,-70.0,-68.0,-73.0,-65.0,-69.0,-85.0,-90.0,-85.0,-90.0,17.0,17.0,20.0,20.0,1
959,CC:2F:71:3E:C5:1F,3221909,406912423,11352,1388692,3210557,405523731,6,48500,4061020,40087,3064218,8413,996802,11968,34,16316,186,6,822,144444.0,39000.0,-69.0,-71.0,-68.0,-61.0,-69.0,-72.0,-68.0,-62.0,-85.0,-90.0,-85.0,-90.0,16.0,19.0,17.0,29.0,1
960,CC:2F:71:3F:1F:24,7592984,7076789381,4382427,6671265650,3210557,405523731,80,1008013,613279624,999508,612258194,8505,1021430,955199,619,4387146,447510,80,5512,115556.0,28889.0,-71.0,-66.0,-73.0,-68.0,-71.0,-65.0,-73.0,-68.0,-85.0,-90.0,-85.0,-90.0,14.0,24.0,12.0,22.0,1
961,F8:59:71:5A:E0:3D,3285698,510704968,75138,105180975,3210560,405523993,0,72843,63913692,68069,63343268,4774,570424,50878,16,77850,2002,0,505,144444.0,43333.0,-67.0,-73.0,-66.0,-71.0,-67.0,-72.0,-65.0,-71.0,-85.0,-90.0,-85.0,-90.0,18.0,17.0,19.0,19.0,1
962,CC:2F:71:3E:C5:1F,3221912,406912685,11352,1388692,3210560,405523993,6,48500,4061020,40087,3064218,8413,996802,11968,34,16316,186,6,822,144444.0,39000.0,-69.0,-71.0,-68.0,-61.0,-69.0,-72.0,-68.0,-62.0,-85.0,-90.0,-85.0,-90.0,16.0,19.0,17.0,29.0,1
963,CC:2F:71:3F:1F:24,7593663,7077809865,4383101,6672285670,3210562,405524195,80,1008257,613491674,999752,612470244,8505,1021430,955443,619,4387820,447661,80,5514,115556.0,28889.0,-70.0,-64.0,-72.0,-70.0,-70.0,-64.0,-72.0,-70.0,-85.0,-90.0,-85.0,-90.0,15.0,26.0,13.0,20.0,1
964,F8:59:71:5A:E0:3D,3285769,510803844,75201,105278877,3210568,405524967,0,72905,64009172,68131,63438748,4774,570424,50940,16,77912,2004,0,505,144444.0,43333.0,-67.0,-74.0,-65.0,-71.0,-67.0,-73.0,-64.0,-71.0,-85.0,-90.0,-85.0,-90.0,18.0,16.0,20.0,19.0,1
965,CC:2F:71:3E:C5:1F,3221921,406913719,11352,1388692,3210569,405525027,6,48500,4061020,40087,3064218,8413,996802,11968,34,16316,186,6,822,144444.0,39000.0,-69.0,-71.0,-68.0,-61.0,-69.0,-72.0,-68.0,-62.0,-85.0,-90.0,-85.0,-90.0,16.0,19.0,17.0,29.0,1
966,CC:2F:71:3F:1F:24,7594572,7079178728,4384003,6673653701,3210569,405525027,80,1008556,613721855,1000051,612700425,8505,1021430,955742,619,4388711,447897,80,5515,86667.0,13000.0,-69.0,-64.0,-74.0,-68.0,-69.0,-64.0,-73.0,-67.0,-85.0,-90.0,-85.0,-90.0,16.0,26.0,11.0,22.0,1
967,F8:59:71:5A:E0:3D,3285841,510909838,75269,105384549,3210572,405525289,0,72974,64115432,68200,63545008,4774,570424,51009,16,77981,2007,0,505,144444.0,43333.0,-67.0,-74.0,-65.0,-70.0,-66.0,-74.0,-65.0,-70.0,-85.0,-90.0,-85.0,-90.0,18.0,16.0,20.0,20.0,1
968,CC:2F:71:3E:C5:1F,3221924,406913981,11352,1388692,3210572,405525289,6,48500,4061020,40087,3064218,8413,996802,11968,34,16316,186,6,822,144444.0,39000.0,-69.0,-71.0,-68.0,-61.0,-69.0,-72.0,-68.0,-62.0,-85.0,-90.0,-85.0,-90.0,16.0,19.0,17.0,29.0,1
969,CC:2F:71:3F:1F:24,7596033,7081433908,4385460,6675908559,3210573,405525349,80,1008937,613955223,1000432,612933793,8505,1021430,956123,619,4390179,447917,80,5515,104000.0,26000.0,-70.0,-64.0,-72.0,-68.0,-70.0,-64.0,-71.0,-68.0,-85.0,-90.0,-85.0,-90.0,15.0,26.0,13.0,22.0,1
970,F8:59:71:5A:E0:3D,3285912,511012866,75335,105487113,3210577,405525753,0,73040,64217072,68266,63646648,4774,570424,51075,16,78047,2007,0,505,144444.0,43333.0,-67.0,-72.0,-66.0,-70.0,-66.0,-72.0,-65.0,-70.0,-85.0,-90.0,-85.0,-90.0,18.0,18.0,19.0,20.0,1
971,CC:2F:71:3E:C5:1F,3221931,406914647,11352,1388692,3210579,405525955,6,48500,4061020,40087,3064218,8413,996802,11968,34,16316,186,6,822,144444.0,39000.0,-69.0,-71.0,-68.0,-61.0,-69.0,-72.0,-68.0,-62.0,-85.0,-90.0,-85.0,-90.0,16.0,19.0,17.0,29.0,1
972,CC:2F:71:3F:1F:24,7597376,7083497404,4386797,6677971449,3210579,405525955,80,1009261,614188024,1000756,613166594,8505,1021430,956447,619,4391516,447998,80,5515,130000.0,43333.0,-70.0,-64.0,-70.0,-67.0,-69.0,-64.0,-70.0,-67.0,-85.0,-90.0,-85.0,-90.0,15.0,26.0,15.0,23.0,1
973,F8:59:71:5A:E0:3D,3285986,511119118,75404,105592901,3210582,405526217,0,73109,64321898,68335,63751474,4774,570424,51144,16,78116,2007,0,505,144444.0,43333.0,-67.0,-73.0,-66.0,-70.0,-67.0,-72.0,-66.0,-70.0,-85.0,-90.0,-85.0,-90.0,18.0,17.0,19.0,20.0,1
974,CC:2F:71:3E:C5:1F,3221934,406914909,11352,1388692,3210582,405526217,6,48500,4061020,40087,3064218,8413,996802,11968,34,16316,186,6,822,144444.0,39000.0,-69.0,-71.0,-68.0,-61.0,-69.0,-72.0,-68.0,-62.0,-85.0,-90.0,-85.0,-90.0,16.0,19.0,17.0,29.0,1
975,CC:2F:71:3F:1F:24,7598325,7084941400,4387743,6679415183,3210582,405526217,80,1009549,614413690,1001044,613392260,8505,1021430,956735,619,4392462,448072,80,5515,130000.0,43333.0,-71.0,-63.0,-71.0,-68.0,-71.0,-63.0,-71.0,-68.0,-85.0,-90.0,-85.0,-90.0,14.0,27.0,14.0,22.0,1
976,F8:59:71:5A:E0:3D,3286057,511222146,75470,105695465,3210587,405526681,0,73175,64423580,68401,63853156,4774,570424,51210,16,78182,2009,0,505,144444.0,43333.0,-67.0,-73.0,-67.0,-70.0,-67.0,-72.0,-66.0,-70.0,-85.0,-90.0,-85.0,-90.0,18.0,17.0,18.0,20.0,1
977,CC:2F:71:3E:C5:1F,3221939,406915373,11352,1388692,3210587,405526681,6,48500,4061020,40087,3064218,8413,996802,11968,34,16316,186,6,822,144444.0,39000.0,-69.0,-71.0,-68.0,-61.0,-69.0,-72.0,-68.0,-62.0,-85.0,-90.0,-85.0,-90.0,16.0,19.0,17.0,29.0,1
978,CC:2F:71:3F:1F:24,7599481,7086658562,4388894,6681131881,3210587,405526681,80,1009860,614636619,1001355,613615189,8505,1021430,957045,619,4393613,448209,80,5515,130000.0,43333.0,-73.0,-64.0,-73.0,-68.0,-71.0,-64.0,-72.0,-68.0,-85.0,-90.0,-85.0,-90.0,12.0,26.0,12.0,22.0,1
979,F8:59:71:5A:E0:3D,3286127,511323574,75535,105796363,3210592,405527211,0,73240,64523680,68466,63953256,4774,570424,51275,16,78247,2012,0,505,144444.0,43333.0,-67.0,-73.0,-66.0,-70.0,-67.0,-72.0,-66.0,-70.0,-85.0,-90.0,-85.0,-90.0,18.0,17.0,19.0,20.0,1
980,CC:2F:71:3E:C5:1F,3221944,406915903,11352,1388692,3210592,405527211,6,48500,4061020,40087,3064218,8413,996802,11968,34,16316,186,6,822,144444.0,39000.0,-69.0,-71.0,-68.0,-61.0,-69.0,-72.0,-68.0,-62.0,-85.0,-90.0,-85.0,-90.0,16.0,19.0,17.0,29.0,1
981,CC:2F:71:3F:1F:24,7600682,7088501828,4390090,6682974617,3210592,405527211,80,1010141,614851227,1001636,613829797,8505,1021430,957326,619,4394780,448289,80,5515,130000.0,43333.0,-73.0,-65.0,-71.0,-68.0,-72.0,-64.0,-71.0,-67.0,-85.0,-90.0,-85.0,-90.0,12.0,25.0,14.0,22.0,1
982,F8:59:71:5A:E0:3D,3286195,511423434,75599,105895819,3210596,405527615,0,73304,64622240,68530,64051816,4774,570424,51339,16,78311,2013,0,505,144444.0,43333.0,-67.0,-72.0,-66.0,-70.0,-67.0,-72.0,-66.0,-69.0,-85.0,-90.0,-85.0,-90.0,18.0,18.0,19.0,20.0,1
983,CC:2F:71:3E:C5:1F,3221948,406916307,11352,1388692,3210596,405527615,6,48500,4061020,40087,3064218,8413,996802,11968,34,16316,186,6,822,144444.0,39000.0,-69.0,-71.0,-68.0,-61.0,-69.0,-72.0,-68.0,-62.0,-85.0,-90.0,-85.0,-90.0,16.0,19.0,17.0,29.0,1
984,CC:2F:71:3F:1F:24,7601872,7090314692,4391276,6684787077,3210596,405527615,80,1010445,615066014,1001940,614044584,8505,1021430,957630,619,4395995,448302,80,5515,130000.0,43333.0,-71.0,-64.0,-72.0,-68.0,-70.0,-64.0,-72.0,-68.0,-85.0,-90.0,-85.0,-90.0,14.0,26.0,13.0,22.0,1
985,F8:59:71:5A:E0:3D,3286263,511521800,75662,105993721,3210601,405528079,0,73366,64717720,68592,64147296,4774,570424,51401,16,78374,2013,0,505,144444.0,43333.0,-67.0,-72.0,-66.0,-70.0,-67.0,-72.0,-66.0,-69.0,-86.0,-91.0,-86.0,-90.0,19.0,19.0,20.0,20.0,1
986,CC:2F:71:3E:C5:1F,3221953,406916771,11352,1388692,3210601,405528079,6,48500,4061020,40087,3064218,8413,996802,11968,34,16316,186,6,822,144444.0,39000.0,-69.0,-71.0,-68.0,-61.0,-69.0,-72.0,-68.0,-62.0,-86.0,-91.0,-86.0,-90.0,17.0,20.0,18.0,29.0,1
987,CC:2F:71:3F:1F:24,7602878,7091852854,4392277,6686324775,3210601,405528079,80,1010703,615277982,1002198,614256552,8505,1021430,957888,619,4396968,448329,80,5515,130000.0,43333.0,-71.0,-64.0,-72.0,-68.0,-70.0,-64.0,-72.0,-68.0,-86.0,-91.0,-86.0,-90.0,15.0,27.0,14.0,22.0,1
988,F8:59:71:5A:E0:3D,3286328,511618623,75724,106090069,3210604,405528554,0,73430,64816280,68656,64245856,4774,570424,51465,16,78436,2015,0,505,144444.0,43333.0,-67.0,-72.0,-66.0,-70.0,-67.0,-72.0,-66.0,-69.0,-86.0,-91.0,-86.0,-90.0,19.0,19.0,20.0,20.0,1
989,CC:2F:71:3E:C5:1F,3221957,406917314,11352,1388692,3210605,405528622,6,48500,4061020,40087,3064218,8413,996802,11968,34,16316,186,6,822,144444.0,39000.0,-69.0,-71.0,-68.0,-61.0,-69.0,-72.0,-68.0,-62.0,-86.0,-91.0,-86.0,-90.0,17.0,20.0,18.0,29.0,1
990,CC:2F:71:3F:1F:24,7604193,7093879103,4393587,6688350347,3210606,405528756,80,1010998,615492810,1002493,614471380,8505,1021430,958183,619,4398297,448332,80,5515,130000.0,43333.0,-70.0,-64.0,-72.0,-68.0,-70.0,-64.0,-71.0,-67.0,-86.0,-91.0,-86.0,-90.0,16.0,27.0,14.0,22.0,1
991,F8:59:71:5A:E0:3D,3286396,511718483,75788,106189525,3210608,405528958,0,73493,64913300,68719,64342876,4774,570424,51528,16,78500,2016,0,505,144444.0,43333.0,-67.0,-72.0,-66.0,-70.0,-66.0,-72.0,-66.0,-69.0,-86.0,-91.0,-86.0,-90.0,19.0,19.0,20.0,20.0,1
992,CC:2F:71:3E:C5:1F,3221960,406917650,11352,1388692,3210608,405528958,6,48500,4061020,40087,3064218,8413,996802,11968,34,16316,186,6,822,144444.0,39000.0,-69.0,-71.0,-68.0,-61.0,-69.0,-72.0,-68.0,-62.0,-86.0,-91.0,-86.0,-90.0,17.0,20.0,18.0,29.0,1
993,CC:2F:71:3F:1F:24,7605445,7095799712,4394837,6690270754,3210608,405528958,80,1011303,615709263,1002798,614687833,8505,1021430,958488,619,4399545,448385,80,5515,130000.0,43333.0,-71.0,-65.0,-72.0,-68.0,-71.0,-64.0,-72.0,-68.0,-86.0,-91.0,-86.0,-90.0,15.0,26.0,14.0,22.0,1
994,F8:59:71:5A:E0:3D,3286463,511815295,75850,106285873,3210613,405529422,0,73556,65010320,68782,64439896,4774,570424,51591,16,78562,2017,0,505,144444.0,43333.0,-67.0,-72.0,-66.0,-69.0,-66.0,-72.0,-66.0,-69.0,-86.0,-91.0,-86.0,-90.0,19.0,19.0,20.0,21.0,1
995,CC:2F:71:3E:C5:1F,3221965,406918114,11352,1388692,3210613,405529422,6,48500,4061020,40087,3064218,8413,996802,11968,34,16316,186,6,822,144444.0,39000.0,-69.0,-71.0,-68.0,-61.0,-69.0,-72.0,-68.0,-62.0,-86.0,-91.0,-86.0,-90.0,17.0,20.0,18.0,29.0,1
996,CC:2F:71:3F:1F:24,7606861,7097977253,4396248,6692447831,3210613,405529422,80,1011614,615927773,1003109,614906343,8505,1021430,958799,619,4400967,448508,80,5516,130000.0,43333.0,-71.0,-63.0,-72.0,-67.0,-70.0,-63.0,-70.0,-67.0,-86.0,-91.0,-86.0,-90.0,15.0,28.0,14.0,23.0,1
997,F8:59:71:5A:E0:3D,3286531,511915155,75914,106385329,3210617,405529826,0,73619,65107340,68845,64536916,4774,570424,51654,16,78626,2019,0,505,144444.0,43333.0,-67.0,-72.0,-66.0,-70.0,-67.0,-72.0,-65.0,-69.0,-85.0,-90.0,-85.0,-90.0,18.0,18.0,19.0,20.0,1
998,CC:2F:71:3E:C5:1F,3221969,406918518,11352,1388692,3210617,405529826,6,48500,4061020,40087,3064218,8413,996802,11968,34,16316,186,6,822,144444.0,39000.0,-69.0,-71.0,-68.0,-61.0,-69.0,-72.0,-68.0,-62.0,-85.0,-90.0,-85.0,-90.0,16.0,19.0,17.0,29.0,1
999,CC:2F:71:3F:1F:24,7607901,7099568550,4397284,6694038724,3210617,405529826,80,1011898,616138715,1003393,615117285,8505,1021430,959083,619,4402003,448543,80,5516,130000.0,43333.0,-70.0,-63.0,-71.0,-68.0,-70.0,-63.0,-71.0,-67.0,-85.0,-90.0,-85.0,-90.0,15.0,27.0,14.0,22.0,1
1000,F8:59:71:5A:E0:3D,3286596,512013259,75977,106483231,3210619,405530028,0,73682,65204360,68908,64633936,4774,570424,51717,16,78689,2020,0,505,144444.0,43333.0,-67.0,-71.0,-66.0,-70.0,-67.0,-71.0,-66.0,-69.0,-85.0,-90.0,-85.0,-90.0,18.0,19.0,19.0,20.0,1
1001,CC:2F:71:3E:C5:1F,3221973,406918922,11352,1388692,3210621,405530230,6,48500,4061020,40087,3064218,8413,996802,11968,34,16316,186,6,822,144444.0,39000.0,-69.0,-71.0,-68.0,-61.0,-69.0,-72.0,-68.0,-62.0,-85.0,-90.0,-85.0,-90.0,16.0,19.0,17.0,29.0,1
1002,CC:2F:71:3F:1F:24,7608920,7101118607,4398299,6695588377,3210621,405530230,80,1012189,616362096,1003684,615340666,8505,1021430,959373,619,4402985,448577,80,5516,130000.0,39000.0,-70.0,-64.0,-71.0,-67.0,-70.0,-64.0,-71.0,-67.0,-85.0,-90.0,-85.0,-90.0,15.0,26.0,14.0,23.0,1
1003,F8:59:71:5A:E0:3D,3286670,512118043,76044,106587349,3210626,405530694,0,73749,65307540,68975,64737116,4774,570424,51784,16,78756,2021,0,505,144444.0,43333.0,-67.0,-72.0,-66.0,-70.0,-66.0,-72.0,-66.0,-69.0,-85.0,-90.0,-85.0,-90.0,18.0,18.0,19.0,20.0,1
1004,CC:2F:71:3E:C5:1F,3221978,406919386,11352,1388692,3210626,405530694,6,48500,4061020,40087,3064218,8413,996802,11968,34,16316,186,6,822,144444.0,39000.0,-69.0,-71.0,-68.0,-61.0,-69.0,-72.0,-68.0,-62.0,-85.0,-90.0,-85.0,-90.0,16.0,19.0,17.0,29.0,1
1005,CC:2F:71:3F:1F:24,7610397,7103387584,4399771,6697856890,3210626,405530694,80,1012504,616584099,1003999,615562669,8505,1021430,959688,619,4404490,448763,80,5516,130000.0,43333.0,-71.0,-64.0,-71.0,-68.0,-71.0,-64.0,-72.0,-68.0,-85.0,-90.0,-85.0,-90.0,14.0,26.0,14.0,22.0,1
1006,F8:59:71:5A:E0:3D,3286738,512217933,76110,106687037,3210628,405530896,0,73814,65406206,69040,64835782,4774,570424,51849,16,78822,2021,0,505,144444.0,43333.0,-67.0,-72.0,-66.0,-69.0,-66.0,-71.0,-65.0,-69.0,-85.0,-91.0,-85.0,-91.0,18.0,19.0,19.0,22.0,1
1007,CC:2F:71:3E:C5:1F,3221981,406919704,11353,1388808,3210628,405530896,6,48501,4061090,40088,3064288,8413,996802,11968,34,16317,186,6,822,144444.0,39000.0,-69.0,-70.0,-68.0,-60.0,-69.0,-72.0,-68.0,-62.0,-85.0,-91.0,-85.0,-91.0,16.0,21.0,17.0,31.0,1
1008,CC:2F:71:3F:1F:24,7612003,7105869974,4401375,6700339078,3210628,405530896,80,1012819,616807176,1004314,615785746,8505,1021430,960000,619,4406094,448862,80,5516,130000.0,43333.0,-71.0,-64.0,-72.0,-68.0,-71.0,-64.0,-72.0,-68.0,-85.0,-91.0,-85.0,-91.0,14.0,27.0,13.0,23.0,1
1009,F8:59:71:5A:E0:3D,3286805,512316239,76173,106784939,3210632,405531300,0,73877,65503226,69103,64932802,4774,570424,51912,16,78885,2021,0,505,144444.0,43333.0,-67.0,-73.0,-65.0,-70.0,-67.0,-72.0,-65.0,-70.0,-85.0,-91.0,-85.0,-91.0,18.0,18.0,20.0,21.0,1
1010,CC:2F:71:3E:C5:1F,3221988,406920370,11353,1388808,3210635,405531562,6,48502,4061160,40089,3064358,8413,996802,11968,34,16317,186,6,822,144444.0,39000.0,-70.0,-71.0,-68.0,-61.0,-69.0,-70.0,-67.0,-60.0,-85.0,-91.0,-85.0,-91.0,15.0,20.0,17.0,30.0,1
1011,CC:2F:71:3F:1F:24,7613281,7107834430,4402646,6702302868,3210635,405531562,80,1013086,617023196,1004581,616001766,8505,1021430,960267,619,4407365,448914,80,5516,144444.0,43333.0,-70.0,-63.0,-73.0,-69.0,-70.0,-63.0,-72.0,-69.0,-85.0,-91.0,-85.0,-91.0,15.0,28.0,12.0,22.0,1
1012,F8:59:71:5A:E0:3D,3286878,512422375,76241,106890611,3210637,405531764,0,73945,65607974,69171,65037550,4774,570424,51980,16,78952,2021,0,506,144444.0,43333.0,-66.0,-73.0,-66.0,-70.0,-66.0,-72.0,-65.0,-69.0,-85.0,-91.0,-85.0,-91.0,19.0,18.0,19.0,21.0,1
1013,CC:2F:71:3E:C5:1F,3221990,406920572,11353,1388808,3210637,405531764,6,48502,4061160,40089,3064358,8413,996802,11968,34,16317,186,6,822,144444.0,39000.0,-70.0,-71.0,-68.0,-61.0,-69.0,-70.0,-67.0,-60.0,-85.0,-91.0,-85.0,-91.0,15.0,20.0,17.0,30.0,1
1014,CC:2F:71:3F:1F:24,7614337,7109449636,4403700,6703917872,3210637,405531764,80,1013376,617253265,1004871,616231835,8505,1021430,960557,619,4408419,449138,80,5516,86667.0,13000.0,-69.0,-63.0,-72.0,-69.0,-69.0,-63.0,-71.0,-69.0,-85.0,-91.0,-85.0,-91.0,16.0,28.0,13.0,22.0,1
1015,F8:59:71:5A:E0:3D,3286947,512523789,76306,106991621,3210641,405532168,0,74010,65708074,69236,65137650,4774,570424,52045,16,79017,2025,0,506,144444.0,43333.0,-67.0,-72.0,-65.0,-70.0,-67.0,-72.0,-64.0,-69.0,-85.0,-91.0,-85.0,-91.0,18.0,19.0,20.0,21.0,1
1016,CC:2F:71:3E:C5:1F,3221994,406920976,11353,1388808,3210641,405532168,6,48502,4061160,40089,3064358,8413,996802,11968,34,16317,186,6,822,144444.0,39000.0,-70.0,-71.0,-68.0,-61.0,-69.0,-70.0,-67.0,-60.0,-85.0,-91.0,-85.0,-91.0,15.0,20.0,17.0,30.0,1
1017,CC:2F:71:3F:1F:24,7615519,7111233695,4404876,6705701325,3210643,405532370,80,1013731,617476332,1005226,616454902,8505,1021430,960911,619,4409595,449153,80,5518,86667.0,14444.0,-70.0,-64.0,-72.0,-70.0,-69.0,-64.0,-71.0,-70.0,-85.0,-91.0,-85.0,-91.0,15.0,27.0,13.0,21.0,1
1018,F8:59:71:5A:E0:3D,3287017,512623863,76371,107091231,3210646,405532632,0,74076,65808314,69302,65237890,4774,570424,52111,16,79083,2027,0,506,144444.0,43333.0,-67.0,-72.0,-65.0,-70.0,-67.0,-71.0,-64.0,-70.0,-85.0,-91.0,-85.0,-90.0,18.0,19.0,20.0,20.0,1
1019,CC:2F:71:3E:C5:1F,3221999,406921440,11353,1388808,3210646,405532632,6,48502,4061160,40089,3064358,8413,996802,11968,34,16317,186,6,822,144444.0,39000.0,-70.0,-71.0,-68.0,-61.0,-69.0,-70.0,-67.0,-60.0,-85.0,-91.0,-85.0,-90.0,15.0,20.0,17.0,29.0,1
1020,CC:2F:71:3F:1F:24,7616390,7112561173,4405744,6707028541,3210646,405532632,80,1014007,617696386,1005502,616674956,8505,1021430,961186,619,4410463,449202,80,5518,144444.0,39000.0,-71.0,-65.0,-72.0,-70.0,-71.0,-64.0,-72.0,-70.0,-85.0,-91.0,-85.0,-90.0,14.0,26.0,13.0,20.0,1
1021,F8:59:71:5A:E0:3D,3287086,512725277,76436,107192241,3210650,405533036,0,74140,65906874,69366,65336450,4774,570424,52175,16,79148,2027,0,506,144444.0,43333.0,-67.0,-71.0,-65.0,-70.0,-67.0,-70.0,-64.0,-69.0,-85.0,-91.0,-85.0,-90.0,18.0,20.0,20.0,20.0,1
1022,CC:2F:71:3E:C5:1F,3222003,406921844,11353,1388808,3210650,405533036,6,48502,4061160,40089,3064358,8413,996802,11968,34,16317,186,6,822,144444.0,39000.0,-70.0,-71.0,-68.0,-61.0,-69.0,-70.0,-67.0,-60.0,-85.0,-91.0,-85.0,-90.0,15.0,20.0,17.0,29.0,1
1023,CC:2F:71:3F:1F:24,7617639,7114415067,4406989,6708882031,3210650,405533036,80,1014336,617922356,1005831,616900926,8505,1021430,961515,619,4411700,449277,80,5518,130000.0,43333.0,-69.0,-64.0,-72.0,-67.0,-69.0,-64.0,-72.0,-67.0,-85.0,-91.0,-85.0,-90.0,16.0,27.0,13.0,23.0,1
1024,F8:59:71:5A:E0:3D,3287159,512832907,76505,107299467,3210654,405533440,0,74209,66013204,69435,65442780,4774,570424,52244,16,79217,2029,0,506,144444.0,43333.0,-67.0,-72.0,-65.0,-70.0,-67.0,-72.0,-64.0,-70.0,-85.0,-91.0,-85.0,-90.0,18.0,19.0,20.0,20.0,1
1025,CC:2F:71:3E:C5:1F,3222007,406922248,11353,1388808,3210654,405533440,6,48502,4061160,40089,3064358,8413,996802,11968,34,16317,186,6,822,144444.0,39000.0,-70.0,-71.0,-68.0,-61.0,-69.0,-70.0,-67.0,-60.0,-85.0,-91.0,-85.0,-90.0,15.0,20.0,17.0,29.0,1
1026,CC:2F:71:3F:1F:24,7618566,7115826333,4407912,6710292893,3210654,405533440,80,1014608,618151755,1006103,617130325,8505,1021430,961787,619,4412615,449722,80,5519,86667.0,13000.0,-69.0,-64.0,-72.0,-70.0,-69.0,-64.0,-72.0,-69.0,-85.0,-91.0,-85.0,-90.0,16.0,27.0,13.0,20.0,1
1027,F8:59:71:5A:E0:3D,3287229,512932721,76569,107398755,3210660,405533966,0,74274,66111882,69499,65541340,4775,570542,52309,16,79281,2031,0,506,144444.0,43333.0,-67.0,-72.0,-64.0,-71.0,-66.0,-72.0,-64.0,-70.0,-85.0,-91.0,-85.0,-90.0,18.0,19.0,21.0,19.0,1
1028,CC:2F:71:3E:C5:1F,3222013,406922774,11353,1388808,3210660,405533966,6,48502,4061160,40089,3064358,8413,996802,11968,34,16317,186,6,822,144444.0,39000.0,-70.0,-71.0,-68.0,-61.0,-69.0,-70.0,-67.0,-60.0,-85.0,-91.0,-85.0,-90.0,15.0,20.0,17.0,29.0,1
1029,CC:2F:71:3F:1F:24,7619781,7117690469,4409121,6712156503,3210660,405533966,80,1014950,618377765,1006445,617356335,8505,1021430,962129,619,4413828,449759,80,5519,86667.0,14444.0,-70.0,-64.0,-72.0,-70.0,-70.0,-64.0,-72.0,-70.0,-85.0,-91.0,-85.0,-90.0,15.0,27.0,13.0,20.0,1
1030,F8:59:71:5A:E0:3D,3287298,513035760,76635,107501319,3210663,405534441,0,74338,66210456,69563,65639914,4775,570542,52372,16,79345,2031,0,506,144444.0,43333.0,-66.0,-72.0,-64.0,-71.0,-66.0,-71.0,-64.0,-70.0,-85.0,-91.0,-85.0,-90.0,19.0,19.0,21.0,19.0,1
1031,CC:2F:71:3E:C5:1F,3222018,406923451,11353,1388808,3210665,405534643,6,48502,4061160,40089,3064358,8413,996802,11968,34,16317,186,6,822,144444.0,39000.0,-70.0,-71.0,-68.0,-61.0,-69.0,-70.0,-67.0,-60.0,-85.0,-91.0,-85.0,-90.0,15.0,20.0,17.0,29.0,1
1032,CC:2F:71:3F:1F:24,7621497,7120338946,4410832,6714804303,3210665,405534643,80,1015358,618624730,1006853,617603300,8505,1021430,962537,619,4415551,449925,80,5519,86667.0,14444.0,-70.0,-65.0,-72.0,-70.0,-70.0,-65.0,-72.0,-70.0,-85.0,-91.0,-85.0,-90.0,15.0,26.0,13.0,20.0,1
1033,F8:59:71:5A:E0:3D,3287374,513145146,76705,107610099,3210669,405535047,0,74411,66322876,69636,65752334,4775,570542,52445,16,79417,2031,0,506,144444.0,43333.0,-67.0,-72.0,-64.0,-71.0,-66.0,-72.0,-64.0,-70.0,-85.0,-91.0,-85.0,-90.0,18.0,19.0,21.0,19.0,1
1034,CC:2F:71:3E:C5:1F,3222022,406923855,11353,1388808,3210669,405535047,6,48502,4061160,40089,3064358,8413,996802,11968,34,16317,186,6,822,144444.0,39000.0,-70.0,-71.0,-68.0,-61.0,-69.0,-70.0,-67.0,-60.0,-85.0,-91.0,-85.0,-90.0,15.0,20.0,17.0,29.0,1
1035,CC:2F:71:3F:1F:24,7623314,7123155904,4412645,6717620857,3210669,405535047,80,1015798,618872376,1007293,617850946,8505,1021430,962976,619,4417364,449928,80,5519,86667.0,14444.0,-70.0,-65.0,-72.0,-70.0,-70.0,-64.0,-72.0,-70.0,-84.0,-90.0,-84.0,-90.0,14.0,25.0,12.0,20.0,1
1036,F8:59:71:5A:E0:3D,3287442,513246418,76770,107711109,3210672,405535309,0,74476,66422976,69701,65852434,4775,570542,52510,16,79482,2033,0,506,144444.0,43333.0,-66.0,-72.0,-65.0,-71.0,-66.0,-72.0,-64.0,-70.0,-84.0,-90.0,-84.0,-90.0,18.0,18.0,19.0,19.0,1
1037,CC:2F:71:3E:C5:1F,3222025,406924117,11353,1388808,3210672,405535309,6,48502,4061160,40089,3064358,8413,996802,11968,34,16317,186,6,822,144444.0,39000.0,-70.0,-71.0,-68.0,-61.0,-69.0,-70.0,-67.0,-60.0,-84.0,-90.0,-84.0,-90.0,14.0,19.0,16.0,29.0,1
1038,CC:2F:71:3F:1F:24,7624457,7124909620,4413783,6719374109,3210674,405535511,80,1016117,619087356,1007612,618065926,8505,1021430,963295,619,4418488,449952,80,5519,65000.0,14444.0,-70.0,-65.0,-73.0,-70.0,-70.0,-65.0,-72.0,-70.0,-84.0,-90.0,-84.0,-90.0,14.0,25.0,11.0,20.0,1
1039,F8:59:71:5A:E0:3D,3287515,513348266,76837,107812351,3210678,405535915,0,74543,66523288,69768,65952746,4775,570542,52577,16,79549,2034,0,506,144444.0,43333.0,-67.0,-72.0,-64.0,-71.0,-66.0,-72.0,-64.0,-70.0,-84.0,-90.0,-84.0,-90.0,17.0,18.0,20.0,19.0,1
1040,CC:2F:71:3E:C5:1F,3222031,406924723,11353,1388808,3210678,405535915,6,48502,4061160,40089,3064358,8413,996802,11968,34,16317,186,6,822,144444.0,39000.0,-70.0,-71.0,-68.0,-61.0,-69.0,-70.0,-67.0,-60.0,-84.0,-90.0,-84.0,-90.0,14.0,19.0,16.0,29.0,1
1041,CC:2F:71:3F:1F:24,7625649,7126740072,4414971,6721204157,3210678,405535915,80,1016472,619322116,1007967,618300686,8505,1021430,963650,619,4419690,450091,80,5519,86667.0,14444.0,-70.0,-65.0,-73.0,-71.0,-70.0,-65.0,-72.0,-70.0,-84.0,-90.0,-84.0,-90.0,14.0,25.0,11.0,19.0,1
1042,F8:59:71:5A:E0:3D,3287583,513449540,76902,107913361,3210681,405536179,0,74608,66623388,69833,66052846,4775,570542,52642,16,79614,2034,0,506,144444.0,43333.0,-67.0,-72.0,-64.0,-71.0,-67.0,-72.0,-64.0,-70.0,-84.0,-90.0,-84.0,-90.0,17.0,18.0,20.0,19.0,1
1043,CC:2F:71:3E:C5:1F,3222035,406925047,11353,1388808,3210682,405536239,6,48504,4061348,40090,3064428,8414,996920,11969,34,16317,186,6,822,144444.0,39000.0,-69.0,-70.0,-69.0,-61.0,-69.0,-70.0,-68.0,-60.0,-84.0,-90.0,-84.0,-90.0,15.0,20.0,15.0,29.0,1
1044,CC:2F:71:3F:1F:24,7626777,7128461531,4416095,6722925292,3210682,405536239,80,1016787,619543046,1008282,618521616,8505,1021430,963965,619,4420814,450145,80,5520,65000.0,14444.0,-71.0,-65.0,-73.0,-70.0,-70.0,-65.0,-73.0,-70.0,-84.0,-90.0,-84.0,-90.0,13.0,25.0,11.0,20.0,1
1045,F8:59:71:5A:E0:3D,3287654,513551076,76967,108014371,3210687,405536705,0,74673,66723488,69898,66152946,4775,570542,52707,16,79679,2034,0,506,144444.0,43333.0,-67.0,-72.0,-64.0,-71.0,-66.0,-72.0,-64.0,-70.0,-84.0,-90.0,-84.0,-90.0,17.0,18.0,20.0,19.0,1
1046,CC:2F:71:3E:C5:1F,3222040,406925513,11353,1388808,3210687,405536705,6,48504,4061348,40090,3064428,8414,996920,11969,34,16317,186,6,822,144444.0,39000.0,-69.0,-70.0,-69.0,-61.0,-69.0,-70.0,-68.0,-60.0,-84.0,-90.0,-84.0,-90.0,15.0,20.0,15.0,29.0,1
1047,CC:2F:71:3F:1F:24,7628089,7130477305,4417400,6724940398,3210689,405536907,80,1017136,619772908,1008630,618751360,8506,1021548,964314,619,4422119,450151,80,5521,65000.0,14444.0,-70.0,-65.0,-72.0,-70.0,-70.0,-64.0,-72.0,-69.0,-84.0,-90.0,-84.0,-90.0,14.0,25.0,12.0,20.0,1
1048,F8:59:71:5A:E0:3D,3287723,513652490,77032,108115381,3210691,405537109,0,74738,66823588,69963,66253046,4775,570542,52772,16,79744,2034,0,506,144444.0,43333.0,-67.0,-72.0,-64.0,-71.0,-66.0,-72.0,-64.0,-70.0,-84.0,-90.0,-84.0,-90.0,17.0,18.0,20.0,19.0,1
1049,CC:2F:71:3E:C5:1F,3222044,406925917,11353,1388808,3210691,405537109,6,48504,4061348,40090,3064428,8414,996920,11969,34,16317,186,6,822,144444.0,39000.0,-69.0,-70.0,-69.0,-61.0,-69.0,-70.0,-68.0,-60.0,-84.0,-90.0,-84.0,-90.0,15.0,20.0,15.0,29.0,1
1050,CC:2F:71:3F:1F:24,7629641,7132878807,4418950,6727341698,3210691,405537109,80,1017514,620006026,1009008,618984478,8506,1021548,964692,619,4423653,450211,80,5522,86667.0,14444.0,-70.0,-65.0,-72.0,-70.0,-69.0,-64.0,-72.0,-69.0,-84.0,-90.0,-84.0,-90.0,14.0,25.0,12.0,20.0,1
1051,F8:59:71:5A:E0:3D,3287793,513756870,77099,108219499,3210694,405537371,0,74807,66929862,70032,66359320,4775,570542,52840,16,79811,2034,0,506,144444.0,43333.0,-67.0,-72.0,-64.0,-71.0,-66.0,-72.0,-64.0,-70.0,-84.0,-90.0,-84.0,-90.0,17.0,18.0,20.0,19.0,1
1052,CC:2F:71:3E:C5:1F,3222049,406926381,11353,1388808,3210696,405537573,6,48504,4061348,40090,3064428,8414,996920,11969,34,16317,186,6,822,144444.0,39000.0,-69.0,-70.0,-69.0,-61.0,-69.0,-70.0,-68.0,-60.0,-84.0,-90.0,-84.0,-90.0,15.0,20.0,15.0,29.0,1
1053,CC:2F:71:3F:1F:24,7631381,7135571347,4420683,6730033572,3210698,405537775,80,1017933,620239752,1009427,619218204,8506,1021548,965110,619,4425402,450245,80,5522,86667.0,14444.0,-70.0,-64.0,-73.0,-70.0,-69.0,-64.0,-72.0,-69.0,-84.0,-90.0,-84.0,-90.0,14.0,26.0,11.0,20.0,1
1054,F8:59:71:5A:E0:3D,3287860,513855176,77162,108317401,3210698,405537775,0,74869,67025342,70094,66454800,4775,570542,52902,16,79874,2035,0,506,144444.0,43333.0,-67.0,-72.0,-64.0,-71.0,-66.0,-72.0,-64.0,-70.0,-84.0,-90.0,-84.0,-90.0,17.0,18.0,20.0,19.0,1
1055,CC:2F:71:3E:C5:1F,3222053,406926785,11353,1388808,3210700,405537977,6,48504,4061348,40090,3064428,8414,996920,11969,34,16317,186,6,822,144444.0,39000.0,-69.0,-70.0,-69.0,-61.0,-69.0,-70.0,-68.0,-60.0,-84.0,-90.0,-84.0,-90.0,15.0,20.0,15.0,29.0,1
1056,CC:2F:71:3F:1F:24,7632268,7136914913,4421568,6731376936,3210700,405537977,80,1018231,620461204,1009725,619439656,8506,1021548,965407,619,4426269,450298,80,5522,78000.0,13000.0,-69.0,-64.0,-72.0,-69.0,-69.0,-64.0,-72.0,-69.0,-84.0,-90.0,-84.0,-90.0,15.0,26.0,12.0,21.0,1
1057,F8:59:71:5A:E0:3D,3287929,513956590,77227,108418411,3210702,405538179,0,74934,67125442,70159,66554900,4775,570542,52967,16,79939,2035,0,506,144444.0,43333.0,-67.0,-72.0,-64.0,-71.0,-66.0,-71.0,-64.0,-70.0,-84.0,-90.0,-84.0,-90.0,17.0,18.0,20.0,19.0,1
1058,CC:2F:71:3E:C5:1F,3222055,406926987,11353,1388808,3210702,405538179,6,48504,4061348,40090,3064428,8414,996920,11969,34,16317,186,6,822,144444.0,39000.0,-69.0,-70.0,-69.0,-61.0,-69.0,-70.0,-68.0,-60.0,-84.0,-90.0,-84.0,-90.0,15.0,20.0,15.0,29.0,1
1059,CC:2F:71:3F:1F:24,7633114,7138200049,4422410,6732661668,3210704,405538381,80,1018498,620678452,1009992,619656904,8506,1021548,965674,619,4427129,450325,80,5522,86667.0,14444.0,-70.0,-64.0,-73.0,-70.0,-69.0,-64.0,-72.0,-69.0,-84.0,-90.0,-84.0,-90.0,14.0,26.0,11.0,20.0,1
1060,F8:59:71:5A:E0:3D,3288001,514061172,77294,108522529,3210707,405538643,0,75001,67228622,70226,66658080,4775,570542,53034,16,80005,2035,0,506,144444.0,43333.0,-67.0,-72.0,-64.0,-70.0,-66.0,-72.0,-64.0,-70.0,-84.0,-90.0,-84.0,-90.0,17.0,18.0,20.0,20.0,1
1061,CC:2F:71:3E:C5:1F,3222060,406927451,11353,1388808,3210707,405538643,6,48504,4061348,40090,3064428,8414,996920,11969,34,16317,186,6,822,144444.0,39000.0,-69.0,-70.0,-69.0,-61.0,-69.0,-70.0,-68.0,-60.0,-84.0,-90.0,-84.0,-90.0,15.0,20.0,15.0,29.0,1
1062,CC:2F:71:3F:1F:24,7634672,7140606987,4423963,6735068142,3210709,405538845,80,1018883,620915378,1010377,619893830,8506,1021548,966059,619,4428675,450363,80,5523,86667.0,14444.0,-71.0,-65.0,-74.0,-71.0,-70.0,-64.0,-72.0,-70.0,-84.0,-90.0,-84.0,-90.0,13.0,25.0,10.0,19.0,1
1063,F8:59:71:5A:E0:3D,3288073,514167248,77362,108628201,3210711,405539047,0,75070,67335008,70295,66764466,4775,570542,53102,16,80074,2035,0,506,144444.0,43333.0,-67.0,-72.0,-64.0,-71.0,-66.0,-72.0,-64.0,-70.0,-84.0,-90.0,-84.0,-90.0,17.0,18.0,20.0,19.0,1
1064,CC:2F:71:3E:C5:1F,3222064,406927855,11353,1388808,3210711,405539047,6,48504,4061348,40090,3064428,8414,996920,11969,34,16317,186,6,822,144444.0,39000.0,-69.0,-70.0,-69.0,-61.0,-69.0,-70.0,-68.0,-60.0,-84.0,-90.0,-84.0,-90.0,15.0,20.0,15.0,29.0,1
1065,CC:2F:71:3F:1F:24,7636066,7142757771,4425353,6737218522,3210713,405539249,80,1019248,621153358,1010742,620131810,8506,1021548,966424,619,4430069,450435,80,5524,86667.0,14444.0,-69.0,-64.0,-72.0,-69.0,-69.0,-64.0,-72.0,-69.0,-84.0,-90.0,-84.0,-90.0,15.0,26.0,12.0,21.0,1
1066,F8:59:71:5A:E0:3D,3288143,514270216,77428,108730765,3210715,405539451,0,75136,67436648,70361,66866106,4775,570542,53168,16,80140,2038,0,506,144444.0,43333.0,-67.0,-72.0,-64.0,-71.0,-66.0,-72.0,-64.0,-70.0,-84.0,-90.0,-84.0,-90.0,17.0,18.0,20.0,19.0,1
1067,CC:2F:71:3E:C5:1F,3222068,406928259,11353,1388808,3210715,405539451,6,48504,4061348,40090,3064428,8414,996920,11969,34,16317,186,6,822,144444.0,39000.0,-69.0,-70.0,-69.0,-61.0,-69.0,-70.0,-68.0,-60.0,-84.0,-90.0,-84.0,-90.0,15.0,20.0,15.0,29.0,1
1068,CC:2F:71:3F:1F:24,7637410,7144822353,4426695,6739282902,3210715,405539451,80,1019607,621380437,1011101,620358889,8506,1021548,966783,619,4431400,450539,80,5524,86667.0,14444.0,-70.0,-65.0,-73.0,-70.0,-69.0,-64.0,-72.0,-69.0,-84.0,-90.0,-84.0,-90.0,14.0,25.0,11.0,20.0,1
1069,F8:59:71:5A:E0:3D,3288212,514370136,77492,108830221,3210720,405539915,0,75201,67536762,70426,66966220,4775,570542,53232,16,80204,2039,0,506,144444.0,43333.0,-67.0,-72.0,-64.0,-70.0,-67.0,-71.0,-64.0,-70.0,-84.0,-90.0,-84.0,-90.0,17.0,18.0,20.0,20.0,1
1070,CC:2F:71:3E:C5:1F,3222073,406928723,11353,1388808,3210720,405539915,6,48504,4061348,40090,3064428,8414,996920,11969,34,16317,186,6,822,144444.0,39000.0,-69.0,-70.0,-69.0,-61.0,-69.0,-70.0,-68.0,-60.0,-84.0,-90.0,-84.0,-90.0,15.0,20.0,15.0,29.0,1
1071,CC:2F:71:3F:1F:24,7638623,7146684953,4427903,6741145038,3210720,405539915,80,1019947,621600509,1011441,620578961,8506,1021548,967123,619,4432617,450564,80,5525,86667.0,14444.0,-70.0,-65.0,-72.0,-69.0,-69.0,-64.0,-72.0,-69.0,-84.0,-90.0,-84.0,-90.0,14.0,25.0,12.0,21.0,1
1072,F8:59:71:5A:E0:3D,3288281,514470269,77556,108929677,3210725,405540592,0,75265,67635322,70490,67064780,4775,570542,53296,16,80268,2040,0,506,144444.0,43333.0,-67.0,-72.0,-64.0,-71.0,-66.0,-71.0,-64.0,-70.0,-84.0,-90.0,-84.0,-89.0,17.0,18.0,20.0,18.0,1
1073,CC:2F:71:3E:C5:1F,3222078,406929400,11353,1388808,3210725,405540592,6,48504,4061348,40090,3064428,8414,996920,11969,34,16317,186,6,822,144444.0,39000.0,-69.0,-70.0,-69.0,-61.0,-69.0,-70.0,-68.0,-60.0,-84.0,-90.0,-84.0,-89.0,15.0,20.0,15.0,28.0,1
1074,CC:2F:71:3F:1F:24,7639682,7148306050,4428957,6742765458,3210725,405540592,80,1020263,621826615,1011757,620805067,8506,1021548,967439,619,4433666,450641,80,5526,86667.0,14444.0,-70.0,-65.0,-72.0,-71.0,-70.0,-65.0,-72.0,-71.0,-84.0,-90.0,-84.0,-89.0,14.0,25.0,12.0,18.0,1
1075,F8:59:71:5A:E0:3D,3288351,514573237,77622,109032241,3210729,405540996,0,75336,67744732,70561,67174190,4775,570542,53362,16,80334,2040,0,506,144444.0,43333.0,-67.0,-72.0,-66.0,-70.0,-67.0,-71.0,-65.0,-70.0,-84.0,-90.0,-84.0,-90.0,17.0,18.0,18.0,20.0,1
1076,CC:2F:71:3E:C5:1F,3222083,406929864,11353,1388808,3210730,405541056,6,48504,4061348,40090,3064428,8414,996920,11969,34,16317,186,6,822,144444.0,39000.0,-69.0,-70.0,-69.0,-61.0,-69.0,-70.0,-68.0,-60.0,-84.0,-90.0,-84.0,-90.0,15.0,20.0,15.0,29.0,1
1077,CC:2F:71:3F:1F:24,7640780,7149988588,4430050,6744447532,3210730,405541056,80,1020593,622054135,1012087,621032587,8506,1021548,967768,619,4434769,450662,80,5526,65000.0,14444.0,-70.0,-64.0,-72.0,-70.0,-70.0,-64.0,-71.0,-70.0,-84.0,-90.0,-84.0,-90.0,14.0,26.0,12.0,20.0,1
1078,F8:59:71:5A:E0:3D,3288420,514673157,77686,109131697,3210734,405541460,0,75402,67846400,70627,67275858,4775,570542,53426,16,80398,2040,0,506,144444.0,43333.0,-67.0,-73.0,-65.0,-72.0,-66.0,-72.0,-65.0,-71.0,-84.0,-90.0,-84.0,-90.0,17.0,17.0,19.0,18.0,1
1079,CC:2F:71:3E:C5:1F,3222087,406930268,11353,1388808,3210734,405541460,6,48504,4061348,40090,3064428,8414,996920,11969,34,16317,186,6,822,144444.0,39000.0,-69.0,-70.0,-69.0,-61.0,-69.0,-70.0,-68.0,-60.0,-84.0,-90.0,-84.0,-90.0,15.0,20.0,15.0,29.0,1
1080,CC:2F:71:3F:1F:24,7641967,7151804128,4431233,6746262668,3210734,405541460,80,1020934,622275042,1012428,621253494,8506,1021548,968109,619,4435928,450663,80,5526,86667.0,14444.0,-69.0,-64.0,-72.0,-70.0,-68.0,-64.0,-71.0,-69.0,-84.0,-90.0,-84.0,-90.0,15.0,26.0,12.0,20.0,1
1081,F8:59:71:5A:E0:3D,3288487,514771463,77749,109229599,3210738,405541864,0,75466,67944974,70691,67374432,4775,570542,53489,16,80461,2041,0,506,144444.0,43333.0,-67.0,-72.0,-65.0,-72.0,-66.0,-72.0,-65.0,-71.0,-84.0,-90.0,-84.0,-90.0,17.0,18.0,19.0,18.0,1
1082,CC:2F:71:3E:C5:1F,3222091,406930672,11353,1388808,3210738,405541864,6,48504,4061348,40090,3064428,8414,996920,11969,34,16317,186,6,822,144444.0,39000.0,-69.0,-70.0,-69.0,-61.0,-69.0,-70.0,-68.0,-60.0,-84.0,-90.0,-84.0,-90.0,15.0,20.0,15.0,29.0,1
1083,CC:2F:71:3F:1F:24,7643002,7153387250,4432264,6747845386,3210738,405541864,80,1021244,622493268,1012738,621471720,8506,1021548,968419,619,4436983,450737,80,5526,86667.0,14444.0,-69.0,-64.0,-72.0,-68.0,-69.0,-64.0,-72.0,-68.0,-84.0,-90.0,-84.0,-90.0,15.0,26.0,12.0,22.0,1
1084,F8:59:71:5A:E0:3D,3288555,514872735,77814,109330609,3210741,405542126,0,75531,68045074,70756,67474532,4775,570542,53554,16,80526,2041,0,506,144444.0,43333.0,-67.0,-72.0,-65.0,-72.0,-67.0,-72.0,-65.0,-71.0,-84.0,-90.0,-84.0,-90.0,17.0,18.0,19.0,18.0,1
1085,CC:2F:71:3E:C5:1F,3222096,406931136,11353,1388808,3210743,405542328,6,48504,4061348,40090,3064428,8414,996920,11969,34,16317,186,6,822,144444.0,39000.0,-69.0,-70.0,-69.0,-61.0,-69.0,-70.0,-68.0,-60.0,-84.0,-90.0,-84.0,-90.0,15.0,20.0,15.0,29.0,1
1086,CC:2F:71:3F:1F:24,7644088,7155050788,4433345,6749508460,3210743,405542328,80,1021570,622716284,1013064,621694736,8506,1021548,968745,619,4438063,450761,80,5527,104000.0,26000.0,-70.0,-65.0,-72.0,-68.0,-69.0,-64.0,-72.0,-68.0,-84.0,-90.0,-84.0,-90.0,14.0,25.0,12.0,22.0,1
1087,F8:59:71:5A:E0:3D,3288626,514974351,77879,109431619,3210747,405542732,0,75596,68145216,70821,67574674,4775,570542,53619,16,80591,2042,0,506,144444.0,43333.0,-67.0,-72.0,-66.0,-72.0,-67.0,-72.0,-65.0,-71.0,-84.0,-90.0,-84.0,-90.0,17.0,18.0,18.0,18.0,1
1088,CC:2F:71:3E:C5:1F,3222100,406931540,11353,1388808,3210747,405542732,6,48504,4061348,40090,3064428,8414,996920,11969,34,16317,186,6,822,144444.0,39000.0,-69.0,-70.0,-69.0,-61.0,-69.0,-70.0,-68.0,-60.0,-84.0,-90.0,-84.0,-90.0,15.0,20.0,15.0,29.0,1
1089,CC:2F:71:3F:1F:24,7645100,7156599024,4434353,6751056292,3210747,405542732,80,1021872,622937758,1013366,621916210,8506,1021548,969047,619,4439072,450859,80,5528,86667.0,14444.0,-69.0,-64.0,-72.0,-68.0,-69.0,-64.0,-72.0,-67.0,-84.0,-90.0,-84.0,-90.0,15.0,26.0,12.0,22.0,1
1090,F8:59:71:5A:E0:3D,3288695,515074493,77944,109531191,3210751,405543302,0,75661,68245330,70886,67674788,4775,570542,53683,16,80656,2042,0,506,144444.0,43333.0,-67.0,-72.0,-66.0,-72.0,-67.0,-71.0,-65.0,-71.0,-84.0,-90.0,-84.0,-90.0,17.0,18.0,18.0,18.0,1
1091,CC:2F:71:3E:C5:1F,3222105,406932226,11354,1388924,3210751,405543302,6,48506,4061488,40092,3064568,8414,996920,11969,34,16318,186,6,822,144444.0,39000.0,-66.0,-67.0,-65.0,-60.0,-68.0,-69.0,-67.0,-60.0,-84.0,-90.0,-84.0,-90.0,18.0,23.0,19.0,30.0,1
1092,CC:2F:71:3F:1F:24,7646144,7158193722,4435391,6752650218,3210753,405543504,80,1022164,623158010,1013658,622136462,8506,1021548,969339,619,4440093,450867,80,5528,86667.0,14444.0,-70.0,-65.0,-73.0,-69.0,-69.0,-65.0,-72.0,-69.0,-84.0,-90.0,-84.0,-90.0,14.0,25.0,11.0,21.0,1
1093,F8:59:71:5A:E0:3D,3288766,515177409,78010,109633643,3210756,405543766,0,75728,68348524,70953,67777982,4775,570542,53749,16,80722,2042,0,506,144444.0,39000.0,-67.0,-72.0,-65.0,-71.0,-66.0,-71.0,-65.0,-70.0,-84.0,-90.0,-84.0,-90.0,17.0,18.0,19.0,19.0,1
1094,CC:2F:71:3E:C5:1F,3222112,406932892,11354,1388924,3210758,405543968,6,48506,4061488,40092,3064568,8414,996920,11969,34,16318,186,6,822,144444.0,39000.0,-66.0,-67.0,-65.0,-60.0,-68.0,-69.0,-67.0,-60.0,-84.0,-90.0,-84.0,-90.0,18.0,23.0,19.0,30.0,1
1095,CC:2F:71:3F:1F:24,7647412,7160135490,4436654,6754591522,3210758,405543968,80,1022495,623383416,1013989,622361868,8506,1021548,969670,619,4441373,450900,80,5528,130000.0,43333.0,-71.0,-64.0,-72.0,-69.0,-71.0,-64.0,-72.0,-69.0,-84.0,-90.0,-84.0,-90.0,13.0,26.0,12.0,21.0,1
1096,F8:59:71:5A:E0:3D,3288834,515275721,78073,109731489,3210761,405544232,0,75793,68447216,71017,67876556,4776,570660,53813,16,80785,2043,0,506,144444.0,43333.0,-67.0,-73.0,-66.0,-71.0,-67.0,-72.0,-65.0,-71.0,-84.0,-90.0,-84.0,-90.0,17.0,17.0,18.0,19.0,1
1097,CC:2F:71:3E:C5:1F,3222115,406933156,11354,1388924,3210761,405544232,6,48506,4061488,40092,3064568,8414,996920,11969,34,16318,186,6,822,144444.0,39000.0,-66.0,-67.0,-65.0,-60.0,-68.0,-69.0,-67.0,-60.0,-84.0,-90.0,-84.0,-90.0,18.0,23.0,19.0,30.0,1
1098,CC:2F:71:3F:1F:24,7648583,7161936970,4437822,6756392738,3210761,405544232,80,1022796,623597456,1014290,622575908,8506,1021548,969971,619,4442531,450935,80,5528,130000.0,43333.0,-71.0,-64.0,-72.0,-70.0,-71.0,-64.0,-72.0,-69.0,-84.0,-90.0,-84.0,-90.0,13.0,26.0,12.0,20.0,1
1099,F8:59:71:5A:E0:3D,3288900,515372473,78135,109827837,3210765,405544636,0,75856,68544250,71080,67973590,4776,570660,53875,16,80847,2044,0,506,144444.0,43333.0,-67.0,-72.0,-65.0,-70.0,-67.0,-72.0,-65.0,-71.0,-84.0,-90.0,-84.0,-90.0,17.0,18.0,19.0,20.0,1
1100,CC:2F:71:3E:C5:1F,3222119,406933560,11354,1388924,3210765,405544636,6,48506,4061488,40092,3064568,8414,996920,11969,34,16318,186,6,822,144444.0,39000.0,-66.0,-67.0,-65.0,-60.0,-68.0,-69.0,-67.0,-60.0,-84.0,-90.0,-84.0,-90.0,18.0,23.0,19.0,30.0,1
1101,CC:2F:71:3F:1F:24,7649846,7163882468,4439081,6758337832,3210765,405544636,80,1023095,623811452,1014589,622789904,8506,1021548,970270,619,4443800,450953,80,5528,130000.0,43333.0,-72.0,-64.0,-73.0,-70.0,-72.0,-64.0,-72.0,-69.0,-84.0,-90.0,-84.0,-90.0,12.0,26.0,11.0,20.0,1
1102,F8:59:71:5A:E0:3D,3288969,515472393,78199,109927293,3210770,405545100,0,75921,68644378,71145,68073718,4776,570660,53938,16,80910,2045,0,506,144444.0,43333.0,-67.0,-73.0,-66.0,-72.0,-67.0,-73.0,-66.0,-71.0,-84.0,-90.0,-84.0,-90.0,17.0,17.0,18.0,18.0,1
1103,CC:2F:71:3E:C5:1F,3222124,406934024,11354,1388924,3210770,405545100,6,48506,4061488,40092,3064568,8414,996920,11969,34,16318,186,6,822,144444.0,39000.0,-66.0,-67.0,-65.0,-60.0,-68.0,-69.0,-67.0,-60.0,-84.0,-90.0,-84.0,-90.0,18.0,23.0,19.0,30.0,1
1104,CC:2F:71:3F:1F:24,7651107,7165823068,4440337,6760277968,3210770,405545100,80,1023364,624024690,1014858,623003142,8506,1021548,970539,619,4445056,451039,80,5528,130000.0,43333.0,-72.0,-64.0,-73.0,-70.0,-71.0,-64.0,-72.0,-69.0,-84.0,-90.0,-84.0,-90.0,12.0,26.0,11.0,20.0,1
1105,F8:59:71:5A:E0:3D,3289034,515569005,78261,110023641,3210773,405545364,0,75986,68744506,71210,68173846,4776,570660,54001,16,80973,2047,0,506,144444.0,43333.0,-67.0,-73.0,-66.0,-71.0,-67.0,-72.0,-65.0,-71.0,-85.0,-90.0,-85.0,-90.0,18.0,17.0,19.0,19.0,1
1106,CC:2F:71:3E:C5:1F,3222127,406934288,11354,1388924,3210773,405545364,6,48508,4061676,40093,3064638,8415,997038,11970,34,16318,186,6,822,144444.0,39000.0,-69.0,-70.0,-69.0,-60.0,-68.0,-68.0,-68.0,-60.0,-85.0,-90.0,-85.0,-90.0,16.0,20.0,16.0,30.0,1
1107,CC:2F:71:3F:1F:24,7652182,7167462647,4441409,6761917283,3210773,405545364,80,1023626,624237558,1015120,623216010,8506,1021548,970799,619,4446128,451048,80,5528,130000.0,43333.0,-71.0,-64.0,-72.0,-70.0,-71.0,-64.0,-72.0,-69.0,-85.0,-90.0,-85.0,-90.0,14.0,26.0,13.0,20.0,1
1108,F8:59:71:5A:E0:3D,3289101,515667311,78324,110121543,3210777,405545768,0,76050,68843066,71274,68272406,4776,570660,54065,16,81036,2047,0,506,144444.0,43333.0,-67.0,-72.0,-65.0,-71.0,-66.0,-72.0,-65.0,-71.0,-85.0,-90.0,-85.0,-90.0,18.0,18.0,20.0,19.0,1
1109,CC:2F:71:3E:C5:1F,3222144,406940318,11354,1388924,3210790,405551394,6,48508,4061676,40093,3064638,8415,997038,11970,34,16318,186,6,822,144444.0,39000.0,-69.0,-70.0,-69.0,-60.0,-68.0,-68.0,-68.0,-60.0,-85.0,-90.0,-85.0,-90.0,16.0,20.0,16.0,30.0,1
1110,CC:2F:71:3F:1F:24,7653440,7169383727,4442650,6763832333,3210790,405551394,80,1023907,624463550,1015401,623442002,8506,1021548,971080,619,4447369,451077,80,5528,130000.0,43333.0,-72.0,-64.0,-73.0,-69.0,-72.0,-64.0,-72.0,-69.0,-85.0,-90.0,-85.0,-90.0,13.0,26.0,12.0,21.0,1
1111,F8:59:71:5A:E0:3D,3289195,515782741,78391,110225661,3210804,405557080,0,76116,68944706,71340,68374046,4776,570660,54131,16,81103,2047,0,506,144444.0,43333.0,-67.0,-72.0,-65.0,-71.0,-66.0,-72.0,-65.0,-70.0,-85.0,-90.0,-85.0,-90.0,18.0,18.0,20.0,19.0,1
1112,CC:2F:71:3E:C5:1F,3222158,406946004,11354,1388924,3210804,405557080,6,48508,4061676,40093,3064638,8415,997038,11970,34,16318,186,6,822,144444.0,39000.0,-69.0,-70.0,-69.0,-60.0,-68.0,-68.0,-68.0,-60.0,-85.0,-90.0,-85.0,-90.0,16.0,20.0,16.0,30.0,1
1113,CC:2F:71:3F:1F:24,7654788,7171452409,4443984,6765895329,3210804,405557080,80,1024181,624677576,1015675,623656028,8506,1021548,971354,619,4448655,451161,80,5528,130000.0,43333.0,-72.0,-65.0,-72.0,-70.0,-72.0,-64.0,-72.0,-70.0,-85.0,-90.0,-85.0,-90.0,13.0,25.0,13.0,20.0,1
1114,F8:59:71:5A:E0:3D,3289265,515884428,78456,110326671,3210809,405557757,0,76181,69044806,71405,68474146,4776,570660,54196,16,81168,2048,0,506,144444.0,43333.0,-66.0,-72.0,-65.0,-70.0,-66.0,-72.0,-64.0,-70.0,-85.0,-90.0,-85.0,-90.0,19.0,18.0,20.0,20.0,1
1115,CC:2F:71:3E:C5:1F,3222163,406946681,11354,1388924,3210809,405557757,6,48508,4061676,40093,3064638,8415,997038,11970,34,16318,186,6,822,144444.0,39000.0,-69.0,-70.0,-69.0,-60.0,-68.0,-68.0,-68.0,-60.0,-85.0,-90.0,-85.0,-90.0,16.0,20.0,16.0,30.0,1
1116,CC:2F:71:3F:1F:24,7656341,7173851172,4445530,6768293213,3210811,405557959,80,1024499,624898230,1015993,623876682,8506,1021548,971672,619,4450249,451268,80,5529,130000.0,43333.0,-72.0,-64.0,-73.0,-70.0,-71.0,-64.0,-72.0,-69.0,-85.0,-90.0,-85.0,-90.0,13.0,26.0,12.0,20.0,1
1117,F8:59:71:5A:E0:3D,3289330,515982532,78519,110424573,3210811,405557959,0,76244,69141826,71468,68571166,4776,570660,54259,16,81231,2049,0,506,144444.0,43333.0,-66.0,-72.0,-65.0,-70.0,-66.0,-71.0,-64.0,-70.0,-85.0,-90.0,-85.0,-90.0,19.0,18.0,20.0,20.0,1
1118,CC:2F:71:3E:C5:1F,3222167,406947085,11354,1388924,3210813,405558161,6,48508,4061676,40093,3064638,8415,997038,11970,34,16318,186,6,822,144444.0,39000.0,-69.0,-70.0,-69.0,-60.0,-68.0,-68.0,-68.0,-60.0,-85.0,-90.0,-85.0,-90.0,16.0,20.0,16.0,30.0,1
1119,CC:2F:71:3F:1F:24,7658067,7176531502,4447254,6770973341,3210813,405558161,80,1024829,625124322,1016323,624102774,8506,1021548,972001,619,4451973,451347,80,5529,117000.0,39000.0,-72.0,-64.0,-72.0,-70.0,-71.0,-64.0,-72.0,-69.0,-85.0,-90.0,-85.0,-90.0,13.0,26.0,13.0,20.0,1
1120,F8:59:71:5A:E0:3D,3289402,516084208,78584,110525583,3210818,405558625,0,76310,69243480,71534,68672820,4776,570660,54324,16,81296,2049,0,506,144444.0,43333.0,-66.0,-72.0,-65.0,-70.0,-66.0,-72.0,-65.0,-70.0,-85.0,-90.0,-85.0,-90.0,19.0,18.0,20.0,20.0,1
1121,CC:2F:71:3E:C5:1F,3222172,406947549,11354,1388924,3210818,405558625,6,48508,4061676,40093,3064638,8415,997038,11970,34,16318,186,6,822,144444.0,39000.0,-69.0,-70.0,-69.0,-60.0,-68.0,-68.0,-68.0,-60.0,-85.0,-90.0,-85.0,-90.0,16.0,20.0,16.0,30.0,1
1122,CC:2F:71:3F:1F:24,7659517,7178761185,4448699,6773202560,3210818,405558625,80,1025160,625344093,1016654,624322545,8506,1021548,972332,619,4453408,451427,80,5530,130000.0,43333.0,-72.0,-64.0,-73.0,-70.0,-71.0,-64.0,-72.0,-69.0,-85.0,-90.0,-85.0,-90.0,13.0,26.0,12.0,20.0,1
1123,F8:59:71:5A:E0:3D,3289469,516185420,78649,110626593,3210820,405558827,0,76375,69343580,71599,68772920,4776,570660,54389,16,81361,2049,0,506,144444.0,43333.0,-66.0,-72.0,-65.0,-70.0,-66.0,-72.0,-65.0,-70.0,-85.0,-91.0,-85.0,-91.0,19.0,19.0,20.0,21.0,1
1124,CC:2F:71:3E:C5:1F,3222174,406947751,11354,1388924,3210820,405558827,6,48508,4061676,40093,3064638,8415,997038,11970,34,16318,186,6,822,144444.0,39000.0,-69.0,-70.0,-69.0,-60.0,-68.0,-68.0,-68.0,-60.0,-85.0,-91.0,-85.0,-91.0,16.0,21.0,16.0,31.0,1
1125,CC:2F:71:3F:1F:24,7660618,7180450975,4449796,6774891946,3210822,405559029,80,1025453,625564453,1016947,624542905,8506,1021548,972625,619,4454515,451454,80,5531,130000.0,43333.0,-72.0,-64.0,-73.0,-69.0,-71.0,-64.0,-72.0,-69.0,-85.0,-91.0,-85.0,-91.0,13.0,27.0,12.0,22.0,1
1126,F8:59:71:5A:E0:3D,3289538,516286834,78714,110727603,3210824,405559231,0,76440,69443680,71664,68873020,4776,570660,54454,16,81426,2049,0,506,144444.0,43333.0,-66.0,-72.0,-65.0,-71.0,-66.0,-71.0,-64.0,-70.0,-85.0,-91.0,-85.0,-90.0,19.0,19.0,20.0,19.0,1
1127,CC:2F:71:3E:C5:1F,3222179,406948215,11354,1388924,3210825,405559291,6,48508,4061676,40093,3064638,8415,997038,11970,34,16318,186,6,822,144444.0,39000.0,-69.0,-70.0,-69.0,-60.0,-68.0,-68.0,-68.0,-60.0,-85.0,-91.0,-85.0,-90.0,16.0,21.0,16.0,30.0,1
1128,CC:2F:71:3F:1F:24,7661416,7181656517,4450589,6776097024,3210827,405559493,80,1025720,625780487,1017214,624758939,8506,1021548,972892,619,4455300,451489,80,5531,130000.0,43333.0,-72.0,-65.0,-73.0,-70.0,-72.0,-65.0,-72.0,-70.0,-85.0,-91.0,-85.0,-90.0,13.0,26.0,12.0,20.0,1
1129,F8:59:71:5A:E0:3D,3289607,516383824,78777,110824067,3210830,405559757,0,76504,69540806,71728,68970146,4776,570660,54518,16,81489,2050,0,506,144444.0,43333.0,-66.0,-72.0,-64.0,-70.0,-66.0,-72.0,-64.0,-70.0,-85.0,-91.0,-85.0,-90.0,19.0,19.0,21.0,20.0,1
1130,CC:2F:71:3E:C5:1F,3222184,406948681,11354,1388924,3210830,405559757,6,48508,4061676,40093,3064638,8415,997038,11970,34,16318,186,6,822,144444.0,39000.0,-69.0,-70.0,-69.0,-60.0,-68.0,-68.0,-68.0,-60.0,-85.0,-91.0,-85.0,-90.0,16.0,21.0,16.0,30.0,1
1131,CC:2F:71:3F:1F:24,7662288,7182984759,4451458,6777425002,3210830,405559757,80,1026004,625995535,1017497,624973869,8507,1021666,973176,619,4456176,451527,80,5533,130000.0,43333.0,-73.0,-65.0,-73.0,-70.0,-72.0,-64.0,-72.0,-69.0,-85.0,-91.0,-85.0,-90.0,12.0,26.0,12.0,20.0,1
1132,F8:59:71:5A:E0:3D,3289676,516485238,78842,110925077,3210834,405560161,0,76569,69640920,71793,69070260,4776,570660,54582,16,81554,2051,0,506,144444.0,43333.0,-66.0,-72.0,-65.0,-70.0,-66.0,-72.0,-65.0,-70.0,-85.0,-91.0,-85.0,-90.0,19.0,19.0,20.0,20.0,1
1133,CC:2F:71:3E:C5:1F,3222188,406949085,11354,1388924,3210834,405560161,6,48508,4061676,40093,3064638,8415,997038,11970,34,16318,186,6,822,144444.0,39000.0,-69.0,-70.0,-69.0,-60.0,-68.0,-68.0,-68.0,-60.0,-85.0,-91.0,-85.0,-90.0,16.0,21.0,16.0,30.0,1
1134,CC:2F:71:3F:1F:24,7663494,7184831168,4452660,6779271007,3210834,405560161,80,1026314,626219930,1017807,625198264,8507,1021666,973486,619,4457379,451554,80,5534,130000.0,43333.0,-71.0,-64.0,-71.0,-69.0,-71.0,-63.0,-71.0,-69.0,-85.0,-91.0,-85.0,-90.0,14.0,27.0,14.0,21.0,1
1135,F8:59:71:5A:E0:3D,3289746,516586712,78907,111026087,3210839,405560625,0,76634,69741020,71858,69170360,4776,570660,54647,16,81619,2052,0,506,144444.0,43333.0,-67.0,-72.0,-65.0,-70.0,-66.0,-72.0,-64.0,-70.0,-85.0,-90.0,-85.0,-90.0,18.0,18.0,20.0,20.0,1
1136,CC:2F:71:3E:C5:1F,3222193,406949549,11354,1388924,3210839,405560625,6,48508,4061676,40093,3064638,8415,997038,11970,34,16318,186,6,822,144444.0,39000.0,-69.0,-70.0,-69.0,-60.0,-68.0,-68.0,-68.0,-60.0,-85.0,-90.0,-85.0,-90.0,16.0,20.0,16.0,30.0,1
1137,CC:2F:71:3F:1F:24,7664496,7186361570,4453657,6780800945,3210839,405560625,80,1026589,626433822,1018082,625412156,8507,1021666,973761,619,4458375,451659,80,5534,130000.0,43333.0,-71.0,-64.0,-72.0,-69.0,-71.0,-64.0,-72.0,-69.0,-85.0,-90.0,-85.0,-90.0,14.0,26.0,13.0,21.0,1
1138,F8:59:71:5A:E0:3D,3289811,516684816,78970,111123989,3210841,405560827,0,76698,69839594,71922,69268934,4776,570660,54710,16,81682,2052,0,506,144444.0,43333.0,-66.0,-71.0,-65.0,-70.0,-66.0,-71.0,-65.0,-70.0,-85.0,-90.0,-85.0,-90.0,19.0,19.0,20.0,20.0,1
1139,CC:2F:71:3E:C5:1F,3222195,406949751,11354,1388924,3210841,405560827,6,48508,4061676,40093,3064638,8415,997038,11970,34,16318,186,6,822,144444.0,39000.0,-69.0,-70.0,-69.0,-60.0,-68.0,-68.0,-68.0,-60.0,-85.0,-90.0,-85.0,-90.0,16.0,20.0,16.0,30.0,1
1140,CC:2F:71:3F:1F:24,7665555,7187985118,4454714,6782424291,3210841,405560827,80,1026851,626645038,1018344,625623372,8507,1021666,974023,619,4459404,451717,80,5536,130000.0,43333.0,-72.0,-64.0,-72.0,-69.0,-71.0,-64.0,-72.0,-69.0,-85.0,-90.0,-85.0,-90.0,13.0,26.0,13.0,21.0,1
1141,F8:59:71:5A:E0:3D,3289880,516783324,79033,111221891,3210847,405561433,0,76761,69936614,71985,69365954,4776,570660,54773,16,81745,2053,0,506,144444.0,43333.0,-66.0,-72.0,-65.0,-70.0,-66.0,-72.0,-65.0,-70.0,-85.0,-90.0,-85.0,-90.0,19.0,18.0,20.0,20.0,1
1142,CC:2F:71:3E:C5:1F,3222201,406950357,11354,1388924,3210847,405561433,6,48508,4061676,40093,3064638,8415,997038,11970,34,16318,186,6,822,144444.0,39000.0,-69.0,-70.0,-69.0,-60.0,-68.0,-68.0,-68.0,-60.0,-85.0,-90.0,-85.0,-90.0,16.0,20.0,16.0,30.0,1
1143,CC:2F:71:3F:1F:24,7666638,7189644974,4455791,6784083541,3210847,405561433,80,1027136,626868778,1018629,625847112,8507,1021666,974306,619,4460481,451761,80,5537,130000.0,43333.0,-71.0,-65.0,-74.0,-68.0,-70.0,-65.0,-73.0,-68.0,-85.0,-90.0,-85.0,-90.0,14.0,25.0,11.0,22.0,1
1144,F8:59:71:5A:E0:3D,3289950,516887704,79100,111326009,3210850,405561695,0,76831,70044456,72055,69473796,4776,570660,54840,16,81812,2054,0,506,144444.0,43333.0,-67.0,-72.0,-65.0,-71.0,-67.0,-72.0,-65.0,-70.0,-85.0,-91.0,-85.0,-90.0,18.0,19.0,20.0,19.0,1
1145,CC:2F:71:3E:C5:1F,3222204,406950619,11354,1388924,3210850,405561695,6,48508,4061676,40093,3064638,8415,997038,11970,34,16318,186,6,822,144444.0,39000.0,-69.0,-70.0,-69.0,-60.0,-68.0,-68.0,-68.0,-60.0,-85.0,-91.0,-85.0,-90.0,16.0,21.0,16.0,30.0,1
1146,CC:2F:71:3F:1F:24,7667969,7191689813,4457119,6786128118,3210850,405561695,80,1027454,627091044,1018947,626069378,8507,1021666,974624,619,4461836,451781,80,5537,130000.0,39000.0,-71.0,-65.0,-74.0,-69.0,-71.0,-65.0,-73.0,-68.0,-85.0,-91.0,-85.0,-90.0,14.0,26.0,11.0,21.0,1
1147,F8:59:71:5A:E0:3D,3290020,516987766,79164,111425465,3210856,405562301,0,76897,70146138,72121,69575478,4776,570660,54905,16,81876,2055,0,506,144444.0,43333.0,-67.0,-72.0,-65.0,-70.0,-66.0,-72.0,-65.0,-70.0,-85.0,-91.0,-85.0,-90.0,18.0,19.0,20.0,20.0,1
1148,CC:2F:71:3E:C5:1F,3222210,406951225,11354,1388924,3210856,405562301,6,48508,4061676,40093,3064638,8415,997038,11970,34,16318,186,6,822,144444.0,39000.0,-69.0,-70.0,-69.0,-60.0,-68.0,-68.0,-68.0,-60.0,-85.0,-91.0,-85.0,-90.0,16.0,21.0,16.0,30.0,1
1149,CC:2F:71:3F:1F:24,7669534,7194108753,4458678,6788546452,3210856,405562301,80,1027795,627317074,1019288,626295408,8507,1021666,974965,619,4463383,451883,80,5537,144444.0,43333.0,-72.0,-65.0,-74.0,-68.0,-71.0,-65.0,-73.0,-68.0,-85.0,-91.0,-85.0,-90.0,13.0,26.0,11.0,22.0,1
1150,F8:59:71:5A:E0:3D,3290086,517087424,79228,111524921,3210858,405562503,0,76961,70244712,72185,69674052,4776,570660,54968,16,81940,2055,0,506,144444.0,43333.0,-67.0,-72.0,-65.0,-71.0,-67.0,-72.0,-65.0,-70.0,-85.0,-91.0,-85.0,-90.0,18.0,19.0,20.0,19.0,1
1151,CC:2F:71:3E:C5:1F,3222212,406951427,11354,1388924,3210858,405562503,6,48508,4061676,40093,3064638,8415,997038,11970,34,16318,186,6,822,144444.0,39000.0,-69.0,-70.0,-69.0,-60.0,-68.0,-68.0,-68.0,-60.0,-85.0,-91.0,-85.0,-90.0,16.0,21.0,16.0,30.0,1
1152,CC:2F:71:3F:1F:24,7670396,7195422797,4459537,6789860074,3210859,405562723,80,1028075,627531712,1019568,626510046,8507,1021666,975245,619,4464256,451978,80,5538,130000.0,39000.0,-71.0,-65.0,-73.0,-68.0,-70.0,-65.0,-73.0,-68.0,-85.0,-91.0,-85.0,-90.0,14.0,26.0,12.0,22.0,1
1153,F8:59:71:5A:E0:3D,3290165,517198644,79299,111635255,3210866,405563389,0,77032,70354052,72256,69783392,4776,570660,55039,16,82011,2055,0,506,144444.0,43333.0,-67.0,-72.0,-65.0,-71.0,-66.0,-71.0,-64.0,-70.0,-86.0,-91.0,-86.0,-91.0,19.0,19.0,21.0,20.0,1
1154,CC:2F:71:3E:C5:1F,3222220,406952313,11354,1388924,3210866,405563389,6,48508,4061676,40093,3064638,8415,997038,11970,34,16318,186,6,822,144444.0,39000.0,-69.0,-70.0,-69.0,-60.0,-68.0,-68.0,-68.0,-60.0,-86.0,-91.0,-86.0,-91.0,17.0,21.0,17.0,31.0,1
1155,CC:2F:71:3F:1F:24,7671104,7196485577,4460238,6790922188,3210866,405563389,80,1028331,627760698,1019824,626739032,8507,1021666,975501,619,4464957,452282,80,5539,130000.0,43333.0,-71.0,-65.0,-73.0,-68.0,-70.0,-65.0,-73.0,-68.0,-86.0,-91.0,-86.0,-91.0,15.0,26.0,13.0,23.0,1
1156,F8:59:71:5A:E0:3D,3290230,517295467,79361,111731603,3210869,405563864,0,77095,70451086,72319,69880426,4776,570660,55101,16,82073,2056,0,506,144444.0,43333.0,-67.0,-72.0,-65.0,-71.0,-66.0,-71.0,-65.0,-70.0,-86.0,-91.0,-86.0,-91.0,19.0,19.0,21.0,20.0,1
1157,CC:2F:71:3E:C5:1F,3222223,406952788,11354,1388924,3210869,405563864,6,48508,4061676,40093,3064638,8415,997038,11970,34,16318,186,6,822,144444.0,39000.0,-69.0,-70.0,-69.0,-60.0,-68.0,-68.0,-68.0,-60.0,-86.0,-91.0,-86.0,-91.0,17.0,21.0,17.0,31.0,1
1158,CC:2F:71:3F:1F:24,7671886,7197663141,4461017,6792099277,3210869,405563864,80,1028609,627969774,1020102,626948108,8507,1021666,975779,619,4465723,452324,80,5539,130000.0,43333.0,-71.0,-65.0,-74.0,-68.0,-71.0,-65.0,-73.0,-68.0,-86.0,-91.0,-86.0,-91.0,15.0,26.0,12.0,23.0,1
1159,F8:59:71:5A:E0:3D,3290297,517393773,79424,111829505,3210873,405564268,0,77160,70551200,72384,69980540,4776,570660,55165,16,82136,2056,0,506,144444.0,43333.0,-67.0,-72.0,-65.0,-71.0,-67.0,-72.0,-65.0,-70.0,-86.0,-91.0,-86.0,-91.0,19.0,19.0,21.0,20.0,1
1160,CC:2F:71:3E:C5:1F,3222227,406953192,11354,1388924,3210873,405564268,6,48508,4061676,40093,3064638,8415,997038,11970,34,16318,186,6,822,144444.0,39000.0,-69.0,-70.0,-69.0,-60.0,-68.0,-68.0,-68.0,-60.0,-86.0,-91.0,-86.0,-91.0,17.0,21.0,17.0,31.0,1
1161,CC:2F:71:3F:1F:24,7672912,7199233157,4462039,6793668889,3210873,405564268,80,1028881,628189176,1020374,627167510,8507,1021666,976049,619,4466758,452354,80,5540,130000.0,43333.0,-71.0,-64.0,-74.0,-68.0,-71.0,-64.0,-73.0,-68.0,-86.0,-91.0,-86.0,-91.0,15.0,27.0,12.0,23.0,1
1162,F8:59:71:5A:E0:3D,3290365,517491971,79487,111927239,3210878,405564732,0,77224,70649774,72448,70079114,4776,570660,55228,16,82199,2059,0,506,144444.0,43333.0,-67.0,-72.0,-65.0,-71.0,-67.0,-72.0,-65.0,-70.0,-86.0,-91.0,-86.0,-91.0,19.0,19.0,21.0,20.0,1
1163,CC:2F:71:3E:C5:1F,3222232,406953656,11354,1388924,3210878,405564732,6,48508,4061676,40093,3064638,8415,997038,11970,34,16318,186,6,822,144444.0,39000.0,-69.0,-70.0,-69.0,-60.0,-68.0,-68.0,-68.0,-60.0,-86.0,-91.0,-86.0,-91.0,17.0,21.0,17.0,31.0,1
1164,CC:2F:71:3F:1F:24,7674308,7201385315,4463430,6795820583,3210878,405564732,80,1029175,628405420,1020668,627383754,8507,1021666,976343,619,4468149,452452,80,5541,130000.0,43333.0,-72.0,-65.0,-74.0,-68.0,-71.0,-65.0,-73.0,-68.0,-86.0,-91.0,-86.0,-91.0,14.0,26.0,12.0,23.0,1
1165,F8:59:71:5A:E0:3D,3290431,517591629,79551,112026695,3210880,405564934,0,77291,70753010,72515,70182350,4776,570660,55291,16,82263,2060,0,506,144444.0,43333.0,-68.0,-73.0,-66.0,-71.0,-67.0,-72.0,-65.0,-71.0,-86.0,-91.0,-86.0,-91.0,18.0,18.0,20.0,20.0,1
1166,CC:2F:71:3E:C5:1F,3222236,406954060,11354,1388924,3210882,405565136,6,48508,4061676,40093,3064638,8415,997038,11970,34,16318,186,6,822,144444.0,39000.0,-69.0,-70.0,-69.0,-60.0,-68.0,-68.0,-68.0,-60.0,-86.0,-91.0,-86.0,-91.0,17.0,21.0,17.0,31.0,1
1167,CC:2F:71:3F:1F:24,7675526,7203258235,4464644,6797693099,3210882,405565136,80,1029496,628630490,1020989,627608824,8507,1021666,976664,619,4469333,452474,80,5542,130000.0,43333.0,-72.0,-65.0,-74.0,-68.0,-71.0,-64.0,-73.0,-67.0,-86.0,-91.0,-86.0,-91.0,14.0,26.0,12.0,23.0,1
1168,F8:59:71:5A:E0:3D,3290502,517693249,79616,112127705,3210886,405565544,0,77357,70854664,72581,70284004,4776,570660,55356,16,82328,2061,0,506,144444.0,43333.0,-67.0,-72.0,-66.0,-71.0,-67.0,-71.0,-65.0,-70.0,-86.0,-91.0,-86.0,-91.0,19.0,19.0,20.0,20.0,1
1169,CC:2F:71:3E:C5:1F,3222243,406954730,11354,1388924,3210889,405565806,6,48508,4061676,40093,3064638,8415,997038,11970,34,16318,186,6,822,144444.0,39000.0,-69.0,-70.0,-69.0,-60.0,-68.0,-68.0,-68.0,-60.0,-86.0,-91.0,-86.0,-91.0,17.0,21.0,17.0,31.0,1
1170,CC:2F:71:3F:1F:24,7677014,7205547355,4466125,6799981549,3210889,405565806,80,1029801,628855715,1021294,627834049,8507,1021666,976969,619,4470844,452594,80,5543,130000.0,39000.0,-71.0,-64.0,-73.0,-68.0,-71.0,-64.0,-72.0,-68.0,-86.0,-91.0,-86.0,-91.0,15.0,27.0,13.0,23.0,1
1171,F8:59:71:5A:E0:3D,3290571,517796075,79682,112230269,3210889,405565806,0,77424,70957858,72648,70387198,4776,570660,55422,16,82394,2063,0,506,144444.0,43333.0,-67.0,-72.0,-65.0,-70.0,-66.0,-71.0,-64.0,-70.0,-86.0,-91.0,-86.0,-91.0,19.0,19.0,21.0,21.0,1
1172,CC:2F:71:3E:C5:1F,3222245,406954932,11354,1388924,3210891,405566008,6,48508,4061676,40093,3064638,8415,997038,11970,34,16318,186,6,822,144444.0,39000.0,-69.0,-70.0,-69.0,-60.0,-68.0,-68.0,-68.0,-60.0,-86.0,-91.0,-86.0,-91.0,17.0,21.0,17.0,31.0,1
1173,CC:2F:71:3F:1F:24,7678741,7208215103,4467846,6802648687,3210895,405566416,80,1030148,629079727,1021641,628058061,8507,1021666,977316,619,4472564,452669,80,5543,130000.0,43333.0,-71.0,-64.0,-72.0,-68.0,-70.0,-64.0,-72.0,-68.0,-86.0,-91.0,-86.0,-91.0,15.0,27.0,14.0,23.0,1
1174,F8:59:71:5A:E0:3D,3290644,517896459,79747,112329841,3210897,405566618,0,77490,71059526,72714,70488866,4776,570660,55486,16,82459,2063,0,506,144444.0,43333.0,-67.0,-72.0,-64.0,-71.0,-67.0,-72.0,-64.0,-70.0,-86.0,-91.0,-86.0,-91.0,19.0,19.0,22.0,20.0,1
1175,CC:2F:71:3E:C5:1F,3222252,406955658,11355,1389040,3210897,405566618,6,48510,4061816,40095,3064778,8415,997038,11970,34,16319,186,6,822,144444.0,39000.0,-66.0,-62.0,-67.0,-60.0,-67.0,-66.0,-67.0,-60.0,-86.0,-91.0,-86.0,-91.0,20.0,29.0,19.0,31.0,1
1176,CC:2F:71:3F:1F:24,7679785,7209816239,4468888,6804249621,3210897,405566618,80,1030422,629294963,1021915,628273297,8507,1021666,977590,619,4473607,452820,80,5543,115556.0,26000.0,-70.0,-64.0,-72.0,-69.0,-69.0,-64.0,-71.0,-68.0,-86.0,-91.0,-86.0,-91.0,16.0,27.0,14.0,22.0,1
1177,F8:59:71:5A:E0:3D,3290711,517996177,79811,112429297,3210900,405566880,0,77554,71158086,72778,70587426,4776,570660,55550,16,82523,2063,0,506,144444.0,43333.0,-67.0,-72.0,-65.0,-70.0,-67.0,-72.0,-65.0,-70.0,-86.0,-91.0,-86.0,-91.0,19.0,19.0,21.0,21.0,1
1178,CC:2F:71:3E:C5:1F,3222255,406955920,11355,1389040,3210900,405566880,6,48510,4061816,40095,3064778,8415,997038,11970,34,16319,186,6,822,144444.0,39000.0,-66.0,-62.0,-67.0,-60.0,-67.0,-66.0,-67.0,-60.0,-86.0,-91.0,-86.0,-91.0,20.0,29.0,19.0,31.0,1
1179,CC:2F:71:3F:1F:24,7680640,7211116831,4469739,6805549883,3210901,405566948,80,1030693,629508739,1022186,628487073,8507,1021666,977861,619,4474458,452922,80,5543,115556.0,28889.0,-70.0,-64.0,-72.0,-69.0,-70.0,-64.0,-72.0,-69.0,-86.0,-91.0,-86.0,-91.0,16.0,27.0,14.0,22.0,1
1180,F8:59:71:5A:E0:3D,3290782,518096355,79876,112528869,3210906,405567486,0,77621,71259860,72845,70689200,4776,570660,55615,16,82588,2063,0,507,144444.0,43333.0,-67.0,-72.0,-65.0,-71.0,-66.0,-72.0,-65.0,-71.0,-86.0,-91.0,-86.0,-91.0,19.0,19.0,21.0,20.0,1
1181,CC:2F:71:3E:C5:1F,3222261,406956526,11355,1389040,3210906,405567486,6,48510,4061816,40095,3064778,8415,997038,11970,34,16319,186,6,822,144444.0,39000.0,-66.0,-62.0,-67.0,-60.0,-67.0,-66.0,-67.0,-60.0,-86.0,-91.0,-86.0,-91.0,20.0,29.0,19.0,31.0,1
1182,CC:2F:71:3F:1F:24,7681780,7212863881,4470874,6807296395,3210906,405567486,80,1031007,629727219,1022500,628705553,8507,1021666,978174,619,4475576,452957,80,5543,115556.0,28889.0,-70.0,-64.0,-72.0,-68.0,-70.0,-64.0,-72.0,-68.0,-86.0,-91.0,-86.0,-91.0,16.0,27.0,14.0,23.0,1
1183,F8:59:71:5A:E0:3D,3290849,518193416,79938,112625217,3210911,405568199,0,77684,71356894,72908,70786234,4776,570660,55677,16,82650,2063,0,507,144444.0,43333.0,-67.0,-72.0,-65.0,-71.0,-66.0,-72.0,-65.0,-70.0,-86.0,-91.0,-86.0,-90.0,19.0,19.0,21.0,19.0,1
1184,CC:2F:71:3E:C5:1F,3222266,406957239,11355,1389040,3210911,405568199,6,48510,4061816,40095,3064778,8415,997038,11970,34,16319,186,6,822,144444.0,39000.0,-66.0,-62.0,-67.0,-60.0,-67.0,-66.0,-67.0,-60.0,-86.0,-91.0,-86.0,-90.0,20.0,29.0,19.0,30.0,1
1185,CC:2F:71:3F:1F:24,7682581,7214068591,4471670,6808500392,3210911,405568199,80,1031298,629943566,1022790,628921782,8508,1021784,978464,619,4476389,452968,80,5543,115556.0,28889.0,-70.0,-64.0,-71.0,-68.0,-70.0,-64.0,-72.0,-68.0,-86.0,-91.0,-86.0,-90.0,16.0,27.0,15.0,22.0,1
1186,F8:59:71:5A:E0:3D,3290917,518291782,80001,112723119,3210916,405568663,0,77749,71457008,72973,70886348,4776,570660,55741,16,82713,2064,0,507,144444.0,43333.0,-66.0,-72.0,-65.0,-70.0,-66.0,-71.0,-65.0,-70.0,-86.0,-91.0,-86.0,-90.0,20.0,19.0,21.0,20.0,1
1187,CC:2F:71:3E:C5:1F,3222273,406957905,11355,1389040,3210918,405568865,6,48510,4061816,40095,3064778,8415,997038,11970,34,16319,186,6,822,144444.0,39000.0,-66.0,-62.0,-67.0,-60.0,-67.0,-66.0,-67.0,-60.0,-86.0,-91.0,-86.0,-90.0,20.0,29.0,19.0,30.0,1
1188,CC:2F:71:3F:1F:24,7683450,7215383026,4472530,6809813712,3210920,405569314,80,1031580,630164156,1023072,629142372,8508,1021784,978746,619,4477249,453049,80,5543,130000.0,39000.0,-71.0,-64.0,-72.0,-69.0,-71.0,-64.0,-72.0,-69.0,-86.0,-91.0,-86.0,-90.0,15.0,27.0,14.0,21.0,1
1189,F8:59:71:5A:E0:3D,3290990,518396753,80068,112827237,3210922,405569516,0,77815,71558648,73039,70987988,4776,570660,55807,16,82779,2065,0,507,144444.0,43333.0,-67.0,-72.0,-65.0,-71.0,-66.0,-72.0,-65.0,-70.0,-86.0,-91.0,-86.0,-90.0,19.0,19.0,21.0,19.0,1
1190,CC:2F:71:3E:C5:1F,3222277,406958556,11355,1389040,3210922,405569516,6,48510,4061816,40095,3064778,8415,997038,11970,34,16319,186,6,822,144444.0,39000.0,-66.0,-62.0,-67.0,-60.0,-67.0,-66.0,-67.0,-60.0,-86.0,-91.0,-86.0,-90.0,20.0,29.0,19.0,30.0,1
1191,CC:2F:71:3F:1F:24,7684519,7217023354,4473597,6811453838,3210922,405569516,80,1031883,630387382,1023375,629365598,8508,1021784,979048,619,4478316,453344,80,5544,104000.0,26000.0,-71.0,-64.0,-73.0,-70.0,-71.0,-64.0,-72.0,-70.0,-86.0,-91.0,-86.0,-91.0,15.0,27.0,13.0,21.0,1
1192,F8:59:71:5A:E0:3D,3291059,518495508,80131,112925139,3210928,405570369,0,77879,71657208,73103,71086548,4776,570660,55871,16,82843,2066,0,507,144444.0,43333.0,-67.0,-72.0,-65.0,-70.0,-66.0,-72.0,-65.0,-70.0,-86.0,-91.0,-86.0,-91.0,19.0,19.0,21.0,21.0,1
1193,CC:2F:71:3E:C5:1F,3222283,406959409,11355,1389040,3210928,405570369,6,48510,4061816,40095,3064778,8415,997038,11970,34,16319,186,6,822,144444.0,39000.0,-66.0,-62.0,-67.0,-60.0,-67.0,-66.0,-67.0,-60.0,-86.0,-91.0,-86.0,-91.0,20.0,29.0,19.0,31.0,1
1194,CC:2F:71:3F:1F:24,7685498,7218515529,4474570,6812945160,3210928,405570369,80,1032162,630599018,1023654,629577234,8508,1021784,979327,619,4479288,453360,80,5544,86667.0,14444.0,-71.0,-64.0,-72.0,-70.0,-71.0,-64.0,-72.0,-69.0,-86.0,-91.0,-86.0,-91.0,15.0,27.0,14.0,21.0,1
1195,F8:59:71:5A:E0:3D,3291131,518597431,80196,113026149,3210935,405571282,0,77943,71755768,73167,71185108,4776,570660,55935,16,82908,2068,0,507,144444.0,43333.0,-67.0,-72.0,-65.0,-70.0,-66.0,-72.0,-65.0,-70.0,-86.0,-91.0,-86.0,-90.0,19.0,19.0,21.0,20.0,1
1196,CC:2F:71:3E:C5:1F,3222290,406960322,11355,1389040,3210935,405571282,6,48510,4061816,40095,3064778,8415,997038,11970,34,16319,186,6,822,144444.0,39000.0,-66.0,-62.0,-67.0,-60.0,-67.0,-66.0,-67.0,-60.0,-86.0,-91.0,-86.0,-90.0,20.0,29.0,19.0,30.0,1
1197,CC:2F:71:3F:1F:24,7686602,7220195910,4475667,6814624628,3210935,405571282,80,1032473,630820632,1023965,629798848,8508,1021784,979638,619,4480385,453376,80,5544,86667.0,14444.0,-71.0,-64.0,-72.0,-70.0,-71.0,-64.0,-72.0,-70.0,-86.0,-91.0,-86.0,-90.0,15.0,27.0,14.0,20.0,1
1198,F8:59:71:5A:E0:3D,3291199,518697291,80260,113125605,3210939,405571686,0,78007,71854328,73231,71283668,4776,570660,55999,16,82972,2069,0,507,144444.0,43333.0,-67.0,-72.0,-65.0,-70.0,-66.0,-72.0,-65.0,-70.0,-86.0,-91.0,-86.0,-90.0,19.0,19.0,21.0,20.0,1
1199,CC:2F:71:3E:C5:1F,3222295,406960999,11355,1389040,3210940,405571959,6,48510,4061816,40095,3064778,8415,997038,11970,34,16319,186,6,822,144444.0,39000.0,-66.0,-62.0,-67.0,-60.0,-67.0,-66.0,-67.0,-60.0,-86.0,-91.0,-86.0,-90.0,20.0,29.0,19.0,30.0,1
1200,CC:2F:71:3F:1F:24,7688168,7222615453,4477228,6817043494,3210940,405571959,80,1032845,631055998,1024337,630034214,8508,1021784,980010,619,4481946,453501,80,5545,115556.0,26000.0,-71.0,-64.0,-73.0,-70.0,-71.0,-64.0,-72.0,-69.0,-86.0,-91.0,-86.0,-90.0,15.0,27.0,13.0,20.0,1
1201,F8:59:71:5A:E0:3D,3291270,518800532,80326,113228169,3210944,405572363,0,78073,71955968,73297,71385308,4776,570660,56065,16,83038,2070,0,507,144444.0,43333.0,-67.0,-72.0,-65.0,-70.0,-66.0,-71.0,-64.0,-70.0,-86.0,-91.0,-86.0,-90.0,19.0,19.0,21.0,20.0,1
1202,CC:2F:71:3E:C5:1F,3222299,406961403,11355,1389040,3210944,405572363,6,48511,4061934,40095,3064778,8416,997156,11971,34,16319,186,6,823,144444.0,39000.0,-69.0,-70.0,-69.0,-61.0,-67.0,-66.0,-67.0,-60.0,-86.0,-91.0,-86.0,-90.0,17.0,21.0,17.0,29.0,1
1203,CC:2F:71:3F:1F:24,7689314,7224373305,4478369,6818800880,3210945,405572425,80,1033124,631267576,1024616,630245792,8508,1021784,980289,619,4483088,453572,80,5546,115556.0,28889.0,-70.0,-64.0,-71.0,-70.0,-71.0,-64.0,-71.0,-69.0,-86.0,-91.0,-86.0,-90.0,16.0,27.0,15.0,20.0,1
1204,F8:59:71:5A:E0:3D,3291340,518900514,80390,113327625,3210950,405572889,0,78139,72057622,73363,71486962,4776,570660,56130,16,83102,2071,0,507,144444.0,43333.0,-67.0,-72.0,-65.0,-70.0,-66.0,-72.0,-65.0,-70.0,-87.0,-92.0,-87.0,-91.0,20.0,20.0,22.0,21.0,1
1205,CC:2F:71:3E:C5:1F,3222305,406961929,11355,1389040,3210950,405572889,6,48512,4062004,40096,3064848,8416,997156,11971,34,16319,186,6,823,144444.0,39000.0,-69.0,-70.0,-69.0,-61.0,-67.0,-66.0,-67.0,-60.0,-87.0,-92.0,-87.0,-91.0,18.0,22.0,18.0,30.0,1
1206,CC:2F:71:3F:1F:24,7690819,7226697441,4479869,6821124552,3210950,405572889,80,1033468,631495318,1024960,630473534,8508,1021784,980632,619,4484588,453795,80,5547,115556.0,28889.0,-70.0,-64.0,-72.0,-70.0,-71.0,-64.0,-72.0,-69.0,-87.0,-92.0,-87.0,-91.0,17.0,28.0,15.0,21.0,1
1207,F8:59:71:5A:E0:3D,3291406,519000172,80454,113427081,3210952,405573091,0,78202,72154642,73426,71583982,4776,570660,56193,16,83166,2072,0,507,144444.0,43333.0,-67.0,-72.0,-65.0,-70.0,-66.0,-72.0,-65.0,-70.0,-87.0,-92.0,-87.0,-91.0,20.0,20.0,22.0,21.0,1
1208,CC:2F:71:3E:C5:1F,3222307,406962131,11355,1389040,3210952,405573091,6,48512,4062004,40096,3064848,8416,997156,11971,34,16319,186,6,823,144444.0,39000.0,-69.0,-70.0,-69.0,-61.0,-67.0,-66.0,-67.0,-60.0,-87.0,-92.0,-87.0,-91.0,18.0,22.0,18.0,30.0,1
1209,CC:2F:71:3F:1F:24,7691870,7228299334,4480916,6822726041,3210954,405573293,80,1033782,631714366,1025274,630692582,8508,1021784,980946,619,4485634,453869,80,5547,115556.0,28889.0,-70.0,-64.0,-72.0,-70.0,-70.0,-64.0,-72.0,-69.0,-87.0,-92.0,-87.0,-91.0,17.0,28.0,15.0,21.0,1
1210,F8:59:71:5A:E0:3D,3291473,519098478,80517,113524983,3210956,405573495,0,78265,72251662,73489,71681002,4776,570660,56256,16,83229,2072,0,507,144444.0,43333.0,-67.0,-73.0,-65.0,-71.0,-66.0,-72.0,-65.0,-70.0,-87.0,-92.0,-87.0,-91.0,20.0,19.0,22.0,20.0,1
1211,CC:2F:71:3E:C5:1F,3222311,406962535,11355,1389040,3210956,405573495,6,48512,4062004,40096,3064848,8416,997156,11971,34,16319,186,6,823,144444.0,39000.0,-69.0,-70.0,-69.0,-61.0,-67.0,-66.0,-67.0,-60.0,-87.0,-92.0,-87.0,-91.0,18.0,22.0,18.0,30.0,1
1212,CC:2F:71:3F:1F:24,7692889,7229858226,4481930,6824284469,3210959,405573757,80,1034076,631929050,1025568,630907266,8508,1021784,981240,619,4486647,453893,80,5547,117000.0,39000.0,-71.0,-64.0,-71.0,-70.0,-70.0,-64.0,-72.0,-69.0,-87.0,-92.0,-87.0,-91.0,16.0,28.0,16.0,21.0,1
1213,F8:59:71:5A:E0:3D,3291542,519196906,80580,113622885,3210962,405574021,0,78329,72348800,73552,71778022,4777,570778,56320,16,83292,2073,0,507,144444.0,43333.0,-67.0,-73.0,-65.0,-71.0,-67.0,-72.0,-65.0,-70.0,-87.0,-92.0,-87.0,-91.0,20.0,19.0,22.0,20.0,1
1214,CC:2F:71:3E:C5:1F,3222317,406963061,11355,1389040,3210962,405574021,6,48512,4062004,40096,3064848,8416,997156,11971,34,16319,186,6,823,144444.0,39000.0,-69.0,-70.0,-69.0,-61.0,-67.0,-66.0,-67.0,-60.0,-87.0,-92.0,-87.0,-91.0,18.0,22.0,18.0,30.0,1
1215,CC:2F:71:3F:1F:24,7694000,7231563466,4483038,6825989445,3210962,405574021,80,1034348,632141634,1025840,631119850,8508,1021784,981512,619,4487742,453993,80,5547,115556.0,28889.0,-72.0,-64.0,-73.0,-70.0,-71.0,-64.0,-72.0,-70.0,-87.0,-92.0,-87.0,-91.0,15.0,28.0,14.0,21.0,1
1216,F8:59:71:5A:E0:3D,3291610,519296820,80644,113722229,3210966,405574591,0,78393,72447360,73616,71876582,4777,570778,56384,16,83356,2073,0,507,144444.0,43333.0,-67.0,-72.0,-66.0,-71.0,-66.0,-72.0,-65.0,-70.0,-87.0,-92.0,-87.0,-91.0,20.0,20.0,21.0,20.0,1
1217,CC:2F:71:3E:C5:1F,3222323,406963833,11355,1389040,3210968,405574793,6,48512,4062004,40096,3064848,8416,997156,11971,34,16319,186,6,823,144444.0,39000.0,-69.0,-70.0,-69.0,-61.0,-67.0,-66.0,-67.0,-60.0,-87.0,-92.0,-87.0,-91.0,18.0,22.0,18.0,30.0,1
1218,CC:2F:71:3F:1F:24,7695378,7233686150,4484410,6828111357,3210968,405574793,80,1034695,632369648,1026187,631347864,8508,1021784,981858,619,4489126,454100,80,5547,115556.0,28889.0,-71.0,-64.0,-73.0,-70.0,-71.0,-64.0,-72.0,-69.0,-87.0,-92.0,-87.0,-91.0,16.0,28.0,14.0,21.0,1
1219,F8:59:71:5A:E0:3D,3291680,519396882,80708,113821685,3210972,405575197,0,78458,72547488,73681,71976710,4777,570778,56447,16,83419,2074,0,507,144444.0,43333.0,-68.0,-73.0,-66.0,-71.0,-67.0,-72.0,-65.0,-71.0,-87.0,-92.0,-87.0,-91.0,19.0,19.0,21.0,20.0,1
1220,CC:2F:71:3E:C5:1F,3222328,406964297,11355,1389040,3210973,405575257,6,48512,4062004,40096,3064848,8416,997156,11971,34,16319,186,6,823,144444.0,39000.0,-69.0,-70.0,-69.0,-61.0,-67.0,-66.0,-67.0,-60.0,-87.0,-92.0,-87.0,-91.0,18.0,22.0,18.0,30.0,1
1221,CC:2F:71:3F:1F:24,7696525,7235446698,4485552,6829871441,3210973,405575257,80,1035011,632588296,1026503,631566512,8508,1021784,982174,619,4490243,454304,80,5547,115556.0,28889.0,-71.0,-65.0,-72.0,-70.0,-70.0,-64.0,-72.0,-69.0,-87.0,-92.0,-87.0,-91.0,16.0,27.0,15.0,21.0,1
1222,F8:59:71:5A:E0:3D,3291747,519496600,80772,113921141,3210975,405575459,0,78523,72647588,73746,72076810,4777,570778,56512,16,83484,2074,0,507,144444.0,43333.0,-67.0,-73.0,-66.0,-71.0,-67.0,-72.0,-65.0,-71.0,-87.0,-92.0,-87.0,-91.0,20.0,19.0,21.0,20.0,1
1223,CC:2F:71:3E:C5:1F,3222330,406964499,11355,1389040,3210975,405575459,6,48512,4062004,40096,3064848,8416,997156,11971,34,16319,186,6,823,144444.0,39000.0,-69.0,-70.0,-69.0,-61.0,-67.0,-66.0,-67.0,-60.0,-87.0,-92.0,-87.0,-91.0,18.0,22.0,18.0,30.0,1
1224,CC:2F:71:3F:1F:24,7697643,7237151258,4486666,6831575597,3210977,405575661,80,1035324,632814419,1026816,631792635,8508,1021784,982487,619,4491385,454821,80,5547,115556.0,28889.0,-70.0,-65.0,-73.0,-70.0,-70.0,-64.0,-72.0,-70.0,-87.0,-92.0,-87.0,-91.0,17.0,27.0,14.0,21.0,1
1225,F8:59:71:5A:E0:3D,3291820,519601324,80839,114025259,3210981,405576065,0,78591,72752322,73814,72181544,4777,570778,56579,16,83551,2074,0,507,144444.0,43333.0,-67.0,-72.0,-65.0,-71.0,-66.0,-72.0,-65.0,-70.0,-86.0,-92.0,-86.0,-91.0,19.0,20.0,21.0,20.0,1
1226,CC:2F:71:3E:C5:1F,3222336,406965105,11355,1389040,3210981,405576065,6,48512,4062004,40096,3064848,8416,997156,11971,34,16319,186,6,823,144444.0,39000.0,-69.0,-70.0,-69.0,-61.0,-67.0,-66.0,-67.0,-60.0,-86.0,-92.0,-86.0,-91.0,17.0,22.0,17.0,30.0,1
1227,CC:2F:71:3F:1F:24,7698693,7238756401,4487712,6833180336,3210981,405576065,80,1035636,633037014,1027128,632015230,8508,1021784,982799,619,4492431,454900,80,5547,86667.0,14444.0,-70.0,-65.0,-73.0,-70.0,-70.0,-65.0,-72.0,-69.0,-86.0,-92.0,-86.0,-91.0,16.0,27.0,13.0,21.0,1
1228,F8:59:71:5A:E0:3D,3291889,519704094,80905,114127767,3210984,405576327,0,78657,72853962,73880,72283184,4777,570778,56645,16,83617,2074,0,507,130000.0,39000.0,-67.0,-73.0,-65.0,-71.0,-66.0,-72.0,-65.0,-70.0,-86.0,-92.0,-86.0,-91.0,19.0,19.0,21.0,20.0,1
1229,CC:2F:71:3E:C5:1F,3222339,406965367,11355,1389040,3210984,405576327,6,48512,4062004,40096,3064848,8416,997156,11971,34,16319,186,6,823,144444.0,39000.0,-69.0,-70.0,-69.0,-61.0,-67.0,-66.0,-67.0,-60.0,-86.0,-92.0,-86.0,-91.0,17.0,22.0,17.0,30.0,1
1230,CC:2F:71:3F:1F:24,7700135,7240982869,4489151,6835406542,3210984,405576327,80,1036010,633272696,1027502,632250912,8508,1021784,983173,619,4493863,455121,80,5547,86667.0,14444.0,-70.0,-64.0,-73.0,-69.0,-70.0,-64.0,-72.0,-68.0,-86.0,-92.0,-86.0,-91.0,16.0,28.0,13.0,22.0,1
1231,F8:59:71:5A:E0:3D,3291958,519803968,80969,114227111,3210989,405576857,0,78721,72952522,73944,72381744,4777,570778,56709,16,83681,2076,0,507,144444.0,43333.0,-67.0,-73.0,-65.0,-70.0,-67.0,-72.0,-65.0,-70.0,-86.0,-92.0,-86.0,-91.0,19.0,19.0,21.0,21.0,1
1232,CC:2F:71:3E:C5:1F,3222344,406965897,11355,1389040,3210989,405576857,6,48512,4062004,40096,3064848,8416,997156,11971,34,16319,186,6,823,144444.0,39000.0,-69.0,-70.0,-69.0,-61.0,-67.0,-66.0,-67.0,-60.0,-86.0,-92.0,-86.0,-91.0,17.0,22.0,17.0,30.0,1
1233,CC:2F:71:3F:1F:24,7701201,7242612103,4490210,6837035044,3210991,405577059,80,1036331,633494994,1027823,632473210,8508,1021784,983494,619,4494928,455125,80,5547,86667.0,14444.0,-70.0,-64.0,-72.0,-69.0,-70.0,-64.0,-72.0,-69.0,-86.0,-91.0,-86.0,-90.0,16.0,27.0,14.0,21.0,1
1234,F8:59:71:5A:E0:3D,3292028,519906936,81035,114329675,3210993,405577261,0,78787,73054162,74010,72483384,4777,570778,56775,16,83747,2078,0,507,144444.0,43333.0,-67.0,-72.0,-66.0,-71.0,-66.0,-71.0,-65.0,-70.0,-86.0,-91.0,-86.0,-90.0,19.0,19.0,20.0,19.0,1
1235,CC:2F:71:3E:C5:1F,3222348,406966301,11355,1389040,3210993,405577261,6,48512,4062004,40096,3064848,8416,997156,11971,34,16319,186,6,823,144444.0,39000.0,-69.0,-70.0,-69.0,-61.0,-67.0,-66.0,-67.0,-60.0,-86.0,-91.0,-86.0,-90.0,17.0,21.0,17.0,29.0,1
1236,CC:2F:71:3F:1F:24,7702372,7244393980,4491379,6838816719,3210993,405577261,80,1036671,633723461,1028163,632701677,8508,1021784,983833,619,4496096,455137,80,5547,86667.0,14444.0,-71.0,-64.0,-73.0,-70.0,-71.0,-64.0,-72.0,-70.0,-86.0,-91.0,-86.0,-90.0,15.0,27.0,13.0,20.0,1
1237,F8:59:71:5A:E0:3D,3292097,520006856,81099,114429131,3210998,405577725,0,78852,73154276,74075,72583498,4777,570778,56839,16,83811,2078,0,507,144444.0,43333.0,-68.0,-73.0,-66.0,-71.0,-67.0,-73.0,-66.0,-71.0,-86.0,-91.0,-86.0,-90.0,18.0,18.0,20.0,19.0,1
1238,CC:2F:71:3E:C5:1F,3222353,406966765,11355,1389040,3210998,405577725,6,48512,4062004,40096,3064848,8416,997156,11971,34,16319,186,6,823,144444.0,39000.0,-69.0,-70.0,-69.0,-61.0,-67.0,-66.0,-67.0,-60.0,-86.0,-91.0,-86.0,-90.0,17.0,21.0,17.0,29.0,1
1239,CC:2F:71:3F:1F:24,7703824,7246632729,4492826,6841055004,3210998,405577725,80,1036990,633941286,1028482,632919502,8508,1021784,984152,619,4497531,455255,80,5547,115556.0,28889.0,-72.0,-65.0,-73.0,-70.0,-71.0,-65.0,-72.0,-70.0,-86.0,-91.0,-86.0,-90.0,14.0,26.0,13.0,20.0,1
1240,F8:59:71:5A:E0:3D,3292163,520103608,81161,114525479,3211002,405578129,0,78916,73252850,74139,72682072,4777,570778,56902,16,83873,2079,0,507,144444.0,43333.0,-67.0,-72.0,-65.0,-70.0,-67.0,-72.0,-65.0,-70.0,-86.0,-91.0,-86.0,-90.0,19.0,19.0,21.0,20.0,1
1241,CC:2F:71:3E:C5:1F,3222357,406967169,11355,1389040,3211002,405578129,6,48512,4062004,40096,3064848,8416,997156,11971,34,16319,186,6,823,144444.0,39000.0,-69.0,-70.0,-69.0,-61.0,-67.0,-66.0,-67.0,-60.0,-85.0,-91.0,-85.0,-90.0,16.0,21.0,16.0,29.0,1
1242,CC:2F:71:3F:1F:24,7705199,7248753434,4494196,6843175032,3211003,405578402,80,1037307,634163230,1028799,633141446,8508,1021784,984462,619,4498915,455386,80,5547,115556.0,28889.0,-71.0,-64.0,-72.0,-69.0,-71.0,-64.0,-72.0,-69.0,-85.0,-91.0,-85.0,-90.0,14.0,27.0,13.0,21.0,1
1243,F8:59:71:5A:E0:3D,3292230,520203539,81225,114624935,3211005,405578604,0,78979,73349912,74202,72779134,4777,570778,56965,16,83937,2079,0,507,144444.0,43333.0,-68.0,-72.0,-66.0,-71.0,-67.0,-72.0,-65.0,-71.0,-85.0,-91.0,-85.0,-90.0,17.0,19.0,19.0,19.0,1
1244,CC:2F:71:3E:C5:1F,3222362,406967846,11355,1389040,3211007,405578806,6,48512,4062004,40096,3064848,8416,997156,11971,34,16319,186,6,823,144444.0,39000.0,-69.0,-70.0,-69.0,-61.0,-67.0,-66.0,-67.0,-60.0,-85.0,-91.0,-85.0,-90.0,16.0,21.0,16.0,29.0,1
1245,CC:2F:71:3F:1F:24,7706114,7250134053,4495107,6844555247,3211007,405578806,80,1037593,634376531,1029085,633354747,8508,1021784,984748,619,4499826,455407,80,5547,115556.0,28889.0,-72.0,-65.0,-73.0,-70.0,-72.0,-64.0,-73.0,-69.0,-85.0,-91.0,-85.0,-90.0,13.0,26.0,12.0,20.0,1
1246,F8:59:71:5A:E0:3D,3292301,520306567,81291,114727499,3211010,405579068,0,79047,73454660,74270,72883882,4777,570778,57031,16,84003,2080,0,507,144444.0,43333.0,-67.0,-72.0,-65.0,-70.0,-66.0,-72.0,-65.0,-70.0,-85.0,-91.0,-85.0,-90.0,18.0,19.0,20.0,20.0,1
1247,CC:2F:71:3E:C5:1F,3222365,406968108,11355,1389040,3211010,405579068,6,48512,4062004,40096,3064848,8416,997156,11971,34,16319,186,6,823,144444.0,39000.0,-69.0,-70.0,-69.0,-61.0,-67.0,-66.0,-67.0,-60.0,-85.0,-91.0,-85.0,-90.0,16.0,21.0,16.0,29.0,1
1248,CC:2F:71:3F:1F:24,7707439,7252164942,4496427,6846585672,3211012,405579270,80,1037915,634608103,1029407,633586319,8508,1021784,985070,619,4501126,455461,80,5548,130000.0,43333.0,-71.0,-64.0,-72.0,-69.0,-71.0,-63.0,-72.0,-68.0,-85.0,-91.0,-85.0,-90.0,14.0,27.0,13.0,21.0,1
1249,F8:59:71:5A:E0:3D,3292369,520406427,81355,114826955,3211014,405579472,0,79112,73554774,74335,72983996,4777,570778,57095,16,84067,2080,0,507,144444.0,43333.0,-67.0,-72.0,-65.0,-71.0,-66.0,-71.0,-65.0,-70.0,-85.0,-91.0,-85.0,-90.0,18.0,19.0,20.0,19.0,1
1250,CC:2F:71:3E:C5:1F,3222369,406968512,11355,1389040,3211014,405579472,6,48512,4062004,40096,3064848,8416,997156,11971,34,16319,186,6,823,144444.0,39000.0,-69.0,-70.0,-69.0,-61.0,-67.0,-66.0,-67.0,-60.0,-85.0,-91.0,-85.0,-90.0,16.0,21.0,16.0,29.0,1
1251,CC:2F:71:3F:1F:24,7709293,7255042846,4498277,6849463172,3211016,405579674,80,1038267,634835279,1029759,633813495,8508,1021784,985422,619,4502957,455564,80,5548,130000.0,43333.0,-71.0,-64.0,-72.0,-69.0,-70.0,-63.0,-72.0,-68.0,-85.0,-91.0,-85.0,-90.0,14.0,27.0,13.0,21.0,1
1252,F8:59:71:5A:E0:3D,3292438,520507841,81420,114927965,3211018,405579876,0,79180,73659522,74403,73088744,4777,570778,57161,16,84132,2080,0,507,144444.0,43333.0,-67.0,-72.0,-65.0,-71.0,-67.0,-71.0,-65.0,-70.0,-85.0,-91.0,-85.0,-90.0,18.0,19.0,20.0,19.0,1
1253,CC:2F:71:3E:C5:1F,3222373,406968916,11355,1389040,3211018,405579876,6,48512,4062004,40096,3064848,8416,997156,11971,34,16319,186,6,823,144444.0,39000.0,-69.0,-70.0,-69.0,-61.0,-67.0,-66.0,-67.0,-60.0,-85.0,-91.0,-85.0,-90.0,16.0,21.0,16.0,29.0,1
1254,CC:2F:71:3F:1F:24,7711155,7257934752,4500137,6852354876,3211018,405579876,80,1038628,635063499,1030120,634041715,8508,1021784,985783,619,4504856,455814,80,5548,130000.0,43333.0,-71.0,-63.0,-72.0,-69.0,-70.0,-63.0,-71.0,-69.0,-85.0,-91.0,-84.0,-90.0,14.0,28.0,12.0,21.0,1
1255,F8:59:71:5A:E0:3D,3292509,520610869,81486,115030529,3211023,405580340,0,79246,73761176,74469,73190398,4777,570778,57226,16,84198,2081,0,507,144444.0,43333.0,-67.0,-72.0,-65.0,-71.0,-67.0,-72.0,-65.0,-70.0,-85.0,-91.0,-84.0,-90.0,18.0,19.0,19.0,19.0,1
1256,CC:2F:71:3E:C5:1F,3222378,406969380,11355,1389040,3211023,405580340,6,48512,4062004,40096,3064848,8416,997156,11971,34,16319,186,6,823,144444.0,39000.0,-69.0,-70.0,-69.0,-61.0,-67.0,-66.0,-67.0,-60.0,-85.0,-91.0,-84.0,-90.0,16.0,21.0,15.0,29.0,1
1257,CC:2F:71:3F:1F:24,7712882,7260609428,4501859,6855029088,3211023,405580340,80,1038959,635287015,1030451,634265231,8508,1021784,986114,619,4506552,455963,80,5548,130000.0,43333.0,-71.0,-64.0,-72.0,-69.0,-70.0,-63.0,-72.0,-69.0,-85.0,-91.0,-84.0,-90.0,14.0,27.0,12.0,21.0,1
1258,F8:59:71:5A:E0:3D,3292578,520710845,81551,115130101,3211027,405580744,0,79310,73859736,74533,73288958,4777,570778,57290,16,84263,2082,0,507,144444.0,43333.0,-67.0,-72.0,-65.0,-70.0,-67.0,-72.0,-65.0,-71.0,-85.0,-91.0,-84.0,-90.0,18.0,19.0,19.0,20.0,1
1259,CC:2F:71:3E:C5:1F,3222383,406969900,11356,1389156,3211027,405580744,6,48513,4062074,40097,3064918,8416,997156,11971,34,16320,186,6,823,144444.0,43333.0,-69.0,-70.0,-69.0,-60.0,-67.0,-67.0,-68.0,-60.0,-85.0,-91.0,-84.0,-90.0,16.0,21.0,15.0,30.0,1
1260,CC:2F:71:3F:1F:24,7714256,7262720823,4503229,6857140079,3211027,405580744,80,1039255,635504176,1030747,634482392,8508,1021784,986408,619,4507930,456023,80,5549,130000.0,43333.0,-71.0,-65.0,-72.0,-71.0,-71.0,-64.0,-73.0,-70.0,-85.0,-91.0,-84.0,-90.0,14.0,26.0,12.0,19.0,1
1261,F8:59:71:5A:E0:3D,3292647,520810767,81615,115229557,3211032,405581210,0,79374,73958296,74597,73387518,4777,570778,57354,16,84327,2083,0,507,144444.0,43333.0,-67.0,-73.0,-65.0,-71.0,-66.0,-72.0,-65.0,-70.0,-85.0,-91.0,-84.0,-90.0,18.0,18.0,19.0,19.0,1
1262,CC:2F:71:3E:C5:1F,3222389,406970426,11356,1389156,3211033,405581270,6,48514,4062144,40098,3064988,8416,997156,11971,34,16320,186,6,823,144444.0,43333.0,-70.0,-70.0,-69.0,-61.0,-68.0,-68.0,-68.0,-60.0,-85.0,-91.0,-84.0,-90.0,15.0,21.0,15.0,29.0,1
1263,CC:2F:71:3F:1F:24,7715440,7264537081,4504407,6858955811,3211033,405581270,80,1039563,635724958,1031054,634703056,8509,1021902,986716,619,4509126,456049,80,5549,130000.0,43333.0,-72.0,-64.0,-72.0,-70.0,-71.0,-64.0,-72.0,-70.0,-85.0,-91.0,-84.0,-90.0,13.0,27.0,12.0,20.0,1
1264,F8:59:71:5A:E0:3D,3292717,520912241,81680,115330567,3211037,405581674,0,79441,74061504,74664,73490726,4777,570778,57419,16,84392,2083,0,507,144444.0,43333.0,-67.0,-72.0,-65.0,-70.0,-66.0,-72.0,-65.0,-70.0,-85.0,-91.0,-84.0,-90.0,18.0,19.0,19.0,20.0,1
1265,CC:2F:71:3E:C5:1F,3222393,406970830,11356,1389156,3211037,405581674,6,48514,4062144,40098,3064988,8416,997156,11971,34,16320,186,6,823,144444.0,43333.0,-70.0,-70.0,-69.0,-61.0,-68.0,-68.0,-68.0,-60.0,-85.0,-91.0,-84.0,-90.0,15.0,21.0,15.0,29.0,1
1266,CC:2F:71:3F:1F:24,7716820,7266663821,4505783,6861082147,3211037,405581674,80,1039883,635965586,1031374,634943684,8509,1021902,987035,619,4510502,456397,80,5549,115556.0,28889.0,-70.0,-65.0,-73.0,-69.0,-69.0,-64.0,-72.0,-68.0,-85.0,-91.0,-84.0,-90.0,15.0,26.0,11.0,21.0,1
1267,F8:59:71:5A:E0:3D,3292790,521019871,81749,115437793,3211041,405582078,0,79512,74170872,74735,73600094,4777,570778,57488,16,84461,2083,0,507,144444.0,43333.0,-67.0,-72.0,-65.0,-71.0,-66.0,-71.0,-65.0,-71.0,-85.0,-91.0,-84.0,-90.0,18.0,19.0,19.0,19.0,1
1268,CC:2F:71:3E:C5:1F,3222397,406971234,11356,1389156,3211041,405582078,6,48514,4062144,40098,3064988,8416,997156,11971,34,16320,186,6,823,144444.0,43333.0,-70.0,-70.0,-69.0,-61.0,-68.0,-68.0,-68.0,-60.0,-85.0,-91.0,-84.0,-90.0,15.0,21.0,15.0,29.0,1
1269,CC:2F:71:3F:1F:24,7717958,7268410621,4506917,6862828543,3211041,405582078,80,1040194,636183806,1031685,635161904,8509,1021902,987346,619,4511629,456408,80,5549,115556.0,28889.0,-70.0,-65.0,-73.0,-69.0,-69.0,-65.0,-72.0,-69.0,-85.0,-91.0,-84.0,-90.0,15.0,26.0,11.0,21.0,1
1270,F8:59:71:5A:E0:3D,3292860,521119853,81813,115537249,3211047,405582604,0,79576,74269432,74799,73698654,4777,570778,57552,16,84525,2084,0,507,144444.0,43333.0,-67.0,-72.0,-66.0,-71.0,-67.0,-71.0,-65.0,-71.0,-84.0,-90.0,-84.0,-90.0,17.0,18.0,18.0,19.0,1
1271,CC:2F:71:3E:C5:1F,3222403,406971760,11356,1389156,3211047,405582604,6,48516,4062332,40099,3065058,8417,997274,11972,34,16320,186,6,823,144444.0,43333.0,-70.0,-70.0,-69.0,-61.0,-68.0,-68.0,-68.0,-60.0,-84.0,-90.0,-84.0,-90.0,14.0,20.0,15.0,29.0,1
1272,CC:2F:71:3F:1F:24,7718858,7269772187,4507811,6864189583,3211047,405582604,80,1040469,636401417,1031960,635379515,8509,1021902,987621,619,4512521,456473,80,5551,130000.0,43333.0,-70.0,-65.0,-73.0,-69.0,-70.0,-64.0,-73.0,-69.0,-84.0,-90.0,-84.0,-90.0,14.0,25.0,11.0,21.0,1
1273,F8:59:71:5A:E0:3D,3292928,521219713,81877,115636705,3211051,405583008,0,79642,74371100,74865,73800322,4777,570778,57616,16,84588,2085,0,507,144444.0,43333.0,-67.0,-72.0,-65.0,-71.0,-66.0,-71.0,-65.0,-71.0,-84.0,-90.0,-84.0,-90.0,17.0,18.0,19.0,19.0,1
1274,CC:2F:71:3E:C5:1F,3222407,406972164,11356,1389156,3211051,405583008,6,48516,4062332,40099,3065058,8417,997274,11972,34,16320,186,6,823,144444.0,43333.0,-70.0,-70.0,-69.0,-61.0,-68.0,-68.0,-68.0,-60.0,-84.0,-90.0,-84.0,-90.0,14.0,20.0,15.0,29.0,1
1275,CC:2F:71:3F:1F:24,7720083,7271657473,4509032,6866074465,3211051,405583008,80,1040741,636616537,1032232,635594635,8509,1021902,987893,619,4513735,456561,80,5552,130000.0,43333.0,-71.0,-65.0,-74.0,-69.0,-70.0,-64.0,-73.0,-69.0,-84.0,-90.0,-84.0,-90.0,13.0,25.0,10.0,21.0,1
1276,F8:59:71:5A:E0:3D,3292994,521319371,81941,115736161,3211053,405583210,0,79706,74469660,74929,73898882,4777,570778,57680,16,84653,2085,0,507,144444.0,43333.0,-68.0,-72.0,-66.0,-72.0,-67.0,-72.0,-66.0,-71.0,-84.0,-90.0,-84.0,-90.0,16.0,18.0,18.0,18.0,1
1277,CC:2F:71:3E:C5:1F,3222409,406972366,11356,1389156,3211053,405583210,6,48516,4062332,40099,3065058,8417,997274,11972,34,16320,186,6,823,144444.0,43333.0,-70.0,-70.0,-69.0,-61.0,-68.0,-68.0,-68.0,-60.0,-84.0,-90.0,-84.0,-90.0,14.0,20.0,15.0,29.0,1
1278,CC:2F:71:3F:1F:24,7721824,7274357111,4510769,6868773699,3211055,405583412,80,1041062,636844523,1032553,635822621,8509,1021902,988214,619,4515488,456741,80,5553,130000.0,43333.0,-70.0,-64.0,-74.0,-69.0,-70.0,-64.0,-73.0,-68.0,-84.0,-90.0,-84.0,-90.0,14.0,26.0,10.0,21.0,1
1279,F8:59:71:5A:E0:3D,3293065,521422399,82007,115838725,3211058,405583674,0,79773,74572840,74996,74002062,4777,570778,57747,16,84719,2086,0,507,144444.0,43333.0,-67.0,-72.0,-65.0,-71.0,-67.0,-72.0,-65.0,-71.0,-84.0,-90.0,-84.0,-90.0,17.0,18.0,19.0,19.0,1
1280,CC:2F:71:3E:C5:1F,3222416,406973032,11356,1389156,3211060,405583876,6,48516,4062332,40099,3065058,8417,997274,11972,34,16320,186,6,823,144444.0,43333.0,-70.0,-70.0,-69.0,-61.0,-68.0,-68.0,-68.0,-60.0,-84.0,-90.0,-84.0,-90.0,14.0,20.0,15.0,29.0,1
1281,CC:2F:71:3F:1F:24,7723444,7276864117,4512384,6871280241,3211060,405583876,80,1041375,637064591,1032866,636042689,8509,1021902,988527,619,4517103,456939,80,5553,130000.0,43333.0,-71.0,-65.0,-74.0,-69.0,-70.0,-64.0,-73.0,-69.0,-84.0,-90.0,-84.0,-90.0,13.0,25.0,10.0,21.0,1
1282,F8:59:71:5A:E0:3D,3293133,521522259,82071,115938181,3211062,405584078,0,79836,74669860,75059,74099082,4777,570778,57810,16,84783,2087,0,507,144444.0,43333.0,-67.0,-71.0,-65.0,-71.0,-67.0,-71.0,-65.0,-71.0,-84.0,-90.0,-84.0,-89.0,17.0,19.0,19.0,18.0,1
1283,CC:2F:71:3E:C5:1F,3222419,406973507,11356,1389156,3211063,405584351,6,48516,4062332,40099,3065058,8417,997274,11972,34,16320,186,6,823,144444.0,43333.0,-70.0,-70.0,-69.0,-61.0,-68.0,-68.0,-68.0,-60.0,-84.0,-90.0,-84.0,-89.0,14.0,20.0,15.0,28.0,1
1284,CC:2F:71:3F:1F:24,7724623,7278677216,4513560,6873092865,3211063,405584351,80,1041679,637287841,1033170,636265939,8509,1021902,988828,619,4518258,457011,80,5555,130000.0,43333.0,-70.0,-64.0,-73.0,-69.0,-69.0,-64.0,-73.0,-69.0,-84.0,-90.0,-84.0,-89.0,14.0,26.0,11.0,20.0,1
1285,F8:59:71:5A:E0:3D,3293202,521622392,82135,116037637,3211067,405584755,0,79900,74768420,75123,74197642,4777,570778,57874,16,84847,2089,0,507,144444.0,43333.0,-68.0,-72.0,-66.0,-72.0,-67.0,-72.0,-65.0,-71.0,-84.0,-90.0,-84.0,-89.0,16.0,18.0,18.0,17.0,1
1286,CC:2F:71:3E:C5:1F,3222423,406973911,11356,1389156,3211067,405584755,6,48516,4062332,40099,3065058,8417,997274,11972,34,16320,186,6,823,144444.0,43333.0,-70.0,-70.0,-69.0,-61.0,-68.0,-68.0,-68.0,-60.0,-84.0,-90.0,-84.0,-89.0,14.0,20.0,15.0,28.0,1
1287,CC:2F:71:3F:1F:24,7725693,7280310633,4514626,6874725878,3211067,405584755,80,1041941,637497972,1033432,636476070,8509,1021902,989090,619,4519316,457138,80,5555,130000.0,43333.0,-70.0,-64.0,-72.0,-68.0,-70.0,-64.0,-73.0,-68.0,-84.0,-90.0,-84.0,-89.0,14.0,26.0,12.0,21.0,1
1288,F8:59:71:5A:E0:3D,3293269,521722110,82199,116137093,3211070,405585017,0,79964,74866980,75187,74296202,4777,570778,57938,16,84911,2090,0,507,144444.0,43333.0,-67.0,-72.0,-66.0,-71.0,-67.0,-72.0,-65.0,-71.0,-84.0,-90.0,-84.0,-89.0,17.0,18.0,18.0,18.0,1
1289,CC:2F:71:3E:C5:1F,3222427,406974235,11356,1389156,3211071,405585079,6,48516,4062332,40099,3065058,8417,997274,11972,34,16320,186,6,823,144444.0,43333.0,-70.0,-70.0,-69.0,-61.0,-68.0,-68.0,-68.0,-60.0,-84.0,-90.0,-84.0,-89.0,14.0,20.0,15.0,28.0,1
1290,CC:2F:71:3F:1F:24,7727155,7282566847,4516082,6876981566,3211073,405585281,80,1042231,637713838,1033722,636691936,8509,1021902,989380,619,4520801,457236,80,5556,130000.0,43333.0,-70.0,-64.0,-73.0,-68.0,-69.0,-64.0,-72.0,-68.0,-84.0,-90.0,-84.0,-89.0,14.0,26.0,11.0,21.0,1
1291,F8:59:71:5A:E0:3D,3293337,521820478,82262,116234995,3211075,405585483,0,80028,74964118,75250,74393222,4778,570896,58002,16,84974,2091,0,507,144444.0,43333.0,-67.0,-71.0,-66.0,-71.0,-67.0,-71.0,-65.0,-71.0,-84.0,-90.0,-84.0,-89.0,17.0,19.0,18.0,18.0,1
1292,CC:2F:71:3E:C5:1F,3222433,406974841,11356,1389156,3211077,405585685,6,48516,4062332,40099,3065058,8417,997274,11972,34,16320,186,6,823,144444.0,43333.0,-70.0,-70.0,-69.0,-61.0,-68.0,-68.0,-68.0,-60.0,-84.0,-90.0,-84.0,-89.0,14.0,20.0,15.0,28.0,1
1293,CC:2F:71:3F:1F:24,7728370,7284436329,4517293,6878850644,3211077,405585685,80,1042543,637936734,1034034,636914832,8509,1021902,989691,619,4522012,457346,80,5558,130000.0,43333.0,-71.0,-65.0,-74.0,-69.0,-70.0,-64.0,-74.0,-69.0,-84.0,-90.0,-84.0,-89.0,13.0,25.0,10.0,20.0,1
1294,F8:59:71:5A:E0:3D,3293405,521920338,82326,116334451,3211079,405585887,0,80092,75062678,75314,74491782,4778,570896,58066,16,85038,2093,0,507,144444.0,43333.0,-67.0,-71.0,-65.0,-71.0,-67.0,-71.0,-65.0,-71.0,-84.0,-90.0,-84.0,-89.0,17.0,19.0,19.0,18.0,1
1295,CC:2F:71:3E:C5:1F,3222435,406975043,11356,1389156,3211079,405585887,6,48516,4062332,40099,3065058,8417,997274,11972,34,16320,186,6,823,144444.0,43333.0,-70.0,-70.0,-69.0,-61.0,-68.0,-68.0,-68.0,-60.0,-84.0,-90.0,-84.0,-89.0,14.0,20.0,15.0,28.0,1
1296,CC:2F:71:3F:1F:24,7729506,7286182775,4518427,6880596888,3211079,405585887,80,1042852,638160656,1034343,637138754,8509,1021902,989999,619,4523144,457502,80,5558,130000.0,39000.0,-70.0,-65.0,-73.0,-69.0,-70.0,-64.0,-73.0,-69.0,-84.0,-90.0,-84.0,-89.0,14.0,25.0,11.0,20.0,1
1297,F8:59:71:5A:E0:3D,3293476,522023198,82392,116436847,3211084,405586351,0,80160,75167426,75382,74596530,4778,570896,58132,16,85104,2093,0,507,144444.0,43333.0,-67.0,-72.0,-66.0,-71.0,-67.0,-72.0,-65.0,-71.0,-83.0,-90.0,-83.0,-89.0,16.0,18.0,17.0,18.0,1
1298,CC:2F:71:3E:C5:1F,3222440,406975507,11356,1389156,3211084,405586351,6,48516,4062332,40099,3065058,8417,997274,11972,34,16320,186,6,823,144444.0,43333.0,-70.0,-70.0,-69.0,-61.0,-68.0,-68.0,-68.0,-60.0,-83.0,-90.0,-83.0,-89.0,13.0,20.0,14.0,28.0,1
1299,CC:2F:71:3F:1F:24,7730754,7288095246,4519670,6882508895,3211084,405586351,80,1043161,638382015,1034652,637360113,8509,1021902,990308,619,4524389,457672,80,5559,130000.0,43333.0,-70.0,-64.0,-74.0,-69.0,-70.0,-64.0,-73.0,-68.0,-83.0,-90.0,-83.0,-89.0,13.0,26.0,9.0,20.0,1
1300,F8:59:71:5A:E0:3D,3293543,522121504,82455,116534749,3211088,405586755,0,80225,75267540,75447,74696644,4778,570896,58196,16,85167,2093,0,507,144444.0,43333.0,-67.0,-72.0,-65.0,-70.0,-67.0,-71.0,-65.0,-71.0,-83.0,-90.0,-83.0,-89.0,16.0,18.0,18.0,19.0,1
1301,CC:2F:71:3E:C5:1F,3222444,406975911,11356,1389156,3211088,405586755,6,48516,4062332,40099,3065058,8417,997274,11972,34,16320,186,6,823,144444.0,43333.0,-70.0,-70.0,-69.0,-61.0,-68.0,-68.0,-68.0,-60.0,-83.0,-90.0,-83.0,-89.0,13.0,20.0,14.0,28.0,1
1302,CC:2F:71:3F:1F:24,7731607,7289390278,4520519,6883803523,3211088,405586755,80,1043430,638596985,1034921,637575083,8509,1021902,990577,619,4525238,457819,80,5559,115556.0,28889.0,-69.0,-65.0,-72.0,-70.0,-70.0,-64.0,-72.0,-69.0,-83.0,-90.0,-83.0,-89.0,14.0,25.0,11.0,19.0,1
1303,F8:59:71:5A:E0:3D,3293612,522222918,82520,116635759,3211092,405587159,0,80290,75367654,75512,74796758,4778,570896,58260,16,85231,2093,0,507,144444.0,43333.0,-68.0,-72.0,-66.0,-71.0,-67.0,-72.0,-65.0,-71.0,-83.0,-90.0,-83.0,-89.0,15.0,18.0,17.0,18.0,1
1304,CC:2F:71:3E:C5:1F,3222449,406976375,11356,1389156,3211093,405587219,6,48516,4062332,40099,3065058,8417,997274,11972,34,16320,186,6,823,144444.0,43333.0,-70.0,-70.0,-69.0,-61.0,-68.0,-68.0,-68.0,-60.0,-83.0,-90.0,-83.0,-89.0,13.0,20.0,14.0,28.0,1
1305,CC:2F:71:3F:1F:24,7732350,7290512114,4521257,6884924895,3211093,405587219,80,1043694,638809607,1035185,637787705,8509,1021902,990841,619,4525976,457825,80,5559,115556.0,28889.0,-71.0,-64.0,-73.0,-68.0,-70.0,-64.0,-72.0,-68.0,-83.0,-90.0,-83.0,-89.0,12.0,26.0,10.0,21.0,1
1306,F8:59:71:5A:E0:3D,3293680,522321284,82583,116733661,3211097,405587623,0,80353,75464674,75575,74893778,4778,570896,58323,16,85295,2094,0,507,144444.0,43333.0,-67.0,-72.0,-66.0,-71.0,-67.0,-72.0,-65.0,-70.0,-83.0,-90.0,-83.0,-89.0,16.0,18.0,17.0,18.0,1
1307,CC:2F:71:3E:C5:1F,3222453,406976779,11356,1389156,3211097,405587623,6,48516,4062332,40099,3065058,8417,997274,11972,34,16320,186,6,823,144444.0,43333.0,-70.0,-70.0,-69.0,-61.0,-68.0,-68.0,-68.0,-60.0,-83.0,-90.0,-83.0,-89.0,13.0,20.0,14.0,28.0,1
1308,CC:2F:71:3F:1F:24,7733473,7292234780,4522376,6886647157,3211097,405587623,80,1044013,639034419,1035504,638012517,8509,1021902,991158,619,4527092,458048,80,5559,86667.0,13000.0,-70.0,-64.0,-73.0,-69.0,-69.0,-64.0,-72.0,-69.0,-83.0,-90.0,-83.0,-89.0,13.0,26.0,10.0,20.0,1
1309,F8:59:71:5A:E0:3D,3293747,522422496,82648,116834671,3211099,405587825,0,80418,75564774,75640,74993878,4778,570896,58388,16,85360,2094,0,507,144444.0,43333.0,-67.0,-72.0,-65.0,-71.0,-67.0,-72.0,-65.0,-71.0,-83.0,-90.0,-83.0,-89.0,16.0,18.0,18.0,18.0,1
1310,CC:2F:71:3E:C5:1F,3222455,406976981,11356,1389156,3211099,405587825,6,48516,4062332,40099,3065058,8417,997274,11972,34,16320,186,6,823,144444.0,43333.0,-70.0,-70.0,-69.0,-61.0,-68.0,-68.0,-68.0,-60.0,-83.0,-90.0,-83.0,-89.0,13.0,20.0,14.0,28.0,1
1311,CC:2F:71:3F:1F:24,7734464,7293742560,4523363,6888154533,3211101,405588027,80,1044325,639250544,1035816,638228642,8509,1021902,991470,619,4528082,458069,80,5559,86667.0,14444.0,-70.0,-64.0,-73.0,-69.0,-69.0,-64.0,-72.0,-68.0,-83.0,-90.0,-83.0,-89.0,13.0,26.0,10.0,20.0,1
1312,F8:59:71:5A:E0:3D,3293821,522527280,82715,116938789,3211106,405588491,0,80486,75669508,75708,75098612,4778,570896,58455,16,85427,2095,0,507,144444.0,43333.0,-67.0,-72.0,-65.0,-71.0,-67.0,-71.0,-65.0,-71.0,-83.0,-90.0,-83.0,-89.0,16.0,18.0,18.0,18.0,1
1313,CC:2F:71:3E:C5:1F,3222462,406977647,11356,1389156,3211106,405588491,6,48516,4062332,40099,3065058,8417,997274,11972,34,16320,186,6,823,144444.0,43333.0,-70.0,-70.0,-69.0,-61.0,-68.0,-68.0,-68.0,-60.0,-83.0,-90.0,-83.0,-89.0,13.0,20.0,14.0,28.0,1
1314,CC:2F:71:3F:1F:24,7735666,7295586042,4524560,6889997551,3211106,405588491,80,1044651,639481684,1036142,638459782,8509,1021902,991796,619,4529279,458174,80,5559,86667.0,14444.0,-70.0,-64.0,-72.0,-69.0,-70.0,-64.0,-72.0,-69.0,-83.0,-90.0,-83.0,-89.0,13.0,26.0,11.0,20.0,1
1315,F8:59:71:5A:E0:3D,3293887,522626938,82779,117038245,3211108,405588693,0,80551,75769650,75773,75198754,4778,570896,58519,16,85491,2096,0,507,144444.0,43333.0,-67.0,-72.0,-65.0,-71.0,-67.0,-72.0,-65.0,-70.0,-83.0,-90.0,-83.0,-89.0,16.0,18.0,18.0,18.0,1
1316,CC:2F:71:3E:C5:1F,3222464,406977849,11356,1389156,3211108,405588693,6,48516,4062332,40099,3065058,8417,997274,11972,34,16320,186,6,823,144444.0,43333.0,-70.0,-70.0,-69.0,-61.0,-68.0,-68.0,-68.0,-60.0,-83.0,-90.0,-83.0,-89.0,13.0,20.0,14.0,28.0,1
1317,CC:2F:71:3F:1F:24,7736740,7297230682,4525630,6891641787,3211110,405588895,80,1044976,639704436,1036467,638682534,8509,1021902,992121,619,4530349,458213,80,5559,65000.0,13000.0,-70.0,-64.0,-74.0,-69.0,-69.0,-64.0,-73.0,-69.0,-83.0,-90.0,-83.0,-89.0,13.0,26.0,9.0,20.0,1
1318,F8:59:71:5A:E0:3D,3293963,522736324,82849,117147025,3211114,405589299,0,80615,75868238,75837,75297342,4778,570896,58583,16,85561,2098,0,507,144444.0,43333.0,-66.0,-72.0,-65.0,-71.0,-67.0,-72.0,-65.0,-71.0,-83.0,-90.0,-83.0,-89.0,17.0,18.0,18.0,18.0,1
1319,CC:2F:71:3E:C5:1F,3222470,406978455,11356,1389156,3211114,405589299,6,48516,4062332,40099,3065058,8417,997274,11972,34,16320,186,6,823,144444.0,43333.0,-70.0,-70.0,-69.0,-61.0,-68.0,-68.0,-68.0,-60.0,-83.0,-90.0,-83.0,-89.0,13.0,20.0,14.0,28.0,1
1320,CC:2F:71:3F:1F:24,7737832,7298902182,4526718,6893312883,3211114,405589299,80,1045308,639951126,1036799,638929224,8509,1021902,992453,619,4531437,458258,80,5560,86667.0,14444.0,-70.0,-65.0,-73.0,-69.0,-70.0,-65.0,-72.0,-68.0,-83.0,-90.0,-83.0,-89.0,13.0,25.0,10.0,20.0,1
1321,F8:59:71:5A:E0:3D,3294034,522840820,82917,117251259,3211117,405589561,0,80690,75982416,75912,75411520,4778,570896,58657,16,85629,2098,0,507,144444.0,43333.0,-67.0,-72.0,-65.0,-71.0,-67.0,-72.0,-65.0,-70.0,-83.0,-90.0,-83.0,-89.0,16.0,18.0,18.0,18.0,1
1322,CC:2F:71:3E:C5:1F,3222473,406978717,11356,1389156,3211117,405589561,6,48516,4062332,40099,3065058,8417,997274,11972,34,16320,186,6,823,144444.0,43333.0,-70.0,-70.0,-69.0,-61.0,-68.0,-68.0,-68.0,-60.0,-83.0,-90.0,-83.0,-89.0,13.0,20.0,14.0,28.0,1
1323,CC:2F:71:3F:1F:24,7739297,7301153087,4528179,6895563392,3211118,405589695,80,1045680,640185745,1037171,639163843,8509,1021902,992824,619,4532847,458589,80,5561,86667.0,14444.0,-70.0,-65.0,-73.0,-70.0,-70.0,-65.0,-73.0,-69.0,-83.0,-90.0,-83.0,-89.0,13.0,25.0,10.0,19.0,1
1324,F8:59:71:5A:E0:3D,3294107,522944263,82983,117353823,3211124,405590440,0,80756,76084056,75978,75513160,4778,570896,58723,16,85695,2099,0,507,144444.0,43333.0,-67.0,-72.0,-65.0,-71.0,-66.0,-72.0,-65.0,-70.0,-83.0,-90.0,-83.0,-89.0,16.0,18.0,18.0,18.0,1
1325,CC:2F:71:3E:C5:1F,3222480,406979596,11356,1389156,3211124,405590440,6,48516,4062332,40099,3065058,8417,997274,11972,34,16320,186,6,823,144444.0,43333.0,-70.0,-70.0,-69.0,-61.0,-68.0,-68.0,-68.0,-60.0,-83.0,-90.0,-83.0,-89.0,13.0,20.0,14.0,28.0,1
1326,CC:2F:71:3F:1F:24,7741005,7303795156,4529881,6898204716,3211124,405590440,80,1046082,640420559,1037573,639398657,8509,1021902,993226,619,4534584,458879,80,5563,86667.0,14444.0,-71.0,-66.0,-74.0,-70.0,-70.0,-65.0,-73.0,-69.0,-83.0,-90.0,-83.0,-89.0,12.0,24.0,9.0,19.0,1
1327,F8:59:71:5A:E0:3D,3294176,523048583,83050,117457941,3211126,405590642,0,80823,76187236,76045,75616340,4778,570896,58790,16,85762,2100,0,507,144444.0,43333.0,-67.0,-72.0,-65.0,-70.0,-67.0,-72.0,-65.0,-70.0,-83.0,-90.0,-83.0,-89.0,16.0,18.0,18.0,19.0,1
1328,CC:2F:71:3E:C5:1F,3222482,406979798,11356,1389156,3211126,405590642,6,48516,4062332,40099,3065058,8417,997274,11972,34,16320,186,6,823,144444.0,43333.0,-70.0,-70.0,-69.0,-61.0,-68.0,-68.0,-68.0,-60.0,-83.0,-90.0,-83.0,-89.0,13.0,20.0,14.0,28.0,1
1329,CC:2F:71:3F:1F:24,7742686,7306400532,4531560,6900809890,3211126,405590642,80,1046481,640660735,1037972,639638833,8509,1021902,993625,619,4536274,459171,80,5563,86667.0,14444.0,-70.0,-65.0,-73.0,-68.0,-69.0,-64.0,-72.0,-68.0,-83.0,-90.0,-83.0,-89.0,13.0,25.0,10.0,21.0,1
1330,F8:59:71:5A:E0:3D,3294250,523153367,83117,117562059,3211133,405591308,0,80891,76291970,76113,75721074,4778,570896,58857,16,85829,2102,0,507,144444.0,43333.0,-68.0,-73.0,-66.0,-71.0,-67.0,-72.0,-65.0,-71.0,-83.0,-90.0,-83.0,-89.0,15.0,17.0,17.0,18.0,1
1331,CC:2F:71:3E:C5:1F,3222489,406980464,11356,1389156,3211133,405591308,6,48516,4062332,40099,3065058,8417,997274,11972,34,16320,186,6,823,144444.0,43333.0,-70.0,-70.0,-69.0,-61.0,-68.0,-68.0,-68.0,-60.0,-83.0,-90.0,-83.0,-89.0,13.0,20.0,14.0,28.0,1
1332,CC:2F:71:3F:1F:24,7744147,7308652818,4533014,6903061510,3211133,405591308,80,1046858,640892299,1038349,639870397,8509,1021902,994002,619,4537724,459208,80,5563,86667.0,14444.0,-69.0,-64.0,-72.0,-69.0,-69.0,-64.0,-72.0,-68.0,-83.0,-90.0,-83.0,-89.0,14.0,26.0,11.0,20.0,1
1333,F8:59:71:5A:E0:3D,3294316,523253025,83181,117661515,3211135,405591510,0,80958,76395178,76180,75824282,4778,570896,58922,16,85893,2103,0,507,144444.0,43333.0,-67.0,-72.0,-65.0,-70.0,-66.0,-72.0,-65.0,-70.0,-83.0,-90.0,-83.0,-89.0,16.0,18.0,18.0,19.0,1
1334,CC:2F:71:3E:C5:1F,3222491,406980666,11356,1389156,3211135,405591510,6,48516,4062332,40099,3065058,8417,997274,11972,34,16320,186,6,823,144444.0,43333.0,-70.0,-70.0,-69.0,-61.0,-68.0,-68.0,-68.0,-60.0,-83.0,-90.0,-83.0,-89.0,13.0,20.0,14.0,28.0,1
1335,CC:2F:71:3F:1F:24,7745584,7310866940,4534449,6905275430,3211135,405591510,80,1047236,641121610,1038727,640099708,8509,1021902,994380,619,4539138,459267,80,5563,86667.0,14444.0,-69.0,-65.0,-73.0,-69.0,-69.0,-64.0,-72.0,-68.0,-83.0,-90.0,-83.0,-89.0,14.0,25.0,10.0,20.0,1
1336,F8:59:71:5A:E0:3D,3294395,523357551,83246,117762525,3211149,405595026,0,81022,76493738,76244,75922842,4778,570896,58986,16,85957,2103,0,507,144444.0,43333.0,-66.0,-72.0,-65.0,-70.0,-66.0,-72.0,-64.0,-70.0,-83.0,-90.0,-83.0,-89.0,17.0,18.0,18.0,19.0,1
1337,CC:2F:71:3E:C5:1F,3222506,406984242,11356,1389156,3211150,405595086,6,48516,4062332,40099,3065058,8417,997274,11972,34,16320,186,6,823,144444.0,43333.0,-70.0,-70.0,-69.0,-61.0,-68.0,-68.0,-68.0,-60.0,-83.0,-90.0,-83.0,-89.0,13.0,20.0,14.0,28.0,1
1338,CC:2F:71:3F:1F:24,7746704,7312569878,4535554,6906974792,3211150,405595086,80,1047565,641347684,1039056,640325782,8509,1021902,994709,619,4540273,459341,80,5563,86667.0,14444.0,-69.0,-64.0,-73.0,-68.0,-69.0,-64.0,-72.0,-68.0,-83.0,-90.0,-83.0,-89.0,14.0,26.0,10.0,21.0,1
1339,F8:59:71:5A:E0:3D,3294465,523461931,83313,117866643,3211152,405595288,0,81091,76600068,76313,76029172,4778,570896,59054,16,86025,2103,0,508,144444.0,43333.0,-67.0,-72.0,-66.0,-71.0,-66.0,-71.0,-64.0,-70.0,-83.0,-90.0,-83.0,-89.0,16.0,18.0,17.0,18.0,1
1340,CC:2F:71:3E:C5:1F,3222508,406984444,11356,1389156,3211152,405595288,6,48516,4062332,40099,3065058,8417,997274,11972,34,16320,186,6,823,144444.0,43333.0,-70.0,-70.0,-69.0,-61.0,-68.0,-68.0,-68.0,-60.0,-83.0,-90.0,-83.0,-89.0,13.0,20.0,14.0,28.0,1
1341,CC:2F:71:3F:1F:24,7747499,7313777210,4536347,6908181922,3211152,405595288,80,1047845,641575410,1039336,640553508,8509,1021902,994986,619,4541056,459359,80,5563,86667.0,14444.0,-70.0,-65.0,-72.0,-69.0,-70.0,-65.0,-72.0,-69.0,-83.0,-90.0,-83.0,-89.0,13.0,25.0,11.0,20.0,1
1342,F8:59:71:5A:E0:3D,3294537,523563829,83379,117967769,3211158,405596060,0,81157,76701736,76379,76130840,4778,570896,59118,16,86091,2103,0,508,144444.0,43333.0,-67.0,-72.0,-66.0,-71.0,-66.0,-72.0,-65.0,-70.0,-82.0,-89.0,-82.0,-89.0,15.0,17.0,16.0,18.0,1
1343,CC:2F:71:3E:C5:1F,3222517,406985478,11357,1389216,3211160,405596262,6,48518,4062472,40101,3065198,8417,997274,11972,34,16321,186,6,823,130000.0,39000.0,-65.0,-68.0,-64.0,-60.0,-68.0,-70.0,-68.0,-60.0,-82.0,-89.0,-82.0,-89.0,17.0,21.0,18.0,29.0,1
1344,CC:2F:71:3F:1F:24,7748344,7315053636,4537184,6909457374,3211160,405596262,80,1048109,641785276,1039600,640763374,8509,1021902,995250,619,4541882,459492,80,5563,65000.0,13000.0,-69.0,-65.0,-72.0,-69.0,-69.0,-65.0,-72.0,-69.0,-82.0,-89.0,-82.0,-89.0,13.0,24.0,10.0,20.0,1
1345,F8:59:71:5A:E0:3D,3294606,523663749,83443,118067225,3211163,405596524,0,81221,76800296,76443,76229400,4778,570896,59182,16,86155,2105,0,508,144444.0,43333.0,-67.0,-72.0,-65.0,-71.0,-67.0,-72.0,-65.0,-70.0,-82.0,-89.0,-82.0,-89.0,15.0,17.0,17.0,18.0,1
1346,CC:2F:71:3E:C5:1F,3222520,406985740,11357,1389216,3211163,405596524,6,48518,4062472,40101,3065198,8417,997274,11972,34,16321,186,6,823,130000.0,39000.0,-65.0,-68.0,-64.0,-60.0,-68.0,-70.0,-68.0,-60.0,-82.0,-89.0,-82.0,-89.0,17.0,21.0,18.0,29.0,1
1347,CC:2F:71:3F:1F:24,7749587,7316967562,4538424,6911371038,3211163,405596524,80,1048465,642025932,1039956,641004030,8509,1021902,995605,619,4543143,459601,80,5564,86667.0,14444.0,-70.0,-65.0,-73.0,-69.0,-70.0,-64.0,-72.0,-69.0,-82.0,-89.0,-82.0,-89.0,12.0,24.0,9.0,20.0,1
1348,F8:59:71:5A:E0:3D,3294677,523771177,83512,118174451,3211165,405596726,0,81291,76908110,76513,76337214,4778,570896,59251,16,86224,2105,0,508,144444.0,43333.0,-67.0,-72.0,-65.0,-70.0,-67.0,-72.0,-65.0,-70.0,-82.0,-89.0,-82.0,-89.0,15.0,17.0,17.0,19.0,1
1349,CC:2F:71:3E:C5:1F,3222526,406986346,11357,1389216,3211169,405597130,6,48518,4062472,40101,3065198,8417,997274,11972,34,16321,186,6,823,130000.0,39000.0,-65.0,-68.0,-64.0,-60.0,-68.0,-70.0,-68.0,-60.0,-82.0,-89.0,-82.0,-89.0,17.0,21.0,18.0,29.0,1
1350,CC:2F:71:3F:1F:24,7750772,7318777928,4539603,6913180798,3211169,405597130,80,1048808,642254134,1040299,641232232,8509,1021902,995948,619,4544322,459690,80,5564,86667.0,13000.0,-69.0,-65.0,-72.0,-68.0,-69.0,-64.0,-72.0,-68.0,-82.0,-89.0,-82.0,-89.0,13.0,24.0,10.0,21.0,1
1351,F8:59:71:5A:E0:3D,3294746,523871153,83577,118274023,3211169,405597130,0,81358,77009884,76580,76438988,4778,570896,59316,16,86289,2105,0,508,144444.0,43333.0,-67.0,-72.0,-65.0,-71.0,-67.0,-72.0,-65.0,-70.0,-82.0,-89.0,-82.0,-89.0,15.0,17.0,17.0,18.0,1
1352,CC:2F:71:3E:C5:1F,3222527,406986480,11357,1389216,3211170,405597264,6,48518,4062472,40101,3065198,8417,997274,11972,34,16321,186,6,823,130000.0,39000.0,-65.0,-68.0,-64.0,-60.0,-68.0,-70.0,-68.0,-60.0,-82.0,-89.0,-82.0,-89.0,17.0,21.0,18.0,29.0,1
1353,CC:2F:71:3F:1F:24,7751816,7320378152,4540645,6914780820,3211171,405597332,80,1049120,642479536,1040611,641457634,8509,1021902,996258,619,4545358,459715,80,5564,86667.0,14444.0,-70.0,-64.0,-72.0,-68.0,-69.0,-64.0,-72.0,-68.0,-82.0,-89.0,-82.0,-89.0,12.0,25.0,10.0,21.0,1
1354,F8:59:71:5A:E0:3D,3294817,523974181,83643,118376587,3211174,405597594,0,81426,77114632,76648,76543736,4778,570896,59382,16,86354,2106,0,508,144444.0,43333.0,-67.0,-73.0,-65.0,-71.0,-67.0,-72.0,-65.0,-71.0,-82.0,-89.0,-82.0,-89.0,15.0,16.0,17.0,18.0,1
1355,CC:2F:71:3E:C5:1F,3222531,406986810,11357,1389216,3211174,405597594,6,48518,4062472,40101,3065198,8417,997274,11972,34,16321,186,6,823,130000.0,39000.0,-65.0,-68.0,-64.0,-60.0,-68.0,-70.0,-68.0,-60.0,-82.0,-89.0,-82.0,-89.0,17.0,21.0,18.0,29.0,1
1356,CC:2F:71:3F:1F:24,7752730,7321768954,4541554,6916171158,3211176,405597796,80,1049411,642695692,1040902,641673790,8509,1021902,996549,619,4546273,459838,80,5564,86667.0,14444.0,-70.0,-65.0,-73.0,-69.0,-70.0,-65.0,-72.0,-69.0,-82.0,-89.0,-82.0,-89.0,12.0,24.0,9.0,20.0,1
1357,F8:59:71:5A:E0:3D,3294883,524070933,83705,118472935,3211178,405597998,0,81488,77210112,76710,76639216,4778,570896,59444,16,86417,2108,0,508,144444.0,43333.0,-67.0,-72.0,-65.0,-71.0,-67.0,-72.0,-65.0,-70.0,-82.0,-89.0,-82.0,-89.0,15.0,17.0,17.0,18.0,1
1358,CC:2F:71:3E:C5:1F,3222535,406987214,11357,1389216,3211178,405597998,6,48518,4062472,40101,3065198,8417,997274,11972,34,16321,186,6,823,130000.0,39000.0,-65.0,-68.0,-64.0,-60.0,-68.0,-70.0,-68.0,-60.0,-82.0,-89.0,-82.0,-89.0,17.0,21.0,18.0,29.0,1
1359,CC:2F:71:3F:1F:24,7753683,7323227194,4542505,6917629196,3211178,405597998,80,1049731,642916610,1041222,641894708,8509,1021902,996866,619,4547224,459870,80,5565,86667.0,14444.0,-70.0,-65.0,-74.0,-69.0,-70.0,-64.0,-73.0,-69.0,-82.0,-89.0,-82.0,-89.0,12.0,24.0,8.0,20.0,1
1360,F8:59:71:5A:E0:3D,3294960,524176015,83769,118572391,3211191,405603624,0,81552,77308672,76774,76737776,4778,570896,59508,16,86481,2110,0,508,144444.0,43333.0,-67.0,-72.0,-66.0,-71.0,-67.0,-72.0,-65.0,-70.0,-82.0,-89.0,-82.0,-89.0,15.0,17.0,16.0,18.0,1
1361,CC:2F:71:3E:C5:1F,3222550,406993042,11357,1389216,3211193,405603826,6,48518,4062472,40101,3065198,8417,997274,11972,34,16321,186,6,823,130000.0,39000.0,-65.0,-68.0,-64.0,-60.0,-68.0,-70.0,-68.0,-60.0,-82.0,-89.0,-82.0,-89.0,17.0,21.0,18.0,29.0,1
1362,CC:2F:71:3F:1F:24,7754747,7324836904,4543554,6919233078,3211193,405603826,80,1050074,643157719,1041565,642135817,8509,1021902,997209,619,4548273,459874,80,5567,86667.0,14444.0,-70.0,-64.0,-72.0,-69.0,-69.0,-64.0,-72.0,-69.0,-82.0,-89.0,-82.0,-89.0,12.0,25.0,10.0,20.0,1
1363,F8:59:71:5A:E0:3D,3295048,524290717,83839,118681003,3211209,405609714,0,81625,77421316,76847,76850420,4778,570896,59578,16,86551,2119,0,508,144444.0,43333.0,-66.0,-72.0,-65.0,-70.0,-66.0,-71.0,-65.0,-70.0,-82.0,-89.0,-82.0,-88.0,16.0,17.0,17.0,18.0,1
1364,CC:2F:71:3E:C5:1F,3222566,406998930,11357,1389216,3211209,405609714,6,48518,4062472,40101,3065198,8417,997274,11972,34,16321,186,6,823,130000.0,39000.0,-65.0,-68.0,-64.0,-60.0,-68.0,-70.0,-68.0,-60.0,-82.0,-89.0,-82.0,-88.0,17.0,21.0,18.0,28.0,1
1365,CC:2F:71:3F:1F:24,7755600,7326120962,4544391,6920511248,3211209,405609714,80,1050355,643372759,1041846,642350857,8509,1021902,997490,619,4549110,460001,80,5570,86667.0,14444.0,-70.0,-65.0,-73.0,-69.0,-69.0,-64.0,-72.0,-68.0,-82.0,-89.0,-82.0,-88.0,12.0,24.0,9.0,19.0,1
1366,F8:59:71:5A:E0:3D,3295114,524389094,83902,118778905,3211212,405610189,0,81688,77518336,76910,76947440,4778,570896,59641,16,86614,2119,0,508,144444.0,43333.0,-67.0,-72.0,-65.0,-70.0,-66.0,-72.0,-65.0,-70.0,-82.0,-89.0,-82.0,-88.0,15.0,17.0,17.0,18.0,1
1367,CC:2F:71:3E:C5:1F,3222571,406999607,11357,1389216,3211214,405610391,6,48518,4062472,40101,3065198,8417,997274,11972,34,16321,186,6,823,130000.0,39000.0,-65.0,-68.0,-64.0,-60.0,-68.0,-70.0,-68.0,-60.0,-82.0,-89.0,-82.0,-88.0,17.0,21.0,18.0,28.0,1
1368,CC:2F:71:3F:1F:24,7757147,7328510691,4545933,6922900300,3211214,405610391,80,1050738,643599233,1042229,642577331,8509,1021902,997873,619,4550636,460040,80,5570,86667.0,14444.0,-71.0,-65.0,-73.0,-69.0,-70.0,-65.0,-72.0,-68.0,-82.0,-89.0,-82.0,-88.0,11.0,24.0,9.0,19.0,1
1369,F8:59:71:5A:E0:3D,3295186,524492264,83968,118881469,3211218,405610795,0,81756,77623084,76978,77052188,4778,570896,59707,16,86680,2119,0,508,144444.0,43333.0,-66.0,-72.0,-66.0,-71.0,-66.0,-72.0,-65.0,-70.0,-82.0,-89.0,-82.0,-88.0,16.0,17.0,16.0,17.0,1
1370,CC:2F:71:3E:C5:1F,3222576,407000071,11357,1389216,3211219,405610855,6,48518,4062472,40101,3065198,8417,997274,11972,34,16321,186,6,823,130000.0,39000.0,-65.0,-68.0,-64.0,-60.0,-68.0,-70.0,-68.0,-60.0,-82.0,-89.0,-82.0,-88.0,17.0,21.0,18.0,28.0,1
1371,CC:2F:71:3F:1F:24,7759091,7331529433,4547872,6925918578,3211219,405610855,80,1051160,643842063,1042651,642820161,8509,1021902,998295,619,4552559,460191,80,5570,104000.0,26000.0,-70.0,-65.0,-73.0,-69.0,-70.0,-65.0,-72.0,-69.0,-82.0,-88.0,-81.0,-88.0,12.0,23.0,8.0,19.0,1
1372,F8:59:71:5A:E0:3D,3295258,524599752,84037,118988695,3211221,405611057,0,81826,77730898,77048,77160002,4778,570896,59776,16,86749,2119,0,508,144444.0,43333.0,-67.0,-72.0,-65.0,-70.0,-67.0,-72.0,-65.0,-70.0,-82.0,-88.0,-81.0,-88.0,15.0,16.0,16.0,18.0,1
1373,CC:2F:71:3E:C5:1F,3222578,407000273,11357,1389216,3211221,405611057,6,48518,4062472,40101,3065198,8417,997274,11972,34,16321,186,6,823,130000.0,39000.0,-65.0,-68.0,-64.0,-60.0,-68.0,-70.0,-68.0,-60.0,-82.0,-88.0,-81.0,-88.0,17.0,20.0,17.0,28.0,1
1374,CC:2F:71:3F:1F:24,7760991,7334467983,4549768,6928856724,3211223,405611259,80,1051615,644099165,1043106,643077263,8509,1021902,998749,619,4554487,460393,80,5572,86667.0,14444.0,-70.0,-65.0,-73.0,-69.0,-70.0,-65.0,-72.0,-69.0,-82.0,-88.0,-81.0,-88.0,12.0,23.0,8.0,19.0,1
1375,F8:59:71:5A:E0:3D,3295334,524708255,84107,119096592,3211227,405611663,0,81896,77837308,77118,77266412,4778,570896,59846,16,86819,2121,0,508,144444.0,43333.0,-67.0,-72.0,-65.0,-70.0,-67.0,-72.0,-65.0,-70.0,-82.0,-88.0,-81.0,-88.0,15.0,16.0,16.0,18.0,1
1376,CC:2F:71:3E:C5:1F,3222584,407000879,11357,1389216,3211227,405611663,6,48518,4062472,40101,3065198,8417,997274,11972,34,16321,186,6,823,130000.0,39000.0,-65.0,-68.0,-64.0,-60.0,-68.0,-70.0,-68.0,-60.0,-82.0,-88.0,-81.0,-88.0,17.0,20.0,17.0,28.0,1
1377,CC:2F:71:3F:1F:24,7762450,7336710759,4551222,6931099034,3211228,405611725,80,1051977,644326766,1043468,643304864,8509,1021902,999111,619,4555926,460475,80,5572,86667.0,14444.0,-69.0,-64.0,-72.0,-69.0,-69.0,-64.0,-72.0,-69.0,-82.0,-88.0,-81.0,-88.0,13.0,24.0,9.0,19.0,1
1378,F8:59:71:5A:E0:3D,3295404,524809651,84172,119197602,3211232,405612049,0,81964,77942070,77186,77371174,4778,570896,59911,16,86884,2125,0,508,144444.0,43333.0,-67.0,-72.0,-65.0,-71.0,-67.0,-72.0,-65.0,-70.0,-83.0,-89.0,-82.0,-88.0,16.0,17.0,17.0,17.0,1
1379,CC:2F:71:3E:C5:1F,3222590,407001327,11357,1389216,3211233,405612111,6,48520,4062660,40102,3065268,8418,997392,11973,34,16321,186,6,823,130000.0,39000.0,-69.0,-70.0,-68.0,-61.0,-68.0,-70.0,-68.0,-60.0,-83.0,-89.0,-82.0,-88.0,14.0,19.0,14.0,27.0,1
1380,CC:2F:71:3F:1F:24,7763669,7338566646,4552436,6932954535,3211233,405612111,80,1052336,644558645,1043826,643536625,8510,1022020,999469,619,4557155,460610,80,5574,86667.0,14444.0,-70.0,-64.0,-72.0,-69.0,-69.0,-64.0,-72.0,-68.0,-83.0,-89.0,-82.0,-88.0,13.0,25.0,10.0,19.0,1
1381,F8:59:71:5A:E0:3D,3295475,524909775,84236,119297058,3211239,405612717,0,82030,78042302,77251,77471288,4779,571014,59976,16,86948,2125,0,508,144444.0,43333.0,-67.0,-72.0,-66.0,-71.0,-66.0,-72.0,-65.0,-70.0,-83.0,-89.0,-82.0,-88.0,16.0,17.0,16.0,17.0,1
1382,CC:2F:71:3E:C5:1F,3222596,407001933,11357,1389216,3211239,405612717,6,48520,4062660,40102,3065268,8418,997392,11973,34,16321,186,6,823,130000.0,39000.0,-69.0,-70.0,-68.0,-61.0,-68.0,-70.0,-68.0,-60.0,-83.0,-89.0,-82.0,-88.0,14.0,19.0,14.0,27.0,1
1383,CC:2F:71:3F:1F:24,7764929,7340501952,4553690,6934889235,3211239,405612717,80,1052679,644783585,1044169,643761565,8510,1022020,999812,619,4558409,460622,80,5574,65000.0,13000.0,-70.0,-65.0,-73.0,-69.0,-69.0,-64.0,-72.0,-68.0,-83.0,-89.0,-82.0,-88.0,13.0,24.0,9.0,19.0,1
1384,F8:59:71:5A:E0:3D,3295549,525021865,84308,119408946,3211241,405612919,0,82103,78154736,77324,77583722,4779,571014,60048,16,87020,2128,0,508,144444.0,43333.0,-67.0,-72.0,-65.0,-70.0,-66.0,-71.0,-65.0,-70.0,-83.0,-89.0,-82.0,-88.0,16.0,17.0,17.0,18.0,1
1385,CC:2F:71:3E:C5:1F,3222598,407002135,11357,1389216,3211241,405612919,6,48520,4062660,40102,3065268,8418,997392,11973,34,16321,186,6,823,130000.0,39000.0,-69.0,-70.0,-68.0,-61.0,-68.0,-70.0,-68.0,-60.0,-83.0,-89.0,-82.0,-88.0,14.0,19.0,14.0,27.0,1
1386,CC:2F:71:3F:1F:24,7766046,7342206956,4554805,6936594037,3211241,405612919,80,1053016,645032408,1044506,644010388,8510,1022020,1000148,619,4559524,460639,80,5574,86667.0,14444.0,-70.0,-65.0,-73.0,-69.0,-70.0,-65.0,-73.0,-69.0,-83.0,-89.0,-82.0,-88.0,13.0,24.0,9.0,19.0,1
1387,F8:59:71:5A:E0:3D,3295621,525123541,84373,119509956,3211248,405613585,0,82168,78254836,77389,77683822,4779,571014,60113,16,87085,2128,0,508,144444.0,43333.0,-67.0,-73.0,-65.0,-71.0,-67.0,-72.0,-65.0,-71.0,-83.0,-89.0,-82.0,-88.0,16.0,16.0,17.0,17.0,1
1388,CC:2F:71:3E:C5:1F,3222605,407002801,11357,1389216,3211248,405613585,6,48520,4062660,40102,3065268,8418,997392,11973,34,16321,186,6,823,130000.0,39000.0,-69.0,-70.0,-68.0,-61.0,-68.0,-70.0,-68.0,-60.0,-83.0,-89.0,-82.0,-88.0,14.0,19.0,14.0,27.0,1
1389,CC:2F:71:3F:1F:24,7767343,7344198546,4556095,6938584961,3211248,405613585,80,1053363,645257862,1044853,644235842,8510,1022020,1000495,619,4560814,460927,80,5574,86667.0,14444.0,-70.0,-65.0,-73.0,-69.0,-70.0,-65.0,-73.0,-69.0,-83.0,-89.0,-82.0,-88.0,13.0,24.0,9.0,19.0,1
1390,F8:59:71:5A:E0:3D,3295686,525224551,84438,119610966,3211248,405613585,0,82233,78354992,77454,77783978,4779,571014,60178,16,87150,2129,0,508,144444.0,43333.0,-67.0,-72.0,-66.0,-71.0,-66.0,-72.0,-65.0,-70.0,-83.0,-89.0,-82.0,-88.0,16.0,17.0,16.0,17.0,1
1391,CC:2F:71:3E:C5:1F,3222607,407003003,11357,1389216,3211250,405613787,6,48520,4062660,40102,3065268,8418,997392,11973,34,16321,186,6,823,130000.0,39000.0,-69.0,-70.0,-68.0,-61.0,-68.0,-70.0,-68.0,-60.0,-83.0,-89.0,-82.0,-88.0,14.0,19.0,14.0,27.0,1
1392,CC:2F:71:3F:1F:24,7768617,7346161692,4557367,6940547905,3211250,405613787,80,1053727,645486824,1045217,644464804,8510,1022020,1000858,619,4562086,460975,80,5574,86667.0,14444.0,-70.0,-65.0,-74.0,-69.0,-69.0,-65.0,-72.0,-69.0,-83.0,-89.0,-82.0,-88.0,13.0,24.0,8.0,19.0,1
1393,F8:59:71:5A:E0:3D,3295758,525324815,84502,119710422,3211256,405614393,0,82297,78453552,77518,77882538,4779,571014,60242,16,87214,2130,0,508,144444.0,43333.0,-67.0,-72.0,-66.0,-71.0,-67.0,-72.0,-65.0,-71.0,-83.0,-89.0,-82.0,-88.0,16.0,17.0,16.0,17.0,1
1394,CC:2F:71:3E:C5:1F,3222613,407003609,11357,1389216,3211256,405614393,6,48520,4062660,40102,3065268,8418,997392,11973,34,16321,186,6,823,130000.0,39000.0,-69.0,-70.0,-68.0,-61.0,-68.0,-70.0,-68.0,-60.0,-83.0,-89.0,-82.0,-88.0,14.0,19.0,14.0,27.0,1
1395,CC:2F:71:3F:1F:24,7769385,7347320830,4558129,6941706437,3211256,405614393,80,1054001,645697804,1045491,644675784,8510,1022020,1001132,619,4562848,460983,80,5574,86667.0,14444.0,-70.0,-65.0,-74.0,-69.0,-70.0,-65.0,-73.0,-69.0,-83.0,-89.0,-82.0,-88.0,13.0,24.0,8.0,19.0,1
1396,F8:59:71:5A:E0:3D,3295824,525423009,84567,119808556,3211257,405614453,0,82365,78555446,77586,77984432,4779,571014,60307,16,87279,2130,0,508,144444.0,43333.0,-66.0,-72.0,-65.0,-71.0,-66.0,-72.0,-65.0,-70.0,-83.0,-89.0,-82.0,-88.0,17.0,17.0,17.0,17.0,1
1397,CC:2F:71:3E:C5:1F,3222614,407003669,11357,1389216,3211257,405614453,6,48520,4062660,40102,3065268,8418,997392,11973,34,16321,186,6,823,130000.0,39000.0,-69.0,-70.0,-68.0,-61.0,-68.0,-70.0,-68.0,-60.0,-83.0,-89.0,-82.0,-88.0,14.0,19.0,14.0,27.0,1
1398,CC:2F:71:3F:1F:24,7770626,7349225476,4559369,6943611023,3211257,405614453,80,1054362,645925218,1045852,644903198,8510,1022020,1001492,619,4564088,461094,80,5574,86667.0,14444.0,-69.0,-64.0,-74.0,-69.0,-68.0,-64.0,-72.0,-69.0,-83.0,-89.0,-82.0,-88.0,14.0,25.0,8.0,19.0,1
1399,F8:59:71:5A:E0:3D,3295895,525521719,84630,119906458,3211265,405615261,0,82429,78654020,77650,78083006,4779,571014,60370,16,87342,2130,0,508,144444.0,43333.0,-67.0,-73.0,-65.0,-72.0,-67.0,-72.0,-65.0,-71.0,-83.0,-89.0,-82.0,-88.0,16.0,16.0,17.0,16.0,1
1400,CC:2F:71:3E:C5:1F,3222622,407004477,11357,1389216,3211265,405615261,6,48520,4062660,40102,3065268,8418,997392,11973,34,16321,186,6,823,130000.0,39000.0,-69.0,-70.0,-68.0,-61.0,-68.0,-70.0,-68.0,-60.0,-83.0,-89.0,-82.0,-88.0,14.0,19.0,14.0,27.0,1
1401,CC:2F:71:3F:1F:24,7771426,7350430740,4560161,6944815479,3211265,405615261,80,1054645,646141732,1046135,645119712,8510,1022020,1001775,619,4564880,461104,80,5574,86667.0,14444.0,-73.0,-63.0,-72.0,-70.0,-72.0,-63.0,-71.0,-70.0,-83.0,-89.0,-82.0,-88.0,10.0,26.0,10.0,18.0,1
1402,F8:59:71:5A:E0:3D,3295960,525622729,84695,120007468,3211265,405615261,0,82494,78754120,77715,78183106,4779,571014,60435,16,87407,2131,0,508,144444.0,43333.0,-67.0,-73.0,-64.0,-71.0,-66.0,-74.0,-64.0,-70.0,-83.0,-89.0,-82.0,-88.0,16.0,16.0,18.0,17.0,1
1403,CC:2F:71:3E:C5:1F,3222623,407004537,11357,1389216,3211266,405615321,6,48520,4062660,40102,3065268,8418,997392,11973,34,16321,186,6,823,130000.0,39000.0,-69.0,-70.0,-68.0,-61.0,-68.0,-70.0,-68.0,-60.0,-83.0,-89.0,-82.0,-88.0,14.0,19.0,14.0,27.0,1
1404,CC:2F:71:3F:1F:24,7772623,7352273936,4561357,6946658615,3211266,405615321,80,1054986,646370524,1046476,645348504,8510,1022020,1002116,619,4566076,461120,80,5574,104000.0,26000.0,-71.0,-63.0,-71.0,-68.0,-71.0,-63.0,-70.0,-68.0,-83.0,-89.0,-82.0,-88.0,12.0,26.0,11.0,20.0,1
1405,F8:59:71:5A:E0:3D,3296036,525730621,84764,120114694,3211272,405615927,0,82565,78863488,77786,78292474,4779,571014,60504,16,87476,2132,0,508,144444.0,43333.0,-66.0,-72.0,-64.0,-70.0,-66.0,-72.0,-64.0,-70.0,-83.0,-89.0,-82.0,-88.0,17.0,17.0,18.0,18.0,1
1406,CC:2F:71:3E:C5:1F,3222631,407005345,11357,1389216,3211274,405616129,6,48520,4062660,40102,3065268,8418,997392,11973,34,16321,186,6,823,130000.0,39000.0,-69.0,-70.0,-68.0,-61.0,-68.0,-70.0,-68.0,-60.0,-83.0,-89.0,-82.0,-88.0,14.0,19.0,14.0,27.0,1
1407,CC:2F:71:3F:1F:24,7774002,7354394462,4562728,6948778333,3211274,405616129,80,1055273,646598958,1046763,645576938,8510,1022020,1002402,619,4567447,461161,80,5574,144444.0,43333.0,-73.0,-64.0,-72.0,-70.0,-73.0,-64.0,-71.0,-70.0,-83.0,-89.0,-82.0,-88.0,10.0,25.0,10.0,18.0,1
1408,F8:59:71:5A:E0:3D,3296103,525830552,84828,120214150,3211275,405616402,0,82629,78962048,77850,78391034,4779,571014,60568,16,87540,2133,0,508,144444.0,43333.0,-67.0,-73.0,-65.0,-70.0,-67.0,-72.0,-65.0,-70.0,-83.0,-89.0,-83.0,-88.0,16.0,16.0,18.0,18.0,1
1409,CC:2F:71:3E:C5:1F,3222632,407005618,11357,1389216,3211275,405616402,6,48520,4062660,40102,3065268,8418,997392,11973,34,16321,186,6,823,130000.0,39000.0,-69.0,-70.0,-68.0,-61.0,-68.0,-70.0,-68.0,-60.0,-83.0,-89.0,-83.0,-88.0,14.0,19.0,15.0,27.0,1
1410,CC:2F:71:3F:1F:24,7774990,7355906614,4563715,6950290212,3211275,405616402,80,1055552,646812609,1047042,645790589,8510,1022020,1002680,619,4568434,461208,80,5574,144444.0,43333.0,-72.0,-64.0,-71.0,-70.0,-72.0,-64.0,-71.0,-70.0,-83.0,-89.0,-83.0,-88.0,11.0,25.0,12.0,18.0,1
1411,F8:59:71:5A:E0:3D,3296172,525927566,84890,120310498,3211282,405617068,0,82692,79059068,77913,78488054,4779,571014,60631,16,87602,2134,0,508,144444.0,43333.0,-67.0,-73.0,-65.0,-71.0,-66.0,-73.0,-64.0,-70.0,-83.0,-89.0,-83.0,-88.0,16.0,16.0,18.0,17.0,1
1412,CC:2F:71:3E:C5:1F,3222639,407006284,11357,1389216,3211282,405617068,6,48520,4062660,40102,3065268,8418,997392,11973,34,16321,186,6,823,130000.0,39000.0,-69.0,-70.0,-68.0,-61.0,-68.0,-70.0,-68.0,-60.0,-83.0,-89.0,-83.0,-88.0,14.0,19.0,15.0,27.0,1
1413,CC:2F:71:3F:1F:24,7776073,7357557046,4564789,6951939776,3211284,405617270,80,1055867,647032637,1047357,646010617,8510,1022020,1002995,619,4569508,461257,80,5574,144444.0,43333.0,-74.0,-64.0,-72.0,-70.0,-73.0,-64.0,-71.0,-69.0,-83.0,-89.0,-83.0,-88.0,9.0,25.0,11.0,18.0,1
1414,F8:59:71:5A:E0:3D,3296238,526027224,84954,120409954,3211284,405617270,0,82757,79159182,77978,78588168,4779,571014,60695,16,87666,2134,0,508,144444.0,43333.0,-67.0,-73.0,-65.0,-71.0,-66.0,-73.0,-65.0,-70.0,-83.0,-89.0,-83.0,-88.0,16.0,16.0,18.0,17.0,1
1415,CC:2F:71:3E:C5:1F,3222641,407006486,11357,1389216,3211284,405617270,6,48520,4062660,40102,3065268,8418,997392,11973,34,16321,186,6,823,130000.0,39000.0,-69.0,-70.0,-68.0,-61.0,-68.0,-70.0,-68.0,-60.0,-83.0,-89.0,-83.0,-88.0,14.0,19.0,15.0,27.0,1
1416,CC:2F:71:3F:1F:24,7777120,7359166156,4565836,6953548886,3211284,405617270,80,1056168,647248105,1047658,646226085,8510,1022020,1003296,619,4570555,461311,80,5574,144444.0,43333.0,-73.0,-64.0,-72.0,-70.0,-73.0,-64.0,-71.0,-70.0,-83.0,-89.0,-83.0,-88.0,10.0,25.0,11.0,18.0,1
1417,F8:59:71:5A:E0:3D,3296305,526125530,85017,120507856,3211288,405617674,0,82819,79254662,78040,78683648,4779,571014,60757,16,87729,2135,0,508,144444.0,43333.0,-67.0,-73.0,-65.0,-71.0,-66.0,-72.0,-64.0,-70.0,-83.0,-89.0,-83.0,-88.0,16.0,16.0,18.0,17.0,1
1418,CC:2F:71:3E:C5:1F,3222647,407007092,11357,1389216,3211290,405617876,6,48520,4062660,40102,3065268,8418,997392,11973,34,16321,186,6,823,130000.0,39000.0,-69.0,-70.0,-68.0,-61.0,-68.0,-70.0,-68.0,-60.0,-83.0,-89.0,-83.0,-88.0,14.0,19.0,15.0,27.0,1
1419,CC:2F:71:3F:1F:24,7777282,7359369922,4565992,6953752046,3211290,405617876,80,1056310,647442225,1047800,646420205,8510,1022020,1003438,619,4570711,461316,80,5574,144444.0,43333.0,-73.0,-64.0,-72.0,-70.0,-73.0,-64.0,-71.0,-70.0,-83.0,-89.0,-83.0,-88.0,10.0,25.0,11.0,18.0,1
1420,F8:59:71:5A:E0:3D,3296372,526222342,85079,120604204,3211293,405618138,0,82881,79350142,78102,78779128,4779,571014,60819,16,87791,2135,0,508,144444.0,43333.0,-67.0,-73.0,-65.0,-71.0,-66.0,-72.0,-64.0,-70.0,-84.0,-90.0,-84.0,-89.0,17.0,17.0,19.0,18.0,1
1421,CC:2F:71:3E:C5:1F,3222650,407007354,11357,1389216,3211293,405618138,6,48520,4062660,40102,3065268,8418,997392,11973,34,16321,186,6,823,130000.0,39000.0,-69.0,-70.0,-68.0,-61.0,-68.0,-70.0,-68.0,-60.0,-84.0,-90.0,-84.0,-89.0,15.0,20.0,16.0,28.0,1
1422,CC:2F:71:3F:1F:24,7777441,7359573344,4566148,6953955206,3211293,405618138,80,1056453,647637941,1047943,646615921,8510,1022020,1003579,619,4570866,461318,80,5575,144444.0,43333.0,-72.0,-64.0,-71.0,-71.0,-72.0,-64.0,-71.0,-70.0,-84.0,-90.0,-84.0,-89.0,12.0,26.0,13.0,18.0,1
1423,F8:59:71:5A:E0:3D,3296436,526318892,85141,120700552,3211295,405618340,0,82944,79447176,78165,78876162,4779,571014,60881,16,87853,2135,0,508,144444.0,43333.0,-67.0,-72.0,-64.0,-71.0,-66.0,-72.0,-64.0,-70.0,-84.0,-90.0,-84.0,-89.0,17.0,18.0,20.0,18.0,1
1424,CC:2F:71:3E:C5:1F,3222652,407007556,11357,1389216,3211295,405618340,6,48520,4062660,40102,3065268,8418,997392,11973,34,16321,186,6,823,130000.0,39000.0,-69.0,-70.0,-68.0,-61.0,-68.0,-70.0,-68.0,-60.0,-84.0,-90.0,-84.0,-89.0,15.0,20.0,16.0,28.0,1
1425,CC:2F:71:3F:1F:24,7777609,7359783357,4566312,6954164815,3211297,405618542,80,1056603,647836329,1048093,646814309,8510,1022020,1003729,619,4571031,461321,80,5575,144444.0,43333.0,-72.0,-64.0,-72.0,-71.0,-72.0,-63.0,-71.0,-70.0,-84.0,-90.0,-84.0,-89.0,12.0,26.0,12.0,18.0,1
1426,F8:59:71:5A:E0:3D,3296505,526415962,85204,120797016,3211301,405618946,0,83006,79542656,78227,78971642,4779,571014,60943,16,87916,2135,0,508,144444.0,43333.0,-67.0,-72.0,-65.0,-71.0,-66.0,-72.0,-64.0,-70.0,-84.0,-90.0,-84.0,-89.0,17.0,18.0,19.0,18.0,1
1427,CC:2F:71:3E:C5:1F,3222659,407008222,11358,1389276,3211301,405618946,6,48522,4062800,40104,3065408,8418,997392,11973,34,16322,186,6,823,130000.0,39000.0,-69.0,-63.0,-67.0,-61.0,-68.0,-69.0,-68.0,-60.0,-84.0,-90.0,-84.0,-89.0,15.0,27.0,17.0,28.0,1
1428,CC:2F:71:3F:1F:24,7777768,7359983929,4566467,6954364983,3211301,405618946,80,1056743,648028793,1048233,647006773,8510,1022020,1003869,619,4571186,461323,80,5575,144444.0,43333.0,-72.0,-64.0,-72.0,-71.0,-72.0,-63.0,-71.0,-70.0,-84.0,-90.0,-84.0,-89.0,12.0,26.0,12.0,18.0,1
1429,F8:59:71:5A:E0:3D,3296570,526512460,85266,120893252,3211304,405619208,0,83069,79639690,78290,79068676,4779,571014,61005,16,87978,2135,0,508,144444.0,39000.0,-67.0,-72.0,-65.0,-71.0,-66.0,-72.0,-64.0,-71.0,-85.0,-90.0,-84.0,-89.0,18.0,18.0,19.0,18.0,1
1430,CC:2F:71:3E:C5:1F,3222662,407008484,11358,1389276,3211304,405619208,6,48522,4062800,40104,3065408,8418,997392,11973,34,16322,186,6,823,130000.0,39000.0,-69.0,-63.0,-67.0,-61.0,-68.0,-69.0,-68.0,-60.0,-85.0,-90.0,-84.0,-89.0,16.0,27.0,17.0,28.0,1
1431,CC:2F:71:3F:1F:24,7778495,7361083607,4567191,6955464399,3211304,405619208,80,1056954,648232467,1048444,647210447,8510,1022020,1004080,619,4571878,461363,80,5575,144444.0,43333.0,-72.0,-64.0,-71.0,-71.0,-72.0,-64.0,-71.0,-70.0,-85.0,-90.0,-84.0,-89.0,13.0,26.0,13.0,18.0,1
1432,F8:59:71:5A:E0:3D,3296641,526614020,85331,120994206,3211310,405619814,0,83134,79739790,78355,79168776,4779,571014,61070,16,88042,2135,0,508,144444.0,43333.0,-67.0,-73.0,-64.0,-71.0,-67.0,-74.0,-64.0,-71.0,-85.0,-90.0,-84.0,-89.0,18.0,17.0,20.0,18.0,1
1433,CC:2F:71:3E:C5:1F,3222668,407009090,11358,1389276,3211310,405619814,6,48522,4062800,40104,3065408,8418,997392,11973,34,16322,186,6,823,130000.0,39000.0,-69.0,-63.0,-67.0,-61.0,-68.0,-69.0,-68.0,-60.0,-85.0,-90.0,-84.0,-89.0,16.0,27.0,17.0,28.0,1
1434,CC:2F:71:3F:1F:24,7780409,7364051677,4569099,6958431863,3211310,405619814,80,1057307,648468591,1048797,647446571,8510,1022020,1004432,619,4573818,461643,80,5575,130000.0,43333.0,-73.0,-64.0,-72.0,-69.0,-73.0,-63.0,-72.0,-69.0,-85.0,-90.0,-84.0,-89.0,12.0,26.0,12.0,20.0,1
1435,F8:59:71:5A:E0:3D,3296706,526715030,85396,121095216,3211310,405619814,0,83201,79842998,78422,79271984,4779,571014,61135,16,88108,2136,0,508,144444.0,43333.0,-68.0,-73.0,-65.0,-71.0,-68.0,-73.0,-65.0,-71.0,-85.0,-90.0,-84.0,-89.0,17.0,17.0,19.0,18.0,1
1436,CC:2F:71:3E:C5:1F,3222668,407009090,11358,1389276,3211310,405619814,6,48522,4062800,40104,3065408,8418,997392,11973,34,16322,186,6,823,130000.0,39000.0,-69.0,-63.0,-67.0,-61.0,-68.0,-69.0,-68.0,-60.0,-85.0,-90.0,-84.0,-89.0,16.0,27.0,17.0,28.0,1
1437,CC:2F:71:3F:1F:24,7782056,7366596962,4570744,6960976946,3211312,405620016,80,1057652,648695720,1049142,647673700,8510,1022020,1004777,619,4575463,461752,80,5576,130000.0,43333.0,-69.0,-65.0,-72.0,-69.0,-69.0,-64.0,-72.0,-69.0,-85.0,-90.0,-84.0,-89.0,16.0,25.0,12.0,20.0,1
1438,F8:59:71:5A:E0:3D,3296779,526818260,85462,121197780,3211317,405620480,0,83267,79944666,78488,79373652,4779,571014,61201,16,88174,2137,0,508,144444.0,43333.0,-67.0,-71.0,-65.0,-70.0,-66.0,-71.0,-65.0,-70.0,-84.0,-89.0,-84.0,-88.0,17.0,18.0,19.0,18.0,1
1439,CC:2F:71:3E:C5:1F,3222678,407010343,11361,1389863,3211317,405620480,6,48527,4063545,40109,3066153,8418,997392,11978,34,16325,186,6,824,130000.0,39000.0,-65.0,-61.0,-67.0,-59.0,-68.0,-67.0,-67.0,-60.0,-84.0,-89.0,-84.0,-88.0,19.0,28.0,17.0,29.0,1
1440,CC:2F:71:3F:1F:24,7783513,7368846874,4572196,6963226394,3211317,405620480,80,1058002,648924124,1049492,647902104,8510,1022020,1005127,619,4576915,462222,80,5576,115556.0,28889.0,-69.0,-64.0,-72.0,-69.0,-69.0,-64.0,-72.0,-69.0,-84.0,-89.0,-84.0,-88.0,15.0,25.0,12.0,19.0,1
1441,F8:59:71:5A:E0:3D,3296848,526922580,85529,121301898,3211319,405620682,0,83334,80047846,78555,79476832,4779,571014,61268,16,88241,2137,0,508,144444.0,43333.0,-67.0,-72.0,-64.0,-70.0,-66.0,-72.0,-64.0,-70.0,-84.0,-89.0,-84.0,-88.0,17.0,17.0,20.0,18.0,1
1442,CC:2F:71:3E:C5:1F,3222681,407010675,11362,1389993,3211319,405620682,6,48528,4063615,40110,3066223,8418,997392,11978,34,16326,186,6,824,130000.0,39000.0,-69.0,-71.0,-68.0,-60.0,-68.0,-67.0,-67.0,-60.0,-84.0,-89.0,-84.0,-88.0,15.0,18.0,16.0,28.0,1
1443,CC:2F:71:3F:1F:24,7785451,7371856836,4574132,6966236154,3211319,405620682,80,1058415,649174466,1049905,648152446,8510,1022020,1005539,619,4578850,462630,80,5577,86667.0,13000.0,-67.0,-64.0,-72.0,-69.0,-67.0,-64.0,-72.0,-69.0,-84.0,-89.0,-84.0,-88.0,17.0,25.0,12.0,19.0,1
1444,F8:59:71:5A:E0:3D,3296924,527031966,85599,121410678,3211325,405621288,0,83404,80155646,78625,79584632,4779,571014,61338,16,88311,2138,0,508,144444.0,43333.0,-67.0,-72.0,-66.0,-70.0,-67.0,-72.0,-65.0,-70.0,-84.0,-89.0,-84.0,-88.0,17.0,17.0,18.0,18.0,1
1445,CC:2F:71:3E:C5:1F,3222688,407011341,11362,1389993,3211326,405621348,6,48528,4063615,40110,3066223,8418,997392,11978,34,16326,186,6,824,130000.0,39000.0,-69.0,-71.0,-68.0,-60.0,-68.0,-67.0,-67.0,-60.0,-84.0,-89.0,-84.0,-88.0,15.0,18.0,16.0,28.0,1
1446,CC:2F:71:3F:1F:24,7787317,7374746556,4575991,6969125208,3211326,405621348,80,1058840,649417750,1050330,648395730,8510,1022020,1005964,619,4580710,462684,80,5579,86667.0,14444.0,-69.0,-65.0,-72.0,-69.0,-68.0,-64.0,-72.0,-68.0,-84.0,-89.0,-84.0,-88.0,15.0,24.0,12.0,19.0,1
1447,F8:59:71:5A:E0:3D,3296993,527134680,85665,121513130,3211328,405621550,0,83470,80257286,78691,79686272,4779,571014,61404,16,88377,2141,0,508,144444.0,43333.0,-67.0,-72.0,-65.0,-71.0,-66.0,-71.0,-64.0,-70.0,-85.0,-89.0,-84.0,-89.0,18.0,17.0,19.0,18.0,1
1448,CC:2F:71:3E:C5:1F,3222690,407011543,11362,1389993,3211328,405621550,6,48528,4063615,40110,3066223,8418,997392,11978,34,16326,186,6,824,130000.0,39000.0,-69.0,-71.0,-68.0,-60.0,-68.0,-67.0,-67.0,-60.0,-85.0,-89.0,-84.0,-89.0,16.0,18.0,16.0,29.0,1
1449,CC:2F:71:3F:1F:24,7788965,7377290876,4577637,6971669326,3211328,405621550,80,1059269,649653253,1050759,648631233,8510,1022020,1006393,619,4582356,462734,80,5579,86667.0,14444.0,-69.0,-65.0,-72.0,-68.0,-69.0,-65.0,-72.0,-67.0,-85.0,-89.0,-84.0,-89.0,16.0,24.0,12.0,21.0,1
1450,F8:59:71:5A:E0:3D,3297069,527242785,85734,121620356,3211335,405622429,0,83540,80365156,78761,79794142,4779,571014,61473,16,88446,2141,0,509,144444.0,43333.0,-67.0,-72.0,-65.0,-70.0,-66.0,-71.0,-64.0,-70.0,-85.0,-89.0,-84.0,-89.0,18.0,17.0,19.0,19.0,1
1451,CC:2F:71:3E:C5:1F,3222697,407012422,11362,1389993,3211335,405622429,6,48528,4063615,40110,3066223,8418,997392,11978,34,16326,186,6,824,130000.0,39000.0,-69.0,-71.0,-68.0,-60.0,-68.0,-67.0,-67.0,-60.0,-85.0,-89.0,-84.0,-89.0,16.0,18.0,16.0,29.0,1
1452,CC:2F:71:3F:1F:24,7790173,7379143485,4578838,6973521056,3211335,405622429,80,1059610,649909723,1051100,648887703,8510,1022020,1006732,619,4583557,463351,80,5579,86667.0,14444.0,-68.0,-65.0,-71.0,-67.0,-68.0,-65.0,-72.0,-67.0,-85.0,-89.0,-84.0,-89.0,17.0,24.0,13.0,22.0,1
1453,F8:59:71:5A:E0:3D,3297142,527351827,85804,121729136,3211338,405622691,0,83610,80472956,78831,79901942,4779,571014,61543,16,88516,2142,0,509,144444.0,43333.0,-66.0,-71.0,-65.0,-70.0,-66.0,-71.0,-64.0,-70.0,-85.0,-89.0,-84.0,-89.0,19.0,18.0,19.0,19.0,1
1454,CC:2F:71:3E:C5:1F,3222700,407012684,11362,1389993,3211338,405622691,6,48528,4063615,40110,3066223,8418,997392,11978,34,16326,186,6,824,130000.0,39000.0,-69.0,-71.0,-68.0,-60.0,-68.0,-67.0,-67.0,-60.0,-85.0,-89.0,-84.0,-89.0,16.0,18.0,16.0,29.0,1
1455,CC:2F:71:3F:1F:24,7791507,7381201353,4580169,6975578662,3211338,405622691,80,1059960,650144337,1051450,649122317,8510,1022020,1007076,619,4584880,463378,80,5579,86667.0,14444.0,-69.0,-66.0,-72.0,-67.0,-69.0,-65.0,-72.0,-67.0,-85.0,-89.0,-84.0,-89.0,16.0,23.0,12.0,22.0,1
1456,F8:59:71:5A:E0:3D,3297214,527453505,85869,121830146,3211345,405623359,0,83676,80574610,78897,80003596,4779,571014,61608,16,88581,2142,0,509,144444.0,43333.0,-66.0,-71.0,-65.0,-70.0,-66.0,-71.0,-64.0,-70.0,-85.0,-89.0,-84.0,-89.0,19.0,18.0,19.0,19.0,1
1457,CC:2F:71:3E:C5:1F,3222707,407013352,11362,1389993,3211345,405623359,6,48528,4063615,40110,3066223,8418,997392,11978,34,16326,186,6,824,130000.0,39000.0,-69.0,-71.0,-68.0,-60.0,-68.0,-67.0,-67.0,-60.0,-85.0,-89.0,-84.0,-89.0,16.0,18.0,16.0,29.0,1
1458,CC:2F:71:3F:1F:24,7792727,7383071975,4581382,6977448616,3211345,405623359,80,1060322,650371765,1051811,649349627,8511,1022138,1007438,619,4586097,463382,80,5580,86667.0,14444.0,-69.0,-66.0,-72.0,-67.0,-69.0,-65.0,-72.0,-67.0,-85.0,-89.0,-84.0,-89.0,16.0,23.0,12.0,22.0,1
1459,F8:59:71:5A:E0:3D,3297282,527554779,85934,121931156,3211348,405623623,0,83743,80676382,78963,80105250,4780,571132,61674,16,88646,2142,0,509,144444.0,43333.0,-66.0,-71.0,-64.0,-70.0,-66.0,-71.0,-64.0,-70.0,-85.0,-89.0,-84.0,-89.0,19.0,18.0,20.0,19.0,1
1460,CC:2F:71:3E:C5:1F,3222711,407013732,11363,1390109,3211348,405623623,6,48530,4063791,40112,3066399,8418,997392,11979,34,16327,186,6,824,130000.0,39000.0,-70.0,-71.0,-69.0,-60.0,-68.0,-68.0,-68.0,-59.0,-85.0,-89.0,-84.0,-89.0,15.0,18.0,15.0,29.0,1
1461,CC:2F:71:3F:1F:24,7793801,7384710760,4582453,6979087137,3211348,405623623,80,1060693,650601942,1052182,649579804,8511,1022138,1007807,619,4587172,463798,80,5581,115556.0,28889.0,-69.0,-65.0,-71.0,-67.0,-68.0,-65.0,-71.0,-67.0,-85.0,-89.0,-84.0,-89.0,16.0,24.0,13.0,22.0,1
1462,F8:59:71:5A:E0:3D,3297353,527654901,85998,122030612,3211355,405624289,0,83810,80779590,79030,80208458,4780,571132,61739,16,88710,2143,0,509,144444.0,43333.0,-66.0,-72.0,-65.0,-70.0,-66.0,-71.0,-64.0,-69.0,-85.0,-89.0,-84.0,-89.0,19.0,17.0,19.0,19.0,1
1463,CC:2F:71:3E:C5:1F,3222719,407014514,11364,1390225,3211355,405624289,6,48533,4064037,40115,3066645,8418,997392,11980,34,16328,186,6,824,130000.0,39000.0,-70.0,-71.0,-69.0,-60.0,-68.0,-68.0,-68.0,-59.0,-85.0,-89.0,-84.0,-89.0,15.0,18.0,15.0,29.0,1
1464,CC:2F:71:3F:1F:24,7794662,7386015838,4583307,6980391549,3211355,405624289,80,1060999,650825348,1052488,649803210,8511,1022138,1008113,619,4588009,464093,80,5583,115556.0,28889.0,-68.0,-65.0,-71.0,-67.0,-68.0,-65.0,-71.0,-67.0,-85.0,-89.0,-84.0,-89.0,17.0,24.0,13.0,22.0,1
1465,F8:59:71:5A:E0:3D,3297422,527756481,86063,122131622,3211359,405624859,0,83874,80878150,79094,80307018,4780,571132,61803,16,88775,2143,0,509,144444.0,43333.0,-66.0,-71.0,-65.0,-70.0,-66.0,-71.0,-64.0,-70.0,-85.0,-89.0,-84.0,-89.0,19.0,18.0,19.0,19.0,1
1466,CC:2F:71:3E:C5:1F,3222724,407015146,11364,1390225,3211360,405624921,6,48534,4064155,40115,3066645,8419,997510,11981,34,16328,186,6,824,130000.0,39000.0,-70.0,-71.0,-68.0,-60.0,-69.0,-69.0,-68.0,-59.0,-85.0,-89.0,-84.0,-89.0,15.0,18.0,16.0,29.0,1
1467,CC:2F:71:3F:1F:24,7795967,7388021702,4584607,6982396781,3211360,405624921,80,1061390,651055631,1052879,650033493,8511,1022138,1008504,619,4589326,464528,80,5583,115556.0,26000.0,-69.0,-65.0,-72.0,-67.0,-68.0,-65.0,-71.0,-67.0,-85.0,-89.0,-84.0,-89.0,16.0,24.0,12.0,22.0,1
1468,F8:59:71:5A:E0:3D,3297492,527857957,86128,122232632,3211364,405625325,0,83939,80978250,79159,80407118,4780,571132,61868,16,88840,2143,0,509,144444.0,43333.0,-66.0,-71.0,-64.0,-70.0,-66.0,-71.0,-64.0,-70.0,-85.0,-89.0,-84.0,-89.0,19.0,18.0,20.0,19.0,1
1469,CC:2F:71:3E:C5:1F,3222730,407015752,11364,1390225,3211366,405625527,6,48535,4064225,40116,3066715,8419,997510,11981,34,16328,186,6,824,130000.0,39000.0,-70.0,-71.0,-69.0,-60.0,-69.0,-71.0,-68.0,-60.0,-85.0,-89.0,-84.0,-89.0,15.0,18.0,15.0,29.0,1
1470,CC:2F:71:3F:1F:24,7797271,7390024178,4585905,6984398651,3211366,405625527,80,1061779,651292803,1053268,650270665,8511,1022138,1008892,619,4590613,465039,80,5583,104000.0,26000.0,-68.0,-65.0,-71.0,-67.0,-68.0,-65.0,-71.0,-67.0,-85.0,-89.0,-84.0,-89.0,17.0,24.0,13.0,22.0,1
1471,F8:59:71:5A:E0:3D,3297567,527965707,86197,122339858,3211370,405625849,0,84008,81084510,79228,80513378,4780,571132,61937,16,88909,2143,0,509,144444.0,43333.0,-66.0,-71.0,-64.0,-70.0,-66.0,-71.0,-64.0,-70.0,-85.0,-89.0,-84.0,-89.0,19.0,18.0,20.0,19.0,1
1472,CC:2F:71:3E:C5:1F,3222734,407016074,11364,1390225,3211370,405625849,6,48535,4064225,40116,3066715,8419,997510,11981,34,16328,186,6,824,130000.0,39000.0,-70.0,-71.0,-69.0,-60.0,-69.0,-71.0,-68.0,-60.0,-85.0,-89.0,-84.0,-89.0,15.0,18.0,15.0,29.0,1
1473,CC:2F:71:3F:1F:24,7798693,7392210689,4587323,6986584840,3211370,405625849,80,1062186,651539801,1053675,650517663,8511,1022138,1009299,619,4592032,465821,80,5583,86667.0,13000.0,-69.0,-65.0,-72.0,-67.0,-68.0,-65.0,-72.0,-67.0,-85.0,-89.0,-84.0,-89.0,16.0,24.0,12.0,22.0,1
1474,F8:59:71:5A:E0:3D,3297644,528075153,86267,122448638,3211377,405626515,0,84078,81192408,79298,80621276,4780,571132,62007,16,88979,2147,0,509,144444.0,43333.0,-67.0,-71.0,-65.0,-70.0,-67.0,-71.0,-65.0,-70.0,-85.0,-89.0,-84.0,-89.0,18.0,18.0,19.0,19.0,1
1475,CC:2F:71:3E:C5:1F,3222741,407016740,11364,1390225,3211377,405626515,6,48535,4064225,40116,3066715,8419,997510,11981,34,16328,186,6,824,130000.0,39000.0,-70.0,-71.0,-69.0,-60.0,-69.0,-71.0,-68.0,-60.0,-85.0,-89.0,-84.0,-89.0,15.0,18.0,15.0,29.0,1
1476,CC:2F:71:3F:1F:24,7800411,7394865433,4589034,6989238918,3211377,405626515,80,1062609,651794319,1054098,650772181,8511,1022138,1009721,619,4593753,466112,80,5583,65000.0,13000.0,-69.0,-64.0,-72.0,-67.0,-68.0,-64.0,-71.0,-67.0,-85.0,-89.0,-84.0,-89.0,16.0,25.0,12.0,22.0,1
1477,F8:59:71:5A:E0:3D,3297715,528181087,86335,122554310,3211380,405626777,0,84147,81298696,79367,80727564,4780,571132,62076,16,89047,2148,0,509,144444.0,43333.0,-67.0,-71.0,-65.0,-70.0,-66.0,-71.0,-65.0,-70.0,-85.0,-89.0,-84.0,-89.0,18.0,18.0,19.0,19.0,1
1478,CC:2F:71:3E:C5:1F,3222745,407017062,11364,1390225,3211381,405626837,6,48535,4064225,40116,3066715,8419,997510,11981,34,16328,186,6,824,130000.0,39000.0,-70.0,-71.0,-69.0,-60.0,-69.0,-71.0,-68.0,-60.0,-85.0,-90.0,-85.0,-89.0,15.0,19.0,16.0,29.0,1
1479,CC:2F:71:3F:1F:24,7801915,7397188363,4590534,6991561526,3211381,405626837,80,1062977,652020599,1054466,650998461,8511,1022138,1010089,619,4595243,466166,80,5583,86667.0,14444.0,-69.0,-64.0,-72.0,-67.0,-68.0,-64.0,-71.0,-67.0,-85.0,-90.0,-85.0,-89.0,16.0,26.0,13.0,22.0,1
1480,F8:59:71:5A:E0:3D,3297785,528282561,86400,122655320,3211385,405627241,0,84211,81397256,79431,80826124,4780,571132,62140,16,89112,2149,0,509,144444.0,43333.0,-66.0,-72.0,-64.0,-70.0,-66.0,-71.0,-64.0,-70.0,-85.0,-90.0,-85.0,-89.0,19.0,18.0,21.0,19.0,1
1481,CC:2F:71:3E:C5:1F,3222750,407017600,11364,1390225,3211386,405627375,6,48535,4064225,40116,3066715,8419,997510,11981,34,16328,186,6,824,130000.0,39000.0,-70.0,-71.0,-69.0,-60.0,-69.0,-71.0,-68.0,-60.0,-85.0,-90.0,-85.0,-89.0,15.0,19.0,16.0,29.0,1
1482,CC:2F:71:3F:1F:24,7803731,7399999281,4592343,6994371712,3211388,405627569,80,1063411,652263269,1054900,651241131,8511,1022138,1010523,619,4597032,466204,80,5583,86667.0,14444.0,-68.0,-65.0,-71.0,-67.0,-68.0,-64.0,-71.0,-67.0,-85.0,-90.0,-85.0,-89.0,17.0,25.0,14.0,22.0,1
1483,F8:59:71:5A:E0:3D,3297856,528385655,86466,122757884,3211390,405627771,0,84277,81498896,79497,80927764,4780,571132,62206,16,89178,2151,0,509,144444.0,43333.0,-66.0,-72.0,-65.0,-70.0,-66.0,-71.0,-65.0,-70.0,-85.0,-90.0,-85.0,-89.0,19.0,18.0,20.0,19.0,1
1484,CC:2F:71:3E:C5:1F,3222754,407017996,11364,1390225,3211390,405627771,6,48535,4064225,40116,3066715,8419,997510,11981,34,16328,186,6,824,130000.0,39000.0,-70.0,-71.0,-69.0,-60.0,-69.0,-71.0,-68.0,-60.0,-85.0,-90.0,-85.0,-89.0,15.0,19.0,16.0,29.0,1
1485,CC:2F:71:3F:1F:24,7805229,7402315835,4593839,6996688064,3211390,405627771,80,1063779,652491125,1055268,651468987,8511,1022138,1010891,619,4598531,466429,80,5583,86667.0,14444.0,-69.0,-65.0,-72.0,-67.0,-68.0,-64.0,-72.0,-67.0,-85.0,-90.0,-85.0,-89.0,16.0,25.0,13.0,22.0,1
1486,F8:59:71:5A:E0:3D,3297926,528487129,86531,122858894,3211395,405628235,0,84342,81599052,79562,81027920,4780,571132,62271,16,89243,2151,0,509,144444.0,43333.0,-66.0,-71.0,-65.0,-70.0,-66.0,-71.0,-64.0,-70.0,-85.0,-90.0,-85.0,-89.0,19.0,19.0,20.0,19.0,1
1487,CC:2F:71:3E:C5:1F,3222759,407018460,11364,1390225,3211395,405628235,6,48535,4064225,40116,3066715,8419,997510,11981,34,16328,186,6,824,130000.0,39000.0,-70.0,-71.0,-69.0,-60.0,-69.0,-71.0,-68.0,-60.0,-85.0,-90.0,-85.0,-89.0,15.0,19.0,16.0,29.0,1
1488,CC:2F:71:3F:1F:24,7806939,7404943895,4595544,6999315660,3211395,405628235,80,1064207,652732557,1055696,651710419,8511,1022138,1011319,619,4600263,466450,80,5584,86667.0,14444.0,-69.0,-65.0,-72.0,-67.0,-68.0,-65.0,-72.0,-67.0,-85.0,-90.0,-85.0,-89.0,16.0,25.0,13.0,22.0,1
1489,F8:59:71:5A:E0:3D,3297998,528593205,86599,122964566,3211399,405628639,0,84410,81703772,79630,81132640,4780,571132,62339,16,89311,2153,0,509,144444.0,43333.0,-67.0,-71.0,-65.0,-70.0,-66.0,-71.0,-64.0,-70.0,-85.0,-90.0,-85.0,-89.0,18.0,19.0,20.0,19.0,1
1490,CC:2F:71:3E:C5:1F,3222763,407018864,11364,1390225,3211399,405628639,6,48535,4064225,40116,3066715,8419,997510,11981,34,16328,186,6,824,130000.0,39000.0,-70.0,-71.0,-69.0,-60.0,-69.0,-71.0,-68.0,-60.0,-85.0,-90.0,-85.0,-89.0,15.0,19.0,16.0,29.0,1
1491,CC:2F:71:3F:1F:24,7808220,7406915333,4596821,7001286694,3211399,405628639,80,1064546,652959777,1056035,651937639,8511,1022138,1011658,619,4601525,466472,80,5585,86667.0,14444.0,-69.0,-65.0,-72.0,-68.0,-68.0,-65.0,-72.0,-67.0,-85.0,-90.0,-85.0,-89.0,16.0,25.0,13.0,21.0,1
1492,F8:59:71:5A:E0:3D,3298068,528694892,86664,123065576,3211404,405629316,0,84475,81803872,79695,81232740,4780,571132,62404,16,89376,2154,0,509,144444.0,43333.0,-67.0,-71.0,-64.0,-70.0,-66.0,-71.0,-64.0,-70.0,-85.0,-89.0,-84.0,-89.0,18.0,18.0,20.0,19.0,1
1493,CC:2F:71:3E:C5:1F,3222768,407019541,11364,1390225,3211404,405629316,6,48535,4064225,40116,3066715,8419,997510,11981,34,16328,186,6,824,130000.0,39000.0,-70.0,-71.0,-69.0,-60.0,-69.0,-71.0,-68.0,-60.0,-85.0,-89.0,-84.0,-89.0,15.0,18.0,15.0,29.0,1
1494,CC:2F:71:3F:1F:24,7809327,7408610694,4597923,7002981378,3211404,405629316,80,1064902,653197503,1056391,652175365,8511,1022138,1012013,619,4602610,466984,80,5585,115556.0,28889.0,-69.0,-65.0,-73.0,-68.0,-68.0,-64.0,-72.0,-67.0,-85.0,-89.0,-84.0,-89.0,16.0,24.0,11.0,21.0,1
1495,F8:59:71:5A:E0:3D,3298140,528799306,86731,123169526,3211409,405629780,0,84539,81902432,79759,81331300,4780,571132,62468,16,89443,2154,0,509,144444.0,43333.0,-67.0,-72.0,-65.0,-70.0,-66.0,-71.0,-64.0,-70.0,-85.0,-89.0,-84.0,-89.0,18.0,17.0,19.0,19.0,1
1496,CC:2F:71:3E:C5:1F,3222773,407020005,11364,1390225,3211409,405629780,6,48535,4064225,40116,3066715,8419,997510,11981,34,16328,186,6,824,130000.0,39000.0,-70.0,-71.0,-69.0,-60.0,-69.0,-71.0,-68.0,-60.0,-85.0,-89.0,-84.0,-89.0,15.0,18.0,15.0,29.0,1
1497,CC:2F:71:3F:1F:24,7810435,7410307476,4599026,7004677696,3211409,405629780,80,1065216,653420577,1056705,652398439,8511,1022138,1012327,619,4603719,467326,80,5585,86667.0,14444.0,-68.0,-64.0,-72.0,-69.0,-68.0,-64.0,-72.0,-68.0,-85.0,-89.0,-84.0,-89.0,17.0,25.0,12.0,20.0,1
1498,F8:59:71:5A:E0:3D,3298206,528898964,86795,123268982,3211411,405629982,0,84606,82005612,79826,81434480,4780,571132,62535,16,89507,2155,0,509,144444.0,43333.0,-66.0,-72.0,-64.0,-70.0,-66.0,-71.0,-64.0,-70.0,-85.0,-89.0,-84.0,-89.0,19.0,17.0,20.0,19.0,1
1499,CC:2F:71:3E:C5:1F,3222777,407020409,11364,1390225,3211413,405630184,6,48535,4064225,40116,3066715,8419,997510,11981,34,16328,186,6,824,130000.0,39000.0,-70.0,-71.0,-69.0,-60.0,-69.0,-71.0,-68.0,-60.0,-85.0,-89.0,-84.0,-89.0,15.0,18.0,15.0,29.0,1
1500,CC:2F:71:3F:1F:24,7811635,7412143290,4600222,7006513106,3211413,405630184,80,1065564,653647830,1057053,652625692,8511,1022138,1012674,619,4604941,467360,80,5585,86667.0,14444.0,-69.0,-66.0,-72.0,-67.0,-69.0,-65.0,-72.0,-66.0,-85.0,-89.0,-84.0,-89.0,16.0,23.0,12.0,22.0,1
1501,F8:59:71:5A:E0:3D,3298275,529000378,86860,123369992,3211415,405630386,0,84672,82107266,79892,81536134,4780,571132,62600,16,89572,2156,0,509,144444.0,43333.0,-67.0,-72.0,-65.0,-70.0,-66.0,-71.0,-64.0,-70.0,-85.0,-89.0,-84.0,-89.0,18.0,17.0,19.0,19.0,1
1502,CC:2F:71:3E:C5:1F,3222781,407020813,11364,1390225,3211417,405630588,6,48535,4064225,40116,3066715,8419,997510,11981,34,16328,186,6,824,130000.0,39000.0,-70.0,-71.0,-69.0,-60.0,-69.0,-71.0,-68.0,-60.0,-85.0,-89.0,-84.0,-89.0,15.0,18.0,15.0,29.0,1
1503,CC:2F:71:3F:1F:24,7812622,7413650940,4601205,7008020352,3211417,405630588,80,1065861,653860002,1057350,652837864,8511,1022138,1012971,619,4605910,467383,80,5585,86667.0,14444.0,-69.0,-65.0,-71.0,-67.0,-69.0,-65.0,-72.0,-67.0,-85.0,-89.0,-84.0,-89.0,16.0,24.0,13.0,22.0,1
1504,F8:59:71:5A:E0:3D,3298342,529100096,86924,123469448,3211418,405630648,0,84736,82205826,79956,81634694,4780,571132,62664,16,89636,2156,0,509,144444.0,43333.0,-66.0,-72.0,-65.0,-70.0,-66.0,-71.0,-64.0,-70.0,-85.0,-90.0,-85.0,-89.0,19.0,18.0,20.0,19.0,1
1505,CC:2F:71:3E:C5:1F,3222784,407021075,11364,1390225,3211420,405630850,6,48535,4064225,40116,3066715,8419,997510,11981,34,16328,186,6,824,130000.0,39000.0,-70.0,-71.0,-69.0,-60.0,-69.0,-71.0,-68.0,-60.0,-85.0,-90.0,-85.0,-89.0,15.0,19.0,16.0,29.0,1
1506,CC:2F:71:3F:1F:24,7813820,7415490998,4602398,7009859946,3211422,405631052,80,1066206,654101114,1057695,653078976,8511,1022138,1013315,619,4607117,467643,80,5585,115556.0,28889.0,-69.0,-65.0,-73.0,-67.0,-68.0,-65.0,-71.0,-67.0,-85.0,-90.0,-85.0,-89.0,16.0,25.0,12.0,22.0,1
1507,F8:59:71:5A:E0:3D,3298421,529212706,86997,123581452,3211424,405631254,0,84808,82316706,80028,81745574,4780,571132,62736,16,89709,2158,0,509,144444.0,43333.0,-66.0,-71.0,-65.0,-70.0,-66.0,-71.0,-64.0,-70.0,-85.0,-90.0,-85.0,-89.0,19.0,19.0,20.0,19.0,1
1508,CC:2F:71:3E:C5:1F,3222791,407021797,11365,1390341,3211426,405631456,6,48537,4064365,40118,3066855,8419,997510,11981,34,16329,186,6,824,130000.0,39000.0,-70.0,-70.0,-68.0,-60.0,-69.0,-70.0,-68.0,-60.0,-85.0,-90.0,-85.0,-89.0,15.0,20.0,17.0,29.0,1
1509,CC:2F:71:3F:1F:24,7815379,7417898570,4603953,7012267114,3211426,405631456,80,1066586,654345980,1058075,653323842,8511,1022138,1013695,619,4608672,468406,80,5585,115556.0,28889.0,-68.0,-64.0,-72.0,-67.0,-68.0,-64.0,-71.0,-66.0,-85.0,-90.0,-85.0,-89.0,17.0,26.0,13.0,22.0,1
1510,F8:59:71:5A:E0:3D,3298492,529317148,87064,123685570,3211428,405631578,0,84876,82420004,80095,81848754,4781,571250,62804,16,89776,2159,0,509,144444.0,43333.0,-66.0,-71.0,-64.0,-70.0,-66.0,-71.0,-64.0,-70.0,-85.0,-90.0,-85.0,-89.0,19.0,19.0,21.0,19.0,1
1511,CC:2F:71:3E:C5:1F,3222795,407022121,11365,1390341,3211430,405631780,6,48537,4064365,40118,3066855,8419,997510,11981,34,16329,186,6,824,130000.0,39000.0,-70.0,-70.0,-68.0,-60.0,-69.0,-70.0,-68.0,-60.0,-85.0,-90.0,-85.0,-89.0,15.0,20.0,17.0,29.0,1
1512,CC:2F:71:3F:1F:24,7816664,7419866657,4605232,7014234675,3211432,405631982,80,1066963,654575414,1058452,653553276,8511,1022138,1014072,619,4609938,468653,80,5586,115556.0,28889.0,-69.0,-65.0,-72.0,-67.0,-68.0,-64.0,-71.0,-67.0,-85.0,-90.0,-85.0,-89.0,16.0,25.0,13.0,22.0,1
1513,F8:59:71:5A:E0:3D,3298562,529415772,87128,123783588,3211434,405632184,0,84940,82517130,80159,81945880,4781,571250,62868,16,89840,2159,0,509,144444.0,43333.0,-66.0,-71.0,-64.0,-70.0,-66.0,-71.0,-64.0,-70.0,-85.0,-90.0,-85.0,-89.0,19.0,19.0,21.0,19.0,1
1514,CC:2F:71:3E:C5:1F,3222799,407022525,11365,1390341,3211434,405632184,6,48537,4064365,40118,3066855,8419,997510,11981,34,16329,186,6,824,130000.0,39000.0,-70.0,-70.0,-68.0,-60.0,-69.0,-70.0,-68.0,-60.0,-85.0,-90.0,-85.0,-89.0,15.0,20.0,17.0,29.0,1
1515,CC:2F:71:3F:1F:24,7818113,7422105635,4606679,7016473451,3211434,405632184,80,1067349,654803834,1058838,653781696,8511,1022138,1014458,619,4611386,468953,80,5586,115556.0,28889.0,-69.0,-65.0,-72.0,-67.0,-69.0,-65.0,-72.0,-67.0,-85.0,-90.0,-85.0,-89.0,16.0,25.0,13.0,22.0,1
1516,F8:59:71:5A:E0:3D,3298629,529516984,87193,123884598,3211436,405632386,0,85005,82617230,80224,82045980,4781,571250,62933,16,89905,2159,0,509,144444.0,43333.0,-67.0,-71.0,-65.0,-70.0,-66.0,-71.0,-64.0,-70.0,-85.0,-90.0,-85.0,-89.0,18.0,19.0,20.0,19.0,1
1517,CC:2F:71:3E:C5:1F,3222801,407022727,11365,1390341,3211436,405632386,6,48537,4064365,40118,3066855,8419,997510,11981,34,16329,186,6,824,130000.0,39000.0,-70.0,-70.0,-68.0,-60.0,-69.0,-70.0,-68.0,-60.0,-85.0,-90.0,-85.0,-89.0,15.0,20.0,17.0,29.0,1
1518,CC:2F:71:3F:1F:24,7819644,7424472293,4608206,7018839705,3211438,405632588,80,1067754,655037532,1059243,654015394,8511,1022138,1014863,619,4612919,469351,80,5586,115556.0,28889.0,-69.0,-65.0,-72.0,-67.0,-68.0,-64.0,-72.0,-67.0,-85.0,-90.0,-85.0,-89.0,16.0,25.0,13.0,22.0,1
1519,F8:59:71:5A:E0:3D,3298700,529615668,87257,123982616,3211443,405633052,0,85070,82715924,80289,82144674,4781,571250,62998,16,89969,2159,0,509,144444.0,43333.0,-66.0,-71.0,-65.0,-70.0,-66.0,-71.0,-64.0,-69.0,-85.0,-90.0,-85.0,-89.0,19.0,19.0,20.0,19.0,1
1520,CC:2F:71:3E:C5:1F,3222808,407023393,11365,1390341,3211443,405633052,6,48537,4064365,40118,3066855,8419,997510,11981,34,16329,186,6,824,130000.0,39000.0,-70.0,-70.0,-68.0,-60.0,-69.0,-70.0,-68.0,-60.0,-85.0,-90.0,-85.0,-89.0,15.0,20.0,17.0,29.0,1
1521,CC:2F:71:3F:1F:24,7821002,7426563249,4609559,7020930197,3211443,405633052,80,1068102,655258588,1059591,654236450,8511,1022138,1015209,619,4614278,469664,80,5586,115556.0,28889.0,-68.0,-64.0,-72.0,-67.0,-68.0,-64.0,-71.0,-67.0,-85.0,-90.0,-85.0,-89.0,17.0,26.0,13.0,22.0,1
1522,F8:59:71:5A:E0:3D,3298766,529715326,87321,124082072,3211445,405633254,0,85133,82812944,80352,82241694,4781,571250,63061,16,90033,2160,0,509,144444.0,43333.0,-66.0,-71.0,-65.0,-70.0,-66.0,-71.0,-64.0,-70.0,-85.0,-90.0,-85.0,-89.0,19.0,19.0,20.0,19.0,1
1523,CC:2F:71:3E:C5:1F,3222810,407023595,11365,1390341,3211445,405633254,6,48537,4064365,40118,3066855,8419,997510,11981,34,16329,186,6,824,130000.0,39000.0,-70.0,-70.0,-68.0,-60.0,-69.0,-70.0,-68.0,-60.0,-85.0,-90.0,-85.0,-89.0,15.0,20.0,17.0,29.0,1
1524,CC:2F:71:3F:1F:24,7822221,7428434699,4610776,7022801445,3211445,405633254,80,1068465,655481779,1059954,654459641,8511,1022138,1015572,619,4615484,469865,80,5586,115556.0,28889.0,-69.0,-65.0,-73.0,-67.0,-68.0,-65.0,-72.0,-67.0,-85.0,-90.0,-85.0,-89.0,16.0,25.0,12.0,22.0,1
1525,F8:59:71:5A:E0:3D,3298837,529816942,87386,124183082,3211451,405633860,0,85198,82913044,80417,82341794,4781,571250,63126,16,90097,2160,0,509,144444.0,43333.0,-66.0,-71.0,-65.0,-70.0,-66.0,-71.0,-64.0,-70.0,-84.0,-90.0,-84.0,-89.0,18.0,19.0,19.0,19.0,1
1526,CC:2F:71:3E:C5:1F,3222817,407024263,11365,1390341,3211452,405633922,6,48537,4064365,40118,3066855,8419,997510,11981,34,16329,186,6,824,130000.0,39000.0,-70.0,-70.0,-68.0,-60.0,-69.0,-70.0,-68.0,-60.0,-84.0,-90.0,-84.0,-89.0,14.0,20.0,16.0,29.0,1
1527,CC:2F:71:3F:1F:24,7823606,7430566403,4612154,7024932481,3211452,405633922,80,1068845,655719275,1060333,654697019,8512,1022256,1015951,619,4616872,470219,80,5587,115556.0,28889.0,-69.0,-65.0,-72.0,-67.0,-68.0,-64.0,-72.0,-67.0,-84.0,-90.0,-84.0,-89.0,15.0,25.0,12.0,22.0,1
1528,F8:59:71:5A:E0:3D,3298909,529922938,87454,124288754,3211455,405634184,0,85266,83017764,80485,82446514,4781,571250,63194,16,90166,2161,0,509,144444.0,43333.0,-66.0,-71.0,-65.0,-70.0,-66.0,-71.0,-64.0,-70.0,-84.0,-90.0,-84.0,-89.0,18.0,19.0,19.0,19.0,1
1529,CC:2F:71:3E:C5:1F,3222820,407024525,11365,1390341,3211455,405634184,6,48537,4064365,40118,3066855,8419,997510,11981,34,16329,186,6,824,130000.0,39000.0,-70.0,-70.0,-68.0,-60.0,-69.0,-70.0,-68.0,-60.0,-84.0,-90.0,-84.0,-89.0,14.0,20.0,16.0,29.0,1
1530,CC:2F:71:3F:1F:24,7825351,7433272565,4613896,7027638381,3211455,405634184,80,1069272,655960965,1060760,654938709,8512,1022256,1016378,619,4618583,470778,80,5588,86667.0,14444.0,-68.0,-64.0,-72.0,-67.0,-68.0,-64.0,-71.0,-67.0,-84.0,-90.0,-84.0,-89.0,16.0,26.0,12.0,22.0,1
1531,F8:59:71:5A:E0:3D,3298982,530026381,87520,124391318,3211462,405635063,0,85332,83119404,80551,82548154,4781,571250,63260,16,90232,2163,0,509,144444.0,43333.0,-66.0,-71.0,-65.0,-70.0,-66.0,-71.0,-64.0,-70.0,-84.0,-90.0,-84.0,-89.0,18.0,19.0,19.0,19.0,1
1532,CC:2F:71:3E:C5:1F,3222827,407025404,11365,1390341,3211462,405635063,6,48537,4064365,40118,3066855,8419,997510,11981,34,16329,186,6,824,130000.0,39000.0,-70.0,-70.0,-68.0,-60.0,-69.0,-70.0,-68.0,-60.0,-84.0,-90.0,-84.0,-89.0,14.0,20.0,16.0,29.0,1
1533,CC:2F:71:3F:1F:24,7826674,7435306412,4615212,7029671349,3211462,405635063,80,1069661,656197149,1061149,655174893,8512,1022256,1016759,619,4619919,471133,80,5589,115556.0,28889.0,-69.0,-65.0,-74.0,-67.0,-69.0,-65.0,-72.0,-67.0,-84.0,-90.0,-84.0,-89.0,15.0,25.0,10.0,22.0,1
1534,F8:59:71:5A:E0:3D,3299049,530127593,87585,124492328,3211464,405635265,0,85398,83221044,80617,82649794,4781,571250,63326,16,90297,2164,0,509,144444.0,43333.0,-67.0,-71.0,-64.0,-70.0,-66.0,-71.0,-64.0,-70.0,-84.0,-90.0,-84.0,-89.0,17.0,19.0,20.0,19.0,1
1535,CC:2F:71:3E:C5:1F,3222829,407025606,11365,1390341,3211464,405635265,6,48537,4064365,40118,3066855,8419,997510,11981,34,16329,186,6,824,130000.0,39000.0,-70.0,-70.0,-68.0,-60.0,-69.0,-70.0,-68.0,-60.0,-84.0,-90.0,-84.0,-89.0,14.0,20.0,16.0,29.0,1
1536,CC:2F:71:3F:1F:24,7828132,7437551457,4616668,7031916192,3211464,405635265,80,1070092,656442830,1061580,655420574,8512,1022256,1017189,619,4621370,471575,80,5590,104000.0,26000.0,-69.0,-64.0,-73.0,-67.0,-68.0,-64.0,-72.0,-67.0,-84.0,-90.0,-84.0,-89.0,15.0,26.0,11.0,22.0,1
1537,F8:59:71:5A:E0:3D,3299120,530230621,87651,124594892,3211469,405635729,0,85463,83321144,80682,82749894,4781,571250,63391,16,90363,2164,0,509,144444.0,43333.0,-66.0,-72.0,-64.0,-70.0,-66.0,-71.0,-64.0,-70.0,-84.0,-90.0,-84.0,-89.0,18.0,18.0,20.0,19.0,1
1538,CC:2F:71:3E:C5:1F,3222836,407026272,11365,1390341,3211471,405635931,6,48537,4064365,40118,3066855,8419,997510,11981,34,16329,186,6,824,130000.0,39000.0,-70.0,-70.0,-68.0,-60.0,-69.0,-70.0,-68.0,-60.0,-84.0,-90.0,-84.0,-89.0,14.0,20.0,16.0,29.0,1
1539,CC:2F:71:3F:1F:24,7829662,7439896139,4618191,7034260208,3211471,405635931,80,1070497,656674157,1061985,655651901,8512,1022256,1017594,619,4622910,471737,80,5590,86667.0,14444.0,-68.0,-64.0,-72.0,-69.0,-68.0,-63.0,-72.0,-68.0,-84.0,-90.0,-84.0,-89.0,16.0,26.0,12.0,20.0,1
1540,F8:59:71:5A:E0:3D,3299188,530330481,87715,124694348,3211473,405636133,0,85527,83419732,80746,82848482,4781,571250,63455,16,90427,2164,0,509,144444.0,43333.0,-67.0,-71.0,-64.0,-70.0,-66.0,-71.0,-64.0,-69.0,-84.0,-90.0,-84.0,-89.0,17.0,19.0,20.0,19.0,1
1541,CC:2F:71:3E:C5:1F,3222838,407026474,11365,1390341,3211473,405636133,6,48537,4064365,40118,3066855,8419,997510,11981,34,16329,186,6,824,130000.0,39000.0,-70.0,-70.0,-68.0,-60.0,-69.0,-70.0,-68.0,-60.0,-84.0,-90.0,-84.0,-89.0,14.0,20.0,16.0,29.0,1
1542,CC:2F:71:3F:1F:24,7830779,7441611747,4619306,7035975614,3211473,405636133,80,1070825,656895665,1062313,655873409,8512,1022256,1017921,619,4624015,471749,80,5590,86667.0,14444.0,-68.0,-64.0,-72.0,-69.0,-68.0,-63.0,-72.0,-69.0,-84.0,-90.0,-84.0,-89.0,16.0,26.0,12.0,20.0,1
1543,F8:59:71:5A:E0:3D,3299258,530431955,87780,124795358,3211478,405636597,0,85592,83519832,80811,82948582,4781,571250,63520,16,90492,2165,0,509,144444.0,43333.0,-67.0,-72.0,-64.0,-70.0,-66.0,-71.0,-64.0,-70.0,-84.0,-90.0,-84.0,-89.0,17.0,18.0,20.0,19.0,1
1544,CC:2F:71:3E:C5:1F,3222843,407026938,11365,1390341,3211478,405636597,6,48537,4064365,40118,3066855,8419,997510,11981,34,16329,186,6,824,130000.0,39000.0,-70.0,-70.0,-68.0,-60.0,-69.0,-70.0,-68.0,-60.0,-84.0,-90.0,-84.0,-89.0,14.0,20.0,16.0,29.0,1
1545,CC:2F:71:3F:1F:24,7831898,7443322989,4620418,7037686190,3211480,405636799,80,1071164,657121367,1062652,656099111,8512,1022256,1018260,619,4625123,471755,80,5590,86667.0,14444.0,-68.0,-64.0,-71.0,-69.0,-68.0,-63.0,-71.0,-69.0,-84.0,-90.0,-84.0,-89.0,16.0,26.0,13.0,20.0,1
1546,F8:59:71:5A:E0:3D,3299329,530534985,87846,124897922,3211483,405637063,0,85658,83621472,80877,83050222,4781,571250,63586,16,90558,2165,0,509,144444.0,43333.0,-67.0,-71.0,-64.0,-70.0,-66.0,-71.0,-64.0,-70.0,-84.0,-90.0,-84.0,-89.0,17.0,19.0,20.0,19.0,1
1547,CC:2F:71:3E:C5:1F,3222848,407027404,11365,1390341,3211483,405637063,6,48539,4064553,40119,3066925,8420,997628,11982,34,16329,186,6,824,130000.0,39000.0,-70.0,-71.0,-67.0,-60.0,-69.0,-70.0,-68.0,-60.0,-84.0,-90.0,-84.0,-89.0,14.0,19.0,17.0,29.0,1
1548,CC:2F:71:3F:1F:24,7833451,7445715467,4621968,7040078404,3211483,405637063,80,1071554,657359065,1063042,656336809,8512,1022256,1018650,619,4626687,472232,80,5590,86667.0,14444.0,-69.0,-64.0,-72.0,-68.0,-68.0,-64.0,-71.0,-68.0,-84.0,-90.0,-84.0,-89.0,15.0,26.0,12.0,21.0,1
1549,F8:59:71:5A:E0:3D,3299397,530634845,87910,124997378,3211487,405637467,0,85722,83720032,80941,83148782,4781,571250,63650,16,90622,2166,0,509,144444.0,43333.0,-67.0,-72.0,-64.0,-71.0,-66.0,-71.0,-63.0,-70.0,-84.0,-90.0,-84.0,-89.0,17.0,18.0,20.0,18.0,1
1550,CC:2F:71:3E:C5:1F,3222852,407027808,11365,1390341,3211487,405637467,6,48539,4064553,40119,3066925,8420,997628,11982,34,16329,186,6,824,130000.0,39000.0,-70.0,-71.0,-67.0,-60.0,-69.0,-70.0,-68.0,-60.0,-84.0,-90.0,-84.0,-89.0,14.0,19.0,17.0,29.0,1
1551,CC:2F:71:3F:1F:24,7834837,7447853971,4623350,7042216504,3211487,405637467,80,1071911,657584269,1063399,656562013,8512,1022256,1019006,619,4628068,472239,80,5590,86667.0,14444.0,-69.0,-64.0,-72.0,-68.0,-68.0,-64.0,-71.0,-68.0,-84.0,-90.0,-84.0,-89.0,15.0,26.0,12.0,21.0,1
1552,F8:59:71:5A:E0:3D,3299467,530736319,87975,125098388,3211492,405637931,0,85788,83821686,81007,83250436,4781,571250,63715,16,90687,2166,0,509,144444.0,43333.0,-66.0,-72.0,-64.0,-70.0,-66.0,-71.0,-63.0,-70.0,-84.0,-90.0,-84.0,-89.0,18.0,18.0,20.0,19.0,1
1553,CC:2F:71:3E:C5:1F,3222857,407028272,11365,1390341,3211492,405637931,6,48539,4064553,40119,3066925,8420,997628,11982,34,16329,186,6,824,130000.0,39000.0,-70.0,-71.0,-67.0,-60.0,-69.0,-70.0,-68.0,-60.0,-84.0,-90.0,-84.0,-89.0,14.0,19.0,17.0,29.0,1
1554,CC:2F:71:3F:1F:24,7836087,7449774909,4624595,7044136978,3211492,405637931,80,1072235,657804019,1063723,656781763,8512,1022256,1019330,619,4629296,472267,80,5591,117000.0,39000.0,-69.0,-64.0,-73.0,-68.0,-68.0,-64.0,-71.0,-68.0,-84.0,-90.0,-84.0,-89.0,15.0,26.0,11.0,21.0,1
1555,F8:59:71:5A:E0:3D,3299533,530835977,88039,125197844,3211494,405638133,0,85852,83920246,81071,83348996,4781,571250,63779,16,90751,2167,0,509,144444.0,43333.0,-66.0,-72.0,-64.0,-70.0,-66.0,-71.0,-63.0,-70.0,-84.0,-90.0,-84.0,-89.0,18.0,18.0,20.0,19.0,1
1556,CC:2F:71:3E:C5:1F,3222861,407028676,11365,1390341,3211496,405638335,6,48539,4064553,40119,3066925,8420,997628,11982,34,16329,186,6,824,130000.0,39000.0,-70.0,-71.0,-67.0,-60.0,-69.0,-70.0,-68.0,-60.0,-84.0,-90.0,-84.0,-89.0,14.0,19.0,17.0,29.0,1
1557,CC:2F:71:3F:1F:24,7837035,7451222865,4625539,7045584530,3211496,405638335,80,1072516,658021657,1064004,656999401,8512,1022256,1019611,619,4630258,472306,80,5591,117000.0,39000.0,-69.0,-64.0,-72.0,-69.0,-69.0,-64.0,-72.0,-69.0,-84.0,-90.0,-84.0,-89.0,15.0,26.0,12.0,20.0,1
1558,F8:59:71:5A:E0:3D,3299602,530937391,88104,125298854,3211498,405638537,0,85917,84020346,81136,83449096,4781,571250,63844,16,90816,2167,0,509,144444.0,43333.0,-66.0,-72.0,-64.0,-70.0,-66.0,-71.0,-64.0,-70.0,-84.0,-90.0,-84.0,-89.0,18.0,18.0,20.0,19.0,1
1559,CC:2F:71:3E:C5:1F,3222864,407029012,11365,1390341,3211499,405638671,6,48539,4064553,40119,3066925,8420,997628,11982,34,16329,186,6,824,130000.0,39000.0,-70.0,-71.0,-67.0,-60.0,-69.0,-70.0,-68.0,-60.0,-84.0,-90.0,-84.0,-89.0,14.0,19.0,17.0,29.0,1
1560,CC:2F:71:3F:1F:24,7838298,7453168099,4626798,7047529360,3211500,405638739,80,1072826,658242769,1064314,657220513,8512,1022256,1019920,619,4631517,472366,80,5591,115556.0,28889.0,-69.0,-64.0,-71.0,-69.0,-69.0,-64.0,-72.0,-69.0,-84.0,-90.0,-84.0,-89.0,15.0,26.0,13.0,20.0,1
1561,F8:59:71:5A:E0:3D,3299670,531035701,88167,125396700,3211503,405639001,0,85981,84118948,81200,83547698,4781,571250,63908,16,90879,2169,0,509,130000.0,39000.0,-66.0,-71.0,-64.0,-70.0,-66.0,-71.0,-63.0,-70.0,-84.0,-90.0,-84.0,-89.0,18.0,19.0,20.0,19.0,1
1562,CC:2F:71:3E:C5:1F,3222868,407029342,11365,1390341,3211503,405639001,6,48539,4064553,40119,3066925,8420,997628,11982,34,16329,186,6,824,130000.0,39000.0,-70.0,-71.0,-67.0,-60.0,-69.0,-70.0,-68.0,-60.0,-84.0,-90.0,-84.0,-89.0,14.0,19.0,17.0,29.0,1
1563,CC:2F:71:3F:1F:24,7839726,7455364565,4628223,7049725564,3211503,405639001,80,1073157,658466635,1064645,657444379,8512,1022256,1020251,619,4632942,472506,80,5592,130000.0,43333.0,-69.0,-64.0,-72.0,-68.0,-68.0,-64.0,-71.0,-68.0,-84.0,-90.0,-84.0,-89.0,15.0,26.0,12.0,21.0,1
1564,F8:59:71:5A:E0:3D,3299738,531135449,88231,125496044,3211507,405639405,0,86044,84215968,81263,83644718,4781,571250,63971,16,90943,2170,0,509,144444.0,43333.0,-67.0,-71.0,-64.0,-70.0,-66.0,-71.0,-64.0,-70.0,-84.0,-90.0,-84.0,-89.0,17.0,19.0,20.0,19.0,1
1565,CC:2F:71:3E:C5:1F,3222872,407029746,11365,1390341,3211507,405639405,6,48539,4064553,40119,3066925,8420,997628,11982,34,16329,186,6,824,130000.0,39000.0,-70.0,-71.0,-67.0,-60.0,-69.0,-70.0,-68.0,-60.0,-84.0,-90.0,-84.0,-89.0,14.0,19.0,17.0,29.0,1
1566,CC:2F:71:3F:1F:24,7840835,7457066587,4629328,7051427182,3211507,405639405,80,1073461,658691271,1064949,657669015,8512,1022256,1020555,619,4634047,472696,80,5593,130000.0,43333.0,-69.0,-64.0,-73.0,-68.0,-69.0,-64.0,-71.0,-68.0,-84.0,-90.0,-84.0,-89.0,15.0,26.0,11.0,21.0,1
1567,F8:59:71:5A:E0:3D,3299811,531243079,88300,125603270,3211511,405639809,0,86113,84322228,81332,83750978,4781,571250,64040,16,91012,2172,0,509,144444.0,43333.0,-66.0,-72.0,-63.0,-70.0,-66.0,-71.0,-63.0,-70.0,-84.0,-90.0,-84.0,-89.0,18.0,18.0,21.0,19.0,1
1568,CC:2F:71:3E:C5:1F,3222876,407030150,11365,1390341,3211511,405639809,6,48539,4064553,40119,3066925,8420,997628,11982,34,16329,186,6,824,130000.0,39000.0,-70.0,-71.0,-67.0,-60.0,-69.0,-70.0,-68.0,-60.0,-84.0,-90.0,-84.0,-89.0,14.0,19.0,17.0,29.0,1
1569,CC:2F:71:3F:1F:24,7841897,7458694715,4630386,7053054906,3211511,405639809,80,1073771,658920799,1065259,657898543,8512,1022256,1020865,619,4635100,472793,80,5593,130000.0,43333.0,-69.0,-64.0,-73.0,-69.0,-69.0,-64.0,-72.0,-68.0,-84.0,-90.0,-84.0,-89.0,15.0,26.0,11.0,20.0,1
1570,F8:59:71:5A:E0:3D,3299881,531344553,88365,125704280,3211516,405640273,0,86178,84422328,81397,83851078,4781,571250,64105,16,91077,2172,0,509,144444.0,43333.0,-66.0,-72.0,-65.0,-70.0,-66.0,-71.0,-64.0,-70.0,-84.0,-90.0,-84.0,-89.0,18.0,18.0,19.0,19.0,1
1571,CC:2F:71:3E:C5:1F,3222881,407030614,11365,1390341,3211516,405640273,6,48539,4064553,40119,3066925,8420,997628,11982,34,16329,186,6,824,130000.0,39000.0,-70.0,-71.0,-67.0,-60.0,-69.0,-70.0,-68.0,-60.0,-84.0,-90.0,-84.0,-89.0,14.0,19.0,17.0,29.0,1
1572,CC:2F:71:3F:1F:24,7843308,7460870031,4631792,7055229758,3211516,405640273,80,1074081,659144529,1065569,658122273,8512,1022256,1021175,619,4636511,472998,80,5593,130000.0,39000.0,-69.0,-64.0,-72.0,-69.0,-68.0,-64.0,-72.0,-69.0,-84.0,-90.0,-84.0,-89.0,15.0,26.0,12.0,20.0,1
1573,F8:59:71:5A:E0:3D,3299949,531446038,88430,125805290,3211519,405640748,0,86244,84523968,81463,83952718,4781,571250,64171,16,91142,2173,0,509,144444.0,43333.0,-65.0,-70.0,-64.0,-69.0,-65.0,-70.0,-64.0,-70.0,-84.0,-90.0,-84.0,-89.0,19.0,20.0,20.0,20.0,1
1574,CC:2F:71:3E:C5:1F,3222886,407031291,11365,1390341,3211521,405640950,6,48539,4064553,40119,3066925,8420,997628,11982,34,16329,186,6,824,130000.0,39000.0,-70.0,-71.0,-67.0,-60.0,-69.0,-70.0,-68.0,-60.0,-84.0,-90.0,-84.0,-89.0,14.0,19.0,17.0,29.0,1
1575,CC:2F:71:3F:1F:24,7844916,7463345213,4633395,7057704263,3211521,405640950,80,1074407,659368076,1065895,658345820,8512,1022256,1021501,619,4638114,473002,80,5593,130000.0,43333.0,-71.0,-64.0,-73.0,-69.0,-70.0,-64.0,-72.0,-68.0,-84.0,-90.0,-84.0,-89.0,13.0,26.0,11.0,20.0,1
1576,F8:59:71:5A:E0:3D,3300017,531545898,88494,125904746,3211523,405641152,0,86307,84620988,81526,84049738,4781,571250,64234,16,91206,2173,0,509,144444.0,43333.0,-66.0,-71.0,-66.0,-70.0,-66.0,-71.0,-65.0,-70.0,-84.0,-90.0,-84.0,-89.0,18.0,19.0,18.0,19.0,1
1577,CC:2F:71:3E:C5:1F,3222890,407031695,11365,1390341,3211525,405641354,6,48539,4064553,40119,3066925,8420,997628,11982,34,16329,186,6,824,130000.0,39000.0,-70.0,-71.0,-67.0,-60.0,-69.0,-70.0,-68.0,-60.0,-84.0,-90.0,-84.0,-89.0,14.0,19.0,17.0,29.0,1
1578,CC:2F:71:3F:1F:24,7846210,7465338135,4634684,7059696721,3211526,405641414,80,1074701,659581414,1066189,658559158,8512,1022256,1021795,619,4639402,473102,80,5593,130000.0,43333.0,-70.0,-64.0,-73.0,-69.0,-70.0,-64.0,-73.0,-69.0,-84.0,-90.0,-84.0,-89.0,14.0,26.0,11.0,20.0,1
1579,F8:59:71:5A:E0:3D,3300086,531645818,88558,126004202,3211528,405641616,0,86371,84719548,81590,84148298,4781,571250,64298,16,91270,2173,0,509,144444.0,43333.0,-67.0,-72.0,-65.0,-71.0,-66.0,-71.0,-65.0,-70.0,-83.0,-89.0,-83.0,-88.0,16.0,17.0,18.0,17.0,1
1580,CC:2F:71:3E:C5:1F,3222893,407031957,11365,1390341,3211528,405641616,6,48539,4064553,40119,3066925,8420,997628,11982,34,16329,186,6,824,130000.0,39000.0,-70.0,-71.0,-67.0,-60.0,-69.0,-70.0,-68.0,-60.0,-83.0,-89.0,-83.0,-88.0,13.0,18.0,16.0,28.0,1
1581,CC:2F:71:3F:1F:24,7847215,7466875757,4635685,7061233939,3211530,405641818,80,1074983,659797688,1066471,658775432,8512,1022256,1022077,619,4640404,473258,80,5593,115556.0,28889.0,-71.0,-65.0,-74.0,-68.0,-70.0,-65.0,-73.0,-68.0,-83.0,-89.0,-83.0,-88.0,12.0,24.0,9.0,20.0,1
1582,F8:59:71:5A:E0:3D,3300152,531742570,88620,126100550,3211532,405642020,0,86434,84816568,81653,84245318,4781,571250,64361,16,91332,2173,0,509,144444.0,43333.0,-67.0,-72.0,-65.0,-70.0,-67.0,-71.0,-65.0,-70.0,-83.0,-89.0,-83.0,-88.0,16.0,17.0,18.0,18.0,1
1583,CC:2F:71:3E:C5:1F,3222897,407032361,11365,1390341,3211532,405642020,6,48539,4064553,40119,3066925,8420,997628,11982,34,16329,186,6,824,130000.0,39000.0,-70.0,-71.0,-67.0,-60.0,-69.0,-70.0,-68.0,-60.0,-83.0,-89.0,-83.0,-88.0,13.0,18.0,16.0,28.0,1
1584,CC:2F:71:3F:1F:24,7848154,7468311465,4636622,7062669445,3211532,405642020,80,1075252,660009640,1066740,658987384,8512,1022256,1022346,619,4641340,473329,80,5594,115556.0,28889.0,-70.0,-64.0,-73.0,-68.0,-69.0,-64.0,-72.0,-67.0,-83.0,-89.0,-83.0,-88.0,13.0,25.0,10.0,20.0,1
1585,F8:59:71:5A:E0:3D,3300220,531842430,88684,126200006,3211536,405642424,0,86497,84913588,81716,84342338,4781,571250,64424,16,91396,2174,0,509,144444.0,43333.0,-67.0,-71.0,-65.0,-70.0,-67.0,-71.0,-65.0,-70.0,-83.0,-89.0,-83.0,-88.0,16.0,18.0,18.0,18.0,1
1586,CC:2F:71:3E:C5:1F,3222901,407032765,11365,1390341,3211536,405642424,6,48539,4064553,40119,3066925,8420,997628,11982,34,16329,186,6,824,130000.0,39000.0,-70.0,-71.0,-67.0,-60.0,-69.0,-70.0,-68.0,-60.0,-83.0,-89.0,-83.0,-88.0,13.0,18.0,16.0,28.0,1
1587,CC:2F:71:3F:1F:24,7849119,7469777652,4637582,7064135168,3211537,405642484,80,1075541,660221388,1067029,659199132,8512,1022256,1022635,619,4642301,473371,80,5594,115556.0,28889.0,-70.0,-64.0,-73.0,-68.0,-69.0,-64.0,-73.0,-67.0,-83.0,-89.0,-83.0,-88.0,13.0,25.0,10.0,20.0,1
1588,F8:59:71:5A:E0:3D,3300286,531937688,88745,126294800,3211541,405642888,0,86559,85009068,81778,84437818,4781,571250,64486,16,91457,2175,0,509,144444.0,43333.0,-67.0,-71.0,-65.0,-71.0,-66.0,-71.0,-65.0,-70.0,-83.0,-91.0,-84.0,-89.0,16.0,20.0,19.0,18.0,1
1589,CC:2F:71:3E:C5:1F,3222906,407033229,11365,1390341,3211541,405642888,6,48539,4064553,40119,3066925,8420,997628,11982,34,16329,186,6,824,130000.0,39000.0,-70.0,-71.0,-67.0,-60.0,-69.0,-70.0,-68.0,-60.0,-83.0,-91.0,-84.0,-89.0,13.0,20.0,17.0,29.0,1
1590,CC:2F:71:3F:1F:24,7850261,7471530372,4638720,7065887484,3211541,405642888,80,1075813,660439332,1067301,659417076,8512,1022256,1022907,619,4643439,473433,80,5594,115556.0,28889.0,-69.0,-64.0,-72.0,-68.0,-69.0,-64.0,-72.0,-68.0,-83.0,-91.0,-84.0,-89.0,14.0,27.0,12.0,21.0,1
1591,F8:59:71:5A:E0:3D,3300359,532039648,88811,126395926,3211548,405643722,0,86623,85107628,81842,84536378,4781,571250,64550,16,91523,2175,0,509,144444.0,43333.0,-66.0,-71.0,-65.0,-70.0,-66.0,-71.0,-65.0,-70.0,-83.0,-91.0,-84.0,-89.0,17.0,20.0,19.0,19.0,1
1592,CC:2F:71:3E:C5:1F,3222914,407034179,11366,1390457,3211548,405643722,6,48541,4064741,40120,3066995,8421,997746,11983,34,16330,186,6,825,130000.0,39000.0,-77.0,-85.0,-75.0,-71.0,-70.0,-72.0,-68.0,-61.0,-83.0,-91.0,-84.0,-89.0,6.0,6.0,9.0,18.0,1
1593,CC:2F:71:3F:1F:24,7851262,7473055220,4639714,7067411498,3211548,405643722,80,1076101,660653476,1067589,659631220,8512,1022256,1023195,619,4644428,473466,80,5594,115556.0,28889.0,-70.0,-64.0,-71.0,-67.0,-69.0,-64.0,-72.0,-67.0,-83.0,-91.0,-84.0,-89.0,13.0,27.0,13.0,22.0,1
1594,F8:59:71:5A:E0:3D,3300428,532139568,88875,126495382,3211553,405644186,0,86687,85206188,81906,84634938,4781,571250,64614,16,91587,2175,0,509,144444.0,43333.0,-67.0,-72.0,-65.0,-70.0,-66.0,-71.0,-65.0,-70.0,-83.0,-91.0,-84.0,-89.0,16.0,19.0,19.0,19.0,1
1595,CC:2F:71:3E:C5:1F,3222919,407034643,11366,1390457,3211553,405644186,6,48542,4064811,40121,3067065,8421,997746,11983,34,16330,186,6,825,130000.0,39000.0,-70.0,-71.0,-69.0,-60.0,-70.0,-72.0,-69.0,-61.0,-83.0,-91.0,-84.0,-89.0,13.0,20.0,15.0,29.0,1
1596,CC:2F:71:3F:1F:24,7852490,7474942410,4640937,7069298224,3211553,405644186,80,1076448,660872980,1067936,659850724,8512,1022256,1023542,619,4645655,473500,80,5594,104000.0,26000.0,-70.0,-64.0,-74.0,-68.0,-69.0,-64.0,-72.0,-67.0,-83.0,-91.0,-84.0,-89.0,13.0,27.0,10.0,21.0,1
1597,F8:59:71:5A:E0:3D,3300498,532241044,88940,126596392,3211558,405644652,0,86752,85306288,81971,84735038,4781,571250,64679,16,91652,2177,0,509,144444.0,43333.0,-67.0,-72.0,-65.0,-70.0,-66.0,-71.0,-65.0,-70.0,-83.0,-91.0,-84.0,-89.0,16.0,19.0,19.0,19.0,1
1598,CC:2F:71:3E:C5:1F,3222925,407035171,11366,1390457,3211559,405644714,6,48542,4064811,40121,3067065,8421,997746,11983,34,16330,186,6,825,130000.0,39000.0,-70.0,-71.0,-69.0,-60.0,-70.0,-72.0,-69.0,-61.0,-83.0,-91.0,-84.0,-89.0,13.0,20.0,15.0,29.0,1
1599,CC:2F:71:3F:1F:24,7853830,7476994129,4642271,7071349415,3211559,405644714,80,1076767,661096895,1068254,660074521,8513,1022374,1023861,619,4646960,473546,80,5594,115556.0,28889.0,-70.0,-65.0,-72.0,-68.0,-70.0,-65.0,-73.0,-68.0,-83.0,-91.0,-84.0,-89.0,13.0,26.0,12.0,21.0,1
1600,F8:59:71:5A:E0:3D,3300566,532342318,89005,126697402,3211561,405644916,0,86818,85406506,82036,84835138,4782,571368,64745,16,91717,2177,0,509,144444.0,43333.0,-67.0,-72.0,-65.0,-71.0,-66.0,-72.0,-65.0,-70.0,-83.0,-91.0,-84.0,-89.0,16.0,19.0,19.0,18.0,1
1601,CC:2F:71:3E:C5:1F,3222929,407035575,11366,1390457,3211563,405645118,6,48542,4064811,40121,3067065,8421,997746,11983,34,16330,186,6,825,130000.0,39000.0,-70.0,-71.0,-69.0,-60.0,-70.0,-72.0,-69.0,-61.0,-83.0,-91.0,-84.0,-89.0,13.0,20.0,15.0,29.0,1
1602,CC:2F:71:3F:1F:24,7854791,7478461527,4643228,7072816409,3211563,405645118,80,1077051,661316175,1068538,660293801,8513,1022374,1024145,619,4647947,473597,80,5594,115556.0,28889.0,-70.0,-64.0,-73.0,-67.0,-69.0,-64.0,-73.0,-67.0,-83.0,-91.0,-84.0,-89.0,13.0,27.0,11.0,22.0,1
1603,F8:59:71:5A:E0:3D,3300633,532439130,89067,126793750,3211566,405645380,0,86880,85502014,82098,84930646,4782,571368,64807,16,91779,2177,0,509,144444.0,43333.0,-67.0,-72.0,-65.0,-71.0,-66.0,-71.0,-65.0,-70.0,-83.0,-91.0,-84.0,-89.0,16.0,19.0,19.0,18.0,1
1604,CC:2F:71:3E:C5:1F,3222932,407035837,11366,1390457,3211566,405645380,6,48542,4064811,40121,3067065,8421,997746,11983,34,16330,186,6,825,130000.0,39000.0,-70.0,-71.0,-69.0,-60.0,-70.0,-72.0,-69.0,-61.0,-83.0,-91.0,-84.0,-89.0,13.0,20.0,15.0,29.0,1
1605,CC:2F:71:3F:1F:24,7855793,7479994827,4644227,7074349447,3211566,405645380,80,1077356,661533773,1068843,660511399,8513,1022374,1024449,619,4648946,473641,80,5595,117000.0,39000.0,-70.0,-65.0,-73.0,-68.0,-70.0,-65.0,-73.0,-68.0,-83.0,-91.0,-84.0,-89.0,13.0,26.0,11.0,21.0,1
1606,F8:59:71:5A:E0:3D,3300702,532540544,89132,126894760,3211570,405645784,0,86945,85602114,82163,85030746,4782,571368,64872,16,91844,2177,0,509,144444.0,43333.0,-67.0,-72.0,-65.0,-70.0,-67.0,-71.0,-65.0,-70.0,-83.0,-91.0,-84.0,-89.0,16.0,19.0,19.0,19.0,1
1607,CC:2F:71:3E:C5:1F,3222936,407036241,11366,1390457,3211570,405645784,6,48542,4064811,40121,3067065,8421,997746,11983,34,16330,186,6,825,130000.0,39000.0,-70.0,-71.0,-69.0,-60.0,-70.0,-72.0,-69.0,-61.0,-83.0,-91.0,-84.0,-89.0,13.0,20.0,15.0,29.0,1
1608,CC:2F:71:3F:1F:24,7856650,7481297993,4645080,7075652209,3211570,405645784,80,1077673,661754135,1069160,660731761,8513,1022374,1024766,619,4649799,473671,80,5595,115556.0,28889.0,-70.0,-65.0,-74.0,-68.0,-69.0,-65.0,-73.0,-68.0,-83.0,-91.0,-84.0,-89.0,13.0,26.0,10.0,21.0,1
1609,F8:59:71:5A:E0:3D,3300769,532638850,89195,126992662,3211574,405646188,0,87008,85699134,82226,85127766,4782,571368,64935,16,91907,2179,0,509,144444.0,43333.0,-67.0,-71.0,-65.0,-70.0,-67.0,-71.0,-65.0,-70.0,-83.0,-91.0,-84.0,-89.0,16.0,20.0,19.0,19.0,1
1610,CC:2F:71:3E:C5:1F,3222940,407036645,11366,1390457,3211574,405646188,6,48542,4064811,40121,3067065,8421,997746,11983,34,16330,186,6,825,130000.0,39000.0,-70.0,-71.0,-69.0,-60.0,-70.0,-72.0,-69.0,-61.0,-83.0,-91.0,-84.0,-89.0,13.0,20.0,15.0,29.0,1
1611,CC:2F:71:3F:1F:24,7857646,7482820765,4646072,7077174577,3211574,405646188,80,1077947,661964991,1069434,660942617,8513,1022374,1025040,619,4650791,473693,80,5595,115556.0,28889.0,-70.0,-64.0,-73.0,-67.0,-69.0,-64.0,-72.0,-67.0,-83.0,-91.0,-84.0,-89.0,13.0,27.0,11.0,22.0,1
1612,F8:59:71:5A:E0:3D,3300858,532746510,89257,127089010,3211601,405657500,0,87071,85796154,82289,85224786,4782,571368,64998,16,91969,2180,0,509,144444.0,43333.0,-67.0,-71.0,-65.0,-70.0,-67.0,-71.0,-65.0,-70.0,-83.0,-90.0,-84.0,-89.0,16.0,19.0,19.0,19.0,1
1613,CC:2F:71:3E:C5:1F,3222967,407047957,11366,1390457,3211601,405657500,6,48542,4064811,40121,3067065,8421,997746,11983,34,16330,186,6,825,130000.0,39000.0,-70.0,-71.0,-69.0,-60.0,-70.0,-72.0,-69.0,-61.0,-83.0,-90.0,-84.0,-89.0,13.0,19.0,15.0,29.0,1
1614,CC:2F:71:3F:1F:24,7858915,7484740668,4647314,7079083168,3211601,405657500,80,1078282,662190850,1069769,661168476,8513,1022374,1025375,619,4652033,473909,80,5596,115556.0,28889.0,-70.0,-64.0,-73.0,-67.0,-69.0,-64.0,-72.0,-67.0,-83.0,-90.0,-84.0,-89.0,13.0,26.0,11.0,22.0,1
1615,F8:59:71:5A:E0:3D,3300926,532849276,89323,127191574,3211603,405657702,0,87136,85896254,82354,85324886,4782,571368,65063,16,92034,2180,0,509,144444.0,43333.0,-67.0,-71.0,-65.0,-70.0,-67.0,-71.0,-65.0,-70.0,-83.0,-90.0,-84.0,-89.0,16.0,19.0,19.0,19.0,1
1616,CC:2F:71:3E:C5:1F,3222971,407048361,11366,1390457,3211605,405657904,6,48542,4064811,40121,3067065,8421,997746,11983,34,16330,186,6,825,130000.0,39000.0,-70.0,-71.0,-69.0,-60.0,-70.0,-72.0,-69.0,-61.0,-83.0,-90.0,-84.0,-89.0,13.0,19.0,15.0,29.0,1
1617,CC:2F:71:3F:1F:24,7860110,7486576109,4648504,7080917932,3211606,405658177,80,1078615,662411632,1070102,661389258,8513,1022374,1025707,619,4653223,474003,80,5596,115556.0,28889.0,-69.0,-64.0,-72.0,-67.0,-69.0,-64.0,-71.0,-67.0,-83.0,-90.0,-84.0,-89.0,14.0,26.0,12.0,22.0,1
1618,F8:59:71:5A:E0:3D,3300994,532947855,89386,127289476,3211608,405658379,0,87199,85993274,82417,85421906,4782,571368,65126,16,92098,2181,0,509,144444.0,43333.0,-67.0,-72.0,-65.0,-70.0,-67.0,-71.0,-65.0,-70.0,-83.0,-90.0,-84.0,-89.0,16.0,18.0,19.0,19.0,1
1619,CC:2F:71:3E:C5:1F,3222976,407049038,11366,1390457,3211610,405658581,6,48542,4064811,40121,3067065,8421,997746,11983,34,16330,186,6,825,130000.0,39000.0,-70.0,-71.0,-69.0,-60.0,-70.0,-72.0,-69.0,-61.0,-83.0,-90.0,-84.0,-89.0,13.0,19.0,15.0,29.0,1
1620,CC:2F:71:3F:1F:24,7861297,7488400111,4649687,7082741530,3211610,405658581,80,1078911,662632288,1070398,661609914,8513,1022374,1026003,619,4654405,474073,80,5597,115556.0,28889.0,-70.0,-65.0,-73.0,-69.0,-70.0,-65.0,-73.0,-68.0,-83.0,-90.0,-84.0,-89.0,13.0,25.0,11.0,20.0,1
1621,F8:59:71:5A:E0:3D,3301064,533049329,89451,127390486,3211613,405658843,0,87264,86093374,82482,85522006,4782,571368,65191,16,92163,2181,0,509,144444.0,43333.0,-67.0,-71.0,-65.0,-70.0,-66.0,-71.0,-65.0,-70.0,-83.0,-90.0,-84.0,-90.0,16.0,19.0,19.0,20.0,1
1622,CC:2F:71:3E:C5:1F,3222979,407049300,11366,1390457,3211613,405658843,6,48542,4064811,40121,3067065,8421,997746,11983,34,16330,186,6,825,130000.0,39000.0,-70.0,-71.0,-69.0,-60.0,-70.0,-72.0,-69.0,-61.0,-83.0,-90.0,-84.0,-90.0,13.0,19.0,15.0,30.0,1
1623,CC:2F:71:3F:1F:24,7862543,7490321195,4650930,7084662352,3211613,405658843,80,1079246,662856480,1070733,661834106,8513,1022374,1026338,619,4655649,474147,80,5597,115556.0,28889.0,-70.0,-65.0,-72.0,-68.0,-69.0,-64.0,-72.0,-67.0,-83.0,-90.0,-84.0,-90.0,13.0,25.0,12.0,22.0,1
1624,F8:59:71:5A:E0:3D,3301131,533147635,89514,127488388,3211617,405659247,0,87328,86191934,82546,85620566,4782,571368,65255,16,92226,2181,0,509,144444.0,43333.0,-67.0,-71.0,-66.0,-70.0,-66.0,-71.0,-65.0,-70.0,-83.0,-90.0,-84.0,-90.0,16.0,19.0,18.0,20.0,1
1625,CC:2F:71:3E:C5:1F,3222983,407049704,11366,1390457,3211617,405659247,6,48542,4064811,40121,3067065,8421,997746,11983,34,16330,186,6,825,130000.0,39000.0,-70.0,-71.0,-69.0,-60.0,-70.0,-72.0,-69.0,-61.0,-83.0,-90.0,-84.0,-90.0,13.0,19.0,15.0,30.0,1
1626,CC:2F:71:3F:1F:24,7863439,7491674144,4651820,7086014695,3211619,405659449,80,1079519,663068159,1071006,662045785,8513,1022374,1026611,619,4656518,474167,80,5597,115556.0,28889.0,-70.0,-65.0,-73.0,-68.0,-70.0,-65.0,-73.0,-68.0,-83.0,-90.0,-84.0,-90.0,13.0,25.0,11.0,22.0,1
1627,F8:59:71:5A:E0:3D,3301200,533249049,89579,127589398,3211621,405659651,0,87393,86292034,82611,85720666,4782,571368,65320,16,92291,2181,0,509,144444.0,43333.0,-67.0,-71.0,-65.0,-71.0,-67.0,-71.0,-65.0,-70.0,-83.0,-90.0,-84.0,-90.0,16.0,19.0,19.0,19.0,1
1628,CC:2F:71:3E:C5:1F,3222987,407050108,11366,1390457,3211621,405659651,6,48542,4064811,40121,3067065,8421,997746,11983,34,16330,186,6,825,130000.0,39000.0,-70.0,-71.0,-69.0,-60.0,-70.0,-72.0,-69.0,-61.0,-83.0,-90.0,-84.0,-90.0,13.0,19.0,15.0,30.0,1
1629,CC:2F:71:3F:1F:24,7864500,7493302072,4652879,7087642421,3211621,405659651,80,1079810,663286817,1071297,662264443,8513,1022374,1026902,619,4657590,474303,80,5597,115556.0,28889.0,-71.0,-65.0,-74.0,-69.0,-70.0,-65.0,-73.0,-68.0,-83.0,-90.0,-84.0,-90.0,12.0,25.0,10.0,21.0,1
1630,F8:59:71:5A:E0:3D,3301270,533350355,89644,127690240,3211626,405660115,0,87457,86390594,82675,85819226,4782,571368,65384,16,92356,2181,0,509,144444.0,43333.0,-66.0,-71.0,-65.0,-70.0,-66.0,-71.0,-65.0,-70.0,-83.0,-90.0,-84.0,-90.0,17.0,19.0,19.0,20.0,1
1631,CC:2F:71:3E:C5:1F,3222992,407050572,11366,1390457,3211626,405660115,6,48542,4064811,40121,3067065,8421,997746,11983,34,16330,186,6,825,130000.0,39000.0,-70.0,-71.0,-69.0,-60.0,-70.0,-72.0,-69.0,-61.0,-83.0,-90.0,-84.0,-90.0,13.0,19.0,15.0,30.0,1
1632,CC:2F:71:3F:1F:24,7865657,7495077288,4654031,7089417173,3211626,405660115,80,1080090,663504397,1071577,662482023,8513,1022374,1027182,619,4658750,474375,80,5598,115556.0,28889.0,-69.0,-64.0,-72.0,-67.0,-69.0,-64.0,-72.0,-67.0,-83.0,-90.0,-84.0,-90.0,14.0,26.0,12.0,23.0,1
1633,F8:59:71:5A:E0:3D,3301335,533448459,89707,127788142,3211628,405660317,0,87520,86487614,82738,85916246,4782,571368,65447,16,92419,2182,0,509,144444.0,43333.0,-66.0,-72.0,-65.0,-71.0,-66.0,-71.0,-65.0,-70.0,-84.0,-90.0,-84.0,-90.0,18.0,18.0,19.0,19.0,1
1634,CC:2F:71:3E:C5:1F,3222994,407050774,11366,1390457,3211628,405660317,6,48542,4064811,40121,3067065,8421,997746,11983,34,16330,186,6,825,130000.0,39000.0,-70.0,-71.0,-69.0,-60.0,-70.0,-72.0,-69.0,-61.0,-84.0,-90.0,-84.0,-90.0,14.0,19.0,15.0,30.0,1
1635,CC:2F:71:3F:1F:24,7867342,7497686934,4655712,7092026415,3211630,405660519,80,1080446,663732057,1071933,662709683,8513,1022374,1027538,619,4660415,474594,80,5598,115556.0,28889.0,-69.0,-64.0,-73.0,-68.0,-69.0,-64.0,-73.0,-68.0,-84.0,-90.0,-84.0,-90.0,15.0,26.0,11.0,22.0,1
1636,F8:59:71:5A:E0:3D,3301404,533549873,89772,127889152,3211632,405660721,0,87585,86587714,82803,86016346,4782,571368,65512,16,92484,2183,0,509,144444.0,43333.0,-66.0,-72.0,-65.0,-70.0,-66.0,-71.0,-64.0,-70.0,-84.0,-90.0,-84.0,-90.0,18.0,18.0,19.0,20.0,1
1637,CC:2F:71:3E:C5:1F,3222999,407051238,11366,1390457,3211633,405660781,6,48542,4064811,40121,3067065,8421,997746,11983,34,16330,186,6,825,130000.0,39000.0,-70.0,-71.0,-69.0,-60.0,-70.0,-72.0,-69.0,-61.0,-84.0,-90.0,-84.0,-90.0,14.0,19.0,15.0,30.0,1
1638,CC:2F:71:3F:1F:24,7868629,7499659551,4656994,7093998568,3211635,405660983,80,1080774,663954198,1072261,662931824,8513,1022374,1027866,619,4661713,474729,80,5598,115556.0,28889.0,-69.0,-64.0,-73.0,-67.0,-69.0,-64.0,-72.0,-67.0,-84.0,-90.0,-84.0,-90.0,15.0,26.0,11.0,23.0,1
1639,F8:59:71:5A:E0:3D,3301472,533648239,89835,127987054,3211637,405661185,0,87648,86684734,82866,86113366,4782,571368,65575,16,92547,2184,0,509,144444.0,43333.0,-67.0,-72.0,-65.0,-70.0,-67.0,-72.0,-65.0,-70.0,-84.0,-90.0,-84.0,-90.0,17.0,18.0,19.0,20.0,1
1640,CC:2F:71:3E:C5:1F,3223003,407051642,11366,1390457,3211637,405661185,6,48542,4064811,40121,3067065,8421,997746,11983,34,16330,186,6,825,130000.0,39000.0,-70.0,-71.0,-69.0,-60.0,-70.0,-72.0,-69.0,-61.0,-84.0,-90.0,-84.0,-90.0,14.0,19.0,15.0,30.0,1
1641,CC:2F:71:3F:1F:24,7869656,7501234147,4658019,7095572962,3211637,405661185,80,1081084,664169374,1072571,663147000,8513,1022374,1028176,619,4662738,474812,80,5598,115556.0,28889.0,-70.0,-64.0,-73.0,-67.0,-70.0,-64.0,-73.0,-67.0,-84.0,-90.0,-84.0,-90.0,14.0,26.0,11.0,23.0,1
1642,F8:59:71:5A:E0:3D,3301540,533748099,89899,128086510,3211641,405661589,0,87712,86783294,82930,86211926,4782,571368,65639,16,92610,2184,0,509,144444.0,43333.0,-67.0,-71.0,-65.0,-70.0,-67.0,-71.0,-65.0,-70.0,-83.0,-90.0,-83.0,-89.0,16.0,19.0,18.0,19.0,1
1643,CC:2F:71:3E:C5:1F,3223007,407052046,11366,1390457,3211641,405661589,6,48542,4064811,40121,3067065,8421,997746,11983,34,16330,186,6,825,130000.0,39000.0,-70.0,-71.0,-69.0,-60.0,-70.0,-72.0,-69.0,-61.0,-83.0,-90.0,-83.0,-89.0,13.0,19.0,14.0,29.0,1
1644,CC:2F:71:3F:1F:24,7870680,7502799121,4659039,7097137532,3211641,405661589,80,1081401,664389620,1072888,663367246,8513,1022374,1028493,619,4663758,474981,80,5598,115556.0,28889.0,-69.0,-64.0,-73.0,-68.0,-69.0,-64.0,-72.0,-67.0,-83.0,-90.0,-83.0,-89.0,14.0,26.0,10.0,21.0,1
1645,F8:59:71:5A:E0:3D,3301607,533844911,89961,128182858,3211646,405662053,0,87774,86878774,82992,86307406,4782,571368,65701,16,92673,2185,0,509,144444.0,43333.0,-67.0,-71.0,-65.0,-70.0,-67.0,-71.0,-65.0,-70.0,-83.0,-90.0,-83.0,-89.0,16.0,19.0,18.0,19.0,1
1646,CC:2F:71:3E:C5:1F,3223012,407052510,11366,1390457,3211646,405662053,6,48542,4064811,40121,3067065,8421,997746,11983,34,16330,186,6,825,130000.0,39000.0,-70.0,-71.0,-69.0,-60.0,-70.0,-72.0,-69.0,-61.0,-83.0,-90.0,-83.0,-89.0,13.0,19.0,14.0,29.0,1
1647,CC:2F:71:3F:1F:24,7871665,7504302993,4660019,7098640940,3211646,405662053,80,1081706,664605598,1073193,663583224,8513,1022374,1028798,619,4664738,475153,80,5599,115556.0,28889.0,-69.0,-65.0,-73.0,-68.0,-69.0,-64.0,-73.0,-68.0,-83.0,-90.0,-83.0,-89.0,14.0,25.0,10.0,21.0,1
1648,F8:59:71:5A:E0:3D,3301673,533944569,90025,128282314,3211648,405662255,0,87838,86977334,83056,86405966,4782,571368,65765,16,92737,2185,0,509,144444.0,43333.0,-67.0,-71.0,-65.0,-70.0,-66.0,-71.0,-65.0,-70.0,-83.0,-90.0,-83.0,-89.0,16.0,19.0,18.0,19.0,1
1649,CC:2F:71:3E:C5:1F,3223014,407052712,11366,1390457,3211648,405662255,6,48542,4064811,40121,3067065,8421,997746,11983,34,16330,186,6,825,130000.0,39000.0,-70.0,-71.0,-69.0,-60.0,-70.0,-72.0,-69.0,-61.0,-83.0,-90.0,-83.0,-89.0,13.0,19.0,14.0,29.0,1
1650,CC:2F:71:3F:1F:24,7872917,7506229685,4661267,7100567228,3211650,405662457,80,1082043,664822628,1073530,663800254,8513,1022374,1029135,619,4665982,475335,80,5599,115556.0,28889.0,-70.0,-64.0,-73.0,-68.0,-69.0,-64.0,-73.0,-68.0,-83.0,-90.0,-83.0,-89.0,13.0,26.0,10.0,21.0,1
1651,F8:59:71:5A:E0:3D,3301743,534044631,90089,128381770,3211654,405662861,0,87902,87075894,83120,86504526,4782,571368,65829,16,92801,2186,0,509,144444.0,43333.0,-67.0,-72.0,-65.0,-71.0,-66.0,-72.0,-65.0,-70.0,-83.0,-90.0,-83.0,-90.0,16.0,18.0,18.0,19.0,1
1652,CC:2F:71:3E:C5:1F,3223020,407053318,11366,1390457,3211654,405662861,6,48542,4064811,40121,3067065,8421,997746,11983,34,16330,186,6,825,130000.0,39000.0,-70.0,-71.0,-69.0,-60.0,-70.0,-72.0,-69.0,-61.0,-83.0,-90.0,-83.0,-90.0,13.0,19.0,14.0,30.0,1
1653,CC:2F:71:3F:1F:24,7873949,7507801124,4662295,7102138263,3211654,405662861,80,1082383,665050443,1073870,664028069,8513,1022374,1029473,619,4667014,475437,80,5599,115556.0,28889.0,-70.0,-65.0,-73.0,-68.0,-70.0,-64.0,-73.0,-68.0,-83.0,-90.0,-83.0,-90.0,13.0,25.0,10.0,22.0,1
1654,F8:59:71:5A:E0:3D,3301810,534143015,90152,128479672,3211658,405663343,0,87965,87172914,83183,86601546,4782,571368,65892,16,92864,2186,0,509,144444.0,43333.0,-67.0,-71.0,-65.0,-70.0,-67.0,-71.0,-65.0,-70.0,-83.0,-90.0,-83.0,-89.0,16.0,19.0,18.0,19.0,1
1655,CC:2F:71:3E:C5:1F,3223024,407053800,11366,1390457,3211658,405663343,6,48542,4064811,40121,3067065,8421,997746,11983,34,16330,186,6,825,130000.0,39000.0,-70.0,-71.0,-69.0,-60.0,-70.0,-72.0,-69.0,-61.0,-83.0,-90.0,-83.0,-89.0,13.0,19.0,14.0,29.0,1
1656,CC:2F:71:3F:1F:24,7875010,7509426328,4663352,7103762985,3211658,405663343,80,1082709,665280567,1074196,664258193,8513,1022374,1029795,619,4668071,475609,80,5599,115556.0,28889.0,-70.0,-65.0,-73.0,-68.0,-70.0,-64.0,-73.0,-67.0,-83.0,-90.0,-83.0,-89.0,13.0,25.0,10.0,21.0,1
1657,F8:59:71:5A:E0:3D,3301883,534247739,90219,128583790,3211664,405663949,0,88032,87276094,83250,86704726,4782,571368,65959,16,92931,2187,0,509,144444.0,43333.0,-67.0,-72.0,-65.0,-70.0,-67.0,-72.0,-65.0,-70.0,-83.0,-90.0,-83.0,-89.0,16.0,18.0,18.0,19.0,1
1658,CC:2F:71:3E:C5:1F,3223030,407054406,11366,1390457,3211664,405663949,6,48542,4064811,40121,3067065,8421,997746,11983,34,16330,186,6,825,130000.0,39000.0,-70.0,-71.0,-69.0,-60.0,-70.0,-72.0,-69.0,-61.0,-83.0,-90.0,-83.0,-89.0,13.0,19.0,14.0,29.0,1
1659,CC:2F:71:3F:1F:24,7875825,7510660256,4664161,7104996307,3211664,405663949,80,1082989,665495537,1074476,664473163,8513,1022374,1030075,619,4668880,475710,80,5599,115556.0,28889.0,-74.0,-68.0,-78.0,-72.0,-72.0,-66.0,-75.0,-70.0,-83.0,-90.0,-83.0,-89.0,9.0,22.0,5.0,17.0,1
1660,F8:59:71:5A:E0:3D,3301949,534346116,90282,128681692,3211667,405664424,0,88095,87373114,83313,86801746,4782,571368,66022,16,92994,2189,0,509,144444.0,43333.0,-67.0,-72.0,-65.0,-70.0,-66.0,-71.0,-65.0,-70.0,-83.0,-90.0,-83.0,-89.0,16.0,18.0,18.0,19.0,1
1661,CC:2F:71:3E:C5:1F,3223033,407054881,11366,1390457,3211667,405664424,6,48542,4064811,40121,3067065,8421,997746,11983,34,16330,186,6,825,130000.0,39000.0,-70.0,-71.0,-69.0,-60.0,-70.0,-72.0,-69.0,-61.0,-83.0,-90.0,-83.0,-89.0,13.0,19.0,14.0,29.0,1
1662,CC:2F:71:3F:1F:24,7876504,7511684243,4664837,7106019819,3211667,405664424,80,1083259,665710499,1074746,664688125,8513,1022374,1030344,619,4669556,475741,80,5600,115556.0,28889.0,-70.0,-65.0,-73.0,-69.0,-70.0,-64.0,-73.0,-68.0,-83.0,-90.0,-83.0,-89.0,13.0,25.0,10.0,20.0,1
1663,F8:59:71:5A:E0:3D,3302019,534444684,90345,128779594,3211674,405665090,0,88158,87470134,83376,86898766,4782,571368,66085,16,93057,2189,0,509,144444.0,43333.0,-67.0,-72.0,-65.0,-70.0,-66.0,-71.0,-65.0,-70.0,-83.0,-90.0,-83.0,-89.0,16.0,18.0,18.0,19.0,1
1664,CC:2F:71:3E:C5:1F,3223040,407055547,11366,1390457,3211674,405665090,6,48542,4064811,40121,3067065,8421,997746,11983,34,16330,186,6,825,130000.0,39000.0,-70.0,-71.0,-69.0,-60.0,-70.0,-72.0,-69.0,-61.0,-83.0,-90.0,-83.0,-89.0,13.0,19.0,14.0,29.0,1
1665,CC:2F:71:3F:1F:24,7877641,7513416878,4665967,7107751788,3211674,405665090,80,1083561,665933849,1075048,664911475,8513,1022374,1030646,619,4670658,475976,80,5600,115556.0,28889.0,-69.0,-64.0,-72.0,-67.0,-69.0,-64.0,-72.0,-67.0,-83.0,-90.0,-83.0,-89.0,14.0,26.0,11.0,22.0,1
1666,F8:59:71:5A:E0:3D,3302087,534547450,90411,128882158,3211676,405665292,0,88225,87573328,83443,87001960,4782,571368,66151,16,93123,2189,0,509,144444.0,43333.0,-67.0,-71.0,-65.0,-71.0,-67.0,-71.0,-65.0,-70.0,-83.0,-90.0,-83.0,-89.0,16.0,19.0,18.0,18.0,1
1667,CC:2F:71:3E:C5:1F,3223042,407055749,11366,1390457,3211676,405665292,6,48542,4064811,40121,3067065,8421,997746,11983,34,16330,186,6,825,130000.0,39000.0,-70.0,-71.0,-69.0,-60.0,-70.0,-72.0,-69.0,-61.0,-83.0,-90.0,-83.0,-89.0,13.0,19.0,14.0,29.0,1
1668,CC:2F:71:3F:1F:24,7878956,7515445842,4667280,7109780550,3211676,405665292,80,1083895,666160497,1075382,665138123,8513,1022374,1030979,619,4671974,476107,80,5600,115556.0,28889.0,-70.0,-64.0,-73.0,-68.0,-69.0,-64.0,-72.0,-68.0,-83.0,-90.0,-83.0,-89.0,13.0,26.0,10.0,21.0,1
1669,F8:59:71:5A:E0:3D,3302155,534647310,90475,128981614,3211680,405665696,0,88289,87671888,83507,87100520,4782,571368,66215,16,93187,2190,0,509,144444.0,43333.0,-67.0,-71.0,-65.0,-70.0,-67.0,-71.0,-65.0,-70.0,-83.0,-90.0,-83.0,-89.0,16.0,19.0,18.0,19.0,1
1670,CC:2F:71:3E:C5:1F,3223048,407056355,11366,1390457,3211682,405665898,6,48542,4064811,40121,3067065,8421,997746,11983,34,16330,186,6,825,130000.0,39000.0,-70.0,-71.0,-69.0,-60.0,-70.0,-72.0,-69.0,-61.0,-83.0,-90.0,-83.0,-89.0,13.0,19.0,14.0,29.0,1
1671,CC:2F:71:3F:1F:24,7880192,7517344284,4668510,7111678386,3211682,405665898,80,1084233,666383289,1075720,665360915,8513,1022374,1031317,619,4673229,476202,80,5600,115556.0,28889.0,-70.0,-64.0,-73.0,-68.0,-70.0,-64.0,-73.0,-68.0,-83.0,-90.0,-83.0,-89.0,13.0,26.0,10.0,21.0,1
1672,F8:59:71:5A:E0:3D,3302223,534748582,90540,129082624,3211683,405665958,0,88354,87771988,83572,87200620,4782,571368,66280,16,93252,2191,0,509,144444.0,43333.0,-67.0,-72.0,-65.0,-71.0,-67.0,-71.0,-65.0,-70.0,-83.0,-90.0,-83.0,-89.0,16.0,18.0,18.0,18.0,1
1673,CC:2F:71:3E:C5:1F,3223049,407056415,11366,1390457,3211683,405665958,6,48542,4064811,40121,3067065,8421,997746,11983,34,16330,186,6,825,130000.0,39000.0,-70.0,-71.0,-69.0,-60.0,-70.0,-72.0,-69.0,-61.0,-83.0,-90.0,-83.0,-89.0,13.0,19.0,14.0,29.0,1
1674,CC:2F:71:3F:1F:24,7881821,7519869446,4670136,7114203286,3211685,405666160,80,1084612,666614995,1076099,665592621,8513,1022374,1031696,619,4674855,476322,80,5600,115556.0,28889.0,-70.0,-65.0,-74.0,-68.0,-69.0,-64.0,-73.0,-68.0,-83.0,-90.0,-83.0,-89.0,13.0,25.0,9.0,21.0,1
1675,F8:59:71:5A:E0:3D,3302293,534848644,90604,129182080,3211689,405666564,0,88418,87870548,83636,87299180,4782,571368,66344,16,93316,2191,0,509,144444.0,43333.0,-67.0,-71.0,-65.0,-70.0,-67.0,-71.0,-65.0,-70.0,-84.0,-90.0,-84.0,-90.0,17.0,19.0,19.0,20.0,1
1676,CC:2F:71:3E:C5:1F,3223055,407057021,11366,1390457,3211689,405666564,6,48542,4064811,40121,3067065,8421,997746,11983,34,16330,186,6,825,130000.0,39000.0,-70.0,-71.0,-69.0,-60.0,-70.0,-72.0,-69.0,-61.0,-84.0,-90.0,-84.0,-90.0,14.0,19.0,15.0,30.0,1
1677,CC:2F:71:3F:1F:24,7883173,7521943349,4671482,7116276583,3211691,405666766,80,1084946,666836646,1076433,665814272,8513,1022374,1032030,619,4676201,476402,80,5600,115556.0,28889.0,-70.0,-65.0,-72.0,-68.0,-70.0,-64.0,-72.0,-68.0,-84.0,-90.0,-84.0,-90.0,14.0,25.0,12.0,22.0,1
1678,F8:59:71:5A:E0:3D,3302363,534953080,90672,129286314,3211691,405666766,0,88485,87973728,83703,87402360,4782,571368,66411,16,93384,2193,0,509,144444.0,43333.0,-67.0,-72.0,-65.0,-71.0,-66.0,-72.0,-65.0,-70.0,-84.0,-90.0,-84.0,-90.0,17.0,18.0,19.0,19.0,1
1679,CC:2F:71:3E:C5:1F,3223058,407057339,11367,1390573,3211691,405666766,6,48544,4064951,40123,3067205,8421,997746,11983,34,16331,186,6,825,130000.0,39000.0,-69.0,-71.0,-70.0,-60.0,-70.0,-72.0,-69.0,-61.0,-84.0,-90.0,-84.0,-90.0,15.0,19.0,14.0,30.0,1
1680,CC:2F:71:3F:1F:24,7884192,7523506613,4672500,7117839787,3211692,405666826,80,1085245,667059204,1076732,666036830,8513,1022374,1032329,619,4677219,476416,80,5601,115556.0,28889.0,-71.0,-65.0,-74.0,-68.0,-70.0,-64.0,-73.0,-67.0,-84.0,-90.0,-84.0,-90.0,13.0,25.0,10.0,22.0,1
1681,F8:59:71:5A:E0:3D,3302429,535051244,90735,129384216,3211694,405667028,0,88548,88070748,83766,87499380,4782,571368,66474,16,93447,2193,0,509,144444.0,43333.0,-67.0,-72.0,-65.0,-71.0,-66.0,-71.0,-65.0,-70.0,-84.0,-90.0,-84.0,-90.0,17.0,18.0,19.0,19.0,1
1682,CC:2F:71:3E:C5:1F,3223065,407058005,11367,1390573,3211698,405667432,6,48544,4064951,40123,3067205,8421,997746,11983,34,16331,186,6,825,130000.0,39000.0,-69.0,-71.0,-70.0,-60.0,-70.0,-72.0,-69.0,-61.0,-84.0,-90.0,-84.0,-90.0,15.0,19.0,14.0,30.0,1
1683,CC:2F:71:3F:1F:24,7885186,7525022955,4673488,7119355523,3211698,405667432,80,1085528,667275502,1077015,666253128,8513,1022374,1032612,619,4678183,476458,80,5601,115556.0,28889.0,-70.0,-65.0,-73.0,-68.0,-70.0,-65.0,-73.0,-68.0,-84.0,-90.0,-84.0,-90.0,14.0,25.0,11.0,22.0,1
1684,F8:59:71:5A:E0:3D,3302501,535151755,90799,129483672,3211702,405668083,0,88612,88169308,83830,87597940,4782,571368,66538,16,93511,2196,0,509,144444.0,43333.0,-67.0,-72.0,-65.0,-70.0,-66.0,-71.0,-65.0,-70.0,-84.0,-90.0,-84.0,-90.0,17.0,18.0,19.0,20.0,1
1685,CC:2F:71:3E:C5:1F,3223069,407058656,11367,1390573,3211702,405668083,6,48544,4064951,40123,3067205,8421,997746,11983,34,16331,186,6,825,130000.0,39000.0,-69.0,-71.0,-70.0,-60.0,-70.0,-72.0,-69.0,-61.0,-84.0,-90.0,-84.0,-90.0,15.0,19.0,14.0,30.0,1
1686,CC:2F:71:3F:1F:24,7886422,7526922870,4674720,7121254787,3211702,405668083,80,1085872,667504562,1077359,666482188,8513,1022374,1032956,619,4679427,476788,80,5601,104000.0,26000.0,-70.0,-64.0,-73.0,-68.0,-70.0,-64.0,-73.0,-68.0,-84.0,-90.0,-84.0,-90.0,14.0,26.0,11.0,22.0,1
1687,F8:59:71:5A:E0:3D,3302570,535254581,90865,129586236,3211705,405668345,0,88678,88270948,83896,87699580,4782,571368,66604,16,93577,2196,0,509,144444.0,43333.0,-67.0,-72.0,-65.0,-70.0,-67.0,-71.0,-65.0,-70.0,-84.0,-90.0,-84.0,-90.0,17.0,18.0,19.0,20.0,1
1688,CC:2F:71:3E:C5:1F,3223072,407058918,11367,1390573,3211705,405668345,6,48544,4064951,40123,3067205,8421,997746,11983,34,16331,186,6,825,130000.0,39000.0,-69.0,-71.0,-70.0,-60.0,-70.0,-72.0,-69.0,-61.0,-84.0,-90.0,-84.0,-90.0,15.0,19.0,14.0,30.0,1
1689,CC:2F:71:3F:1F:24,7887942,7529260189,4676233,7123591440,3211709,405668749,80,1086245,667734830,1077732,666712456,8513,1022374,1033329,619,4680936,476954,80,5601,115556.0,28889.0,-70.0,-65.0,-73.0,-68.0,-69.0,-64.0,-73.0,-68.0,-84.0,-90.0,-84.0,-90.0,14.0,25.0,11.0,22.0,1
1690,F8:59:71:5A:E0:3D,3302645,535359754,90932,129690354,3211713,405669400,0,88745,88374128,83963,87802760,4782,571368,66671,16,93644,2200,0,509,144444.0,43333.0,-67.0,-72.0,-65.0,-71.0,-67.0,-71.0,-65.0,-70.0,-84.0,-90.0,-84.0,-90.0,17.0,18.0,19.0,19.0,1
1691,CC:2F:71:3E:C5:1F,3223080,407059973,11367,1390573,3211713,405669400,6,48544,4064951,40123,3067205,8421,997746,11983,34,16331,186,6,825,130000.0,39000.0,-69.0,-71.0,-70.0,-60.0,-70.0,-72.0,-69.0,-61.0,-84.0,-90.0,-84.0,-90.0,15.0,19.0,14.0,30.0,1
1692,CC:2F:71:3F:1F:24,7889437,7531571934,4677724,7125902534,3211713,405669400,80,1086620,667964892,1078107,666942518,8513,1022374,1033704,619,4682443,477207,80,5601,115556.0,28889.0,-69.0,-64.0,-72.0,-68.0,-69.0,-64.0,-72.0,-67.0,-84.0,-90.0,-84.0,-90.0,15.0,26.0,12.0,22.0,1
1693,F8:59:71:5A:E0:3D,3302714,535459977,90997,129789926,3211717,405670051,0,88811,88474334,84029,87902966,4782,571368,66737,16,93709,2200,0,509,144444.0,43333.0,-67.0,-72.0,-65.0,-70.0,-67.0,-72.0,-65.0,-70.0,-84.0,-90.0,-84.0,-90.0,17.0,18.0,19.0,20.0,1
1694,CC:2F:71:3E:C5:1F,3223084,407060624,11367,1390573,3211717,405670051,6,48544,4064951,40123,3067205,8421,997746,11983,34,16331,186,6,825,130000.0,39000.0,-69.0,-71.0,-70.0,-60.0,-70.0,-72.0,-69.0,-61.0,-84.0,-90.0,-84.0,-90.0,15.0,19.0,14.0,30.0,1
1695,CC:2F:71:3F:1F:24,7891444,7534689881,4679727,7129019830,3211717,405670051,80,1087044,668204698,1078531,667182324,8513,1022374,1034127,619,4684446,477657,80,5601,115556.0,28889.0,-70.0,-65.0,-73.0,-68.0,-69.0,-64.0,-73.0,-68.0,-84.0,-90.0,-84.0,-90.0,14.0,25.0,11.0,22.0,1
1696,F8:59:71:5A:E0:3D,3302786,535561597,91062,129890880,3211724,405670717,0,88876,88574434,84094,88003066,4782,571368,66802,16,93774,2200,0,509,130000.0,39000.0,-67.0,-72.0,-65.0,-71.0,-67.0,-72.0,-65.0,-70.0,-84.0,-90.0,-84.0,-90.0,17.0,18.0,19.0,19.0,1
1697,CC:2F:71:3E:C5:1F,3223092,407061515,11367,1390573,3211725,405670942,6,48544,4064951,40123,3067205,8421,997746,11983,34,16331,186,6,825,130000.0,39000.0,-69.0,-71.0,-70.0,-60.0,-70.0,-72.0,-69.0,-61.0,-84.0,-90.0,-84.0,-90.0,15.0,19.0,14.0,30.0,1
1698,CC:2F:71:3F:1F:24,7892858,7536864982,4681132,7131193816,3211726,405671166,80,1087373,668426852,1078860,667404478,8513,1022374,1034456,619,4685851,477915,80,5601,115556.0,28889.0,-70.0,-64.0,-74.0,-68.0,-69.0,-64.0,-73.0,-68.0,-84.0,-90.0,-84.0,-90.0,14.0,26.0,10.0,22.0,1
1699,F8:59:71:5A:E0:3D,3302855,535661654,91126,129990224,3211729,405671430,0,88939,88671454,84157,88100086,4782,571368,66865,16,93838,2200,0,509,144444.0,43333.0,-66.0,-72.0,-66.0,-71.0,-66.0,-72.0,-65.0,-70.0,-84.0,-90.0,-84.0,-90.0,18.0,18.0,18.0,19.0,1
1700,CC:2F:71:3E:C5:1F,3223096,407062003,11367,1390573,3211729,405671430,6,48546,4065139,40124,3067275,8422,997864,11984,34,16331,186,6,825,130000.0,39000.0,-70.0,-71.0,-68.0,-60.0,-70.0,-72.0,-69.0,-61.0,-84.0,-90.0,-84.0,-90.0,14.0,19.0,16.0,30.0,1
1701,CC:2F:71:3F:1F:24,7893802,7538307040,4682073,7132635610,3211729,405671430,80,1087680,668646060,1079167,667623686,8513,1022374,1034763,619,4686779,478011,80,5602,115556.0,28889.0,-70.0,-65.0,-73.0,-68.0,-69.0,-64.0,-73.0,-68.0,-84.0,-90.0,-84.0,-90.0,14.0,25.0,11.0,22.0,1
1702,F8:59:71:5A:E0:3D,3302927,535762051,91190,130089680,3211737,405672371,0,89004,88771554,84222,88200186,4782,571368,66930,16,93902,2202,0,509,144444.0,43333.0,-67.0,-71.0,-65.0,-71.0,-66.0,-71.0,-65.0,-70.0,-84.0,-90.0,-84.0,-90.0,17.0,19.0,19.0,19.0,1
1703,CC:2F:71:3E:C5:1F,3223104,407062944,11367,1390573,3211737,405672371,6,48546,4065139,40124,3067275,8422,997864,11984,34,16331,186,6,825,130000.0,39000.0,-70.0,-71.0,-68.0,-60.0,-70.0,-72.0,-69.0,-61.0,-84.0,-90.0,-84.0,-90.0,14.0,19.0,16.0,30.0,1
1704,CC:2F:71:3F:1F:24,7894762,7539759384,4683025,7134087013,3211737,405672371,80,1087981,668866769,1079467,667844277,8514,1022492,1035063,619,4687743,478046,80,5603,115556.0,28889.0,-70.0,-64.0,-73.0,-68.0,-69.0,-64.0,-73.0,-68.0,-84.0,-90.0,-84.0,-90.0,14.0,26.0,11.0,22.0,1
1705,F8:59:71:5A:E0:3D,3302995,535863323,91255,130190690,3211740,405672633,0,89068,88870114,84286,88298746,4782,571368,66994,16,93967,2203,0,509,144444.0,43333.0,-67.0,-72.0,-65.0,-70.0,-67.0,-71.0,-65.0,-70.0,-84.0,-90.0,-84.0,-90.0,17.0,18.0,19.0,20.0,1
1706,CC:2F:71:3E:C5:1F,3223107,407063206,11367,1390573,3211740,405672633,6,48546,4065139,40124,3067275,8422,997864,11984,34,16331,186,6,825,130000.0,39000.0,-70.0,-71.0,-68.0,-60.0,-70.0,-72.0,-69.0,-61.0,-84.0,-90.0,-84.0,-90.0,14.0,19.0,16.0,30.0,1
1707,CC:2F:71:3F:1F:24,7895930,7541554864,4684190,7135882231,3211740,405672633,80,1088302,669087757,1079788,668065265,8514,1022492,1035384,619,4688909,478098,80,5603,115556.0,28889.0,-70.0,-65.0,-74.0,-69.0,-70.0,-64.0,-73.0,-68.0,-84.0,-90.0,-84.0,-90.0,14.0,25.0,10.0,21.0,1
1708,F8:59:71:5A:E0:3D,3303064,535961831,91318,130288592,3211746,405673239,0,89131,88967134,84349,88395766,4782,571368,67057,16,94030,2203,0,509,144444.0,43333.0,-67.0,-72.0,-65.0,-70.0,-67.0,-71.0,-65.0,-70.0,-84.0,-90.0,-84.0,-90.0,17.0,18.0,19.0,20.0,1
1709,CC:2F:71:3E:C5:1F,3223113,407063812,11367,1390573,3211746,405673239,6,48546,4065139,40124,3067275,8422,997864,11984,34,16331,186,6,825,130000.0,39000.0,-70.0,-71.0,-68.0,-60.0,-70.0,-72.0,-69.0,-61.0,-84.0,-90.0,-84.0,-90.0,14.0,19.0,16.0,30.0,1
1710,CC:2F:71:3F:1F:24,7896924,7543071382,4685178,7137398143,3211746,405673239,80,1088609,669311237,1080095,668288745,8514,1022492,1035691,619,4689877,478162,80,5604,115556.0,28889.0,-71.0,-65.0,-75.0,-69.0,-70.0,-64.0,-73.0,-68.0,-84.0,-90.0,-84.0,-90.0,13.0,25.0,9.0,21.0,1
1711,F8:59:71:5A:E0:3D,3303132,536063159,91384,130389718,3211748,405673441,0,89199,89070434,84417,88499066,4782,571368,67124,16,94096,2204,0,509,144444.0,43333.0,-67.0,-72.0,-65.0,-70.0,-66.0,-71.0,-65.0,-70.0,-84.0,-90.0,-84.0,-90.0,17.0,18.0,19.0,20.0,1
1712,CC:2F:71:3E:C5:1F,3223115,407064014,11367,1390573,3211748,405673441,6,48546,4065139,40124,3067275,8422,997864,11984,34,16331,186,6,825,130000.0,39000.0,-70.0,-71.0,-68.0,-60.0,-70.0,-72.0,-69.0,-61.0,-84.0,-90.0,-84.0,-90.0,14.0,19.0,16.0,30.0,1
1713,CC:2F:71:3F:1F:24,7897967,7544670740,4686219,7138997299,3211748,405673441,80,1088895,669526473,1080381,668503981,8514,1022492,1035977,619,4690938,478248,80,5604,115556.0,28889.0,-70.0,-64.0,-73.0,-68.0,-69.0,-64.0,-73.0,-68.0,-84.0,-90.0,-84.0,-90.0,14.0,26.0,11.0,22.0,1
1714,F8:59:71:5A:E0:3D,3303205,536166389,91450,130492282,3211755,405674107,0,89264,89170534,84482,88599166,4782,571368,67189,16,94162,2206,0,509,144444.0,43333.0,-67.0,-72.0,-65.0,-70.0,-67.0,-71.0,-65.0,-70.0,-84.0,-90.0,-84.0,-90.0,17.0,18.0,19.0,20.0,1
1715,CC:2F:71:3E:C5:1F,3223122,407064680,11367,1390573,3211755,405674107,6,48546,4065139,40124,3067275,8422,997864,11984,34,16331,186,6,825,130000.0,39000.0,-70.0,-71.0,-68.0,-60.0,-70.0,-72.0,-69.0,-61.0,-84.0,-90.0,-84.0,-90.0,14.0,19.0,16.0,30.0,1
1716,CC:2F:71:3F:1F:24,7899186,7546533193,4687431,7140859086,3211755,405674107,80,1089227,669753448,1080713,668730956,8514,1022492,1036309,619,4692150,478355,80,5605,115556.0,28889.0,-70.0,-64.0,-74.0,-68.0,-69.0,-64.0,-73.0,-68.0,-84.0,-90.0,-84.0,-90.0,14.0,26.0,10.0,22.0,1
1717,F8:59:71:5A:E0:3D,3303280,536269185,91514,130591738,3211766,405677447,0,89329,89269212,84546,88697726,4783,571486,67254,16,94226,2207,0,509,144444.0,43333.0,-66.0,-72.0,-65.0,-70.0,-66.0,-71.0,-65.0,-70.0,-84.0,-90.0,-84.0,-90.0,18.0,18.0,19.0,20.0,1
1718,CC:2F:71:3E:C5:1F,3223135,407068222,11367,1390573,3211768,405677649,6,48546,4065139,40124,3067275,8422,997864,11984,34,16331,186,6,825,130000.0,39000.0,-70.0,-71.0,-68.0,-60.0,-70.0,-72.0,-69.0,-61.0,-84.0,-90.0,-84.0,-90.0,14.0,19.0,16.0,30.0,1
1719,CC:2F:71:3F:1F:24,7900844,7549089057,4689076,7143411408,3211768,405677649,80,1089598,669984274,1081084,668961782,8514,1022492,1036678,619,4693769,478482,80,5605,104000.0,26000.0,-70.0,-64.0,-73.0,-68.0,-69.0,-64.0,-73.0,-68.0,-84.0,-90.0,-84.0,-90.0,14.0,26.0,11.0,22.0,1
1720,F8:59:71:5A:E0:3D,3303353,536371003,91579,130692748,3211774,405678255,0,89394,89369312,84611,88797826,4783,571486,67319,16,94291,2208,0,509,144444.0,43333.0,-66.0,-72.0,-65.0,-70.0,-66.0,-72.0,-65.0,-70.0,-84.0,-90.0,-84.0,-90.0,18.0,18.0,19.0,20.0,1
1721,CC:2F:71:3E:C5:1F,3223141,407068828,11367,1390573,3211774,405678255,6,48546,4065139,40124,3067275,8422,997864,11984,34,16331,186,6,825,130000.0,39000.0,-70.0,-71.0,-68.0,-60.0,-70.0,-72.0,-69.0,-61.0,-84.0,-90.0,-84.0,-90.0,14.0,19.0,16.0,30.0,1
1722,CC:2F:71:3F:1F:24,7902575,7551768273,4690801,7146090018,3211774,405678255,80,1089993,670215078,1081479,669192586,8514,1022492,1037072,619,4695508,478660,80,5606,115556.0,28889.0,-70.0,-64.0,-73.0,-68.0,-70.0,-64.0,-73.0,-68.0,-84.0,-90.0,-84.0,-90.0,14.0,26.0,11.0,22.0,1
1723,F8:59:71:5A:E0:3D,3303417,536468965,91642,130790650,3211775,405678315,0,89456,89464792,84673,88893306,4783,571486,67381,16,94354,2208,0,509,144444.0,43333.0,-67.0,-72.0,-65.0,-70.0,-67.0,-72.0,-65.0,-70.0,-84.0,-90.0,-84.0,-89.0,17.0,18.0,19.0,19.0,1
1724,CC:2F:71:3E:C5:1F,3223142,407068888,11367,1390573,3211775,405678315,6,48546,4065139,40124,3067275,8422,997864,11984,34,16331,186,6,825,130000.0,39000.0,-70.0,-71.0,-68.0,-60.0,-70.0,-72.0,-69.0,-61.0,-84.0,-90.0,-84.0,-89.0,14.0,19.0,16.0,29.0,1
1725,CC:2F:71:3F:1F:24,7903669,7553450055,4691894,7147771740,3211775,405678315,80,1090301,670431568,1081787,669409076,8514,1022492,1037380,619,4696613,478714,80,5606,115556.0,28889.0,-69.0,-64.0,-73.0,-68.0,-69.0,-64.0,-73.0,-68.0,-84.0,-90.0,-84.0,-89.0,15.0,26.0,11.0,21.0,1
1726,F8:59:71:5A:E0:3D,3303488,536570581,91707,130891660,3211781,405678921,0,89521,89564892,84738,88993406,4783,571486,67446,16,94419,2208,0,509,144444.0,43333.0,-66.0,-71.0,-65.0,-70.0,-66.0,-71.0,-65.0,-70.0,-84.0,-90.0,-84.0,-89.0,18.0,19.0,19.0,19.0,1
1727,CC:2F:71:3E:C5:1F,3223150,407069696,11367,1390573,3211783,405679123,6,48546,4065139,40124,3067275,8422,997864,11984,34,16331,186,6,825,130000.0,39000.0,-70.0,-71.0,-68.0,-60.0,-70.0,-72.0,-69.0,-61.0,-84.0,-90.0,-84.0,-89.0,14.0,19.0,16.0,29.0,1
1728,CC:2F:71:3F:1F:24,7904507,7554710774,4692724,7149031651,3211783,405679123,80,1090595,670655570,1082081,669633078,8514,1022492,1037674,619,4697443,478769,80,5606,115556.0,28889.0,-69.0,-65.0,-73.0,-68.0,-69.0,-64.0,-73.0,-68.0,-84.0,-90.0,-84.0,-89.0,15.0,25.0,11.0,21.0,1
1729,F8:59:71:5A:E0:3D,3303554,536668745,91770,130989562,3211784,405679183,0,89586,89664992,84803,89093506,4783,571486,67511,16,94482,2209,0,509,144444.0,43333.0,-67.0,-72.0,-65.0,-71.0,-67.0,-72.0,-65.0,-70.0,-84.0,-90.0,-84.0,-89.0,17.0,18.0,19.0,18.0,1
1730,CC:2F:71:3E:C5:1F,3223151,407069756,11367,1390573,3211784,405679183,6,48546,4065139,40124,3067275,8422,997864,11984,34,16331,186,6,825,130000.0,39000.0,-70.0,-71.0,-68.0,-60.0,-70.0,-72.0,-69.0,-61.0,-84.0,-90.0,-84.0,-89.0,14.0,19.0,16.0,29.0,1
1731,CC:2F:71:3F:1F:24,7905405,7556083220,4693621,7150404037,3211784,405679183,80,1090898,670872716,1082384,669850224,8514,1022492,1037977,619,4698340,478782,80,5606,115556.0,28889.0,-70.0,-64.0,-74.0,-68.0,-69.0,-64.0,-73.0,-68.0,-84.0,-90.0,-84.0,-89.0,14.0,26.0,10.0,21.0,1
1732,F8:59:71:5A:E0:3D,3303621,536769957,91835,131090572,3211786,405679385,0,89650,89763552,84867,89192066,4783,571486,67575,16,94547,2209,0,509,144444.0,43333.0,-66.0,-72.0,-65.0,-70.0,-66.0,-72.0,-65.0,-70.0,-84.0,-90.0,-84.0,-90.0,18.0,18.0,19.0,20.0,1
1733,CC:2F:71:3E:C5:1F,3223153,407069958,11367,1390573,3211786,405679385,6,48546,4065139,40124,3067275,8422,997864,11984,34,16331,186,6,825,130000.0,39000.0,-70.0,-71.0,-68.0,-60.0,-70.0,-72.0,-69.0,-61.0,-84.0,-90.0,-84.0,-90.0,14.0,19.0,16.0,30.0,1
1734,CC:2F:71:3F:1F:24,7906610,7557933992,4694820,7152254203,3211790,405679789,80,1091189,671088852,1082675,670066360,8514,1022492,1038268,619,4699538,478958,80,5606,115556.0,28889.0,-70.0,-64.0,-73.0,-69.0,-69.0,-63.0,-73.0,-68.0,-84.0,-90.0,-84.0,-90.0,14.0,26.0,11.0,21.0,1
1735,F8:59:71:5A:E0:3D,3303693,536871699,91900,131191582,3211793,405680117,0,89715,89863652,84932,89292166,4783,571486,67640,16,94612,2210,0,509,144444.0,43333.0,-66.0,-72.0,-66.0,-70.0,-66.0,-72.0,-65.0,-70.0,-84.0,-90.0,-84.0,-90.0,18.0,18.0,18.0,20.0,1
1736,CC:2F:71:3E:C5:1F,3223160,407070690,11367,1390573,3211793,405680117,6,48546,4065139,40124,3067275,8422,997864,11984,34,16331,186,6,825,130000.0,39000.0,-70.0,-71.0,-68.0,-60.0,-70.0,-72.0,-69.0,-61.0,-84.0,-90.0,-84.0,-90.0,14.0,19.0,16.0,30.0,1
1737,CC:2F:71:3F:1F:24,7908348,7560627558,4696555,7154947441,3211793,405680117,80,1091574,671326990,1083060,670304498,8514,1022492,1038653,619,4701274,479163,80,5606,115556.0,28889.0,-70.0,-64.0,-74.0,-68.0,-70.0,-64.0,-73.0,-68.0,-84.0,-90.0,-84.0,-90.0,14.0,26.0,10.0,22.0,1
1738,F8:59:71:5A:E0:3D,3303762,536974525,91966,131294146,3211796,405680379,0,89781,89965292,84998,89393806,4783,571486,67706,16,94678,2211,0,509,144444.0,43333.0,-67.0,-72.0,-65.0,-70.0,-66.0,-71.0,-65.0,-70.0,-84.0,-90.0,-84.0,-90.0,17.0,18.0,19.0,20.0,1
1739,CC:2F:71:3E:C5:1F,3223163,407070952,11367,1390573,3211796,405680379,6,48546,4065139,40124,3067275,8422,997864,11984,34,16331,186,6,825,130000.0,39000.0,-70.0,-71.0,-68.0,-60.0,-70.0,-72.0,-69.0,-61.0,-84.0,-90.0,-84.0,-90.0,14.0,19.0,16.0,30.0,1
1740,CC:2F:71:3F:1F:24,7910495,7563933748,4698699,7158253369,3211796,405680379,80,1092005,671566838,1083491,670544346,8514,1022492,1039084,619,4703417,479531,80,5606,115556.0,28889.0,-70.0,-64.0,-73.0,-69.0,-69.0,-64.0,-73.0,-68.0,-84.0,-90.0,-84.0,-90.0,14.0,26.0,11.0,21.0,1
1741,F8:59:71:5A:E0:3D,3303833,537076141,92031,131395156,3211802,405680985,0,89846,90065392,85063,89493906,4783,571486,67771,16,94743,2213,0,509,144444.0,43333.0,-67.0,-72.0,-65.0,-71.0,-66.0,-72.0,-65.0,-70.0,-84.0,-90.0,-84.0,-90.0,17.0,18.0,19.0,19.0,1
1742,CC:2F:71:3E:C5:1F,3223169,407071558,11367,1390573,3211802,405680985,6,48546,4065139,40124,3067275,8422,997864,11984,34,16331,186,6,825,130000.0,39000.0,-70.0,-71.0,-68.0,-60.0,-70.0,-72.0,-69.0,-61.0,-84.0,-90.0,-84.0,-90.0,14.0,19.0,16.0,30.0,1
1743,CC:2F:71:3F:1F:24,7911787,7565919699,4699985,7160238714,3211802,405680985,80,1092339,671789212,1083825,670766720,8514,1022492,1039418,619,4704704,479576,80,5607,115556.0,28889.0,-70.0,-64.0,-73.0,-68.0,-69.0,-64.0,-73.0,-68.0,-84.0,-90.0,-84.0,-90.0,14.0,26.0,11.0,22.0,1
1744,F8:59:71:5A:E0:3D,3303901,537177626,92096,131496166,3211805,405681460,0,89911,90165492,85128,89594006,4783,571486,67836,16,94808,2213,0,509,144444.0,43333.0,-67.0,-72.0,-65.0,-70.0,-66.0,-72.0,-65.0,-70.0,-84.0,-90.0,-84.0,-89.0,17.0,18.0,19.0,19.0,1
1745,CC:2F:71:3E:C5:1F,3223172,407072033,11367,1390573,3211805,405681460,6,48546,4065139,40124,3067275,8422,997864,11984,34,16331,186,6,825,130000.0,39000.0,-70.0,-71.0,-68.0,-60.0,-70.0,-72.0,-69.0,-61.0,-84.0,-90.0,-84.0,-89.0,14.0,19.0,16.0,29.0,1
1746,CC:2F:71:3F:1F:24,7913175,7568062448,4701370,7162380988,3211805,405681460,80,1092672,672015910,1084158,670993418,8514,1022492,1039751,619,4706083,479748,80,5608,117000.0,39000.0,-69.0,-64.0,-73.0,-68.0,-69.0,-64.0,-72.0,-68.0,-84.0,-90.0,-84.0,-89.0,15.0,26.0,11.0,21.0,1
1747,F8:59:71:5A:E0:3D,3303975,537282410,92163,131600284,3211812,405682126,0,89978,90268672,85195,89697186,4783,571486,67903,16,94875,2213,0,509,144444.0,43333.0,-67.0,-72.0,-65.0,-70.0,-66.0,-72.0,-65.0,-70.0,-84.0,-90.0,-84.0,-89.0,17.0,18.0,19.0,19.0,1
1748,CC:2F:71:3E:C5:1F,3223179,407072699,11367,1390573,3211812,405682126,6,48546,4065139,40124,3067275,8422,997864,11984,34,16331,186,6,825,130000.0,39000.0,-70.0,-71.0,-68.0,-60.0,-70.0,-72.0,-69.0,-61.0,-84.0,-90.0,-84.0,-89.0,14.0,19.0,16.0,29.0,1
1749,CC:2F:71:3F:1F:24,7914447,7570015788,4702635,7164333662,3211812,405682126,80,1093028,672255100,1084514,671232608,8514,1022492,1040107,619,4707354,479857,80,5608,115556.0,28889.0,-70.0,-64.0,-74.0,-68.0,-69.0,-63.0,-73.0,-68.0,-84.0,-90.0,-84.0,-89.0,14.0,26.0,10.0,21.0,1
1750,F8:59:71:5A:E0:3D,3304043,537385176,92229,131702848,3211814,405682328,0,90044,90370312,85261,89798826,4783,571486,67969,16,94941,2214,0,509,144444.0,43333.0,-67.0,-72.0,-65.0,-71.0,-66.0,-72.0,-65.0,-70.0,-84.0,-90.0,-84.0,-89.0,17.0,18.0,19.0,18.0,1
1751,CC:2F:71:3E:C5:1F,3223181,407072901,11367,1390573,3211814,405682328,6,48546,4065139,40124,3067275,8422,997864,11984,34,16331,186,6,825,130000.0,39000.0,-70.0,-71.0,-68.0,-60.0,-70.0,-72.0,-69.0,-61.0,-84.0,-90.0,-84.0,-89.0,14.0,19.0,16.0,29.0,1
1752,CC:2F:71:3F:1F:24,7915723,7571977021,4703909,7166294693,3211814,405682328,80,1093342,672474211,1084828,671451719,8514,1022492,1040421,619,4708617,479954,80,5609,104000.0,26000.0,-70.0,-64.0,-73.0,-68.0,-69.0,-64.0,-73.0,-68.0,-84.0,-90.0,-84.0,-89.0,14.0,26.0,11.0,21.0,1
1753,F8:59:71:5A:E0:3D,3304123,537494252,92303,131811318,3211820,405682934,0,90120,90478937,85337,89907451,4783,571486,68045,16,95015,2219,0,509,144444.0,43333.0,-67.0,-72.0,-65.0,-70.0,-66.0,-71.0,-65.0,-70.0,-84.0,-90.0,-84.0,-89.0,17.0,18.0,19.0,19.0,1
1754,CC:2F:71:3E:C5:1F,3223187,407073507,11367,1390573,3211820,405682934,6,48546,4065139,40124,3067275,8422,997864,11984,34,16331,186,6,825,130000.0,39000.0,-70.0,-71.0,-68.0,-60.0,-70.0,-72.0,-69.0,-61.0,-84.0,-90.0,-84.0,-89.0,14.0,19.0,16.0,29.0,1
1755,CC:2F:71:3F:1F:24,7917195,7574247119,4705375,7168564185,3211820,405682934,80,1093682,672711603,1085168,671689111,8514,1022492,1040760,619,4710072,480110,80,5609,115556.0,28889.0,-69.0,-64.0,-73.0,-68.0,-69.0,-64.0,-72.0,-68.0,-84.0,-90.0,-84.0,-89.0,15.0,26.0,11.0,21.0,1
1756,F8:59:71:5A:E0:3D,3304192,537595784,92368,131912328,3211824,405683456,0,90188,90583699,85405,90012213,4783,571486,68110,16,95080,2223,0,509,144444.0,43333.0,-67.0,-72.0,-65.0,-71.0,-67.0,-72.0,-65.0,-70.0,-84.0,-90.0,-84.0,-89.0,17.0,18.0,19.0,18.0,1
1757,CC:2F:71:3E:C5:1F,3223191,407074029,11367,1390573,3211824,405683456,6,48546,4065139,40124,3067275,8422,997864,11984,34,16331,186,6,825,130000.0,39000.0,-70.0,-71.0,-68.0,-60.0,-70.0,-72.0,-69.0,-61.0,-84.0,-90.0,-84.0,-89.0,14.0,19.0,16.0,29.0,1
1758,CC:2F:71:3F:1F:24,7918375,7576060217,4706551,7170376761,3211824,405683456,80,1094003,672933863,1085489,671911371,8514,1022492,1041081,619,4711270,480148,80,5609,115556.0,28889.0,-69.0,-64.0,-74.0,-68.0,-69.0,-64.0,-73.0,-68.0,-84.0,-90.0,-84.0,-89.0,15.0,26.0,10.0,21.0,1
1759,F8:59:71:5A:E0:3D,3304264,537697516,92434,132013454,3211830,405684062,0,90253,90683813,85470,90112327,4783,571486,68174,16,95146,2225,0,509,144444.0,43333.0,-67.0,-72.0,-65.0,-70.0,-66.0,-71.0,-65.0,-70.0,-84.0,-90.0,-84.0,-89.0,17.0,18.0,19.0,19.0,1
1760,CC:2F:71:3E:C5:1F,3223198,407074751,11368,1390689,3211830,405684062,6,48547,4065209,40125,3067345,8422,997864,11984,34,16332,186,6,825,130000.0,39000.0,-69.0,-71.0,-68.0,-60.0,-70.0,-72.0,-69.0,-61.0,-84.0,-90.0,-84.0,-89.0,15.0,19.0,16.0,29.0,1
1761,CC:2F:71:3F:1F:24,7920043,7578638477,4708213,7172954415,3211830,405684062,80,1094376,673172517,1085862,672150025,8514,1022492,1041450,619,4712932,480375,80,5610,115556.0,28889.0,-70.0,-64.0,-73.0,-68.0,-69.0,-64.0,-73.0,-68.0,-84.0,-90.0,-84.0,-89.0,14.0,26.0,11.0,21.0,1
1762,F8:59:71:5A:E0:3D,3304333,537800342,92500,132116018,3211833,405684324,0,90320,90787007,85537,90215521,4783,571486,68240,16,95212,2225,0,509,144444.0,43333.0,-67.0,-72.0,-65.0,-70.0,-66.0,-72.0,-65.0,-70.0,-84.0,-90.0,-84.0,-89.0,17.0,18.0,19.0,19.0,1
1763,CC:2F:71:3E:C5:1F,3223201,407075013,11368,1390689,3211833,405684324,6,48548,4065279,40126,3067415,8422,997864,11984,34,16332,186,6,825,130000.0,39000.0,-69.0,-71.0,-68.0,-60.0,-70.0,-72.0,-69.0,-61.0,-84.0,-90.0,-84.0,-89.0,15.0,19.0,16.0,29.0,1
1764,CC:2F:71:3F:1F:24,7922075,7581798749,4710242,7176114425,3211833,405684324,80,1094767,673403273,1086253,672380781,8514,1022492,1041841,619,4714960,480561,80,5610,115556.0,28889.0,-69.0,-64.0,-73.0,-68.0,-69.0,-63.0,-72.0,-68.0,-84.0,-90.0,-84.0,-89.0,15.0,26.0,11.0,21.0,1
1765,F8:59:71:5A:E0:3D,3304404,537901790,92565,132216860,3211839,405684930,0,90386,90888661,85603,90317175,4783,571486,68305,16,95277,2225,0,509,144444.0,43333.0,-67.0,-72.0,-65.0,-71.0,-67.0,-72.0,-65.0,-70.0,-84.0,-90.0,-84.0,-89.0,17.0,18.0,19.0,18.0,1
1766,CC:2F:71:3E:C5:1F,3223207,407075619,11368,1390689,3211839,405684930,6,48548,4065279,40126,3067415,8422,997864,11984,34,16332,186,6,825,130000.0,39000.0,-69.0,-71.0,-68.0,-60.0,-70.0,-72.0,-69.0,-61.0,-84.0,-90.0,-84.0,-89.0,15.0,19.0,16.0,29.0,1
1767,CC:2F:71:3F:1F:24,7923045,7583269846,4711206,7177584916,3211839,405684930,80,1095071,673625600,1086557,672603108,8514,1022492,1042144,619,4715924,480597,80,5610,115556.0,28889.0,-69.0,-64.0,-73.0,-68.0,-69.0,-64.0,-73.0,-68.0,-84.0,-90.0,-84.0,-89.0,15.0,26.0,11.0,21.0,1
1768,F8:59:71:5A:E0:3D,3304470,538004354,92631,132319424,3211839,405684930,0,90455,90994949,85672,90423463,4783,571486,68372,16,95343,2226,0,509,144444.0,43333.0,-67.0,-72.0,-65.0,-71.0,-67.0,-72.0,-65.0,-70.0,-84.0,-90.0,-84.0,-89.0,17.0,18.0,19.0,18.0,1
1769,CC:2F:71:3E:C5:1F,3223207,407075619,11368,1390689,3211839,405684930,6,48548,4065279,40126,3067415,8422,997864,11984,34,16332,186,6,825,130000.0,39000.0,-69.0,-71.0,-68.0,-60.0,-70.0,-72.0,-69.0,-61.0,-84.0,-90.0,-84.0,-89.0,15.0,19.0,16.0,29.0,1
1770,CC:2F:71:3F:1F:24,7923880,7584540978,4712039,7178855846,3211841,405685132,80,1095343,673852132,1086829,672829640,8514,1022492,1042416,619,4716758,480667,80,5610,115556.0,28889.0,-69.0,-64.0,-72.0,-68.0,-69.0,-64.0,-73.0,-68.0,-84.0,-90.0,-84.0,-89.0,15.0,26.0,12.0,21.0,1
1771,F8:59:71:5A:E0:3D,3304544,538109138,92698,132423542,3211846,405685596,0,90522,91098143,85739,90526657,4783,571486,68438,16,95410,2227,0,509,144444.0,43333.0,-67.0,-72.0,-65.0,-71.0,-67.0,-72.0,-65.0,-71.0,-84.0,-90.0,-84.0,-89.0,17.0,18.0,19.0,18.0,1
1772,CC:2F:71:3E:C5:1F,3223214,407076285,11368,1390689,3211846,405685596,6,48548,4065279,40126,3067415,8422,997864,11984,34,16332,186,6,825,130000.0,39000.0,-69.0,-71.0,-68.0,-60.0,-70.0,-72.0,-69.0,-61.0,-84.0,-90.0,-84.0,-89.0,15.0,19.0,16.0,29.0,1
1773,CC:2F:71:3F:1F:24,7924999,7586251942,4713151,7180566144,3211848,405685798,80,1095658,674072222,1087144,673049730,8514,1022492,1042731,619,4717845,480709,80,5611,115556.0,28889.0,-69.0,-64.0,-73.0,-68.0,-69.0,-64.0,-73.0,-68.0,-84.0,-90.0,-84.0,-89.0,15.0,26.0,11.0,21.0,1
1774,F8:59:71:5A:E0:3D,3304611,538208912,92763,132523114,3211848,405685798,0,90587,91196809,85804,90625323,4783,571486,68503,16,95475,2229,0,509,144444.0,43333.0,-67.0,-72.0,-65.0,-71.0,-66.0,-72.0,-65.0,-70.0,-84.0,-90.0,-84.0,-89.0,17.0,18.0,19.0,18.0,1
1775,CC:2F:71:3E:C5:1F,3223216,407076487,11368,1390689,3211848,405685798,6,48548,4065279,40126,3067415,8422,997864,11984,34,16332,186,6,825,130000.0,39000.0,-69.0,-71.0,-68.0,-60.0,-70.0,-72.0,-69.0,-61.0,-84.0,-90.0,-84.0,-89.0,15.0,19.0,16.0,29.0,1
1776,CC:2F:71:3F:1F:24,7926216,7588129312,4714368,7182443514,3211848,405685798,80,1095959,674290662,1087445,673268170,8514,1022492,1043032,619,4719087,480803,80,5611,115556.0,28889.0,-69.0,-64.0,-73.0,-69.0,-69.0,-64.0,-73.0,-68.0,-84.0,-90.0,-84.0,-89.0,15.0,26.0,11.0,20.0,1
1777,F8:59:71:5A:E0:3D,3304679,538305866,92825,132619462,3211854,405686404,0,90650,91293843,85867,90722357,4783,571486,68565,16,95537,2229,0,509,144444.0,43333.0,-68.0,-72.0,-66.0,-72.0,-67.0,-72.0,-65.0,-71.0,-84.0,-90.0,-84.0,-90.0,16.0,18.0,18.0,18.0,1
1778,CC:2F:71:3E:C5:1F,3223222,407077093,11368,1390689,3211854,405686404,6,48548,4065279,40126,3067415,8422,997864,11984,34,16332,186,6,825,130000.0,39000.0,-69.0,-71.0,-68.0,-60.0,-70.0,-72.0,-69.0,-61.0,-84.0,-90.0,-84.0,-90.0,15.0,19.0,16.0,30.0,1
1779,CC:2F:71:3F:1F:24,7927555,7590183942,4715701,7184497538,3211854,405686404,80,1096287,674511293,1087773,673488801,8514,1022492,1043359,619,4720420,480882,80,5612,115556.0,28889.0,-70.0,-64.0,-73.0,-68.0,-69.0,-64.0,-72.0,-68.0,-84.0,-90.0,-84.0,-90.0,14.0,26.0,11.0,22.0,1
1780,F8:59:71:5A:E0:3D,3304747,538405646,92889,132718918,3211858,405686728,0,90717,91397051,85934,90825565,4783,571486,68630,16,95601,2231,0,509,144444.0,43333.0,-67.0,-72.0,-65.0,-71.0,-66.0,-71.0,-65.0,-70.0,-84.0,-90.0,-84.0,-90.0,17.0,18.0,19.0,19.0,1
1781,CC:2F:71:3E:C5:1F,3223226,407077417,11368,1390689,3211858,405686728,6,48548,4065279,40126,3067415,8422,997864,11984,34,16332,186,6,825,130000.0,39000.0,-69.0,-71.0,-68.0,-60.0,-70.0,-72.0,-69.0,-61.0,-84.0,-90.0,-84.0,-90.0,15.0,19.0,16.0,30.0,1
1782,CC:2F:71:3F:1F:24,7929294,7592878528,4717436,7187191800,3211858,405686728,80,1096669,674753673,1088154,673731063,8515,1022610,1043741,619,4722155,481039,80,5612,115556.0,28889.0,-71.0,-65.0,-74.0,-69.0,-69.0,-64.0,-72.0,-68.0,-84.0,-90.0,-84.0,-90.0,13.0,25.0,10.0,21.0,1
1783,F8:59:71:5A:E0:3D,3304820,538513276,92958,132826144,3211862,405687132,0,90785,91501771,86002,90930285,4783,571486,68698,16,95670,2231,0,509,144444.0,43333.0,-67.0,-71.0,-65.0,-71.0,-66.0,-71.0,-65.0,-70.0,-84.0,-90.0,-84.0,-90.0,17.0,19.0,19.0,19.0,1
1784,CC:2F:71:3E:C5:1F,3223230,407077821,11368,1390689,3211862,405687132,6,48548,4065279,40126,3067415,8422,997864,11984,34,16332,186,6,825,130000.0,39000.0,-69.0,-71.0,-68.0,-60.0,-70.0,-72.0,-69.0,-61.0,-84.0,-90.0,-84.0,-90.0,15.0,19.0,16.0,30.0,1
1785,CC:2F:71:3F:1F:24,7930691,7595029819,4718826,7189342212,3211865,405687607,80,1096982,674968255,1088467,673945645,8515,1022610,1044054,619,4723537,481244,80,5612,115556.0,28889.0,-69.0,-64.0,-72.0,-68.0,-69.0,-64.0,-72.0,-68.0,-84.0,-90.0,-84.0,-90.0,15.0,26.0,12.0,22.0,1
1786,F8:59:71:5A:E0:3D,3304887,538610301,93020,132922492,3211867,405687809,0,90847,91597251,86064,91025765,4783,571486,68760,16,95732,2231,0,509,144444.0,43333.0,-67.0,-72.0,-65.0,-71.0,-67.0,-72.0,-65.0,-70.0,-84.0,-90.0,-84.0,-90.0,17.0,18.0,19.0,19.0,1
1787,CC:2F:71:3E:C5:1F,3223235,407078498,11368,1390689,3211867,405687809,6,48548,4065279,40126,3067415,8422,997864,11984,34,16332,186,6,825,130000.0,39000.0,-69.0,-71.0,-68.0,-60.0,-70.0,-72.0,-69.0,-61.0,-84.0,-90.0,-84.0,-90.0,15.0,19.0,16.0,30.0,1
1788,CC:2F:71:3F:1F:24,7931879,7596859745,4720012,7191171936,3211867,405687809,80,1097300,675183107,1088785,674160497,8515,1022610,1044372,619,4724724,481312,80,5613,115556.0,28889.0,-69.0,-64.0,-73.0,-68.0,-69.0,-64.0,-72.0,-68.0,-84.0,-90.0,-84.0,-90.0,15.0,26.0,11.0,22.0,1
1789,F8:59:71:5A:E0:3D,3304956,538710221,93084,133021948,3211872,405688273,0,90911,91695811,86128,91124325,4783,571486,68824,16,95796,2231,0,509,144444.0,43333.0,-67.0,-73.0,-66.0,-71.0,-67.0,-72.0,-65.0,-70.0,-84.0,-90.0,-84.0,-90.0,17.0,17.0,18.0,19.0,1
1790,CC:2F:71:3E:C5:1F,3223240,407078962,11368,1390689,3211872,405688273,6,48548,4065279,40126,3067415,8422,997864,11984,34,16332,186,6,825,130000.0,39000.0,-69.0,-71.0,-68.0,-60.0,-70.0,-72.0,-69.0,-61.0,-84.0,-90.0,-84.0,-90.0,15.0,19.0,16.0,30.0,1
1791,CC:2F:71:3F:1F:24,7933357,7599132478,4721485,7193444205,3211872,405688273,80,1097651,675410672,1089136,674388062,8515,1022610,1044723,619,4726204,481399,80,5614,115556.0,28889.0,-70.0,-64.0,-73.0,-68.0,-69.0,-64.0,-72.0,-68.0,-84.0,-90.0,-84.0,-90.0,14.0,26.0,11.0,22.0,1
1792,F8:59:71:5A:E0:3D,3305024,538808589,93147,133119850,3211877,405688739,0,90975,91794385,86192,91222899,4783,571486,68887,16,95859,2231,0,509,144444.0,43333.0,-67.0,-72.0,-66.0,-71.0,-67.0,-72.0,-65.0,-71.0,-84.0,-90.0,-84.0,-90.0,17.0,18.0,18.0,19.0,1
1793,CC:2F:71:3E:C5:1F,3223245,407079428,11368,1390689,3211877,405688739,6,48549,4065397,40126,3067415,8423,997982,11985,34,16332,186,6,825,130000.0,39000.0,-69.0,-71.0,-68.0,-60.0,-69.0,-71.0,-68.0,-60.0,-84.0,-90.0,-84.0,-90.0,15.0,19.0,16.0,30.0,1
1794,CC:2F:71:3F:1F:24,7934854,7601444104,4722977,7195755365,3211877,405688739,80,1097999,675634682,1089484,674612072,8515,1022610,1045067,619,4727695,481495,80,5614,130000.0,39000.0,-69.0,-64.0,-73.0,-68.0,-69.0,-64.0,-72.0,-68.0,-84.0,-90.0,-84.0,-90.0,15.0,26.0,11.0,22.0,1
1795,F8:59:71:5A:E0:3D,3305090,538906755,93210,133217752,3211880,405689003,0,91039,91891523,86255,91319919,4784,571604,68951,16,95922,2232,0,509,144444.0,43333.0,-66.0,-72.0,-66.0,-70.0,-66.0,-72.0,-65.0,-70.0,-84.0,-90.0,-84.0,-90.0,18.0,18.0,18.0,20.0,1
1796,CC:2F:71:3E:C5:1F,3223250,407079894,11368,1390689,3211882,405689205,6,48550,4065467,40127,3067485,8423,997982,11985,34,16332,186,6,825,130000.0,39000.0,-69.0,-71.0,-68.0,-60.0,-69.0,-71.0,-68.0,-60.0,-84.0,-90.0,-84.0,-90.0,15.0,19.0,16.0,30.0,1
1797,CC:2F:71:3F:1F:24,7936196,7603509820,4724314,7197820615,3211882,405689205,80,1098321,675854188,1089806,674831578,8515,1022610,1045389,619,4729033,481563,80,5614,115556.0,28889.0,-70.0,-64.0,-74.0,-68.0,-69.0,-63.0,-72.0,-67.0,-84.0,-90.0,-84.0,-90.0,14.0,26.0,10.0,22.0,1
1798,F8:59:71:5A:E0:3D,3305159,539006675,93274,133317208,3211885,405689467,0,91105,91993191,86321,91421587,4784,571604,69015,16,95986,2235,0,509,144444.0,43333.0,-68.0,-73.0,-66.0,-72.0,-67.0,-72.0,-66.0,-71.0,-84.0,-90.0,-84.0,-90.0,16.0,17.0,18.0,18.0,1
1799,CC:2F:71:3E:C5:1F,3223253,407080156,11368,1390689,3211885,405689467,6,48550,4065467,40127,3067485,8423,997982,11985,34,16332,186,6,825,130000.0,39000.0,-69.0,-71.0,-68.0,-60.0,-69.0,-71.0,-68.0,-60.0,-84.0,-90.0,-84.0,-90.0,15.0,19.0,16.0,30.0,1
1800,CC:2F:71:3F:1F:24,7937538,7605577062,4725651,7199887393,3211887,405689669,80,1098637,676068750,1090122,675046140,8515,1022610,1045705,619,4730370,481623,80,5614,115556.0,28889.0,-69.0,-64.0,-73.0,-68.0,-69.0,-64.0,-72.0,-68.0,-84.0,-90.0,-84.0,-90.0,15.0,26.0,11.0,22.0,1
1801,F8:59:71:5A:E0:3D,3305225,539106333,93338,133416664,3211887,405689669,0,91170,92093305,86386,91521701,4784,571604,69079,16,96050,2235,0,509,144444.0,43333.0,-67.0,-72.0,-65.0,-71.0,-66.0,-71.0,-65.0,-70.0,-84.0,-90.0,-84.0,-90.0,17.0,18.0,19.0,19.0,1
1802,CC:2F:71:3E:C5:1F,3223257,407080560,11368,1390689,3211889,405689871,6,48550,4065467,40127,3067485,8423,997982,11985,34,16332,186,6,825,130000.0,39000.0,-69.0,-71.0,-68.0,-60.0,-69.0,-71.0,-68.0,-60.0,-84.0,-90.0,-84.0,-90.0,15.0,19.0,16.0,30.0,1
1803,CC:2F:71:3F:1F:24,7939145,7608060145,4727254,7202370072,3211891,405690073,80,1098999,676310679,1090484,675288069,8515,1022610,1046067,619,4731925,481793,80,5615,115556.0,28889.0,-69.0,-64.0,-72.0,-68.0,-69.0,-64.0,-72.0,-68.0,-84.0,-90.0,-84.0,-90.0,15.0,26.0,12.0,22.0,1
1804,F8:59:71:5A:E0:3D,3305302,539215779,93408,133525444,3211894,405690335,0,91241,92202645,86457,91631041,4784,571604,69150,16,96120,2235,0,509,144444.0,43333.0,-67.0,-72.0,-65.0,-71.0,-67.0,-72.0,-65.0,-70.0,-84.0,-90.0,-84.0,-90.0,17.0,18.0,19.0,19.0,1
1805,CC:2F:71:3E:C5:1F,3223262,407081024,11368,1390689,3211894,405690335,6,48550,4065467,40127,3067485,8423,997982,11985,34,16332,186,6,825,130000.0,39000.0,-69.0,-71.0,-68.0,-60.0,-69.0,-71.0,-68.0,-60.0,-84.0,-90.0,-84.0,-90.0,15.0,19.0,16.0,30.0,1
1806,CC:2F:71:3F:1F:24,7940853,7610708945,4728959,7205018610,3211894,405690335,80,1099350,676539427,1090835,675516817,8515,1022610,1046418,619,4733678,482086,80,5616,115556.0,28889.0,-69.0,-64.0,-72.0,-68.0,-69.0,-64.0,-72.0,-68.0,-84.0,-90.0,-84.0,-90.0,15.0,26.0,12.0,22.0,1
1807,F8:59:71:5A:E0:3D,3305367,539313883,93471,133623346,3211896,405690537,0,91304,92299665,86520,91728061,4784,571604,69213,16,96183,2237,0,509,144444.0,43333.0,-67.0,-72.0,-65.0,-70.0,-67.0,-71.0,-65.0,-70.0,-84.0,-90.0,-84.0,-90.0,17.0,18.0,19.0,20.0,1
1808,CC:2F:71:3E:C5:1F,3223264,407081226,11368,1390689,3211896,405690537,6,48550,4065467,40127,3067485,8423,997982,11985,34,16332,186,6,825,130000.0,39000.0,-69.0,-71.0,-68.0,-60.0,-69.0,-71.0,-68.0,-60.0,-84.0,-90.0,-84.0,-90.0,15.0,19.0,16.0,30.0,1
1809,CC:2F:71:3F:1F:24,7942425,7613143527,4730529,7207452990,3211896,405690537,80,1099709,676763169,1091194,675740559,8515,1022610,1046777,619,4735247,482190,80,5616,115556.0,28889.0,-68.0,-64.0,-71.0,-68.0,-69.0,-64.0,-72.0,-68.0,-84.0,-90.0,-84.0,-90.0,16.0,26.0,13.0,22.0,1
1810,F8:59:71:5A:E0:3D,3305436,539412391,93534,133721248,3211902,405691143,0,91367,92396685,86583,91825081,4784,571604,69276,16,96246,2237,0,509,144444.0,43333.0,-67.0,-72.0,-65.0,-71.0,-66.0,-72.0,-65.0,-70.0,-84.0,-90.0,-84.0,-90.0,17.0,18.0,19.0,19.0,1
1811,CC:2F:71:3E:C5:1F,3223270,407081832,11368,1390689,3211902,405691143,6,48550,4065467,40127,3067485,8423,997982,11985,34,16332,186,6,825,130000.0,39000.0,-69.0,-71.0,-68.0,-60.0,-69.0,-71.0,-68.0,-60.0,-84.0,-90.0,-84.0,-90.0,15.0,19.0,16.0,30.0,1
1812,CC:2F:71:3F:1F:24,7943815,7615285861,4731913,7209594718,3211902,405691143,80,1100051,676992057,1091536,675969447,8515,1022610,1047119,619,4736631,482368,80,5616,115556.0,28889.0,-70.0,-64.0,-73.0,-68.0,-69.0,-64.0,-72.0,-68.0,-84.0,-90.0,-84.0,-90.0,14.0,26.0,11.0,22.0,1
1813,F8:59:71:5A:E0:3D,3305506,539516771,93601,133825366,3211905,405691405,0,91433,92498353,86649,91926749,4784,571604,69342,16,96313,2237,0,509,144444.0,43333.0,-67.0,-72.0,-65.0,-70.0,-66.0,-70.0,-65.0,-69.0,-84.0,-90.0,-84.0,-90.0,17.0,18.0,19.0,20.0,1
1814,CC:2F:71:3E:C5:1F,3223273,407082094,11368,1390689,3211905,405691405,6,48550,4065467,40127,3067485,8423,997982,11985,34,16332,186,6,825,130000.0,39000.0,-69.0,-71.0,-68.0,-60.0,-69.0,-71.0,-68.0,-60.0,-84.0,-90.0,-84.0,-90.0,15.0,19.0,16.0,30.0,1
1815,CC:2F:71:3F:1F:24,7945112,7617279514,4733207,7211588109,3211905,405691405,80,1100394,677214330,1091879,676191720,8515,1022610,1047462,619,4737926,482431,80,5616,115556.0,28889.0,-69.0,-64.0,-73.0,-68.0,-69.0,-64.0,-72.0,-68.0,-84.0,-90.0,-84.0,-90.0,15.0,26.0,11.0,22.0,1
1816,F8:59:71:5A:E0:3D,3305576,539616833,93665,133924822,3211911,405692011,0,91497,92596913,86713,92025309,4784,571604,69406,16,96377,2237,0,509,144444.0,43333.0,-66.0,-72.0,-65.0,-70.0,-66.0,-72.0,-64.0,-70.0,-84.0,-90.0,-84.0,-90.0,18.0,18.0,19.0,20.0,1
1817,CC:2F:71:3E:C5:1F,3223279,407082700,11368,1390689,3211911,405692011,6,48550,4065467,40127,3067485,8423,997982,11985,34,16332,186,6,825,130000.0,39000.0,-69.0,-71.0,-68.0,-60.0,-69.0,-71.0,-68.0,-60.0,-84.0,-90.0,-84.0,-90.0,15.0,19.0,16.0,30.0,1
1818,CC:2F:71:3F:1F:24,7946316,7619122398,4734405,7213430387,3211911,405692011,80,1100713,677446368,1092198,676423758,8515,1022610,1047781,619,4739124,482484,80,5616,115556.0,28889.0,-70.0,-65.0,-74.0,-69.0,-69.0,-64.0,-73.0,-68.0,-84.0,-90.0,-84.0,-90.0,14.0,25.0,10.0,21.0,1
1819,F8:59:71:5A:E0:3D,3305646,539722707,93733,134030494,3211913,405692213,0,91565,92701633,86781,92130029,4784,571604,69474,16,96445,2237,0,509,144444.0,43333.0,-66.0,-72.0,-65.0,-70.0,-66.0,-72.0,-64.0,-70.0,-85.0,-91.0,-85.0,-90.0,19.0,19.0,20.0,20.0,1
1820,CC:2F:71:3E:C5:1F,3223281,407082902,11368,1390689,3211913,405692213,6,48550,4065467,40127,3067485,8423,997982,11985,34,16332,186,6,825,130000.0,39000.0,-69.0,-71.0,-68.0,-60.0,-69.0,-71.0,-68.0,-60.0,-85.0,-91.0,-85.0,-90.0,16.0,20.0,17.0,30.0,1
1821,CC:2F:71:3F:1F:24,7947933,7621627446,4736020,7215935233,3211913,405692213,80,1101067,677675468,1092552,676652858,8515,1022610,1048135,619,4740706,482628,80,5617,115556.0,28889.0,-70.0,-65.0,-74.0,-69.0,-71.0,-65.0,-74.0,-69.0,-85.0,-91.0,-85.0,-90.0,15.0,26.0,11.0,21.0,1
1822,F8:59:71:5A:E0:3D,3305718,539824383,93798,134131504,3211920,405692879,0,91630,92801733,86846,92230129,4784,571604,69539,16,96510,2239,0,509,144444.0,43333.0,-67.0,-72.0,-65.0,-70.0,-67.0,-71.0,-65.0,-70.0,-85.0,-91.0,-85.0,-90.0,18.0,19.0,20.0,20.0,1
1823,CC:2F:71:3E:C5:1F,3223288,407083568,11368,1390689,3211920,405692879,6,48550,4065467,40127,3067485,8423,997982,11985,34,16332,186,6,825,130000.0,39000.0,-69.0,-71.0,-68.0,-60.0,-69.0,-71.0,-68.0,-60.0,-85.0,-91.0,-85.0,-90.0,16.0,20.0,17.0,30.0,1
1824,CC:2F:71:3F:1F:24,7949011,7623278014,4737091,7217585135,3211920,405692879,80,1101360,677887718,1092845,676865108,8515,1022610,1048428,619,4741810,482672,80,5619,115556.0,28889.0,-70.0,-64.0,-73.0,-68.0,-69.0,-64.0,-73.0,-68.0,-85.0,-91.0,-85.0,-90.0,15.0,27.0,12.0,22.0,1
1825,F8:59:71:5A:E0:3D,3305782,539920933,93860,134227852,3211922,405693081,0,91692,92897213,86908,92325609,4784,571604,69601,16,96572,2240,0,509,144444.0,43333.0,-66.0,-71.0,-65.0,-70.0,-66.0,-71.0,-65.0,-70.0,-85.0,-91.0,-85.0,-90.0,19.0,20.0,20.0,20.0,1
1826,CC:2F:71:3E:C5:1F,3223290,407083770,11368,1390689,3211922,405693081,6,48550,4065467,40127,3067485,8423,997982,11985,34,16332,186,6,825,130000.0,39000.0,-69.0,-71.0,-68.0,-60.0,-69.0,-71.0,-68.0,-60.0,-85.0,-91.0,-85.0,-90.0,16.0,20.0,17.0,30.0,1
1827,CC:2F:71:3F:1F:24,7950148,7625024837,4738225,7219331483,3211923,405693354,80,1101658,678108726,1093143,677086116,8515,1022610,1048724,619,4742941,482725,80,5619,115556.0,28889.0,-70.0,-64.0,-73.0,-68.0,-69.0,-64.0,-73.0,-68.0,-85.0,-91.0,-85.0,-90.0,15.0,27.0,12.0,22.0,1
1828,F8:59:71:5A:E0:3D,3305851,540021066,93924,134327308,3211927,405693758,0,91756,92995773,86972,92424169,4784,571604,69665,16,96636,2241,0,509,144444.0,43333.0,-67.0,-72.0,-65.0,-70.0,-66.0,-71.0,-65.0,-70.0,-84.0,-90.0,-84.0,-89.0,17.0,18.0,19.0,19.0,1
1829,CC:2F:71:3E:C5:1F,3223297,407084649,11368,1390689,3211929,405693960,6,48550,4065467,40127,3067485,8423,997982,11985,34,16332,186,6,825,130000.0,39000.0,-69.0,-71.0,-68.0,-60.0,-69.0,-71.0,-68.0,-60.0,-84.0,-90.0,-84.0,-89.0,15.0,19.0,16.0,29.0,1
1830,CC:2F:71:3F:1F:24,7951352,7626861976,4739423,7221168016,3211929,405693960,80,1101986,678327947,1093471,677305337,8515,1022610,1049052,619,4744142,482833,80,5619,115556.0,28889.0,-70.0,-64.0,-73.0,-69.0,-69.0,-64.0,-72.0,-68.0,-84.0,-90.0,-84.0,-89.0,14.0,26.0,11.0,20.0,1
1831,F8:59:71:5A:E0:3D,3305919,540119320,93987,134425098,3211932,405694222,0,91819,93092793,87035,92521189,4784,571604,69728,16,96699,2241,0,509,144444.0,39000.0,-67.0,-71.0,-65.0,-70.0,-67.0,-71.0,-65.0,-70.0,-84.0,-90.0,-84.0,-89.0,17.0,19.0,19.0,19.0,1
1832,CC:2F:71:3E:C5:1F,3223300,407084911,11368,1390689,3211932,405694222,6,48550,4065467,40127,3067485,8423,997982,11985,34,16332,186,6,825,130000.0,39000.0,-69.0,-71.0,-68.0,-60.0,-69.0,-71.0,-68.0,-60.0,-84.0,-90.0,-84.0,-89.0,15.0,19.0,16.0,29.0,1
1833,CC:2F:71:3F:1F:24,7952601,7628786818,4740669,7223092596,3211932,405694222,80,1102271,678543129,1093756,677520519,8515,1022610,1049337,619,4745388,482851,80,5619,115556.0,28889.0,-70.0,-64.0,-72.0,-69.0,-70.0,-64.0,-72.0,-68.0,-84.0,-90.0,-84.0,-89.0,14.0,26.0,12.0,20.0,1
1834,F8:59:71:5A:E0:3D,3305987,540219124,94051,134524498,3211936,405694626,0,91883,93191353,87099,92619749,4784,571604,69792,16,96763,2241,0,509,144444.0,43333.0,-67.0,-71.0,-65.0,-71.0,-66.0,-71.0,-65.0,-70.0,-84.0,-90.0,-84.0,-89.0,17.0,19.0,19.0,18.0,1
1835,CC:2F:71:3E:C5:1F,3223304,407085315,11368,1390689,3211936,405694626,6,48550,4065467,40127,3067485,8423,997982,11985,34,16332,186,6,825,130000.0,39000.0,-69.0,-71.0,-68.0,-60.0,-69.0,-71.0,-68.0,-60.0,-84.0,-90.0,-84.0,-89.0,15.0,19.0,16.0,29.0,1
1836,CC:2F:71:3F:1F:24,7954082,7631074576,4742146,7225379950,3211936,405694626,80,1102622,678770427,1094107,677747817,8515,1022610,1049686,619,4746865,482957,80,5620,104000.0,26000.0,-70.0,-64.0,-74.0,-68.0,-69.0,-64.0,-73.0,-68.0,-84.0,-90.0,-84.0,-89.0,14.0,26.0,10.0,21.0,1
1837,F8:59:71:5A:E0:3D,3306058,540322763,94118,134627733,3211940,405695030,0,91950,93293143,87166,92721539,4784,571604,69859,16,96829,2242,0,509,144444.0,43333.0,-67.0,-72.0,-65.0,-71.0,-66.0,-71.0,-65.0,-70.0,-84.0,-90.0,-84.0,-89.0,17.0,18.0,19.0,18.0,1
1838,CC:2F:71:3E:C5:1F,3223308,407085719,11368,1390689,3211940,405695030,6,48550,4065467,40127,3067485,8423,997982,11985,34,16332,186,6,825,130000.0,39000.0,-69.0,-71.0,-68.0,-60.0,-69.0,-71.0,-68.0,-60.0,-84.0,-90.0,-84.0,-89.0,15.0,19.0,16.0,29.0,1
1839,CC:2F:71:3F:1F:24,7955610,7633436588,4743670,7227741558,3211940,405695030,80,1102960,678996105,1094445,677973495,8515,1022610,1050024,619,4748389,483058,80,5620,115556.0,28889.0,-69.0,-64.0,-72.0,-68.0,-69.0,-64.0,-73.0,-68.0,-84.0,-90.0,-84.0,-89.0,15.0,26.0,12.0,21.0,1
1840,F8:59:71:5A:E0:3D,3306131,540428899,94186,134733405,3211945,405695494,0,92018,93397891,87234,92826287,4784,571604,69927,16,96898,2243,0,509,144444.0,43333.0,-67.0,-72.0,-65.0,-70.0,-67.0,-71.0,-65.0,-70.0,-84.0,-90.0,-84.0,-89.0,17.0,18.0,19.0,19.0,1
1841,CC:2F:71:3E:C5:1F,3223313,407086183,11368,1390689,3211945,405695494,6,48550,4065467,40127,3067485,8423,997982,11985,34,16332,186,6,825,130000.0,39000.0,-69.0,-71.0,-68.0,-60.0,-69.0,-71.0,-68.0,-60.0,-84.0,-90.0,-84.0,-89.0,15.0,19.0,16.0,29.0,1
1842,CC:2F:71:3F:1F:24,7956796,7635249953,4744851,7229554459,3211945,405695494,80,1103305,679228860,1094790,678206250,8515,1022610,1050369,619,4749570,483098,80,5620,115556.0,28889.0,-69.0,-64.0,-72.0,-68.0,-69.0,-64.0,-72.0,-68.0,-84.0,-90.0,-84.0,-89.0,15.0,26.0,12.0,21.0,1
1843,F8:59:71:5A:E0:3D,3306198,540525933,94249,134829869,3211949,405696064,0,92079,93491831,87295,92920227,4784,571604,69988,16,96961,2243,0,509,144444.0,43333.0,-67.0,-71.0,-65.0,-69.0,-67.0,-71.0,-65.0,-70.0,-84.0,-90.0,-84.0,-89.0,17.0,19.0,19.0,20.0,1
1844,CC:2F:71:3E:C5:1F,3223318,407086869,11369,1390805,3211949,405696064,6,48551,4065537,40128,3067555,8423,997982,11985,34,16333,186,6,825,130000.0,39000.0,-69.0,-71.0,-68.0,-60.0,-69.0,-71.0,-68.0,-60.0,-84.0,-90.0,-84.0,-89.0,15.0,19.0,16.0,29.0,1
1845,CC:2F:71:3F:1F:24,7957906,7636948143,4745955,7231251877,3211951,405696266,80,1103615,679443940,1095100,678421330,8515,1022610,1050679,619,4750674,483204,80,5620,115556.0,28889.0,-69.0,-64.0,-73.0,-68.0,-69.0,-64.0,-72.0,-68.0,-84.0,-90.0,-84.0,-89.0,15.0,26.0,11.0,21.0,1
1846,F8:59:71:5A:E0:3D,3306268,540627407,94314,134930879,3211954,405696528,0,92145,93593471,87361,93021867,4784,571604,70054,16,97026,2246,0,509,144444.0,43333.0,-68.0,-72.0,-66.0,-71.0,-67.0,-71.0,-65.0,-70.0,-84.0,-90.0,-84.0,-89.0,16.0,18.0,18.0,18.0,1
1847,CC:2F:71:3E:C5:1F,3223325,407087535,11369,1390805,3211956,405696730,6,48552,4065607,40129,3067625,8423,997982,11985,34,16333,186,6,825,130000.0,39000.0,-69.0,-70.0,-67.0,-60.0,-69.0,-70.0,-68.0,-60.0,-84.0,-90.0,-84.0,-89.0,15.0,20.0,17.0,29.0,1
1848,CC:2F:71:3F:1F:24,7959510,7639425413,4747554,7233728683,3211956,405696730,80,1103975,679672100,1095460,678649490,8515,1022610,1051039,619,4752273,483394,80,5620,115556.0,28889.0,-69.0,-64.0,-72.0,-68.0,-69.0,-64.0,-72.0,-68.0,-84.0,-90.0,-84.0,-89.0,15.0,26.0,12.0,21.0,1
1849,F8:59:71:5A:E0:3D,3306334,540724159,94376,135027227,3211958,405696932,0,92208,93690547,87424,93118943,4784,571604,70116,16,97088,2247,0,509,144444.0,43333.0,-67.0,-72.0,-66.0,-71.0,-67.0,-72.0,-65.0,-71.0,-84.0,-90.0,-84.0,-89.0,17.0,18.0,18.0,18.0,1
1850,CC:2F:71:3E:C5:1F,3223327,407087737,11369,1390805,3211958,405696932,6,48552,4065607,40129,3067625,8423,997982,11985,34,16333,186,6,825,130000.0,39000.0,-69.0,-70.0,-67.0,-60.0,-69.0,-70.0,-68.0,-60.0,-84.0,-90.0,-84.0,-89.0,15.0,20.0,17.0,29.0,1
1851,CC:2F:71:3F:1F:24,7960858,7641505220,4748899,7235808037,3211959,405697183,80,1104282,679890060,1095767,678867450,8515,1022610,1051344,619,4753618,483413,80,5620,115556.0,28889.0,-69.0,-64.0,-73.0,-68.0,-69.0,-64.0,-72.0,-68.0,-84.0,-90.0,-84.0,-89.0,15.0,26.0,11.0,21.0,1
1852,F8:59:71:5A:E0:3D,3306400,540822514,94439,135125129,3211961,405697385,0,92271,93787567,87487,93215963,4784,571604,70179,16,97151,2247,0,509,144444.0,43333.0,-67.0,-72.0,-65.0,-70.0,-67.0,-72.0,-65.0,-70.0,-84.0,-90.0,-84.0,-89.0,17.0,18.0,19.0,19.0,1
1853,CC:2F:71:3E:C5:1F,3223332,407088392,11369,1390805,3211963,405697587,6,48552,4065607,40129,3067625,8423,997982,11985,34,16333,186,6,825,130000.0,39000.0,-69.0,-70.0,-67.0,-60.0,-69.0,-70.0,-68.0,-60.0,-84.0,-90.0,-84.0,-89.0,15.0,20.0,17.0,29.0,1
1854,CC:2F:71:3F:1F:24,7962086,7643387467,4750123,7237689880,3211963,405697587,80,1104615,680109856,1096100,679087246,8515,1022610,1051677,619,4754841,483564,80,5620,115556.0,28889.0,-69.0,-64.0,-72.0,-69.0,-69.0,-63.0,-72.0,-69.0,-84.0,-90.0,-84.0,-89.0,15.0,26.0,12.0,20.0,1
1855,F8:59:71:5A:E0:3D,3306470,540921082,94502,135223031,3211968,405698051,0,92334,93884587,87550,93312983,4784,571604,70242,16,97214,2247,0,509,144444.0,43333.0,-67.0,-72.0,-66.0,-71.0,-66.0,-72.0,-65.0,-70.0,-84.0,-90.0,-84.0,-89.0,17.0,18.0,18.0,18.0,1
1856,CC:2F:71:3E:C5:1F,3223337,407088856,11369,1390805,3211968,405698051,6,48552,4065607,40129,3067625,8423,997982,11985,34,16333,186,6,825,130000.0,39000.0,-69.0,-70.0,-67.0,-60.0,-69.0,-70.0,-68.0,-60.0,-84.0,-90.0,-84.0,-89.0,15.0,20.0,17.0,29.0,1
1857,CC:2F:71:3F:1F:24,7963227,7645137483,4751259,7239439432,3211968,405698051,80,1104905,680325726,1096390,679303116,8515,1022610,1051966,619,4755978,483581,80,5620,115556.0,28889.0,-70.0,-64.0,-72.0,-69.0,-69.0,-64.0,-73.0,-69.0,-84.0,-90.0,-84.0,-89.0,14.0,26.0,12.0,20.0,1
1858,F8:59:71:5A:E0:3D,3306536,541020740,94566,135322487,3211970,405698253,0,92398,93983147,87614,93411543,4784,571604,70306,16,97278,2248,0,509,144444.0,43333.0,-67.0,-73.0,-65.0,-71.0,-66.0,-72.0,-65.0,-70.0,-84.0,-90.0,-84.0,-89.0,17.0,17.0,19.0,18.0,1
1859,CC:2F:71:3E:C5:1F,3223339,407089058,11369,1390805,3211970,405698253,6,48552,4065607,40129,3067625,8423,997982,11985,34,16333,186,6,825,130000.0,39000.0,-69.0,-70.0,-67.0,-60.0,-69.0,-70.0,-68.0,-60.0,-84.0,-90.0,-84.0,-89.0,15.0,20.0,17.0,29.0,1
1860,CC:2F:71:3F:1F:24,7964586,7647237423,4752616,7241539170,3211970,405698253,80,1105212,680541960,1096697,679519350,8515,1022610,1052273,619,4757335,483608,80,5620,115556.0,28889.0,-69.0,-64.0,-71.0,-70.0,-68.0,-64.0,-71.0,-69.0,-84.0,-90.0,-84.0,-89.0,15.0,26.0,13.0,19.0,1
1861,F8:59:71:5A:E0:3D,3306604,541117694,94628,135418835,3211976,405698859,0,92461,94080167,87677,93508563,4784,571604,70369,16,97340,2248,0,509,144444.0,43333.0,-67.0,-72.0,-66.0,-71.0,-67.0,-72.0,-65.0,-70.0,-84.0,-90.0,-84.0,-89.0,17.0,18.0,18.0,18.0,1
1862,CC:2F:71:3E:C5:1F,3223345,407089664,11369,1390805,3211976,405698859,6,48552,4065607,40129,3067625,8423,997982,11985,34,16333,186,6,825,130000.0,39000.0,-69.0,-70.0,-67.0,-60.0,-69.0,-70.0,-68.0,-60.0,-84.0,-90.0,-84.0,-89.0,15.0,20.0,17.0,29.0,1
1863,CC:2F:71:3F:1F:24,7965887,7649238259,4753911,7243539400,3211976,405698859,80,1105514,680757782,1096999,679735172,8515,1022610,1052575,619,4758630,483684,80,5620,115556.0,28889.0,-69.0,-64.0,-72.0,-69.0,-69.0,-64.0,-72.0,-69.0,-84.0,-90.0,-84.0,-89.0,15.0,26.0,12.0,20.0,1
1864,F8:59:71:5A:E0:3D,3306698,541233100,94696,135523069,3212002,405710031,0,92529,94183481,87745,93611877,4784,571604,70436,16,97408,2250,0,509,144444.0,43333.0,-67.0,-72.0,-66.0,-70.0,-67.0,-72.0,-65.0,-70.0,-84.0,-90.0,-84.0,-89.0,17.0,18.0,18.0,19.0,1
1865,CC:2F:71:3E:C5:1F,3223371,407100836,11369,1390805,3212002,405710031,6,48554,4065795,40130,3067695,8424,998100,11986,34,16333,186,6,825,130000.0,39000.0,-70.0,-71.0,-69.0,-60.0,-68.0,-69.0,-68.0,-60.0,-84.0,-90.0,-84.0,-89.0,14.0,19.0,15.0,29.0,1
1866,CC:2F:71:3F:1F:24,7967223,7651273133,4755221,7245563102,3212002,405710031,80,1105814,680986198,1097299,679963588,8515,1022610,1052875,619,4759940,483780,80,5622,115556.0,26000.0,-69.0,-64.0,-72.0,-68.0,-69.0,-64.0,-72.0,-68.0,-84.0,-90.0,-84.0,-89.0,15.0,26.0,12.0,21.0,1
1867,F8:59:71:5A:E0:3D,3306766,541332960,94760,135622525,3212006,405710435,0,92594,94283665,87810,93712061,4784,571604,70500,16,97472,2251,0,509,144444.0,43333.0,-67.0,-73.0,-67.0,-71.0,-67.0,-72.0,-66.0,-71.0,-84.0,-90.0,-84.0,-89.0,17.0,17.0,17.0,18.0,1
1868,CC:2F:71:3E:C5:1F,3223376,407101302,11369,1390805,3212007,405710497,6,48554,4065795,40130,3067695,8424,998100,11986,34,16333,186,6,825,130000.0,39000.0,-70.0,-71.0,-69.0,-60.0,-68.0,-69.0,-68.0,-60.0,-84.0,-90.0,-84.0,-89.0,14.0,19.0,15.0,29.0,1
1869,CC:2F:71:3F:1F:24,7968740,7653603529,4756731,7247892830,3212009,405710699,80,1106146,681208850,1097631,680186240,8515,1022610,1053207,619,4761429,483822,80,5622,115556.0,28889.0,-69.0,-64.0,-72.0,-69.0,-69.0,-64.0,-72.0,-68.0,-84.0,-90.0,-84.0,-89.0,15.0,26.0,12.0,20.0,1
1870,F8:59:71:5A:E0:3D,3306838,541434771,94825,135723535,3212013,405711236,0,92662,94386991,87877,93815269,4785,571722,70566,16,97537,2251,0,509,144444.0,43333.0,-67.0,-73.0,-66.0,-71.0,-67.0,-72.0,-66.0,-70.0,-84.0,-90.0,-84.0,-89.0,17.0,17.0,18.0,18.0,1
1871,CC:2F:71:3E:C5:1F,3223382,407102041,11369,1390805,3212013,405711236,6,48554,4065795,40130,3067695,8424,998100,11986,34,16333,186,6,825,130000.0,39000.0,-70.0,-71.0,-69.0,-60.0,-68.0,-69.0,-68.0,-60.0,-84.0,-90.0,-84.0,-89.0,14.0,19.0,15.0,29.0,1
1872,CC:2F:71:3F:1F:24,7970593,7656478188,4758580,7250766952,3212013,405711236,80,1106516,681439476,1098000,680416748,8516,1022728,1053577,619,4763297,484138,80,5623,115556.0,28889.0,-69.0,-64.0,-72.0,-68.0,-69.0,-64.0,-72.0,-68.0,-84.0,-90.0,-84.0,-89.0,15.0,26.0,12.0,21.0,1
1873,F8:59:71:5A:E0:3D,3306908,541536245,94890,135824545,3212018,405711700,0,92727,94487091,87942,93915369,4785,571722,70631,16,97602,2251,0,509,144444.0,43333.0,-67.0,-72.0,-66.0,-71.0,-67.0,-72.0,-66.0,-71.0,-83.0,-90.0,-83.0,-89.0,16.0,18.0,17.0,18.0,1
1874,CC:2F:71:3E:C5:1F,3223387,407102505,11369,1390805,3212018,405711700,6,48554,4065795,40130,3067695,8424,998100,11986,34,16333,186,6,825,130000.0,39000.0,-70.0,-71.0,-69.0,-60.0,-68.0,-69.0,-68.0,-60.0,-83.0,-90.0,-83.0,-89.0,13.0,19.0,14.0,29.0,1
1875,CC:2F:71:3F:1F:24,7971987,7658627318,4759969,7252915618,3212018,405711700,80,1106841,681662210,1098325,680639482,8516,1022728,1053902,619,4764688,484220,80,5623,115556.0,28889.0,-69.0,-64.0,-73.0,-69.0,-69.0,-64.0,-72.0,-69.0,-83.0,-90.0,-83.0,-89.0,14.0,26.0,10.0,20.0,1
1876,F8:59:71:5A:E0:3D,3306978,541639213,94956,135927109,3212022,405712104,0,92796,94593393,88011,94021671,4785,571722,70697,16,97668,2254,0,509,144444.0,43333.0,-67.0,-72.0,-65.0,-70.0,-66.0,-72.0,-65.0,-70.0,-83.0,-90.0,-83.0,-89.0,16.0,18.0,18.0,19.0,1
1877,CC:2F:71:3E:C5:1F,3223391,407102909,11369,1390805,3212022,405712104,6,48554,4065795,40130,3067695,8424,998100,11986,34,16333,186,6,825,130000.0,39000.0,-70.0,-71.0,-69.0,-60.0,-68.0,-69.0,-68.0,-60.0,-83.0,-90.0,-83.0,-89.0,13.0,19.0,14.0,29.0,1
1878,CC:2F:71:3F:1F:24,7973386,7660785856,4761364,7255073752,3212022,405712104,80,1107214,681896068,1098698,680873340,8516,1022728,1054275,619,4766083,484428,80,5623,115556.0,28889.0,-69.0,-65.0,-71.0,-70.0,-69.0,-65.0,-72.0,-69.0,-83.0,-90.0,-83.0,-89.0,14.0,25.0,12.0,19.0,1
1879,F8:59:71:5A:E0:3D,3307046,541739073,95020,136026565,3212026,405712508,0,92861,94693507,88076,94121785,4785,571722,70761,16,97732,2254,0,509,144444.0,43333.0,-67.0,-72.0,-65.0,-70.0,-66.0,-71.0,-65.0,-69.0,-83.0,-90.0,-83.0,-89.0,16.0,18.0,18.0,19.0,1
1880,CC:2F:71:3E:C5:1F,3223395,407103313,11369,1390805,3212026,405712508,6,48554,4065795,40130,3067695,8424,998100,11986,34,16333,186,6,825,130000.0,39000.0,-70.0,-71.0,-69.0,-60.0,-68.0,-69.0,-68.0,-60.0,-83.0,-90.0,-83.0,-89.0,13.0,19.0,14.0,29.0,1
1881,CC:2F:71:3F:1F:24,7974629,7662688875,4762603,7256976367,3212026,405712508,80,1107552,682116609,1099036,681093881,8516,1022728,1054613,619,4767322,484687,80,5624,115556.0,28889.0,-69.0,-64.0,-72.0,-69.0,-69.0,-64.0,-72.0,-69.0,-83.0,-90.0,-83.0,-89.0,14.0,26.0,11.0,20.0,1
1882,F8:59:71:5A:E0:3D,3307115,541838993,95084,136126021,3212031,405712972,0,92926,94793621,88141,94221899,4785,571722,70825,16,97796,2256,0,509,144444.0,43333.0,-67.0,-72.0,-65.0,-70.0,-66.0,-72.0,-65.0,-70.0,-83.0,-89.0,-83.0,-88.0,16.0,17.0,18.0,18.0,1
1883,CC:2F:71:3E:C5:1F,3223400,407103777,11369,1390805,3212031,405712972,6,48554,4065795,40130,3067695,8424,998100,11986,34,16333,186,6,825,130000.0,39000.0,-70.0,-71.0,-69.0,-60.0,-68.0,-69.0,-68.0,-60.0,-83.0,-89.0,-83.0,-88.0,13.0,18.0,14.0,28.0,1
1884,CC:2F:71:3F:1F:24,7975668,7664277935,4763637,7258564963,3212031,405712972,80,1107865,682336763,1099349,681314035,8516,1022728,1054923,619,4768340,484724,80,5624,115556.0,28889.0,-69.0,-64.0,-73.0,-69.0,-68.0,-64.0,-72.0,-69.0,-83.0,-89.0,-83.0,-88.0,14.0,25.0,10.0,19.0,1
1885,F8:59:71:5A:E0:3D,3307182,541937299,95147,136223923,3212035,405713376,0,92989,94890641,88204,94318919,4785,571722,70888,16,97859,2257,0,509,144444.0,43333.0,-66.0,-72.0,-65.0,-70.0,-66.0,-72.0,-65.0,-70.0,-83.0,-89.0,-83.0,-88.0,17.0,17.0,18.0,18.0,1
1886,CC:2F:71:3E:C5:1F,3223404,407104181,11369,1390805,3212035,405713376,6,48554,4065795,40130,3067695,8424,998100,11986,34,16333,186,6,825,130000.0,39000.0,-70.0,-71.0,-69.0,-60.0,-68.0,-69.0,-68.0,-60.0,-83.0,-89.0,-83.0,-88.0,13.0,18.0,14.0,28.0,1
1887,CC:2F:71:3F:1F:24,7976917,7666199733,4764882,7260486357,3212035,405713376,80,1108195,682555647,1099679,681532919,8516,1022728,1055253,619,4769601,484794,80,5624,104000.0,26000.0,-69.0,-64.0,-73.0,-69.0,-69.0,-64.0,-72.0,-69.0,-83.0,-89.0,-83.0,-88.0,14.0,25.0,10.0,19.0,1
1888,F8:59:71:5A:E0:3D,3307247,542035403,95210,136321825,3212037,405713578,0,93052,94987661,88267,94415939,4785,571722,70951,16,97922,2258,0,509,144444.0,43333.0,-66.0,-72.0,-65.0,-70.0,-66.0,-72.0,-65.0,-70.0,-83.0,-89.0,-83.0,-88.0,17.0,17.0,18.0,18.0,1
1889,CC:2F:71:3E:C5:1F,3223406,407104383,11369,1390805,3212037,405713578,6,48554,4065795,40130,3067695,8424,998100,11986,34,16333,186,6,825,130000.0,39000.0,-70.0,-71.0,-69.0,-60.0,-68.0,-69.0,-68.0,-60.0,-83.0,-89.0,-83.0,-88.0,13.0,18.0,14.0,28.0,1
1890,CC:2F:71:3F:1F:24,7977935,7667758333,4765896,7262044553,3212039,405713780,80,1108472,682765625,1099956,681742897,8516,1022728,1055530,619,4770615,484865,80,5624,115556.0,28889.0,-69.0,-64.0,-73.0,-69.0,-69.0,-64.0,-72.0,-69.0,-83.0,-89.0,-83.0,-88.0,14.0,25.0,10.0,19.0,1
1891,F8:59:71:5A:E0:3D,3307315,542133769,95273,136419727,3212042,405714042,0,93115,95084681,88330,94512959,4785,571722,71014,16,97985,2258,0,509,144444.0,43333.0,-66.0,-72.0,-65.0,-70.0,-66.0,-72.0,-65.0,-70.0,-83.0,-89.0,-83.0,-88.0,17.0,17.0,18.0,18.0,1
1892,CC:2F:71:3E:C5:1F,3223411,407104847,11369,1390805,3212042,405714042,6,48554,4065795,40130,3067695,8424,998100,11986,34,16333,186,6,825,130000.0,39000.0,-70.0,-71.0,-69.0,-60.0,-68.0,-69.0,-68.0,-60.0,-83.0,-89.0,-83.0,-88.0,13.0,18.0,14.0,28.0,1
1893,CC:2F:71:3F:1F:24,7978851,7669148624,4766809,7263434582,3212042,405714042,80,1108778,682983934,1100262,681961206,8516,1022728,1055836,619,4771528,484923,80,5624,115556.0,28889.0,-69.0,-64.0,-73.0,-69.0,-69.0,-64.0,-72.0,-69.0,-83.0,-89.0,-83.0,-88.0,14.0,25.0,10.0,19.0,1
1894,F8:59:71:5A:E0:3D,3307381,542230521,95335,136516075,3212046,405714446,0,93180,95184809,88395,94613087,4785,571722,71077,16,98047,2258,0,509,144444.0,43333.0,-67.0,-72.0,-65.0,-71.0,-67.0,-72.0,-64.0,-70.0,-83.0,-89.0,-83.0,-88.0,16.0,17.0,18.0,17.0,1
1895,CC:2F:71:3E:C5:1F,3223415,407105251,11369,1390805,3212046,405714446,6,48554,4065795,40130,3067695,8424,998100,11986,34,16333,186,6,825,130000.0,39000.0,-70.0,-71.0,-69.0,-60.0,-68.0,-69.0,-68.0,-60.0,-83.0,-89.0,-83.0,-88.0,13.0,18.0,14.0,28.0,1
1896,CC:2F:71:3F:1F:24,7979805,7670604800,4767759,7264890354,3212046,405714446,80,1109082,683201118,1100566,682178390,8516,1022728,1056140,619,4772448,485010,80,5624,115556.0,28889.0,-69.0,-64.0,-73.0,-69.0,-69.0,-64.0,-72.0,-69.0,-83.0,-89.0,-83.0,-88.0,14.0,25.0,10.0,19.0,1
1897,F8:59:71:5A:E0:3D,3307449,542330381,95399,136615531,3212050,405714850,0,93244,95283383,88459,94711661,4785,571722,71140,16,98111,2258,0,509,144444.0,43333.0,-66.0,-72.0,-65.0,-70.0,-66.0,-72.0,-64.0,-70.0,-83.0,-89.0,-83.0,-88.0,17.0,17.0,18.0,18.0,1
1898,CC:2F:71:3E:C5:1F,3223420,407105715,11369,1390805,3212051,405714910,6,48554,4065795,40130,3067695,8424,998100,11986,34,16333,186,6,825,130000.0,39000.0,-70.0,-71.0,-69.0,-60.0,-68.0,-69.0,-68.0,-60.0,-83.0,-89.0,-83.0,-88.0,13.0,18.0,14.0,28.0,1
1899,CC:2F:71:3F:1F:24,7980936,7672340484,4768885,7266625574,3212051,405714910,80,1109407,683422544,1100891,682399816,8516,1022728,1056465,619,4773600,485210,80,5625,115556.0,28889.0,-69.0,-65.0,-73.0,-69.0,-69.0,-64.0,-72.0,-69.0,-83.0,-89.0,-83.0,-88.0,14.0,24.0,10.0,19.0,1
1900,F8:59:71:5A:E0:3D,3307518,542430133,95463,136714819,3212055,405715314,0,93309,95383483,88524,94811761,4785,571722,71205,16,98175,2258,0,509,144444.0,43333.0,-67.0,-72.0,-65.0,-70.0,-67.0,-72.0,-64.0,-70.0,-83.0,-89.0,-83.0,-88.0,16.0,17.0,18.0,18.0,1
1901,CC:2F:71:3E:C5:1F,3223424,407106119,11369,1390805,3212055,405715314,6,48554,4065795,40130,3067695,8424,998100,11986,34,16333,186,6,825,130000.0,39000.0,-70.0,-71.0,-69.0,-60.0,-68.0,-69.0,-68.0,-60.0,-83.0,-89.0,-83.0,-88.0,13.0,18.0,14.0,28.0,1
1902,CC:2F:71:3F:1F:24,7982048,7674045936,4769993,7268330622,3212055,405715314,80,1109721,683642484,1101205,682619756,8516,1022728,1056778,619,4774711,485364,80,5625,115556.0,28889.0,-70.0,-65.0,-74.0,-69.0,-69.0,-65.0,-73.0,-69.0,-83.0,-89.0,-83.0,-88.0,13.0,24.0,9.0,19.0,1
1903,F8:59:71:5A:E0:3D,3307584,542529791,95527,136814275,3212057,405715516,0,93370,95477423,88585,94905701,4785,571722,71266,16,98239,2259,0,509,144444.0,43333.0,-67.0,-72.0,-65.0,-71.0,-67.0,-72.0,-65.0,-70.0,-83.0,-89.0,-83.0,-89.0,16.0,17.0,18.0,18.0,1
1904,CC:2F:71:3E:C5:1F,3223426,407106321,11369,1390805,3212057,405715516,6,48554,4065795,40130,3067695,8424,998100,11986,34,16333,186,6,825,130000.0,39000.0,-70.0,-71.0,-69.0,-60.0,-68.0,-69.0,-68.0,-60.0,-83.0,-89.0,-83.0,-89.0,13.0,18.0,14.0,29.0,1
1905,CC:2F:71:3F:1F:24,7983153,7675735985,4771094,7270020267,3212059,405715718,80,1110025,683858957,1101509,682836229,8516,1022728,1057082,619,4775784,485531,80,5625,115556.0,28889.0,-69.0,-64.0,-72.0,-69.0,-69.0,-64.0,-72.0,-68.0,-83.0,-89.0,-83.0,-89.0,14.0,25.0,11.0,20.0,1
1906,F8:59:71:5A:E0:3D,3307653,542629711,95591,136913731,3212062,405715980,0,93436,95579063,88651,95007341,4785,571722,71332,16,98303,2259,0,509,144444.0,43333.0,-67.0,-72.0,-65.0,-71.0,-66.0,-72.0,-65.0,-70.0,-83.0,-89.0,-83.0,-89.0,16.0,17.0,18.0,18.0,1
1907,CC:2F:71:3E:C5:1F,3223433,407106987,11369,1390805,3212064,405716182,6,48554,4065795,40130,3067695,8424,998100,11986,34,16333,186,6,825,130000.0,39000.0,-70.0,-71.0,-69.0,-60.0,-68.0,-69.0,-68.0,-60.0,-83.0,-89.0,-83.0,-89.0,13.0,18.0,14.0,29.0,1
1908,CC:2F:71:3F:1F:24,7984371,7677606707,4772307,7271890525,3212064,405716182,80,1110391,684119623,1101875,683096895,8516,1022728,1057448,619,4777026,485805,80,5625,115556.0,28889.0,-70.0,-65.0,-73.0,-69.0,-69.0,-64.0,-72.0,-68.0,-83.0,-89.0,-83.0,-89.0,13.0,24.0,10.0,20.0,1
1909,F8:59:71:5A:E0:3D,3307735,542749889,95669,137033505,3212066,405716384,0,93515,95699303,88730,95127581,4785,571722,71410,16,98380,2259,0,509,144444.0,43333.0,-67.0,-72.0,-65.0,-71.0,-67.0,-72.0,-64.0,-70.0,-83.0,-89.0,-83.0,-89.0,16.0,17.0,18.0,18.0,1
1910,CC:2F:71:3E:C5:1F,3223437,407107391,11369,1390805,3212068,405716586,6,48554,4065795,40130,3067695,8424,998100,11986,34,16333,186,6,825,130000.0,39000.0,-70.0,-71.0,-69.0,-60.0,-68.0,-69.0,-68.0,-60.0,-83.0,-89.0,-83.0,-89.0,13.0,18.0,14.0,29.0,1
1911,CC:2F:71:3F:1F:24,7985584,7679470075,4773516,7273753489,3212068,405716586,80,1110758,684350057,1102242,683327329,8516,1022728,1057813,619,4778222,486060,80,5625,115556.0,28889.0,-69.0,-65.0,-73.0,-69.0,-69.0,-65.0,-72.0,-69.0,-83.0,-89.0,-83.0,-89.0,14.0,24.0,10.0,20.0,1
1912,F8:59:71:5A:E0:3D,3307804,542847116,95731,137129853,3212073,405717263,0,93577,95794783,88792,95223061,4785,571722,71472,16,98443,2259,0,509,144444.0,43333.0,-67.0,-72.0,-65.0,-71.0,-67.0,-72.0,-65.0,-70.0,-83.0,-89.0,-83.0,-88.0,16.0,17.0,18.0,17.0,1
1913,CC:2F:71:3E:C5:1F,3223442,407108068,11369,1390805,3212073,405717263,6,48554,4065795,40130,3067695,8424,998100,11986,34,16333,186,6,825,130000.0,39000.0,-70.0,-71.0,-69.0,-60.0,-68.0,-69.0,-68.0,-60.0,-83.0,-89.0,-83.0,-88.0,13.0,18.0,14.0,28.0,1
1914,CC:2F:71:3F:1F:24,7986449,7680784752,4774376,7275067489,3212073,405717263,80,1111046,684565661,1102530,683542933,8516,1022728,1058101,619,4779095,486165,80,5625,115556.0,28889.0,-69.0,-65.0,-72.0,-69.0,-69.0,-64.0,-73.0,-69.0,-83.0,-89.0,-83.0,-88.0,14.0,24.0,11.0,19.0,1
1915,F8:59:71:5A:E0:3D,3307871,542946834,95795,137229309,3212076,405717525,0,93641,95893343,88856,95321621,4785,571722,71536,16,98507,2261,0,509,144444.0,43333.0,-67.0,-72.0,-65.0,-70.0,-66.0,-72.0,-65.0,-70.0,-83.0,-89.0,-83.0,-88.0,16.0,17.0,18.0,18.0,1
1916,CC:2F:71:3E:C5:1F,3223445,407108330,11369,1390805,3212076,405717525,6,48554,4065795,40130,3067695,8424,998100,11986,34,16333,186,6,825,130000.0,39000.0,-70.0,-71.0,-69.0,-60.0,-68.0,-69.0,-68.0,-60.0,-83.0,-89.0,-83.0,-88.0,13.0,18.0,14.0,28.0,1
1917,CC:2F:71:3F:1F:24,7987457,7682321299,4775381,7276603774,3212076,405717525,80,1111340,684778351,1102824,683755623,8516,1022728,1058395,619,4780083,486486,80,5625,115556.0,28889.0,-69.0,-65.0,-73.0,-69.0,-69.0,-65.0,-72.0,-69.0,-83.0,-89.0,-83.0,-88.0,14.0,24.0,10.0,19.0,1
1918,F8:59:71:5A:E0:3D,3307938,543045140,95858,137327211,3212080,405717929,0,93704,95990363,88919,95418641,4785,571722,71599,16,98570,2262,0,509,144444.0,43333.0,-67.0,-72.0,-64.0,-70.0,-67.0,-72.0,-64.0,-70.0,-83.0,-89.0,-83.0,-88.0,16.0,17.0,19.0,18.0,1
1919,CC:2F:71:3E:C5:1F,3223449,407108734,11369,1390805,3212080,405717929,6,48554,4065795,40130,3067695,8424,998100,11986,34,16333,186,6,825,130000.0,39000.0,-70.0,-71.0,-69.0,-60.0,-68.0,-69.0,-68.0,-60.0,-83.0,-89.0,-83.0,-88.0,13.0,18.0,14.0,28.0,1
1920,CC:2F:71:3F:1F:24,7988250,7683522135,4776168,7277804004,3212082,405718131,80,1111625,684995059,1103109,683972331,8516,1022728,1058680,619,4780887,486632,80,5625,115556.0,28889.0,-69.0,-65.0,-73.0,-69.0,-69.0,-65.0,-73.0,-69.0,-83.0,-89.0,-83.0,-88.0,14.0,24.0,10.0,19.0,1
1921,F8:59:71:5A:E0:3D,3308007,543146554,95923,137428221,3212084,405718333,0,93769,96090463,88984,95518741,4785,571722,71664,16,98634,2262,0,509,144444.0,43333.0,-67.0,-72.0,-65.0,-71.0,-67.0,-72.0,-64.0,-70.0,-83.0,-89.0,-83.0,-88.0,16.0,17.0,18.0,17.0,1
1922,CC:2F:71:3E:C5:1F,3223453,407109138,11369,1390805,3212084,405718333,6,48554,4065795,40130,3067695,8424,998100,11986,34,16333,186,6,825,130000.0,39000.0,-70.0,-71.0,-69.0,-60.0,-68.0,-69.0,-68.0,-60.0,-83.0,-89.0,-83.0,-88.0,13.0,18.0,14.0,28.0,1
1923,CC:2F:71:3F:1F:24,7989335,7685186615,4777251,7279468282,3212084,405718333,80,1111970,685221557,1103454,684198829,8516,1022728,1059025,619,4781970,487117,80,5626,115556.0,28889.0,-69.0,-65.0,-73.0,-69.0,-69.0,-65.0,-73.0,-69.0,-83.0,-89.0,-83.0,-88.0,14.0,24.0,10.0,19.0,1
1924,F8:59:71:5A:E0:3D,3308073,543244718,95986,137526123,3212087,405718595,0,93835,96192145,89050,95620423,4785,571722,71727,16,98698,2262,0,509,144444.0,43333.0,-67.0,-72.0,-65.0,-71.0,-67.0,-72.0,-64.0,-70.0,-83.0,-89.0,-83.0,-88.0,16.0,17.0,18.0,17.0,1
1925,CC:2F:71:3E:C5:1F,3223456,407109400,11369,1390805,3212087,405718595,6,48554,4065795,40130,3067695,8424,998100,11986,34,16333,186,6,825,130000.0,39000.0,-70.0,-71.0,-69.0,-60.0,-68.0,-69.0,-68.0,-60.0,-83.0,-89.0,-83.0,-88.0,13.0,18.0,14.0,28.0,1
1926,CC:2F:71:3F:1F:24,7990629,7687179561,4778540,7281460764,3212089,405718797,80,1112313,685440671,1103797,684417943,8516,1022728,1059368,619,4783251,487468,80,5628,115556.0,28889.0,-69.0,-64.0,-74.0,-69.0,-69.0,-64.0,-73.0,-69.0,-83.0,-89.0,-83.0,-88.0,14.0,25.0,9.0,19.0,1
1927,F8:59:71:5A:E0:3D,3308140,543343024,96049,137624025,3212091,405718999,0,93899,96290719,89114,95718997,4785,571722,71790,16,98761,2263,0,509,144444.0,43333.0,-66.0,-72.0,-66.0,-71.0,-66.0,-72.0,-65.0,-71.0,-83.0,-89.0,-83.0,-88.0,17.0,17.0,17.0,17.0,1
1928,CC:2F:71:3E:C5:1F,3223462,407110006,11369,1390805,3212093,405719201,6,48554,4065795,40130,3067695,8424,998100,11986,34,16333,186,6,825,130000.0,39000.0,-70.0,-71.0,-69.0,-60.0,-68.0,-69.0,-68.0,-60.0,-83.0,-89.0,-83.0,-88.0,13.0,18.0,14.0,28.0,1
1929,CC:2F:71:3F:1F:24,7992160,7689544997,4780067,7283825796,3212093,405719201,80,1112656,685659951,1104140,684637223,8516,1022728,1059711,619,4784737,487622,80,5628,117000.0,39000.0,-73.0,-68.0,-75.0,-73.0,-71.0,-65.0,-73.0,-70.0,-83.0,-89.0,-83.0,-88.0,10.0,21.0,8.0,15.0,1
1930,F8:59:71:5A:E0:3D,3308220,543460094,96125,137740691,3212095,405719403,0,93975,96407759,89190,95836037,4785,571722,71866,16,98837,2263,0,509,144444.0,43333.0,-67.0,-72.0,-66.0,-71.0,-68.0,-73.0,-67.0,-71.0,-83.0,-89.0,-83.0,-88.0,16.0,17.0,17.0,17.0,1
1931,CC:2F:71:3E:C5:1F,3223466,407110384,11370,1390921,3212096,405719463,6,48556,4065935,40132,3067835,8424,998100,11986,34,16334,186,6,825,130000.0,39000.0,-70.0,-71.0,-68.0,-60.0,-69.0,-69.0,-67.0,-60.0,-83.0,-89.0,-83.0,-88.0,13.0,18.0,15.0,28.0,1
1932,CC:2F:71:3F:1F:24,7993382,7691397309,4781284,7285677644,3212098,405719665,80,1112965,685921353,1104449,684898625,8516,1022728,1060020,619,4785976,487745,80,5629,130000.0,43333.0,-70.0,-64.0,-73.0,-70.0,-70.0,-64.0,-73.0,-69.0,-83.0,-89.0,-83.0,-88.0,13.0,25.0,10.0,18.0,1
1933,F8:59:71:5A:E0:3D,3308290,543561568,96190,137841701,3212100,405719867,0,94039,96506319,89254,95934597,4785,571722,71930,16,98902,2263,0,509,144444.0,43333.0,-68.0,-73.0,-66.0,-71.0,-67.0,-72.0,-66.0,-71.0,-83.0,-89.0,-83.0,-88.0,15.0,16.0,17.0,17.0,1
1934,CC:2F:71:3E:C5:1F,3223472,407110990,11370,1390921,3212102,405720069,6,48556,4065935,40132,3067835,8424,998100,11986,34,16334,186,6,825,130000.0,39000.0,-70.0,-71.0,-68.0,-60.0,-69.0,-69.0,-67.0,-60.0,-83.0,-89.0,-83.0,-88.0,13.0,18.0,15.0,28.0,1
1935,CC:2F:71:3F:1F:24,7994500,7693113893,4782398,7287393824,3212102,405720069,80,1113246,686138959,1104730,685116231,8516,1022728,1060300,619,4787115,487829,80,5629,130000.0,43333.0,-69.0,-64.0,-73.0,-71.0,-69.0,-64.0,-73.0,-71.0,-83.0,-89.0,-83.0,-88.0,14.0,25.0,10.0,17.0,1
1936,F8:59:71:5A:E0:3D,3308358,543661428,96254,137941157,3212104,405720271,0,94103,96604879,89318,96033157,4785,571722,71994,16,98966,2264,0,509,144444.0,43333.0,-67.0,-72.0,-65.0,-70.0,-67.0,-72.0,-65.0,-70.0,-83.0,-89.0,-83.0,-88.0,16.0,17.0,18.0,18.0,1
1937,CC:2F:71:3E:C5:1F,3223474,407111192,11370,1390921,3212104,405720271,6,48556,4065935,40132,3067835,8424,998100,11986,34,16334,186,6,825,130000.0,39000.0,-70.0,-71.0,-68.0,-60.0,-69.0,-69.0,-67.0,-60.0,-84.0,-89.0,-83.0,-88.0,14.0,18.0,15.0,28.0,1
1938,CC:2F:71:3F:1F:24,7995917,7695303485,4783813,7289583214,3212104,405720271,80,1113562,686356481,1105046,685333753,8516,1022728,1060616,619,4788532,487914,80,5630,130000.0,43333.0,-70.0,-64.0,-74.0,-71.0,-70.0,-64.0,-73.0,-71.0,-84.0,-89.0,-83.0,-88.0,14.0,25.0,9.0,17.0,1
1939,F8:59:71:5A:E0:3D,3308426,543759794,96317,138039059,3212109,405720735,0,94169,96706547,89384,96134825,4785,571722,72058,16,99029,2264,0,509,144444.0,43333.0,-67.0,-72.0,-66.0,-70.0,-67.0,-72.0,-66.0,-70.0,-84.0,-89.0,-83.0,-88.0,17.0,17.0,17.0,18.0,1
1940,CC:2F:71:3E:C5:1F,3223479,407111656,11370,1390921,3212109,405720735,6,48556,4065935,40132,3067835,8424,998100,11986,34,16334,186,6,825,130000.0,39000.0,-70.0,-71.0,-68.0,-60.0,-69.0,-69.0,-67.0,-60.0,-84.0,-89.0,-83.0,-88.0,14.0,18.0,15.0,28.0,1
1941,CC:2F:71:3F:1F:24,7997408,7697607273,4785299,7291886538,3212109,405720735,80,1113866,686574063,1105350,685551335,8516,1022728,1060919,619,4789996,487967,80,5630,130000.0,43333.0,-69.0,-64.0,-73.0,-70.0,-69.0,-64.0,-72.0,-70.0,-84.0,-89.0,-83.0,-88.0,15.0,25.0,10.0,18.0,1
1942,F8:59:71:5A:E0:3D,3308494,543858162,96380,138136961,3212114,405721201,0,94233,96803699,89447,96231859,4786,571840,72121,16,99092,2264,0,509,144444.0,43333.0,-67.0,-72.0,-66.0,-71.0,-67.0,-72.0,-66.0,-71.0,-84.0,-89.0,-83.0,-88.0,17.0,17.0,17.0,17.0,1
1943,CC:2F:71:3E:C5:1F,3223484,407112122,11370,1390921,3212114,405721201,6,48556,4065935,40132,3067835,8424,998100,11986,34,16334,186,6,825,130000.0,39000.0,-70.0,-71.0,-68.0,-60.0,-69.0,-69.0,-67.0,-60.0,-84.0,-89.0,-83.0,-88.0,14.0,18.0,15.0,28.0,1
1944,CC:2F:71:3F:1F:24,7998745,7699658956,4786631,7293937755,3212114,405721201,80,1114177,686791258,1105661,685768530,8516,1022728,1061229,619,4791323,487979,80,5630,130000.0,43333.0,-69.0,-64.0,-73.0,-71.0,-69.0,-64.0,-73.0,-70.0,-84.0,-89.0,-83.0,-88.0,15.0,25.0,10.0,17.0,1
1945,F8:59:71:5A:E0:3D,3308562,543958022,96444,138236417,3212118,405721605,0,94299,96905367,89513,96333527,4786,571840,72185,16,99156,2264,0,509,144444.0,43333.0,-67.0,-72.0,-66.0,-71.0,-67.0,-72.0,-66.0,-71.0,-83.0,-89.0,-82.0,-88.0,16.0,17.0,16.0,17.0,1
1946,CC:2F:71:3E:C5:1F,3223488,407112526,11370,1390921,3212118,405721605,6,48556,4065935,40132,3067835,8424,998100,11986,34,16334,186,6,825,130000.0,39000.0,-70.0,-71.0,-68.0,-60.0,-69.0,-69.0,-67.0,-60.0,-83.0,-89.0,-82.0,-88.0,13.0,18.0,14.0,28.0,1
1947,CC:2F:71:3F:1F:24,8000112,7701766870,4787994,7296045265,3212118,405721605,80,1114473,687010556,1105957,685987828,8516,1022728,1061525,619,4792689,488034,80,5630,130000.0,43333.0,-70.0,-64.0,-73.0,-70.0,-69.0,-64.0,-72.0,-70.0,-83.0,-89.0,-82.0,-88.0,13.0,25.0,9.0,18.0,1
1948,F8:59:71:5A:E0:3D,3308631,544056450,96507,138334319,3212124,405722131,0,94363,97003941,89577,96432101,4786,571840,72248,16,99219,2266,0,509,144444.0,43333.0,-67.0,-73.0,-66.0,-71.0,-66.0,-72.0,-66.0,-70.0,-83.0,-89.0,-82.0,-88.0,16.0,16.0,16.0,17.0,1
1949,CC:2F:71:3E:C5:1F,3223494,407113052,11370,1390921,3212124,405722131,6,48558,4066123,40133,3067905,8425,998218,11987,34,16334,186,6,825,130000.0,39000.0,-66.0,-63.0,-67.0,-60.0,-68.0,-68.0,-67.0,-60.0,-83.0,-89.0,-82.0,-88.0,17.0,26.0,15.0,28.0,1
1950,CC:2F:71:3F:1F:24,8001229,7703477474,4789105,7297755343,3212124,405722131,80,1114781,687229782,1106265,686207054,8516,1022728,1061832,619,4793824,488068,80,5630,130000.0,43333.0,-69.0,-64.0,-72.0,-70.0,-69.0,-64.0,-72.0,-70.0,-83.0,-89.0,-82.0,-88.0,14.0,25.0,10.0,18.0,1
1951,F8:59:71:5A:E0:3D,3308696,544154554,96570,138432221,3212126,405722333,0,94427,97102515,89641,96530675,4786,571840,72311,16,99282,2266,0,509,144444.0,43333.0,-67.0,-72.0,-66.0,-70.0,-66.0,-72.0,-65.0,-70.0,-83.0,-89.0,-82.0,-88.0,16.0,17.0,16.0,18.0,1
1952,CC:2F:71:3E:C5:1F,3223498,407113456,11370,1390921,3212128,405722535,6,48558,4066123,40133,3067905,8425,998218,11987,34,16334,186,6,825,130000.0,39000.0,-66.0,-63.0,-67.0,-60.0,-68.0,-68.0,-67.0,-60.0,-83.0,-89.0,-82.0,-88.0,17.0,26.0,15.0,28.0,1
1953,CC:2F:71:3F:1F:24,8002480,7705402364,4790352,7299679829,3212128,405722535,80,1115096,687447214,1106580,686424486,8516,1022728,1062147,619,4795069,488146,80,5630,130000.0,43333.0,-69.0,-64.0,-72.0,-70.0,-69.0,-64.0,-72.0,-70.0,-83.0,-89.0,-82.0,-88.0,14.0,25.0,10.0,18.0,1
1954,F8:59:71:5A:E0:3D,3308767,544254889,96634,138531677,3212133,405723212,0,94492,97202629,89706,96630789,4786,571840,72375,16,99346,2268,0,509,144444.0,43333.0,-67.0,-72.0,-66.0,-70.0,-66.0,-72.0,-65.0,-70.0,-83.0,-89.0,-83.0,-88.0,16.0,17.0,17.0,18.0,1
1955,CC:2F:71:3E:C5:1F,3223503,407114133,11370,1390921,3212133,405723212,6,48558,4066123,40133,3067905,8425,998218,11987,34,16334,186,6,825,130000.0,39000.0,-66.0,-63.0,-67.0,-60.0,-68.0,-68.0,-67.0,-60.0,-83.0,-89.0,-83.0,-88.0,17.0,26.0,16.0,28.0,1
1956,CC:2F:71:3F:1F:24,8003787,7707405521,4791654,7301682309,3212133,405723212,80,1115408,687664613,1106892,686641885,8516,1022728,1062459,619,4796373,488244,80,5630,130000.0,43333.0,-69.0,-64.0,-73.0,-70.0,-69.0,-64.0,-72.0,-70.0,-83.0,-89.0,-83.0,-88.0,14.0,25.0,10.0,18.0,1
1957,F8:59:71:5A:E0:3D,3308832,544351499,96696,138628025,3212136,405723474,0,94554,97298109,89768,96726269,4786,571840,72437,16,99408,2269,0,509,144444.0,43333.0,-67.0,-72.0,-66.0,-70.0,-66.0,-72.0,-65.0,-70.0,-83.0,-89.0,-83.0,-88.0,16.0,17.0,17.0,18.0,1
1958,CC:2F:71:3E:C5:1F,3223506,407114395,11370,1390921,3212136,405723474,6,48558,4066123,40133,3067905,8425,998218,11987,34,16334,186,6,825,130000.0,39000.0,-66.0,-63.0,-67.0,-60.0,-68.0,-68.0,-67.0,-60.0,-83.0,-89.0,-83.0,-88.0,17.0,26.0,16.0,28.0,1
1959,CC:2F:71:3F:1F:24,8004831,7709005177,4792695,7303281703,3212136,405723474,80,1115687,687879227,1107171,686856499,8516,1022728,1062738,619,4797414,488270,80,5630,130000.0,43333.0,-70.0,-64.0,-73.0,-71.0,-69.0,-64.0,-72.0,-70.0,-83.0,-89.0,-83.0,-88.0,13.0,25.0,10.0,17.0,1
1960,F8:59:71:5A:E0:3D,3308901,544451421,96760,138727481,3212141,405723940,0,94619,97398223,89833,96826383,4786,571840,72501,16,99472,2269,0,509,144444.0,43333.0,-66.0,-72.0,-66.0,-70.0,-66.0,-72.0,-66.0,-70.0,-83.0,-89.0,-83.0,-88.0,17.0,17.0,17.0,18.0,1
1961,CC:2F:71:3E:C5:1F,3223513,407115063,11370,1390921,3212143,405724142,6,48558,4066123,40133,3067905,8425,998218,11987,34,16334,186,6,825,130000.0,39000.0,-66.0,-63.0,-67.0,-60.0,-68.0,-68.0,-67.0,-60.0,-83.0,-89.0,-83.0,-88.0,17.0,26.0,16.0,28.0,1
1962,CC:2F:71:3F:1F:24,8005726,7710363853,4793583,7304639711,3212143,405724142,80,1115986,688093069,1107469,687070223,8517,1022846,1063037,619,4798302,488292,80,5631,130000.0,43333.0,-70.0,-64.0,-73.0,-70.0,-69.0,-64.0,-72.0,-70.0,-83.0,-89.0,-83.0,-88.0,13.0,25.0,10.0,18.0,1
1963,F8:59:71:5A:E0:3D,3308968,544549727,96823,138825383,3212145,405724344,0,94682,97495243,89896,96923403,4786,571840,72564,16,99535,2269,0,509,144444.0,43333.0,-67.0,-72.0,-66.0,-70.0,-67.0,-72.0,-66.0,-70.0,-84.0,-89.0,-83.0,-89.0,17.0,17.0,17.0,19.0,1
1964,CC:2F:71:3E:C5:1F,3223515,407115265,11370,1390921,3212145,405724344,6,48558,4066123,40133,3067905,8425,998218,11987,34,16334,186,6,825,130000.0,39000.0,-66.0,-63.0,-67.0,-60.0,-68.0,-68.0,-67.0,-60.0,-84.0,-89.0,-83.0,-89.0,18.0,26.0,16.0,29.0,1
1965,CC:2F:71:3F:1F:24,8006654,7711782227,4794509,7306057883,3212145,405724344,80,1116278,688309143,1107761,687286297,8517,1022846,1063329,619,4799228,488308,80,5631,130000.0,43333.0,-69.0,-64.0,-72.0,-71.0,-69.0,-64.0,-72.0,-71.0,-84.0,-89.0,-83.0,-89.0,15.0,25.0,11.0,18.0,1
1966,F8:59:71:5A:E0:3D,3309040,544657159,96892,138932553,3212148,405724606,0,94753,97604611,89967,97032771,4786,571840,72633,16,99604,2272,0,509,130000.0,39000.0,-68.0,-73.0,-67.0,-71.0,-67.0,-72.0,-66.0,-71.0,-83.0,-89.0,-83.0,-89.0,15.0,16.0,16.0,18.0,1
1967,CC:2F:71:3E:C5:1F,3223520,407115729,11370,1390921,3212150,405724808,6,48558,4066123,40133,3067905,8425,998218,11987,34,16334,186,6,825,130000.0,39000.0,-66.0,-63.0,-67.0,-60.0,-68.0,-68.0,-67.0,-60.0,-83.0,-89.0,-83.0,-89.0,17.0,26.0,16.0,29.0,1
1968,CC:2F:71:3F:1F:24,8007699,7713371242,4795547,7307646232,3212152,405725010,80,1116562,688540410,1108045,687517564,8517,1022846,1063613,619,4800243,488365,80,5631,130000.0,43333.0,-70.0,-65.0,-73.0,-71.0,-70.0,-64.0,-73.0,-71.0,-83.0,-89.0,-83.0,-89.0,13.0,24.0,10.0,18.0,1
1969,F8:59:71:5A:E0:3D,3309109,544755721,96955,139030343,3212154,405725378,0,94816,97701631,90030,97129791,4786,571840,72696,16,99667,2272,0,509,144444.0,43333.0,-68.0,-73.0,-67.0,-71.0,-67.0,-73.0,-67.0,-71.0,-83.0,-89.0,-83.0,-89.0,15.0,16.0,16.0,18.0,1
1970,CC:2F:71:3E:C5:1F,3223526,407116501,11370,1390921,3212156,405725580,6,48558,4066123,40133,3067905,8425,998218,11987,34,16334,186,6,825,130000.0,39000.0,-66.0,-63.0,-67.0,-60.0,-68.0,-68.0,-67.0,-60.0,-83.0,-89.0,-83.0,-89.0,17.0,26.0,16.0,29.0,1
1971,CC:2F:71:3F:1F:24,8008977,7715339162,4796821,7309613582,3212156,405725580,80,1116886,688755982,1108369,687733136,8517,1022846,1063937,619,4801540,488377,80,5632,130000.0,43333.0,-70.0,-65.0,-74.0,-71.0,-70.0,-65.0,-73.0,-71.0,-83.0,-89.0,-83.0,-89.0,13.0,24.0,9.0,18.0,1
1972,F8:59:71:5A:E0:3D,3309175,544852473,97017,139126691,3212158,405725782,0,94881,97801759,90095,97229919,4786,571840,72759,16,99729,2272,0,509,144444.0,43333.0,-68.0,-73.0,-67.0,-71.0,-67.0,-72.0,-66.0,-71.0,-83.0,-89.0,-83.0,-89.0,15.0,16.0,16.0,18.0,1
1973,CC:2F:71:3E:C5:1F,3223528,407116703,11370,1390921,3212158,405725782,6,48558,4066123,40133,3067905,8425,998218,11987,34,16334,186,6,825,130000.0,39000.0,-66.0,-63.0,-67.0,-60.0,-68.0,-68.0,-67.0,-60.0,-83.0,-89.0,-83.0,-89.0,17.0,26.0,16.0,29.0,1
1974,CC:2F:71:3F:1F:24,8009892,7716738246,4797734,7311012464,3212158,405725782,80,1117153,688967878,1108636,687945032,8517,1022846,1064204,619,4802453,488429,80,5635,130000.0,43333.0,-69.0,-64.0,-73.0,-70.0,-69.0,-64.0,-72.0,-70.0,-83.0,-89.0,-83.0,-89.0,14.0,25.0,10.0,19.0,1
1975,F8:59:71:5A:E0:3D,3309245,544953947,97082,139227701,3212163,405726246,0,94947,97903427,90161,97331587,4786,571840,72823,16,99794,2272,0,509,144444.0,43333.0,-68.0,-73.0,-67.0,-72.0,-67.0,-72.0,-66.0,-71.0,-83.0,-89.0,-83.0,-89.0,15.0,16.0,16.0,17.0,1
1976,CC:2F:71:3E:C5:1F,3223533,407117167,11370,1390921,3212163,405726246,6,48558,4066123,40133,3067905,8425,998218,11987,34,16334,186,6,825,130000.0,39000.0,-66.0,-63.0,-67.0,-60.0,-68.0,-68.0,-67.0,-60.0,-83.0,-89.0,-83.0,-89.0,17.0,26.0,16.0,29.0,1
1977,CC:2F:71:3F:1F:24,8011373,7719024766,4799210,7313298520,3212163,405726246,80,1117463,689193058,1108946,688170212,8517,1022846,1064514,619,4803929,488496,80,5635,130000.0,43333.0,-69.0,-64.0,-72.0,-70.0,-68.0,-64.0,-72.0,-70.0,-83.0,-89.0,-83.0,-89.0,14.0,25.0,11.0,19.0,1
1978,F8:59:71:5A:E0:3D,3309316,545056485,97147,139328711,3212169,405727774,0,95016,98009743,90230,97437903,4786,571840,72888,16,99859,2272,0,509,144444.0,43333.0,-67.0,-73.0,-66.0,-71.0,-67.0,-73.0,-66.0,-71.0,-83.0,-89.0,-83.0,-89.0,16.0,16.0,17.0,18.0,1
1979,CC:2F:71:3E:C5:1F,3223539,407118695,11370,1390921,3212169,405727774,6,48558,4066123,40133,3067905,8425,998218,11987,34,16334,186,6,825,130000.0,39000.0,-66.0,-63.0,-67.0,-60.0,-68.0,-68.0,-67.0,-60.0,-83.0,-89.0,-83.0,-89.0,17.0,26.0,16.0,29.0,1
1980,CC:2F:71:3F:1F:24,8013100,7721698704,4800931,7315970930,3212169,405727774,80,1117808,689416530,1109291,688393684,8517,1022846,1064859,619,4805641,488671,80,5635,130000.0,43333.0,-69.0,-64.0,-74.0,-70.0,-69.0,-64.0,-73.0,-70.0,-83.0,-89.0,-83.0,-89.0,14.0,25.0,9.0,19.0,1
1981,F8:59:71:5A:E0:3D,3309385,545154911,97210,139426613,3212175,405728298,0,95080,98108373,90294,97536533,4786,571840,72951,16,99922,2272,0,509,144444.0,43333.0,-67.0,-72.0,-66.0,-71.0,-67.0,-72.0,-66.0,-71.0,-83.0,-89.0,-83.0,-89.0,16.0,17.0,17.0,18.0,1
1982,CC:2F:71:3E:C5:1F,3223545,407119219,11370,1390921,3212175,405728298,6,48558,4066123,40133,3067905,8425,998218,11987,34,16334,186,6,825,130000.0,39000.0,-66.0,-63.0,-67.0,-60.0,-68.0,-68.0,-67.0,-60.0,-83.0,-89.0,-83.0,-89.0,17.0,26.0,16.0,29.0,1
1983,CC:2F:71:3F:1F:24,8014821,7724353149,4802646,7318624851,3212175,405728298,80,1118142,689642211,1109625,688619365,8517,1022846,1065193,619,4807365,488777,80,5635,130000.0,43333.0,-69.0,-64.0,-73.0,-70.0,-68.0,-64.0,-72.0,-70.0,-83.0,-89.0,-83.0,-89.0,14.0,25.0,10.0,19.0,1
1984,F8:59:71:5A:E0:3D,3309455,545257307,97275,139527623,3212180,405729684,0,95145,98208473,90359,97636633,4786,571840,73016,16,99987,2273,0,509,144444.0,43333.0,-67.0,-72.0,-66.0,-71.0,-67.0,-72.0,-66.0,-71.0,-83.0,-89.0,-83.0,-89.0,16.0,17.0,17.0,18.0,1
1985,CC:2F:71:3E:C5:1F,3223552,407120807,11370,1390921,3212182,405729886,6,48558,4066123,40133,3067905,8425,998218,11987,34,16334,186,6,825,130000.0,39000.0,-66.0,-63.0,-67.0,-60.0,-68.0,-68.0,-67.0,-60.0,-83.0,-89.0,-83.0,-89.0,17.0,26.0,16.0,29.0,1
1986,CC:2F:71:3F:1F:24,8016315,7726656657,4804133,7320926771,3212182,405729886,80,1118474,689861631,1109957,688838785,8517,1022846,1065525,619,4808852,488861,80,5635,130000.0,43333.0,-69.0,-64.0,-73.0,-70.0,-69.0,-64.0,-72.0,-70.0,-83.0,-89.0,-83.0,-89.0,14.0,25.0,10.0,19.0,1
1987,F8:59:71:5A:E0:3D,3309525,545355941,97338,139625525,3212187,405730416,0,95211,98310155,90425,97738315,4786,571840,73079,16,100050,2274,0,509,144444.0,43333.0,-67.0,-72.0,-66.0,-71.0,-68.0,-72.0,-66.0,-71.0,-83.0,-89.0,-83.0,-89.0,16.0,17.0,17.0,18.0,1
1988,CC:2F:71:3E:C5:1F,3223557,407121337,11370,1390921,3212187,405730416,6,48558,4066123,40133,3067905,8425,998218,11987,34,16334,186,6,825,130000.0,39000.0,-66.0,-63.0,-67.0,-60.0,-68.0,-68.0,-67.0,-60.0,-83.0,-89.0,-83.0,-89.0,17.0,26.0,16.0,29.0,1
1989,CC:2F:71:3F:1F:24,8017348,7728236115,4805161,7322505699,3212187,405730416,80,1118786,690078603,1110269,689055757,8517,1022846,1065837,619,4809880,488905,80,5636,130000.0,43333.0,-70.0,-64.0,-74.0,-70.0,-69.0,-64.0,-73.0,-70.0,-83.0,-89.0,-83.0,-89.0,13.0,25.0,9.0,19.0,1
1990,F8:59:71:5A:E0:3D,3309593,545453735,97400,139721873,3212193,405731862,0,95274,98407175,90488,97835335,4786,571840,73142,16,100112,2274,0,509,144444.0,43333.0,-67.0,-72.0,-66.0,-71.0,-67.0,-72.0,-65.0,-70.0,-83.0,-89.0,-83.0,-89.0,16.0,17.0,17.0,18.0,1
1991,CC:2F:71:3E:C5:1F,3223563,407122783,11370,1390921,3212193,405731862,6,48558,4066123,40133,3067905,8425,998218,11987,34,16334,186,6,825,130000.0,39000.0,-66.0,-63.0,-67.0,-60.0,-68.0,-68.0,-67.0,-60.0,-83.0,-89.0,-83.0,-89.0,17.0,26.0,16.0,29.0,1
1992,CC:2F:71:3F:1F:24,8018594,7730151201,4806401,7324419339,3212193,405731862,80,1119095,690296725,1110578,689273879,8517,1022846,1066146,619,4811091,488943,80,5636,130000.0,43333.0,-69.0,-64.0,-72.0,-71.0,-69.0,-64.0,-72.0,-70.0,-83.0,-89.0,-83.0,-89.0,14.0,25.0,11.0,18.0,1
1993,F8:59:71:5A:E0:3D,3309663,545553797,97464,139821329,3212199,405732468,0,95338,98505791,90552,97933951,4786,571840,73205,16,100176,2276,0,509,144444.0,43333.0,-67.0,-73.0,-66.0,-71.0,-67.0,-72.0,-66.0,-71.0,-83.0,-89.0,-83.0,-89.0,16.0,16.0,17.0,18.0,1
1994,CC:2F:71:3E:C5:1F,3223569,407123389,11370,1390921,3212199,405732468,6,48558,4066123,40133,3067905,8425,998218,11987,34,16334,186,6,825,130000.0,39000.0,-66.0,-63.0,-67.0,-60.0,-68.0,-68.0,-67.0,-60.0,-83.0,-89.0,-83.0,-89.0,17.0,26.0,16.0,29.0,1
1995,CC:2F:71:3F:1F:24,8019820,7732012158,4807621,7326279690,3212199,405732468,80,1119390,690512864,1110873,689490018,8517,1022846,1066440,619,4812335,489005,80,5636,130000.0,43333.0,-70.0,-64.0,-74.0,-70.0,-69.0,-64.0,-73.0,-70.0,-83.0,-89.0,-83.0,-89.0,13.0,25.0,9.0,19.0,1
1996,F8:59:71:5A:E0:3D,3309731,545655282,97529,139922339,3212202,405732943,0,95404,98607445,90618,98035605,4786,571840,73270,16,100241,2278,0,509,144444.0,43333.0,-68.0,-72.0,-66.0,-71.0,-67.0,-72.0,-66.0,-70.0,-83.0,-89.0,-83.0,-89.0,15.0,17.0,17.0,18.0,1
1997,CC:2F:71:3E:C5:1F,3223572,407123864,11370,1390921,3212202,405732943,6,48558,4066123,40133,3067905,8425,998218,11987,34,16334,186,6,825,130000.0,39000.0,-66.0,-63.0,-67.0,-60.0,-68.0,-68.0,-67.0,-60.0,-83.0,-89.0,-83.0,-89.0,17.0,26.0,16.0,29.0,1
1998,CC:2F:71:3F:1F:24,8020950,7733748911,4808748,7328015968,3212202,405732943,80,1119686,690730972,1111169,689708126,8517,1022846,1066736,619,4813434,489128,80,5637,130000.0,43333.0,-69.0,-64.0,-74.0,-70.0,-68.0,-64.0,-72.0,-70.0,-83.0,-89.0,-83.0,-89.0,14.0,25.0,9.0,19.0,1
1999,F8:59:71:5A:E0:3D,3309801,545753850,97592,140020241,3212209,405733609,0,95467,98704465,90681,98132625,4786,571840,73333,16,100304,2278,0,509,144444.0,43333.0,-67.0,-72.0,-66.0,-70.0,-67.0,-72.0,-66.0,-70.0,-83.0,-89.0,-83.0,-89.0,16.0,17.0,17.0,19.0,1
2000,CC:2F:71:3E:C5:1F,3223579,407124530,11370,1390921,3212209,405733609,6,48558,4066123,40133,3067905,8425,998218,11987,34,16334,186,6,825,130000.0,39000.0,-66.0,-63.0,-67.0,-60.0,-68.0,-68.0,-67.0,-60.0,-83.0,-89.0,-83.0,-89.0,17.0,26.0,16.0,29.0,1
2001,CC:2F:71:3F:1F:24,8022545,7736212337,4810336,7330478728,3212209,405733609,80,1120016,690954208,1111499,689931362,8517,1022846,1067066,619,4815055,489173,80,5638,130000.0,43333.0,-70.0,-64.0,-73.0,-70.0,-69.0,-64.0,-72.0,-70.0,-83.0,-89.0,-83.0,-89.0,13.0,25.0,10.0,19.0,1
2002,F8:59:71:5A:E0:3D,3309865,545853306,97656,140119697,3212209,405733609,0,95533,98806119,90747,98234279,4786,571840,73398,16,100368,2279,0,509,144444.0,43333.0,-67.0,-72.0,-66.0,-71.0,-67.0,-72.0,-66.0,-71.0,-83.0,-89.0,-83.0,-89.0,16.0,17.0,17.0,18.0,1
2003,CC:2F:71:3E:C5:1F,3223581,407124732,11370,1390921,3212211,405733811,6,48558,4066123,40133,3067905,8425,998218,11987,34,16334,186,6,825,130000.0,39000.0,-66.0,-63.0,-67.0,-60.0,-68.0,-68.0,-67.0,-60.0,-83.0,-89.0,-83.0,-89.0,17.0,26.0,16.0,29.0,1
2004,CC:2F:71:3F:1F:24,8024110,7738635801,4811899,7332901990,3212211,405733811,80,1120331,691176006,1111814,690153160,8517,1022846,1067381,619,4816618,489347,80,5640,130000.0,43333.0,-69.0,-64.0,-72.0,-70.0,-69.0,-64.0,-72.0,-70.0,-83.0,-89.0,-83.0,-89.0,14.0,25.0,11.0,19.0,1
2005,F8:59:71:5A:E0:3D,3309935,545953368,97720,140219153,3212215,405734215,0,95596,98903139,90810,98331299,4786,571840,73461,16,100432,2279,0,509,144444.0,43333.0,-67.0,-73.0,-66.0,-71.0,-67.0,-72.0,-66.0,-71.0,-83.0,-89.0,-83.0,-89.0,16.0,16.0,17.0,18.0,1
2006,CC:2F:71:3E:C5:1F,3223585,407125136,11370,1390921,3212215,405734215,6,48558,4066123,40133,3067905,8425,998218,11987,34,16334,186,6,825,130000.0,39000.0,-66.0,-63.0,-67.0,-60.0,-68.0,-68.0,-67.0,-60.0,-83.0,-89.0,-83.0,-89.0,17.0,26.0,16.0,29.0,1
2007,CC:2F:71:3F:1F:24,8025631,7740975902,4813414,7335241485,3212217,405734417,80,1120670,691402232,1112153,690379386,8517,1022846,1067720,619,4818133,489448,80,5640,130000.0,43333.0,-70.0,-65.0,-73.0,-71.0,-70.0,-65.0,-73.0,-71.0,-83.0,-89.0,-83.0,-89.0,13.0,24.0,10.0,18.0,1
2008,F8:59:71:5A:E0:3D,3310003,546054640,97785,140320163,3212218,405734477,0,95661,99003239,90875,98431399,4786,571840,73526,16,100497,2279,0,509,144444.0,43333.0,-67.0,-72.0,-66.0,-70.0,-66.0,-72.0,-65.0,-70.0,-83.0,-89.0,-83.0,-89.0,16.0,17.0,17.0,19.0,1
2009,CC:2F:71:3E:C5:1F,3223588,407125398,11370,1390921,3212218,405734477,6,48558,4066123,40133,3067905,8425,998218,11987,34,16334,186,6,825,130000.0,39000.0,-66.0,-63.0,-67.0,-60.0,-68.0,-68.0,-67.0,-60.0,-83.0,-89.0,-83.0,-89.0,17.0,26.0,16.0,29.0,1
2010,CC:2F:71:3F:1F:24,8027237,7743465596,4815019,7337731119,3212218,405734477,80,1121029,691624532,1112512,690601686,8517,1022846,1068079,619,4819738,489478,80,5640,130000.0,43333.0,-70.0,-64.0,-74.0,-71.0,-69.0,-64.0,-73.0,-70.0,-83.0,-89.0,-83.0,-89.0,13.0,25.0,9.0,18.0,1
2011,F8:59:71:5A:E0:3D,3310070,546152946,97848,140418065,3212222,405734881,0,95726,99103367,90940,98531527,4786,571840,73589,16,100560,2281,0,509,144444.0,43333.0,-67.0,-73.0,-66.0,-71.0,-67.0,-72.0,-66.0,-71.0,-83.0,-89.0,-83.0,-89.0,16.0,16.0,17.0,18.0,1
2012,CC:2F:71:3E:C5:1F,3223592,407125802,11370,1390921,3212222,405734881,6,48558,4066123,40133,3067905,8425,998218,11987,34,16334,186,6,825,130000.0,39000.0,-66.0,-63.0,-67.0,-60.0,-68.0,-68.0,-67.0,-60.0,-83.0,-89.0,-83.0,-89.0,17.0,26.0,16.0,29.0,1
2013,CC:2F:71:3F:1F:24,8028421,7745282078,4816197,7339546995,3212224,405735083,80,1121344,691840400,1112827,690817554,8517,1022846,1068394,619,4820916,489566,80,5640,130000.0,43333.0,-70.0,-65.0,-73.0,-71.0,-69.0,-65.0,-73.0,-71.0,-83.0,-89.0,-83.0,-89.0,13.0,24.0,10.0,18.0,1
2014,F8:59:71:5A:E0:3D,3310139,546252922,97913,140517637,3212226,405735285,0,95792,99205105,91006,98633265,4786,571840,73654,16,100625,2282,0,509,144444.0,43333.0,-67.0,-72.0,-66.0,-71.0,-67.0,-72.0,-66.0,-71.0,-83.0,-89.0,-83.0,-89.0,16.0,17.0,17.0,18.0,1
2015,CC:2F:71:3E:C5:1F,3223597,407126322,11371,1391037,3212226,405735285,6,48560,4066263,40135,3068045,8425,998218,11987,34,16335,186,6,825,130000.0,39000.0,-69.0,-71.0,-67.0,-60.0,-68.0,-68.0,-67.0,-60.0,-83.0,-89.0,-83.0,-89.0,14.0,18.0,16.0,29.0,1
2016,CC:2F:71:3F:1F:24,8029493,7746925902,4817267,7341190617,3212226,405735285,80,1121662,692063856,1113145,691041010,8517,1022846,1068712,619,4821986,489613,80,5642,130000.0,43333.0,-69.0,-64.0,-73.0,-70.0,-69.0,-64.0,-72.0,-70.0,-83.0,-89.0,-83.0,-89.0,14.0,25.0,10.0,19.0,1
2017,F8:59:71:5A:E0:3D,3310207,546351288,97976,140615539,3212231,405735749,0,95855,99302139,91069,98730299,4786,571840,73716,16,100688,2282,0,509,144444.0,43333.0,-66.0,-72.0,-66.0,-70.0,-66.0,-72.0,-65.0,-70.0,-83.0,-89.0,-83.0,-89.0,17.0,17.0,17.0,19.0,1
2018,CC:2F:71:3E:C5:1F,3223602,407126786,11371,1391037,3212231,405735749,6,48560,4066263,40135,3068045,8425,998218,11987,34,16335,186,6,825,130000.0,39000.0,-69.0,-71.0,-67.0,-60.0,-68.0,-68.0,-67.0,-60.0,-83.0,-89.0,-83.0,-89.0,14.0,18.0,16.0,29.0,1
2019,CC:2F:71:3F:1F:24,8030650,7748677336,4818417,7342941385,3212233,405735951,80,1121987,692311964,1113470,691289118,8517,1022846,1069037,619,4823136,489676,80,5642,130000.0,43333.0,-69.0,-64.0,-72.0,-70.0,-69.0,-64.0,-72.0,-70.0,-83.0,-89.0,-83.0,-89.0,14.0,25.0,11.0,19.0,1
2020,F8:59:71:5A:E0:3D,3310284,546465134,98049,140728981,3212235,405736153,0,95931,99419221,91145,98847381,4786,571840,73789,16,100761,2286,0,509,144444.0,43333.0,-67.0,-72.0,-66.0,-70.0,-66.0,-72.0,-65.0,-70.0,-83.0,-89.0,-83.0,-89.0,16.0,17.0,17.0,19.0,1
2021,CC:2F:71:3E:C5:1F,3223606,407127190,11371,1391037,3212235,405736153,6,48560,4066263,40135,3068045,8425,998218,11987,34,16335,186,6,825,130000.0,39000.0,-69.0,-71.0,-67.0,-60.0,-68.0,-68.0,-67.0,-60.0,-83.0,-89.0,-83.0,-89.0,14.0,18.0,16.0,29.0,1
2022,CC:2F:71:3F:1F:24,8032138,7750976861,4819903,7345240708,3212235,405736153,80,1122313,692534660,1113796,691511814,8517,1022846,1069362,619,4824622,489714,80,5643,117000.0,39000.0,-69.0,-64.0,-72.0,-70.0,-68.0,-64.0,-72.0,-70.0,-84.0,-89.0,-83.0,-89.0,15.0,25.0,11.0,19.0,1
2023,F8:59:71:5A:E0:3D,3310354,546568102,98115,140831545,3212239,405736557,0,95998,99522401,91212,98950561,4786,571840,73856,16,100827,2286,0,509,144444.0,43333.0,-67.0,-72.0,-65.0,-70.0,-67.0,-71.0,-65.0,-70.0,-84.0,-89.0,-83.0,-89.0,17.0,17.0,18.0,19.0,1
2024,CC:2F:71:3E:C5:1F,3223611,407127654,11371,1391037,3212240,405736617,6,48560,4066263,40135,3068045,8425,998218,11987,34,16335,186,6,825,130000.0,39000.0,-69.0,-71.0,-67.0,-60.0,-68.0,-68.0,-67.0,-60.0,-84.0,-89.0,-83.0,-89.0,15.0,18.0,16.0,29.0,1
2025,CC:2F:71:3F:1F:24,8033793,7753534663,4821551,7347797844,3212242,405736819,80,1122664,692763280,1114147,691740434,8517,1022846,1069713,619,4826270,489778,80,5645,130000.0,43333.0,-69.0,-64.0,-73.0,-71.0,-69.0,-64.0,-73.0,-71.0,-84.0,-89.0,-83.0,-89.0,15.0,25.0,10.0,18.0,1
2026,F8:59:71:5A:E0:3D,3310424,546668084,98179,140931001,3212245,405737083,0,96062,99619539,91275,99047581,4787,571958,73920,16,100891,2288,0,509,144444.0,43333.0,-67.0,-72.0,-66.0,-71.0,-67.0,-72.0,-66.0,-71.0,-85.0,-90.0,-84.0,-90.0,18.0,18.0,18.0,19.0,1
2027,CC:2F:71:3E:C5:1F,3223616,407128120,11371,1391037,3212245,405737083,6,48560,4066263,40135,3068045,8425,998218,11987,34,16335,186,6,825,130000.0,39000.0,-69.0,-71.0,-67.0,-60.0,-68.0,-68.0,-67.0,-60.0,-85.0,-90.0,-84.0,-90.0,16.0,19.0,17.0,30.0,1
2028,CC:2F:71:3F:1F:24,8035144,7755617599,4822899,7349880516,3212245,405737083,80,1122984,692988428,1114467,691965582,8517,1022846,1070033,619,4827618,489823,80,5645,130000.0,43333.0,-69.0,-64.0,-72.0,-71.0,-69.0,-64.0,-73.0,-71.0,-85.0,-90.0,-84.0,-90.0,16.0,26.0,12.0,19.0,1
2029,F8:59:71:5A:E0:3D,3310494,546771052,98245,141033565,3212249,405737487,0,96129,99722733,91342,99150775,4787,571958,73986,16,100957,2288,0,509,144444.0,43333.0,-67.0,-72.0,-66.0,-71.0,-67.0,-72.0,-65.0,-70.0,-85.0,-90.0,-84.0,-90.0,18.0,18.0,18.0,19.0,1
2030,CC:2F:71:3E:C5:1F,3223620,407128524,11371,1391037,3212249,405737487,6,48560,4066263,40135,3068045,8425,998218,11987,34,16335,186,6,825,130000.0,39000.0,-69.0,-71.0,-67.0,-60.0,-68.0,-68.0,-67.0,-60.0,-85.0,-90.0,-84.0,-90.0,16.0,19.0,17.0,30.0,1
2031,CC:2F:71:3F:1F:24,8036041,7756983781,4823792,7351246294,3212249,405737487,80,1123272,693206828,1114755,692183982,8517,1022846,1070321,619,4828511,489885,80,5645,130000.0,43333.0,-69.0,-64.0,-73.0,-71.0,-69.0,-64.0,-73.0,-70.0,-85.0,-90.0,-84.0,-90.0,16.0,26.0,11.0,19.0,1
2032,F8:59:71:5A:E0:3D,3310562,546869418,98308,141131467,3212254,405737951,0,96195,99824401,91408,99252443,4787,571958,74050,16,101020,2288,0,509,144444.0,43333.0,-67.0,-72.0,-66.0,-70.0,-67.0,-72.0,-65.0,-70.0,-85.0,-90.0,-84.0,-90.0,18.0,18.0,18.0,20.0,1
2033,CC:2F:71:3E:C5:1F,3223625,407128988,11371,1391037,3212254,405737951,6,48560,4066263,40135,3068045,8425,998218,11987,34,16335,186,6,825,130000.0,39000.0,-69.0,-71.0,-67.0,-60.0,-68.0,-68.0,-67.0,-60.0,-85.0,-90.0,-84.0,-90.0,16.0,19.0,17.0,30.0,1
2034,CC:2F:71:3F:1F:24,8037441,7759136420,4825187,7353398469,3212254,405737951,80,1123562,693418705,1115045,692395859,8517,1022846,1070611,619,4829872,489903,80,5645,130000.0,43333.0,-69.0,-64.0,-73.0,-71.0,-69.0,-64.0,-73.0,-70.0,-85.0,-90.0,-84.0,-90.0,16.0,26.0,11.0,19.0,1
2035,F8:59:71:5A:E0:3D,3310629,546970462,98373,141232309,3212256,405738153,0,96261,99926069,91474,99354111,4787,571958,74114,16,101085,2288,0,509,144444.0,43333.0,-67.0,-72.0,-66.0,-71.0,-67.0,-72.0,-66.0,-71.0,-85.0,-91.0,-85.0,-90.0,18.0,19.0,19.0,19.0,1
2036,CC:2F:71:3E:C5:1F,3223628,407129324,11371,1391037,3212257,405738287,6,48560,4066263,40135,3068045,8425,998218,11987,34,16335,186,6,825,130000.0,39000.0,-69.0,-71.0,-67.0,-60.0,-68.0,-68.0,-67.0,-60.0,-85.0,-91.0,-85.0,-90.0,16.0,20.0,18.0,30.0,1
2037,CC:2F:71:3F:1F:24,8038880,7761361108,4826623,7355622821,3212257,405738287,80,1123871,693639635,1115354,692616789,8517,1022846,1070920,619,4831342,490045,80,5645,130000.0,43333.0,-69.0,-64.0,-73.0,-71.0,-69.0,-64.0,-73.0,-70.0,-85.0,-91.0,-85.0,-90.0,16.0,27.0,12.0,19.0,1
2038,F8:59:71:5A:E0:3D,3310698,547069157,98437,141330327,3212261,405738830,0,96325,100023195,91538,99451237,4787,571958,74178,16,101149,2291,0,509,144444.0,43333.0,-67.0,-72.0,-66.0,-70.0,-67.0,-72.0,-65.0,-70.0,-85.0,-91.0,-85.0,-90.0,18.0,19.0,19.0,20.0,1
2039,CC:2F:71:3E:C5:1F,3223634,407130069,11371,1391037,3212263,405739032,6,48560,4066263,40135,3068045,8425,998218,11987,34,16335,186,6,825,130000.0,39000.0,-69.0,-71.0,-67.0,-60.0,-68.0,-68.0,-67.0,-60.0,-85.0,-91.0,-85.0,-90.0,16.0,20.0,18.0,30.0,1
2040,CC:2F:71:3F:1F:24,8039943,7762984785,4827680,7357245753,3212263,405739032,80,1124175,693860153,1115658,692837307,8517,1022846,1071217,619,4832399,490099,80,5647,130000.0,43333.0,-69.0,-64.0,-74.0,-71.0,-69.0,-64.0,-73.0,-71.0,-85.0,-91.0,-85.0,-90.0,16.0,27.0,11.0,19.0,1
2041,F8:59:71:5A:E0:3D,3310764,547167321,98500,141428229,3212264,405739092,0,96390,100123323,91603,99551365,4787,571958,74241,16,101212,2291,0,509,144444.0,43333.0,-66.0,-72.0,-66.0,-70.0,-66.0,-71.0,-65.0,-70.0,-85.0,-91.0,-85.0,-90.0,19.0,19.0,19.0,20.0,1
2042,CC:2F:71:3E:C5:1F,3223635,407130129,11371,1391037,3212264,405739092,6,48560,4066263,40135,3068045,8425,998218,11987,34,16335,186,6,825,130000.0,39000.0,-69.0,-71.0,-67.0,-60.0,-68.0,-68.0,-67.0,-60.0,-85.0,-91.0,-85.0,-90.0,16.0,20.0,18.0,30.0,1
2043,CC:2F:71:3F:1F:24,8041141,7764827677,4828875,7359088383,3212266,405739294,80,1124460,694075273,1115943,693052427,8517,1022846,1071502,619,4833593,490149,80,5648,130000.0,43333.0,-70.0,-64.0,-74.0,-71.0,-69.0,-64.0,-73.0,-71.0,-85.0,-91.0,-85.0,-90.0,15.0,27.0,11.0,19.0,1
2044,F8:59:71:5A:E0:3D,3310833,547265829,98563,141526131,3212270,405739698,0,96454,100221883,91667,99649925,4787,571958,74305,16,101275,2291,0,509,144444.0,43333.0,-67.0,-72.0,-66.0,-70.0,-66.0,-71.0,-65.0,-70.0,-85.0,-91.0,-85.0,-90.0,18.0,19.0,19.0,20.0,1
2045,CC:2F:71:3E:C5:1F,3223641,407130735,11371,1391037,3212270,405739698,6,48560,4066263,40135,3068045,8425,998218,11987,34,16335,186,6,825,130000.0,39000.0,-69.0,-71.0,-67.0,-60.0,-68.0,-68.0,-67.0,-60.0,-85.0,-91.0,-85.0,-90.0,16.0,20.0,18.0,30.0,1
2046,CC:2F:71:3F:1F:24,8042170,7766394876,4829900,7360655178,3212270,405739698,80,1124760,694292711,1116243,693269865,8517,1022846,1071802,619,4834619,490200,80,5648,130000.0,43333.0,-69.0,-64.0,-72.0,-70.0,-69.0,-64.0,-72.0,-70.0,-85.0,-91.0,-85.0,-90.0,16.0,27.0,13.0,20.0,1
2047,F8:59:71:5A:E0:3D,3310899,547365487,98627,141625587,3212272,405739900,0,96517,100318903,91730,99746945,4787,571958,74368,16,101339,2292,0,509,144444.0,43333.0,-67.0,-72.0,-66.0,-71.0,-67.0,-72.0,-66.0,-71.0,-85.0,-91.0,-85.0,-90.0,18.0,19.0,19.0,19.0,1
2048,CC:2F:71:3E:C5:1F,3223643,407130937,11371,1391037,3212272,405739900,6,48560,4066263,40135,3068045,8425,998218,11987,34,16335,186,6,825,130000.0,39000.0,-69.0,-71.0,-67.0,-60.0,-68.0,-68.0,-67.0,-60.0,-85.0,-91.0,-85.0,-90.0,16.0,20.0,18.0,30.0,1
2049,CC:2F:71:3F:1F:24,8043219,7768003740,4830947,7362263840,3212272,405739900,80,1125059,694508165,1116542,693485319,8517,1022846,1072100,619,4835666,490249,80,5650,130000.0,43333.0,-69.0,-64.0,-73.0,-71.0,-69.0,-64.0,-73.0,-70.0,-85.0,-91.0,-85.0,-90.0,16.0,27.0,12.0,19.0,1
2050,F8:59:71:5A:E0:3D,3310970,547464117,98690,141723489,3212280,405740628,0,96582,100419031,91795,99847073,4787,571958,74431,16,101402,2294,0,509,144444.0,43333.0,-67.0,-72.0,-66.0,-71.0,-67.0,-72.0,-66.0,-70.0,-85.0,-91.0,-85.0,-90.0,18.0,19.0,19.0,19.0,1
2051,CC:2F:71:3E:C5:1F,3223651,407131665,11371,1391037,3212280,405740628,6,48560,4066263,40135,3068045,8425,998218,11987,34,16335,186,6,825,130000.0,39000.0,-69.0,-71.0,-67.0,-60.0,-68.0,-68.0,-67.0,-60.0,-85.0,-90.0,-85.0,-90.0,16.0,19.0,18.0,30.0,1
2052,CC:2F:71:3F:1F:24,8044024,7769218878,4831744,7363478250,3212280,405740628,80,1125315,694718615,1116797,693695651,8518,1022964,1072356,619,4836463,490281,80,5651,130000.0,43333.0,-69.0,-64.0,-73.0,-71.0,-69.0,-64.0,-73.0,-70.0,-85.0,-90.0,-85.0,-90.0,16.0,26.0,12.0,19.0,1
2053,F8:59:71:5A:E0:3D,3311036,547562283,98753,141821391,3212283,405740892,0,96646,100517591,91859,99945633,4787,571958,74495,16,101465,2295,0,509,144444.0,43333.0,-68.0,-72.0,-66.0,-71.0,-67.0,-72.0,-66.0,-70.0,-85.0,-90.0,-85.0,-90.0,17.0,18.0,19.0,19.0,1
2054,CC:2F:71:3E:C5:1F,3223654,407131929,11371,1391037,3212283,405740892,6,48562,4066451,40136,3068115,8426,998336,11988,34,16335,186,6,825,130000.0,39000.0,-69.0,-71.0,-67.0,-60.0,-68.0,-69.0,-67.0,-60.0,-85.0,-90.0,-85.0,-90.0,16.0,19.0,18.0,30.0,1
2055,CC:2F:71:3F:1F:24,8045335,7771240086,4833052,7365499194,3212283,405740892,80,1125623,694936311,1117105,693913347,8518,1022964,1072664,619,4837771,490309,80,5651,130000.0,43333.0,-70.0,-64.0,-74.0,-71.0,-69.0,-64.0,-73.0,-70.0,-85.0,-90.0,-85.0,-90.0,15.0,26.0,11.0,19.0,1
2056,F8:59:71:5A:E0:3D,3311105,547660791,98816,141919293,3212289,405741498,0,96710,100616179,91923,100044221,4787,571958,74557,16,101528,2296,0,509,144444.0,43333.0,-66.0,-72.0,-65.0,-70.0,-66.0,-72.0,-65.0,-70.0,-85.0,-90.0,-85.0,-90.0,19.0,18.0,20.0,20.0,1
2057,CC:2F:71:3E:C5:1F,3223660,407132535,11371,1391037,3212289,405741498,6,48562,4066451,40136,3068115,8426,998336,11988,34,16335,186,6,825,130000.0,39000.0,-69.0,-71.0,-67.0,-60.0,-68.0,-69.0,-67.0,-60.0,-85.0,-90.0,-85.0,-90.0,16.0,19.0,18.0,30.0,1
2058,CC:2F:71:3F:1F:24,8046546,7773092775,4834257,7367351277,3212289,405741498,80,1125915,695150126,1117397,694127162,8518,1022964,1072956,619,4838974,490367,80,5653,130000.0,43333.0,-69.0,-64.0,-72.0,-70.0,-68.0,-64.0,-72.0,-70.0,-85.0,-90.0,-85.0,-90.0,16.0,26.0,13.0,20.0,1
2059,F8:59:71:5A:E0:3D,3311172,547760509,98880,142018749,3212292,405741760,0,96775,100716293,91988,100144335,4787,571958,74621,16,101592,2296,0,509,144444.0,43333.0,-67.0,-72.0,-65.0,-70.0,-66.0,-72.0,-65.0,-70.0,-85.0,-90.0,-85.0,-90.0,18.0,18.0,20.0,20.0,1
2060,CC:2F:71:3E:C5:1F,3223663,407132797,11371,1391037,3212292,405741760,6,48562,4066451,40136,3068115,8426,998336,11988,34,16335,186,6,825,130000.0,39000.0,-69.0,-71.0,-67.0,-60.0,-68.0,-69.0,-67.0,-60.0,-85.0,-90.0,-85.0,-90.0,16.0,19.0,18.0,30.0,1
2061,CC:2F:71:3F:1F:24,8047944,7775251243,4835652,7369509483,3212292,405741760,80,1126248,695375094,1117730,694352130,8518,1022964,1073288,619,4840371,490376,80,5653,130000.0,43333.0,-69.0,-64.0,-72.0,-70.0,-68.0,-64.0,-72.0,-70.0,-85.0,-90.0,-85.0,-90.0,16.0,26.0,13.0,20.0,1
2062,F8:59:71:5A:E0:3D,3311240,547860369,98944,142118205,3212296,405742164,0,96839,100814853,92052,100242895,4787,571958,74685,16,101656,2297,0,509,144444.0,43333.0,-67.0,-72.0,-66.0,-70.0,-67.0,-72.0,-65.0,-70.0,-85.0,-90.0,-85.0,-90.0,18.0,18.0,19.0,20.0,1
2063,CC:2F:71:3E:C5:1F,3223669,407133403,11371,1391037,3212298,405742366,6,48562,4066451,40136,3068115,8426,998336,11988,34,16335,186,6,825,130000.0,39000.0,-69.0,-71.0,-67.0,-60.0,-68.0,-69.0,-67.0,-60.0,-85.0,-90.0,-85.0,-90.0,16.0,19.0,18.0,30.0,1
2064,CC:2F:71:3F:1F:24,8049864,7778228813,4837566,7372486447,3212298,405742366,80,1126596,695599160,1118078,694576196,8518,1022964,1073636,619,4842264,490456,80,5653,130000.0,43333.0,-68.0,-64.0,-72.0,-70.0,-68.0,-64.0,-72.0,-70.0,-85.0,-90.0,-85.0,-90.0,17.0,26.0,13.0,20.0,1
2065,F8:59:71:5A:E0:3D,3311308,547960229,99008,142217661,3212300,405742568,0,96905,100916507,92118,100344549,4787,571958,74750,16,101720,2298,0,509,144444.0,43333.0,-67.0,-72.0,-66.0,-70.0,-66.0,-71.0,-65.0,-70.0,-85.0,-90.0,-85.0,-90.0,18.0,18.0,19.0,20.0,1
2066,CC:2F:71:3E:C5:1F,3223671,407133605,11371,1391037,3212300,405742568,6,48562,4066451,40136,3068115,8426,998336,11988,34,16335,186,6,825,130000.0,39000.0,-69.0,-71.0,-67.0,-60.0,-68.0,-69.0,-67.0,-60.0,-85.0,-90.0,-85.0,-90.0,16.0,19.0,18.0,30.0,1
2067,CC:2F:71:3F:1F:24,8051556,7780853907,4839256,7375111339,3212300,405742568,80,1126945,695827470,1118427,694804506,8518,1022964,1073982,619,4843975,490602,80,5653,130000.0,43333.0,-69.0,-64.0,-72.0,-70.0,-69.0,-64.0,-72.0,-70.0,-85.0,-90.0,-85.0,-90.0,16.0,26.0,13.0,20.0,1
2068,F8:59:71:5A:E0:3D,3311376,548061501,99073,142318671,3212303,405742830,0,96969,101015067,92182,100443109,4787,571958,74814,16,101785,2298,0,509,144444.0,43333.0,-67.0,-72.0,-65.0,-71.0,-66.0,-71.0,-65.0,-70.0,-85.0,-90.0,-85.0,-90.0,18.0,18.0,20.0,19.0,1
2069,CC:2F:71:3E:C5:1F,3223674,407133867,11371,1391037,3212303,405742830,6,48562,4066451,40136,3068115,8426,998336,11988,34,16335,186,6,825,130000.0,39000.0,-69.0,-71.0,-67.0,-60.0,-68.0,-69.0,-67.0,-60.0,-85.0,-90.0,-85.0,-90.0,16.0,19.0,18.0,30.0,1
2070,CC:2F:71:3F:1F:24,8053468,7783817559,4841161,7378074325,3212307,405743234,80,1127279,696051252,1118761,695028288,8518,1022964,1074316,619,4845880,490605,80,5653,130000.0,43333.0,-68.0,-64.0,-72.0,-70.0,-68.0,-64.0,-72.0,-70.0,-85.0,-90.0,-85.0,-90.0,17.0,26.0,13.0,20.0,1
2071,F8:59:71:5A:E0:3D,3311447,548163117,99138,142419681,3212309,405743436,0,97034,101115167,92247,100543209,4787,571958,74879,16,101850,2300,0,509,144444.0,43333.0,-67.0,-72.0,-65.0,-71.0,-66.0,-71.0,-64.0,-70.0,-85.0,-90.0,-85.0,-90.0,18.0,18.0,20.0,19.0,1
2072,CC:2F:71:3E:C5:1F,3223680,407134473,11371,1391037,3212309,405743436,6,48562,4066451,40136,3068115,8426,998336,11988,34,16335,186,6,825,130000.0,39000.0,-69.0,-71.0,-67.0,-60.0,-68.0,-69.0,-67.0,-60.0,-85.0,-90.0,-85.0,-90.0,16.0,19.0,18.0,30.0,1
2073,CC:2F:71:3F:1F:24,8054810,7785881282,4842501,7380137846,3212309,405743436,80,1127575,696272443,1119057,695249479,8518,1022964,1074612,619,4847220,490765,80,5653,117000.0,39000.0,-68.0,-65.0,-72.0,-68.0,-69.0,-65.0,-72.0,-68.0,-85.0,-90.0,-85.0,-90.0,17.0,25.0,13.0,22.0,1
2074,F8:59:71:5A:E0:3D,3311512,548264127,99203,142520691,3212309,405743436,0,97099,101215267,92312,100643309,4787,571958,74944,16,101915,2300,0,509,144444.0,43333.0,-67.0,-72.0,-65.0,-70.0,-67.0,-72.0,-65.0,-70.0,-85.0,-90.0,-85.0,-90.0,18.0,18.0,20.0,20.0,1
2075,CC:2F:71:3E:C5:1F,3223683,407134735,11371,1391037,3212312,405743698,6,48562,4066451,40136,3068115,8426,998336,11988,34,16335,186,6,825,130000.0,39000.0,-69.0,-71.0,-67.0,-60.0,-68.0,-69.0,-67.0,-60.0,-85.0,-90.0,-85.0,-90.0,16.0,19.0,18.0,30.0,1
2076,CC:2F:71:3F:1F:24,8056152,7787954054,4843840,7382210356,3212312,405743698,80,1127873,696490699,1119355,695467735,8518,1022964,1074910,619,4848559,491000,80,5653,115556.0,28889.0,-71.0,-65.0,-75.0,-70.0,-70.0,-64.0,-74.0,-69.0,-85.0,-90.0,-85.0,-90.0,14.0,25.0,10.0,20.0,1
2077,F8:59:71:5A:E0:3D,3311587,548367559,99269,142623255,3212318,405744304,0,97165,101316907,92378,100744949,4787,571958,75010,16,101981,2300,0,509,144444.0,43333.0,-67.0,-73.0,-66.0,-71.0,-67.0,-72.0,-65.0,-71.0,-85.0,-90.0,-85.0,-90.0,18.0,17.0,19.0,19.0,1
2078,CC:2F:71:3E:C5:1F,3223689,407135341,11371,1391037,3212318,405744304,6,48562,4066451,40136,3068115,8426,998336,11988,34,16335,186,6,825,130000.0,39000.0,-69.0,-71.0,-67.0,-60.0,-68.0,-69.0,-67.0,-60.0,-85.0,-90.0,-85.0,-90.0,16.0,19.0,18.0,30.0,1
2079,CC:2F:71:3F:1F:24,8057603,7790191550,4845285,7384447246,3212318,405744304,80,1128175,696712271,1119657,695689307,8518,1022964,1075212,619,4850004,491066,80,5654,115556.0,28889.0,-70.0,-65.0,-74.0,-70.0,-70.0,-64.0,-74.0,-69.0,-85.0,-90.0,-85.0,-90.0,15.0,25.0,11.0,20.0,1
2080,F8:59:71:5A:E0:3D,3311649,548462626,99330,142718049,3212319,405744577,0,97227,101412415,92440,100840457,4787,571958,75072,16,102042,2300,0,509,144444.0,43333.0,-67.0,-72.0,-66.0,-71.0,-66.0,-72.0,-65.0,-71.0,-85.0,-90.0,-85.0,-90.0,18.0,18.0,19.0,19.0,1
2081,CC:2F:71:3E:C5:1F,3223690,407135614,11371,1391037,3212319,405744577,6,48562,4066451,40136,3068115,8426,998336,11988,34,16335,186,6,825,130000.0,39000.0,-69.0,-71.0,-67.0,-60.0,-68.0,-69.0,-67.0,-60.0,-85.0,-90.0,-85.0,-90.0,16.0,19.0,18.0,30.0,1
2082,CC:2F:71:3F:1F:24,8058522,7791595535,4846202,7385850824,3212320,405744711,80,1128448,696926243,1119930,695903279,8518,1022964,1075485,619,4850921,491137,80,5655,130000.0,43333.0,-70.0,-65.0,-73.0,-70.0,-70.0,-64.0,-73.0,-69.0,-85.0,-90.0,-85.0,-90.0,15.0,25.0,12.0,20.0,1
2083,F8:59:71:5A:E0:3D,3311720,548562748,99394,142817505,3212326,405745243,0,97291,101510975,92504,100939017,4787,571958,75136,16,102106,2300,0,509,144444.0,43333.0,-67.0,-73.0,-66.0,-72.0,-67.0,-72.0,-65.0,-71.0,-85.0,-90.0,-85.0,-90.0,18.0,17.0,19.0,18.0,1
2084,CC:2F:71:3E:C5:1F,3223699,407136482,11371,1391037,3212328,405745445,6,48562,4066451,40136,3068115,8426,998336,11988,34,16335,186,6,825,130000.0,39000.0,-69.0,-71.0,-67.0,-60.0,-68.0,-69.0,-67.0,-60.0,-85.0,-90.0,-85.0,-90.0,16.0,19.0,18.0,30.0,1
2085,CC:2F:71:3F:1F:24,8059721,7793421722,4847393,7387676277,3212328,405745445,80,1128754,697141467,1120236,696118503,8518,1022964,1075791,619,4852109,491189,80,5655,130000.0,43333.0,-70.0,-64.0,-74.0,-69.0,-69.0,-64.0,-74.0,-69.0,-85.0,-90.0,-85.0,-90.0,15.0,26.0,11.0,21.0,1
2086,F8:59:71:5A:E0:3D,3311788,548665514,99460,142920069,3212328,405745445,0,97359,101615835,92572,101043877,4787,571958,75201,16,102172,2301,0,509,144444.0,43333.0,-67.0,-72.0,-65.0,-71.0,-66.0,-71.0,-65.0,-70.0,-85.0,-90.0,-85.0,-90.0,18.0,18.0,20.0,19.0,1
2087,CC:2F:71:3E:C5:1F,3223699,407136482,11371,1391037,3212328,405745445,6,48562,4066451,40136,3068115,8426,998336,11988,34,16335,186,6,825,130000.0,39000.0,-69.0,-71.0,-67.0,-60.0,-68.0,-69.0,-67.0,-60.0,-85.0,-90.0,-85.0,-90.0,16.0,19.0,18.0,30.0,1
2088,CC:2F:71:3F:1F:24,8061248,7795787776,4848920,7390042331,3212328,405745445,80,1129077,697372863,1120559,696349899,8518,1022964,1076114,619,4853599,491466,80,5656,115556.0,28889.0,-71.0,-65.0,-74.0,-68.0,-71.0,-65.0,-73.0,-68.0,-85.0,-90.0,-85.0,-90.0,14.0,25.0,11.0,22.0,1
2089,F8:59:71:5A:E0:3D,3311859,548767130,99525,143021079,3212334,405746051,0,97425,101717489,92638,101145531,4787,571958,75266,16,102237,2302,0,509,144444.0,43333.0,-67.0,-72.0,-66.0,-71.0,-67.0,-72.0,-66.0,-71.0,-85.0,-90.0,-85.0,-90.0,18.0,18.0,19.0,19.0,1
2090,CC:2F:71:3E:C5:1F,3223705,407137088,11371,1391037,3212334,405746051,6,48562,4066451,40136,3068115,8426,998336,11988,34,16335,186,6,825,130000.0,39000.0,-69.0,-71.0,-67.0,-60.0,-68.0,-69.0,-67.0,-60.0,-85.0,-90.0,-85.0,-90.0,16.0,19.0,18.0,30.0,1
2091,CC:2F:71:3F:1F:24,8062915,7798363334,4850579,7392617081,3212336,405746253,80,1129418,697597733,1120900,696574769,8518,1022964,1076455,619,4855298,491543,80,5656,115556.0,28889.0,-69.0,-65.0,-73.0,-71.0,-69.0,-64.0,-72.0,-71.0,-85.0,-90.0,-85.0,-90.0,16.0,25.0,12.0,19.0,1
2092,F8:59:71:5A:E0:3D,3311927,548868402,99590,143122089,3212337,405746313,0,97490,101817589,92703,101245631,4787,571958,75331,16,102302,2302,0,509,144444.0,43333.0,-67.0,-72.0,-66.0,-72.0,-66.0,-71.0,-65.0,-71.0,-85.0,-90.0,-85.0,-90.0,18.0,18.0,19.0,18.0,1
2093,CC:2F:71:3E:C5:1F,3223708,407137350,11371,1391037,3212337,405746313,6,48562,4066451,40136,3068115,8426,998336,11988,34,16335,186,6,825,130000.0,39000.0,-69.0,-71.0,-67.0,-60.0,-68.0,-69.0,-67.0,-60.0,-85.0,-90.0,-85.0,-90.0,16.0,19.0,18.0,30.0,1
2094,CC:2F:71:3F:1F:24,8064568,7800928490,4852231,7395182177,3212337,405746313,80,1129759,697823793,1121241,696800829,8518,1022964,1076796,619,4856935,491653,80,5656,117000.0,39000.0,-70.0,-64.0,-73.0,-70.0,-69.0,-64.0,-72.0,-70.0,-85.0,-90.0,-85.0,-90.0,15.0,26.0,12.0,20.0,1
2095,F8:59:71:5A:E0:3D,3311997,548968464,99654,143221545,3212343,405746919,0,97554,101916149,92767,101344191,4787,571958,75395,16,102366,2303,0,509,144444.0,43333.0,-67.0,-71.0,-65.0,-70.0,-66.0,-71.0,-65.0,-70.0,-85.0,-90.0,-85.0,-90.0,18.0,19.0,20.0,20.0,1
2096,CC:2F:71:3E:C5:1F,3223714,407137956,11371,1391037,3212343,405746919,6,48562,4066451,40136,3068115,8426,998336,11988,34,16335,186,6,825,130000.0,39000.0,-69.0,-71.0,-67.0,-60.0,-68.0,-69.0,-67.0,-60.0,-85.0,-90.0,-85.0,-90.0,16.0,19.0,18.0,30.0,1
2097,CC:2F:71:3F:1F:24,8065954,7803049976,4853609,7397302689,3212345,405747287,80,1130077,698044752,1121559,697021788,8518,1022964,1077113,619,4858305,491715,80,5657,117000.0,39000.0,-70.0,-64.0,-73.0,-69.0,-69.0,-64.0,-72.0,-69.0,-85.0,-90.0,-85.0,-90.0,15.0,26.0,12.0,21.0,1
2098,F8:59:71:5A:E0:3D,3312068,549070222,99720,143322671,3212348,405747551,0,97619,102016249,92832,101444291,4787,571958,75460,16,102432,2303,0,509,144444.0,43333.0,-66.0,-71.0,-65.0,-71.0,-66.0,-71.0,-65.0,-70.0,-85.0,-90.0,-85.0,-91.0,19.0,19.0,20.0,20.0,1
2099,CC:2F:71:3E:C5:1F,3223720,407138704,11372,1391153,3212348,405747551,6,48566,4066779,40139,3068325,8427,998454,11989,34,16336,186,6,825,130000.0,39000.0,-69.0,-71.0,-68.0,-60.0,-68.0,-69.0,-67.0,-60.0,-85.0,-90.0,-85.0,-91.0,16.0,19.0,17.0,31.0,1
2100,CC:2F:71:3F:1F:24,8067609,7805612322,4855261,7399864771,3212348,405747551,80,1130452,698277436,1121934,697254472,8518,1022964,1077488,619,4859980,491738,80,5657,130000.0,43333.0,-69.0,-64.0,-72.0,-70.0,-69.0,-64.0,-72.0,-70.0,-85.0,-90.0,-85.0,-91.0,16.0,26.0,13.0,21.0,1
2101,F8:59:71:5A:E0:3D,3312140,549171842,99785,143423625,3212355,405748217,0,97685,102117945,92898,101545987,4787,571958,75525,16,102497,2304,0,509,130000.0,39000.0,-68.0,-72.0,-66.0,-72.0,-67.0,-72.0,-66.0,-71.0,-85.0,-90.0,-85.0,-91.0,17.0,18.0,19.0,19.0,1
2102,CC:2F:71:3E:C5:1F,3223727,407139370,11372,1391153,3212355,405748217,6,48566,4066779,40139,3068325,8427,998454,11989,34,16336,186,6,825,130000.0,39000.0,-69.0,-71.0,-68.0,-60.0,-68.0,-69.0,-67.0,-60.0,-85.0,-90.0,-85.0,-91.0,16.0,19.0,17.0,31.0,1
2103,CC:2F:71:3F:1F:24,8069400,7808384812,4857045,7402636595,3212355,405748217,80,1130782,698499564,1122264,697476600,8518,1022964,1077818,619,4861764,491783,80,5658,130000.0,43333.0,-70.0,-65.0,-73.0,-70.0,-70.0,-64.0,-73.0,-70.0,-85.0,-90.0,-85.0,-91.0,15.0,25.0,12.0,21.0,1
2104,F8:59:71:5A:E0:3D,3312206,549271388,99849,143522969,3212357,405748419,0,97750,102218059,92963,101646101,4787,571958,75589,16,102560,2304,0,509,144444.0,43333.0,-67.0,-72.0,-66.0,-71.0,-67.0,-72.0,-65.0,-71.0,-85.0,-90.0,-85.0,-91.0,18.0,18.0,19.0,20.0,1
2105,CC:2F:71:3E:C5:1F,3223729,407139572,11372,1391153,3212357,405748419,6,48566,4066779,40139,3068325,8427,998454,11989,34,16336,186,6,825,130000.0,39000.0,-69.0,-71.0,-68.0,-60.0,-68.0,-69.0,-67.0,-60.0,-85.0,-90.0,-85.0,-91.0,16.0,19.0,17.0,31.0,1
2106,CC:2F:71:3F:1F:24,8070652,7810314210,4858295,7404565791,3212357,405748419,80,1131101,698718670,1122583,697695706,8518,1022964,1078136,619,4863013,491849,80,5658,130000.0,43333.0,-70.0,-65.0,-72.0,-70.0,-70.0,-64.0,-73.0,-70.0,-85.0,-90.0,-85.0,-91.0,15.0,25.0,13.0,21.0,1
2107,F8:59:71:5A:E0:3D,3312276,549370012,99913,143620987,3212363,405749025,0,97816,102318279,93029,101746321,4787,571958,75654,16,102625,2304,0,509,144444.0,43333.0,-67.0,-72.0,-66.0,-71.0,-67.0,-71.0,-65.0,-71.0,-85.0,-90.0,-85.0,-91.0,18.0,18.0,19.0,20.0,1
2108,CC:2F:71:3E:C5:1F,3223735,407140178,11372,1391153,3212363,405749025,6,48566,4066779,40139,3068325,8427,998454,11989,34,16336,186,6,825,130000.0,39000.0,-69.0,-71.0,-68.0,-60.0,-68.0,-69.0,-67.0,-60.0,-85.0,-90.0,-85.0,-91.0,16.0,19.0,17.0,31.0,1
2109,CC:2F:71:3F:1F:24,8071841,7812129476,4859478,7406380451,3212363,405749025,80,1131396,698936847,1122878,697913883,8518,1022964,1078431,619,4864171,491861,80,5658,130000.0,43333.0,-70.0,-65.0,-73.0,-70.0,-70.0,-65.0,-73.0,-70.0,-85.0,-90.0,-85.0,-91.0,15.0,25.0,12.0,21.0,1
2110,F8:59:71:5A:E0:3D,3312342,549468176,99976,143718889,3212366,405749287,0,97879,102415313,93092,101843355,4787,571958,75716,16,102688,2306,0,509,144444.0,43333.0,-67.0,-72.0,-66.0,-71.0,-67.0,-71.0,-65.0,-71.0,-85.0,-90.0,-85.0,-91.0,18.0,18.0,19.0,20.0,1
2111,CC:2F:71:3E:C5:1F,3223738,407140440,11372,1391153,3212366,405749287,6,48566,4066779,40139,3068325,8427,998454,11989,34,16336,186,6,825,130000.0,39000.0,-69.0,-71.0,-68.0,-60.0,-68.0,-69.0,-67.0,-60.0,-85.0,-90.0,-85.0,-91.0,16.0,19.0,17.0,31.0,1
2112,CC:2F:71:3F:1F:24,8073226,7814266990,4860860,7408517703,3212366,405749287,80,1131723,699159739,1123205,698136775,8518,1022964,1078758,619,4865539,492004,80,5658,104000.0,26000.0,-69.0,-65.0,-72.0,-70.0,-69.0,-65.0,-72.0,-69.0,-85.0,-90.0,-85.0,-91.0,16.0,25.0,13.0,21.0,1
2113,F8:59:71:5A:E0:3D,3312416,549574376,100044,143824561,3212372,405749815,0,97949,102521705,93161,101949629,4788,572076,75785,16,102756,2306,0,509,144444.0,43333.0,-67.0,-73.0,-66.0,-71.0,-66.0,-72.0,-65.0,-70.0,-85.0,-90.0,-85.0,-91.0,18.0,17.0,19.0,20.0,1
2114,CC:2F:71:3E:C5:1F,3223744,407140968,11372,1391153,3212372,405749815,6,48566,4066779,40139,3068325,8427,998454,11989,34,16336,186,6,825,130000.0,39000.0,-69.0,-71.0,-68.0,-60.0,-68.0,-69.0,-67.0,-60.0,-85.0,-90.0,-85.0,-91.0,16.0,19.0,17.0,31.0,1
2115,CC:2F:71:3F:1F:24,8075155,7817255746,4862781,7411505729,3212374,405750017,80,1132103,699394719,1123584,698371637,8519,1023082,1079138,619,4867497,492203,80,5658,115556.0,28889.0,-70.0,-65.0,-74.0,-70.0,-70.0,-65.0,-74.0,-70.0,-85.0,-90.0,-85.0,-91.0,15.0,25.0,11.0,21.0,1
2116,F8:59:71:5A:E0:3D,3312503,549690598,100115,143934895,3212388,405755703,0,98021,102632627,93233,102060551,4788,572076,75856,16,102827,2306,0,509,144444.0,43333.0,-67.0,-73.0,-66.0,-71.0,-66.0,-72.0,-65.0,-71.0,-85.0,-90.0,-85.0,-91.0,18.0,17.0,19.0,20.0,1
2117,CC:2F:71:3E:C5:1F,3223771,407152280,11372,1391153,3212399,405761127,6,48566,4066779,40139,3068325,8427,998454,11989,34,16336,186,6,825,130000.0,39000.0,-69.0,-71.0,-68.0,-60.0,-68.0,-69.0,-67.0,-60.0,-85.0,-90.0,-85.0,-91.0,16.0,19.0,17.0,31.0,1
2118,CC:2F:71:3F:1F:24,8076649,7819541378,4864250,7413780251,3212399,405761127,80,1132432,699644093,1123913,698621011,8519,1023082,1079467,619,4868969,492374,80,5659,115556.0,28889.0,-69.0,-64.0,-73.0,-69.0,-69.0,-64.0,-73.0,-69.0,-85.0,-90.0,-85.0,-91.0,16.0,26.0,12.0,22.0,1
2119,F8:59:71:5A:E0:3D,3312585,549800544,100182,144039013,3212403,405761531,0,98089,102737417,93301,102165341,4788,572076,75923,16,102894,2306,0,509,144444.0,43333.0,-67.0,-73.0,-66.0,-71.0,-66.0,-72.0,-65.0,-70.0,-85.0,-90.0,-85.0,-91.0,18.0,17.0,19.0,20.0,1
2120,CC:2F:71:3E:C5:1F,3223775,407152684,11372,1391153,3212403,405761531,6,48566,4066779,40139,3068325,8427,998454,11989,34,16336,186,6,825,130000.0,39000.0,-69.0,-71.0,-68.0,-60.0,-68.0,-69.0,-67.0,-60.0,-85.0,-90.0,-85.0,-91.0,16.0,19.0,17.0,31.0,1
2121,CC:2F:71:3F:1F:24,8078022,7821651118,4865619,7415889587,3212403,405761531,80,1132751,699868056,1124232,698844974,8519,1023082,1079786,619,4870338,492496,80,5659,115556.0,28889.0,-69.0,-65.0,-72.0,-68.0,-69.0,-65.0,-72.0,-68.0,-85.0,-90.0,-85.0,-91.0,16.0,25.0,13.0,23.0,1
2122,F8:59:71:5A:E0:3D,3312653,549899123,100245,144136915,3212408,405762208,0,98155,102839169,93367,102267093,4788,572076,75987,16,102957,2306,0,509,144444.0,43333.0,-67.0,-73.0,-66.0,-71.0,-66.0,-72.0,-66.0,-71.0,-85.0,-90.0,-85.0,-91.0,18.0,17.0,19.0,20.0,1
2123,CC:2F:71:3E:C5:1F,3223780,407153361,11372,1391153,3212408,405762208,6,48566,4066779,40139,3068325,8427,998454,11989,34,16336,186,6,825,130000.0,39000.0,-69.0,-71.0,-68.0,-60.0,-68.0,-69.0,-67.0,-60.0,-85.0,-90.0,-85.0,-91.0,16.0,19.0,17.0,31.0,1
2124,CC:2F:71:3F:1F:24,8079534,7823986537,4867126,7418224329,3212408,405762208,80,1133087,700089172,1124568,699066090,8519,1023082,1080122,619,4871845,492652,80,5659,115556.0,28889.0,-70.0,-65.0,-73.0,-68.0,-69.0,-65.0,-72.0,-68.0,-85.0,-90.0,-85.0,-91.0,15.0,25.0,12.0,23.0,1
2125,F8:59:71:5A:E0:3D,3312719,550000193,100310,144237925,3212409,405762268,0,98219,102937729,93431,102365653,4788,572076,76051,16,103022,2307,0,509,144444.0,43333.0,-66.0,-72.0,-65.0,-71.0,-66.0,-71.0,-65.0,-70.0,-85.0,-90.0,-85.0,-91.0,19.0,18.0,20.0,20.0,1
2126,CC:2F:71:3E:C5:1F,3223783,407153623,11372,1391153,3212411,405762470,6,48566,4066779,40139,3068325,8427,998454,11989,34,16336,186,6,825,130000.0,39000.0,-69.0,-71.0,-68.0,-60.0,-68.0,-69.0,-67.0,-60.0,-85.0,-90.0,-85.0,-91.0,16.0,19.0,17.0,31.0,1
2127,CC:2F:71:3F:1F:24,8081237,7826623341,4868824,7420860669,3212413,405762672,80,1133465,700316690,1124946,699293608,8519,1023082,1080500,619,4873543,492719,80,5659,115556.0,28889.0,-71.0,-65.0,-73.0,-68.0,-70.0,-65.0,-72.0,-68.0,-85.0,-90.0,-85.0,-91.0,14.0,25.0,12.0,23.0,1
2128,F8:59:71:5A:E0:3D,3312790,550098903,100373,144335827,3212417,405763076,0,98282,103034749,93494,102462673,4788,572076,76114,16,103085,2307,0,509,144444.0,43333.0,-67.0,-71.0,-66.0,-71.0,-66.0,-70.0,-65.0,-70.0,-85.0,-90.0,-85.0,-91.0,18.0,19.0,19.0,20.0,1
2129,CC:2F:71:3E:C5:1F,3223789,407154229,11372,1391153,3212417,405763076,6,48566,4066779,40139,3068325,8427,998454,11989,34,16336,186,6,825,130000.0,39000.0,-69.0,-71.0,-68.0,-60.0,-68.0,-69.0,-67.0,-60.0,-85.0,-90.0,-85.0,-91.0,16.0,19.0,17.0,31.0,1
2130,CC:2F:71:3F:1F:24,8083074,7829472547,4870657,7423709471,3212417,405763076,80,1133820,700538642,1125301,699515560,8519,1023082,1080855,619,4875376,492833,80,5659,130000.0,43333.0,-71.0,-64.0,-73.0,-69.0,-70.0,-64.0,-72.0,-69.0,-85.0,-90.0,-85.0,-91.0,14.0,26.0,12.0,22.0,1
2131,F8:59:71:5A:E0:3D,3312854,550198359,100437,144435283,3212417,405763076,0,98346,103133309,93558,102561233,4788,572076,76178,16,103149,2307,0,509,144444.0,43333.0,-67.0,-72.0,-66.0,-71.0,-67.0,-71.0,-65.0,-70.0,-85.0,-90.0,-85.0,-91.0,18.0,18.0,19.0,20.0,1
2132,CC:2F:71:3E:C5:1F,3223789,407154229,11372,1391153,3212417,405763076,6,48566,4066779,40139,3068325,8427,998454,11989,34,16336,186,6,825,130000.0,39000.0,-69.0,-71.0,-68.0,-60.0,-68.0,-69.0,-67.0,-60.0,-85.0,-90.0,-85.0,-91.0,16.0,19.0,17.0,31.0,1
2133,CC:2F:71:3F:1F:24,8084849,7832227047,4872430,7426463769,3212419,405763278,80,1134158,700771308,1125639,699748226,8519,1023082,1081193,619,4877149,492998,80,5659,130000.0,43333.0,-70.0,-64.0,-71.0,-69.0,-70.0,-64.0,-72.0,-69.0,-85.0,-90.0,-85.0,-91.0,15.0,26.0,14.0,22.0,1
2134,F8:59:71:5A:E0:3D,3312930,550303345,100504,144539401,3212426,405763944,0,98414,103238113,93626,102666037,4788,572076,76246,16,103216,2310,0,509,144444.0,43333.0,-67.0,-71.0,-65.0,-70.0,-66.0,-71.0,-65.0,-70.0,-85.0,-90.0,-85.0,-91.0,18.0,19.0,20.0,21.0,1
2135,CC:2F:71:3E:C5:1F,3223798,407155097,11372,1391153,3212426,405763944,6,48566,4066779,40139,3068325,8427,998454,11989,34,16336,186,6,825,130000.0,39000.0,-69.0,-71.0,-68.0,-60.0,-68.0,-69.0,-67.0,-60.0,-84.0,-90.0,-84.0,-90.0,15.0,19.0,16.0,30.0,1
2136,CC:2F:71:3F:1F:24,8086121,7834171439,4873695,7428407495,3212426,405763944,80,1134470,700997782,1125951,699974700,8519,1023082,1081502,619,4878414,493156,80,5659,130000.0,43333.0,-71.0,-64.0,-74.0,-69.0,-70.0,-64.0,-73.0,-69.0,-84.0,-90.0,-84.0,-90.0,13.0,26.0,10.0,21.0,1
2137,F8:59:71:5A:E0:3D,3312997,550407463,100571,144643519,3212426,405763944,0,98481,103341307,93693,102769231,4788,572076,76312,16,103283,2310,0,509,144444.0,43333.0,-67.0,-71.0,-65.0,-70.0,-67.0,-71.0,-65.0,-70.0,-84.0,-90.0,-84.0,-90.0,17.0,19.0,19.0,20.0,1
2138,CC:2F:71:3E:C5:1F,3223798,407155097,11372,1391153,3212426,405763944,6,48566,4066779,40139,3068325,8427,998454,11989,34,16336,186,6,825,130000.0,39000.0,-69.0,-71.0,-68.0,-60.0,-68.0,-69.0,-67.0,-60.0,-84.0,-90.0,-84.0,-90.0,15.0,19.0,16.0,30.0,1
2139,CC:2F:71:3F:1F:24,8087063,7835614475,4874637,7429850531,3212426,405763944,80,1134756,701214380,1126237,700191298,8519,1023082,1081788,619,4879356,493235,80,5659,130000.0,43333.0,-71.0,-65.0,-73.0,-70.0,-70.0,-65.0,-73.0,-69.0,-84.0,-90.0,-84.0,-90.0,13.0,25.0,11.0,20.0,1
2140,F8:59:71:5A:E0:3D,3313069,550507615,100635,144742863,3212434,405764752,0,98545,103439867,93757,102867791,4788,572076,76376,16,103347,2313,0,509,144444.0,43333.0,-67.0,-72.0,-65.0,-70.0,-67.0,-71.0,-65.0,-70.0,-84.0,-90.0,-84.0,-90.0,17.0,18.0,19.0,20.0,1
2141,CC:2F:71:3E:C5:1F,3223806,407155905,11372,1391153,3212434,405764752,6,48566,4066779,40139,3068325,8427,998454,11989,34,16336,186,6,825,130000.0,39000.0,-69.0,-71.0,-68.0,-60.0,-68.0,-69.0,-67.0,-60.0,-84.0,-90.0,-84.0,-90.0,15.0,19.0,16.0,30.0,1
2142,CC:2F:71:3F:1F:24,8088080,7837165605,4875646,7431400853,3212434,405764752,80,1135020,701428678,1126501,700405596,8519,1023082,1082052,619,4880335,493410,80,5661,130000.0,43333.0,-71.0,-64.0,-73.0,-69.0,-70.0,-64.0,-72.0,-69.0,-84.0,-90.0,-84.0,-90.0,13.0,26.0,11.0,21.0,1
2143,F8:59:71:5A:E0:3D,3313133,550605577,100698,144840765,3212435,405764812,0,98611,103541535,93823,102969459,4788,572076,76440,16,103410,2314,0,509,144444.0,43333.0,-67.0,-72.0,-66.0,-70.0,-66.0,-71.0,-65.0,-70.0,-84.0,-90.0,-84.0,-90.0,17.0,18.0,18.0,20.0,1
2144,CC:2F:71:3E:C5:1F,3223807,407155965,11372,1391153,3212435,405764812,6,48566,4066779,40139,3068325,8427,998454,11989,34,16336,186,6,825,130000.0,39000.0,-69.0,-71.0,-68.0,-60.0,-68.0,-69.0,-67.0,-60.0,-84.0,-90.0,-84.0,-90.0,15.0,19.0,16.0,30.0,1
2145,CC:2F:71:3F:1F:24,8089469,7839312825,4877034,7433548013,3212435,405764812,80,1135339,701651972,1126820,700628890,8519,1023082,1082370,619,4881724,493589,80,5661,130000.0,43333.0,-71.0,-64.0,-74.0,-69.0,-70.0,-64.0,-72.0,-69.0,-84.0,-90.0,-84.0,-90.0,13.0,26.0,10.0,21.0,1
2146,F8:59:71:5A:E0:3D,3313203,550705639,100762,144940221,3212441,405765418,0,98675,103640109,93887,103068033,4788,572076,76503,16,103474,2314,0,509,144444.0,43333.0,-67.0,-71.0,-65.0,-71.0,-67.0,-71.0,-65.0,-70.0,-84.0,-90.0,-84.0,-90.0,17.0,19.0,19.0,19.0,1
2147,CC:2F:71:3E:C5:1F,3223813,407156571,11372,1391153,3212441,405765418,6,48566,4066779,40139,3068325,8427,998454,11989,34,16336,186,6,825,130000.0,39000.0,-69.0,-71.0,-68.0,-60.0,-68.0,-69.0,-67.0,-60.0,-84.0,-90.0,-84.0,-90.0,15.0,19.0,16.0,30.0,1
2148,CC:2F:71:3F:1F:24,8090881,7841478490,4878438,7435712870,3212443,405765620,80,1135653,701870969,1127134,700847887,8519,1023082,1082684,619,4883157,493756,80,5661,130000.0,43333.0,-70.0,-64.0,-73.0,-69.0,-70.0,-64.0,-73.0,-69.0,-84.0,-90.0,-84.0,-90.0,14.0,26.0,11.0,21.0,1
2149,F8:59:71:5A:E0:3D,3313270,550806851,100827,145041231,3212443,405765620,0,98741,103741763,93953,103169687,4788,572076,76568,16,103539,2317,0,509,144444.0,43333.0,-67.0,-72.0,-66.0,-71.0,-67.0,-72.0,-65.0,-70.0,-84.0,-90.0,-84.0,-90.0,17.0,18.0,18.0,19.0,1
2150,CC:2F:71:3E:C5:1F,3223815,407156773,11372,1391153,3212443,405765620,6,48566,4066779,40139,3068325,8427,998454,11989,34,16336,186,6,825,130000.0,39000.0,-69.0,-71.0,-68.0,-60.0,-68.0,-69.0,-67.0,-60.0,-84.0,-90.0,-84.0,-90.0,15.0,19.0,16.0,30.0,1
2151,CC:2F:71:3F:1F:24,8092049,7843276724,4879605,7437511044,3212444,405765680,80,1135930,702088141,1127411,701065059,8519,1023082,1082961,619,4884324,494004,80,5661,130000.0,43333.0,-70.0,-64.0,-73.0,-69.0,-70.0,-64.0,-72.0,-69.0,-84.0,-90.0,-84.0,-90.0,14.0,26.0,11.0,21.0,1
2152,F8:59:71:5A:E0:3D,3313342,550911433,100894,145145349,3212448,405766084,0,98808,103844943,94020,103272867,4788,572076,76635,16,103605,2318,0,509,144444.0,43333.0,-67.0,-72.0,-66.0,-71.0,-67.0,-72.0,-66.0,-71.0,-84.0,-90.0,-84.0,-90.0,17.0,18.0,18.0,19.0,1
2153,CC:2F:71:3E:C5:1F,3223820,407157237,11372,1391153,3212448,405766084,6,48566,4066779,40139,3068325,8427,998454,11989,34,16336,186,6,825,130000.0,39000.0,-69.0,-71.0,-68.0,-60.0,-68.0,-69.0,-67.0,-60.0,-84.0,-90.0,-84.0,-90.0,15.0,19.0,16.0,30.0,1
2154,CC:2F:71:3F:1F:24,8093682,7845802936,4881232,7440036650,3212450,405766286,80,1136271,702333015,1127752,701309933,8519,1023082,1083275,619,4885929,494143,80,5661,130000.0,43333.0,-70.0,-64.0,-72.0,-69.0,-69.0,-64.0,-72.0,-69.0,-84.0,-90.0,-84.0,-90.0,14.0,26.0,12.0,21.0,1
2155,F8:59:71:5A:E0:3D,3313411,551012847,100959,145246359,3212452,405766488,0,98873,103945043,94085,103372967,4788,572076,76700,16,103671,2319,0,509,144444.0,43333.0,-67.0,-72.0,-66.0,-71.0,-67.0,-72.0,-66.0,-71.0,-84.0,-90.0,-84.0,-90.0,17.0,18.0,18.0,19.0,1
2156,CC:2F:71:3E:C5:1F,3223824,407157641,11372,1391153,3212452,405766488,6,48566,4066779,40139,3068325,8427,998454,11989,34,16336,186,6,825,130000.0,39000.0,-69.0,-71.0,-68.0,-60.0,-68.0,-69.0,-67.0,-60.0,-84.0,-90.0,-84.0,-90.0,15.0,19.0,16.0,30.0,1
2157,CC:2F:71:3F:1F:24,8095065,7847940116,4882613,7442173628,3212452,405766488,80,1136591,702585433,1128072,701562351,8519,1023082,1083578,619,4887331,494574,80,5661,115556.0,26000.0,-71.0,-65.0,-74.0,-70.0,-70.0,-64.0,-73.0,-69.0,-84.0,-90.0,-84.0,-90.0,13.0,25.0,10.0,20.0,1
2158,F8:59:71:5A:E0:3D,3313487,551122311,101029,145355139,3212458,405767172,0,98943,104052927,94155,103480851,4788,572076,76770,16,103740,2319,0,509,144444.0,43333.0,-68.0,-72.0,-66.0,-71.0,-67.0,-72.0,-66.0,-71.0,-84.0,-90.0,-84.0,-90.0,16.0,18.0,18.0,19.0,1
2159,CC:2F:71:3E:C5:1F,3223830,407158325,11372,1391153,3212458,405767172,6,48566,4066779,40139,3068325,8427,998454,11989,34,16336,186,6,825,130000.0,39000.0,-69.0,-71.0,-68.0,-60.0,-68.0,-69.0,-67.0,-60.0,-84.0,-90.0,-84.0,-90.0,15.0,19.0,16.0,30.0,1
2160,CC:2F:71:3F:1F:24,8096332,7849879997,4883874,7444112825,3212458,405767172,80,1136911,702812674,1128392,701789592,8519,1023082,1083894,619,4888593,494609,80,5665,115556.0,28889.0,-70.0,-64.0,-73.0,-69.0,-69.0,-64.0,-72.0,-68.0,-84.0,-90.0,-84.0,-90.0,14.0,26.0,11.0,21.0,1
2161,F8:59:71:5A:E0:3D,3313555,551222171,101093,145454595,3212462,405767576,0,99008,104153153,94220,103581077,4788,572076,76835,16,103805,2319,0,509,144444.0,43333.0,-68.0,-72.0,-66.0,-71.0,-67.0,-72.0,-65.0,-71.0,-84.0,-90.0,-84.0,-90.0,16.0,18.0,18.0,19.0,1
2162,CC:2F:71:3E:C5:1F,3223834,407158729,11372,1391153,3212462,405767576,6,48566,4066779,40139,3068325,8427,998454,11989,34,16336,186,6,825,130000.0,39000.0,-69.0,-71.0,-68.0,-60.0,-68.0,-69.0,-67.0,-60.0,-84.0,-90.0,-84.0,-90.0,15.0,19.0,16.0,30.0,1
2163,CC:2F:71:3F:1F:24,8097451,7851596671,4884989,7445829095,3212462,405767576,80,1137212,703031232,1128693,702008150,8519,1023082,1084194,619,4889708,494618,80,5665,115556.0,28889.0,-69.0,-64.0,-72.0,-69.0,-69.0,-64.0,-72.0,-69.0,-84.0,-90.0,-84.0,-90.0,15.0,26.0,12.0,21.0,1
2164,F8:59:71:5A:E0:3D,3313624,551322304,101157,145554051,3212467,405768253,0,99072,104251727,94284,103679651,4788,572076,76898,16,103869,2320,0,509,144444.0,43333.0,-67.0,-72.0,-66.0,-71.0,-67.0,-71.0,-65.0,-71.0,-85.0,-91.0,-85.0,-91.0,18.0,19.0,19.0,20.0,1
2165,CC:2F:71:3E:C5:1F,3223839,407159406,11372,1391153,3212467,405768253,6,48566,4066779,40139,3068325,8427,998454,11989,34,16336,186,6,825,130000.0,39000.0,-69.0,-71.0,-68.0,-60.0,-68.0,-69.0,-67.0,-60.0,-85.0,-91.0,-85.0,-91.0,16.0,20.0,17.0,31.0,1
2166,CC:2F:71:3F:1F:24,8099038,7854051576,4886571,7448283323,3212467,405768253,80,1137545,703252152,1129026,702229070,8519,1023082,1084526,619,4891277,494651,80,5665,130000.0,39000.0,-70.0,-64.0,-73.0,-68.0,-69.0,-64.0,-72.0,-68.0,-85.0,-91.0,-85.0,-91.0,15.0,27.0,12.0,23.0,1
2167,F8:59:71:5A:E0:3D,3313695,551425332,101223,145656615,3212472,405768717,0,99139,104354921,94351,103782845,4788,572076,76964,16,103935,2321,0,509,144444.0,43333.0,-67.0,-72.0,-65.0,-71.0,-67.0,-72.0,-65.0,-70.0,-85.0,-91.0,-85.0,-91.0,18.0,19.0,20.0,20.0,1
2168,CC:2F:71:3E:C5:1F,3223844,407159870,11372,1391153,3212472,405768717,6,48566,4066779,40139,3068325,8427,998454,11989,34,16336,186,6,825,130000.0,39000.0,-69.0,-71.0,-68.0,-60.0,-68.0,-69.0,-67.0,-60.0,-85.0,-91.0,-85.0,-91.0,16.0,20.0,17.0,31.0,1
2169,CC:2F:71:3F:1F:24,8100330,7856036824,4887858,7450268107,3212472,405768717,80,1137910,703495258,1129391,702472176,8519,1023082,1084883,619,4892573,495124,80,5665,86667.0,14444.0,-69.0,-64.0,-72.0,-71.0,-69.0,-64.0,-71.0,-71.0,-85.0,-91.0,-85.0,-91.0,16.0,27.0,13.0,20.0,1
2170,F8:59:71:5A:E0:3D,3313762,551526152,101288,145757233,3212474,405768919,0,99204,104455021,94416,103882945,4788,572076,77029,16,104000,2327,0,509,144444.0,43333.0,-67.0,-73.0,-66.0,-71.0,-67.0,-72.0,-65.0,-71.0,-85.0,-91.0,-85.0,-91.0,18.0,18.0,19.0,20.0,1
2171,CC:2F:71:3E:C5:1F,3223848,407160274,11372,1391153,3212476,405769121,6,48566,4066779,40139,3068325,8427,998454,11989,34,16336,186,6,825,130000.0,39000.0,-69.0,-71.0,-68.0,-60.0,-68.0,-69.0,-67.0,-60.0,-85.0,-91.0,-85.0,-91.0,16.0,20.0,17.0,31.0,1
2172,CC:2F:71:3F:1F:24,8101444,7857746104,4888968,7451976983,3212476,405769121,80,1138249,703719422,1129730,702696340,8519,1023082,1085222,619,4893687,495132,80,5665,86667.0,14444.0,-68.0,-63.0,-71.0,-70.0,-68.0,-63.0,-71.0,-70.0,-85.0,-91.0,-85.0,-91.0,17.0,28.0,14.0,21.0,1
2173,F8:59:71:5A:E0:3D,3313832,551626214,101352,145856689,3212480,405769525,0,99269,104555163,94481,103983087,4788,572076,77094,16,104064,2328,0,509,144444.0,43333.0,-67.0,-72.0,-66.0,-71.0,-67.0,-72.0,-65.0,-70.0,-85.0,-91.0,-85.0,-91.0,18.0,19.0,19.0,20.0,1
2174,CC:2F:71:3E:C5:1F,3223852,407160678,11372,1391153,3212480,405769525,6,48566,4066779,40139,3068325,8427,998454,11989,34,16336,186,6,825,130000.0,39000.0,-69.0,-71.0,-68.0,-60.0,-68.0,-69.0,-67.0,-60.0,-85.0,-91.0,-85.0,-91.0,16.0,20.0,17.0,31.0,1
2175,CC:2F:71:3F:1F:24,8102135,7858779188,4889655,7453009663,3212480,405769525,80,1138531,703931902,1130012,702908820,8519,1023082,1085504,619,4894374,495220,80,5665,115556.0,28889.0,-69.0,-65.0,-72.0,-69.0,-69.0,-65.0,-71.0,-69.0,-85.0,-91.0,-85.0,-91.0,16.0,26.0,13.0,22.0,1
2176,F8:59:71:5A:E0:3D,3313899,551725932,101416,145956145,3212483,405769787,0,99333,104653737,94545,104081661,4788,572076,77157,16,104128,2331,0,509,144444.0,43333.0,-67.0,-72.0,-65.0,-71.0,-67.0,-71.0,-65.0,-70.0,-85.0,-91.0,-85.0,-91.0,18.0,19.0,20.0,20.0,1
2177,CC:2F:71:3E:C5:1F,3223855,407160940,11372,1391153,3212483,405769787,6,48566,4066779,40139,3068325,8427,998454,11989,34,16336,186,6,825,130000.0,39000.0,-69.0,-71.0,-68.0,-60.0,-68.0,-69.0,-67.0,-60.0,-85.0,-91.0,-85.0,-91.0,16.0,20.0,17.0,31.0,1
2178,CC:2F:71:3F:1F:24,8103153,7860339096,4890670,7454569309,3212483,405769787,80,1138853,704151276,1130334,703128194,8519,1023082,1085826,619,4895383,495386,80,5665,115556.0,26000.0,-71.0,-65.0,-73.0,-68.0,-70.0,-65.0,-72.0,-68.0,-85.0,-91.0,-85.0,-91.0,14.0,26.0,12.0,23.0,1
2179,F8:59:71:5A:E0:3D,3313969,551825994,101480,146055601,3212489,405770393,0,99397,104752297,94609,104180221,4788,572076,77221,16,104192,2331,0,509,144444.0,43333.0,-67.0,-72.0,-66.0,-71.0,-67.0,-72.0,-65.0,-70.0,-85.0,-91.0,-85.0,-91.0,18.0,19.0,19.0,20.0,1
2180,CC:2F:71:3E:C5:1F,3223861,407161546,11372,1391153,3212489,405770393,6,48566,4066779,40139,3068325,8427,998454,11989,34,16336,186,6,825,130000.0,39000.0,-69.0,-71.0,-68.0,-60.0,-68.0,-69.0,-67.0,-60.0,-85.0,-91.0,-85.0,-91.0,16.0,20.0,17.0,31.0,1
2181,CC:2F:71:3F:1F:24,8104112,7861799642,4891623,7456029249,3212489,405770393,80,1139197,704378970,1130678,703355888,8519,1023082,1086170,619,4896342,495780,80,5666,115556.0,28889.0,-70.0,-65.0,-72.0,-68.0,-70.0,-65.0,-73.0,-68.0,-85.0,-91.0,-85.0,-91.0,15.0,26.0,13.0,23.0,1
2182,F8:59:71:5A:E0:3D,3314039,551930430,101548,146159835,3212491,405770595,0,99458,104846237,94670,104274161,4788,572076,77282,16,104259,2333,0,509,144444.0,43333.0,-67.0,-72.0,-66.0,-71.0,-67.0,-71.0,-65.0,-70.0,-85.0,-91.0,-85.0,-91.0,18.0,19.0,19.0,20.0,1
2183,CC:2F:71:3E:C5:1F,3223864,407161864,11373,1391269,3212491,405770595,6,48568,4066919,40141,3068465,8427,998454,11989,34,16337,186,6,825,144444.0,39000.0,-69.0,-70.0,-69.0,-60.0,-68.0,-69.0,-68.0,-60.0,-85.0,-91.0,-85.0,-91.0,16.0,21.0,16.0,31.0,1
2184,CC:2F:71:3F:1F:24,8105043,7863222686,4892552,7457452091,3212491,405770595,80,1139506,704608412,1130987,703585330,8519,1023082,1086479,619,4897271,496048,80,5666,115556.0,28889.0,-71.0,-65.0,-73.0,-68.0,-70.0,-64.0,-72.0,-68.0,-85.0,-91.0,-85.0,-91.0,14.0,26.0,12.0,23.0,1
2185,F8:59:71:5A:E0:3D,3314112,552032168,101613,146260845,3212499,405771323,0,99531,104957249,94742,104385055,4789,572194,77354,16,104325,2334,0,509,144444.0,43333.0,-67.0,-72.0,-66.0,-71.0,-67.0,-72.0,-65.0,-71.0,-85.0,-91.0,-85.0,-91.0,18.0,19.0,19.0,20.0,1
2186,CC:2F:71:3E:C5:1F,3223872,407162592,11373,1391269,3212499,405771323,6,48568,4066919,40141,3068465,8427,998454,11989,34,16337,186,6,825,144444.0,39000.0,-69.0,-70.0,-69.0,-60.0,-68.0,-69.0,-68.0,-60.0,-85.0,-91.0,-85.0,-91.0,16.0,21.0,16.0,31.0,1
2187,CC:2F:71:3F:1F:24,8106159,7864920985,4893660,7459149662,3212499,405771323,80,1139838,704829668,1131319,703806586,8519,1023082,1086811,619,4898363,496185,80,5666,115556.0,28889.0,-71.0,-65.0,-74.0,-69.0,-70.0,-65.0,-72.0,-68.0,-85.0,-91.0,-85.0,-91.0,14.0,26.0,11.0,22.0,1
2188,F8:59:71:5A:E0:3D,3314180,552132113,101677,146360301,3212503,405771812,0,99596,105057363,94807,104485169,4789,572194,77418,16,104389,2337,0,509,144444.0,43333.0,-67.0,-72.0,-66.0,-71.0,-67.0,-71.0,-65.0,-70.0,-85.0,-91.0,-85.0,-91.0,18.0,19.0,19.0,20.0,1
2189,CC:2F:71:3E:C5:1F,3223877,407163305,11373,1391269,3212504,405772036,6,48568,4066919,40141,3068465,8427,998454,11989,34,16337,186,6,825,144444.0,39000.0,-69.0,-70.0,-69.0,-60.0,-68.0,-69.0,-68.0,-60.0,-85.0,-91.0,-85.0,-91.0,16.0,21.0,16.0,31.0,1
2190,CC:2F:71:3F:1F:24,8107134,7866409254,4894630,7460637218,3212504,405772036,80,1140145,705047286,1131625,704024086,8520,1023200,1087118,619,4899349,496228,80,5666,115556.0,28889.0,-71.0,-65.0,-73.0,-68.0,-70.0,-64.0,-72.0,-68.0,-85.0,-91.0,-85.0,-91.0,14.0,26.0,12.0,23.0,1
2191,F8:59:71:5A:E0:3D,3314248,552230643,101740,146458203,3212508,405772440,0,99659,105154383,94870,104582189,4789,572194,77481,16,104452,2338,0,509,144444.0,43333.0,-67.0,-72.0,-66.0,-71.0,-67.0,-71.0,-65.0,-70.0,-85.0,-91.0,-85.0,-91.0,18.0,19.0,19.0,20.0,1
2192,CC:2F:71:3E:C5:1F,3223884,407163971,11373,1391269,3212511,405772702,6,48568,4066919,40141,3068465,8427,998454,11989,34,16337,186,6,825,144444.0,39000.0,-69.0,-70.0,-69.0,-60.0,-68.0,-69.0,-68.0,-60.0,-85.0,-91.0,-85.0,-91.0,16.0,21.0,16.0,31.0,1
2193,CC:2F:71:3F:1F:24,8108061,7867818314,4895550,7462045612,3212511,405772702,80,1140432,705267066,1131912,704243866,8520,1023200,1087404,619,4900251,496365,80,5666,115556.0,28889.0,-71.0,-64.0,-73.0,-68.0,-70.0,-64.0,-72.0,-68.0,-85.0,-91.0,-85.0,-91.0,14.0,27.0,12.0,23.0,1
2194,F8:59:71:5A:E0:3D,3314317,552330810,101804,146557659,3212513,405773151,0,99724,105254483,94935,104682289,4789,572194,77546,16,104516,2338,0,509,144444.0,43333.0,-66.0,-71.0,-65.0,-70.0,-66.0,-71.0,-65.0,-70.0,-85.0,-91.0,-85.0,-91.0,19.0,20.0,20.0,21.0,1
2195,CC:2F:71:3E:C5:1F,3223886,407164420,11373,1391269,3212513,405773151,6,48568,4066919,40141,3068465,8427,998454,11989,34,16337,186,6,825,144444.0,39000.0,-69.0,-70.0,-69.0,-60.0,-68.0,-69.0,-68.0,-60.0,-85.0,-91.0,-85.0,-91.0,16.0,21.0,16.0,31.0,1
2196,CC:2F:71:3F:1F:24,8109189,7869549397,4896674,7463776044,3212515,405773353,80,1140768,705489648,1132248,704466448,8520,1023200,1087740,619,4901392,496499,80,5666,104000.0,26000.0,-70.0,-65.0,-72.0,-68.0,-70.0,-64.0,-72.0,-68.0,-85.0,-91.0,-85.0,-91.0,15.0,26.0,13.0,23.0,1
2197,F8:59:71:5A:E0:3D,3314387,552431119,101868,146657115,3212519,405774004,0,99788,105353057,94999,104780863,4789,572194,77609,16,104580,2339,0,509,144444.0,43333.0,-67.0,-71.0,-65.0,-70.0,-67.0,-71.0,-65.0,-70.0,-84.0,-90.0,-84.0,-90.0,17.0,19.0,19.0,20.0,1
2198,CC:2F:71:3E:C5:1F,3223892,407165273,11373,1391269,3212519,405774004,6,48568,4066919,40141,3068465,8427,998454,11989,34,16337,186,6,825,144444.0,39000.0,-69.0,-70.0,-69.0,-60.0,-68.0,-69.0,-68.0,-60.0,-84.0,-90.0,-84.0,-90.0,15.0,20.0,15.0,30.0,1
2199,CC:2F:71:3F:1F:24,8110447,7871473611,4897924,7465699203,3212523,405774408,80,1141113,705713677,1132593,704690477,8520,1023200,1088085,619,4902643,496568,80,5667,115556.0,28889.0,-70.0,-64.0,-72.0,-68.0,-70.0,-64.0,-72.0,-68.0,-84.0,-90.0,-84.0,-90.0,14.0,26.0,12.0,22.0,1
2200,F8:59:71:5A:E0:3D,3314457,552532593,101933,146758125,3212524,405774468,0,99854,105454711,95065,104882517,4789,572194,77674,16,104645,2339,0,509,144444.0,43333.0,-67.0,-71.0,-65.0,-70.0,-66.0,-71.0,-65.0,-70.0,-84.0,-90.0,-84.0,-90.0,17.0,19.0,19.0,20.0,1
2201,CC:2F:71:3E:C5:1F,3223897,407165737,11373,1391269,3212524,405774468,6,48568,4066919,40141,3068465,8427,998454,11989,34,16337,186,6,825,144444.0,39000.0,-69.0,-70.0,-69.0,-60.0,-68.0,-69.0,-68.0,-60.0,-84.0,-90.0,-84.0,-90.0,15.0,20.0,15.0,30.0,1
2202,CC:2F:71:3F:1F:24,8111768,7873403242,4899244,7467628774,3212524,405774468,80,1141499,705951800,1132979,704928600,8520,1023200,1088471,619,4903956,496727,80,5669,115556.0,28889.0,-70.0,-65.0,-72.0,-69.0,-70.0,-65.0,-72.0,-68.0,-84.0,-90.0,-84.0,-90.0,14.0,25.0,12.0,21.0,1
2203,F8:59:71:5A:E0:3D,3314527,552632902,101997,146857581,3212530,405775321,0,99918,105553271,95129,104981077,4789,572194,77738,16,104709,2340,0,509,144444.0,43333.0,-67.0,-71.0,-65.0,-71.0,-67.0,-71.0,-65.0,-70.0,-84.0,-90.0,-84.0,-90.0,17.0,19.0,19.0,19.0,1
2204,CC:2F:71:3E:C5:1F,3223903,407166590,11373,1391269,3212530,405775321,6,48568,4066919,40141,3068465,8427,998454,11989,34,16337,186,6,825,144444.0,39000.0,-69.0,-70.0,-69.0,-60.0,-68.0,-69.0,-68.0,-60.0,-84.0,-90.0,-84.0,-90.0,15.0,20.0,15.0,30.0,1
2205,CC:2F:71:3F:1F:24,8113084,7875427771,4900554,7469652450,3212530,405775321,80,1141849,706173102,1133329,705149902,8520,1023200,1088821,619,4905263,496924,80,5670,115556.0,28889.0,-69.0,-65.0,-72.0,-68.0,-70.0,-65.0,-72.0,-68.0,-84.0,-90.0,-84.0,-90.0,15.0,25.0,12.0,22.0,1
2206,F8:59:71:5A:E0:3D,3314596,552733035,102061,146957037,3212535,405775998,0,99982,105651831,95193,105079637,4789,572194,77802,16,104772,2340,0,509,144444.0,43333.0,-67.0,-71.0,-65.0,-70.0,-66.0,-71.0,-65.0,-70.0,-83.0,-90.0,-83.0,-90.0,16.0,19.0,18.0,20.0,1
2207,CC:2F:71:3E:C5:1F,3223908,407167267,11373,1391269,3212535,405775998,6,48568,4066919,40141,3068465,8427,998454,11989,34,16337,186,6,825,144444.0,39000.0,-69.0,-70.0,-69.0,-60.0,-68.0,-69.0,-68.0,-60.0,-83.0,-90.0,-83.0,-90.0,14.0,20.0,14.0,30.0,1
2208,CC:2F:71:3F:1F:24,8114098,7876979018,4901563,7471203020,3212535,405775998,80,1142154,706392038,1133634,705368838,8520,1023200,1089126,619,4906282,496979,80,5670,115556.0,28889.0,-70.0,-65.0,-72.0,-69.0,-70.0,-65.0,-72.0,-68.0,-83.0,-90.0,-83.0,-90.0,13.0,25.0,11.0,21.0,1
2209,F8:59:71:5A:E0:3D,3314662,552829707,102123,147053385,3212539,405776322,0,100045,105748851,95256,105176657,4789,572194,77865,16,104835,2340,0,509,144444.0,43333.0,-66.0,-71.0,-65.0,-70.0,-66.0,-71.0,-65.0,-70.0,-83.0,-90.0,-83.0,-90.0,17.0,19.0,18.0,20.0,1
2210,CC:2F:71:3E:C5:1F,3223914,407167793,11373,1391269,3212541,405776524,6,48570,4067107,40142,3068535,8428,998572,11990,34,16337,186,6,825,144444.0,39000.0,-70.0,-70.0,-68.0,-60.0,-68.0,-69.0,-68.0,-60.0,-83.0,-90.0,-83.0,-90.0,13.0,20.0,15.0,30.0,1
2211,CC:2F:71:3F:1F:24,8115030,7878387007,4902489,7472610483,3212541,405776524,80,1142462,706629216,1133942,705606016,8520,1023200,1089433,619,4907196,497011,80,5670,117000.0,39000.0,-71.0,-65.0,-73.0,-69.0,-70.0,-65.0,-72.0,-69.0,-83.0,-90.0,-83.0,-90.0,12.0,25.0,10.0,21.0,1
2212,F8:59:71:5A:E0:3D,3314739,552940647,102194,147163719,3212545,405776928,0,100115,105856679,95326,105284485,4789,572194,77935,16,104906,2342,0,510,144444.0,43333.0,-67.0,-71.0,-65.0,-70.0,-66.0,-71.0,-65.0,-70.0,-83.0,-90.0,-83.0,-90.0,16.0,19.0,18.0,20.0,1
2213,CC:2F:71:3E:C5:1F,3223918,407168197,11373,1391269,3212545,405776928,6,48570,4067107,40142,3068535,8428,998572,11990,34,16337,186,6,825,144444.0,39000.0,-70.0,-70.0,-68.0,-60.0,-68.0,-69.0,-68.0,-60.0,-83.0,-90.0,-83.0,-90.0,13.0,20.0,15.0,30.0,1
2214,CC:2F:71:3F:1F:24,8115810,7879569891,4903265,7473792963,3212545,405776928,80,1142745,706845758,1134225,705822558,8520,1023200,1089716,619,4907984,497064,80,5672,115556.0,28889.0,-70.0,-65.0,-73.0,-69.0,-70.0,-65.0,-72.0,-69.0,-83.0,-90.0,-83.0,-90.0,13.0,25.0,10.0,21.0,1
2215,F8:59:71:5A:E0:3D,3314805,553040305,102258,147263175,3212547,405777130,0,100179,105955239,95390,105383045,4789,572194,77999,16,104970,2342,0,510,144444.0,43333.0,-67.0,-71.0,-65.0,-70.0,-67.0,-71.0,-65.0,-70.0,-83.0,-90.0,-83.0,-90.0,16.0,19.0,18.0,20.0,1
2216,CC:2F:71:3E:C5:1F,3223920,407168399,11373,1391269,3212547,405777130,6,48570,4067107,40142,3068535,8428,998572,11990,34,16337,186,6,825,144444.0,39000.0,-70.0,-70.0,-68.0,-60.0,-68.0,-69.0,-68.0,-60.0,-83.0,-90.0,-83.0,-90.0,13.0,20.0,15.0,30.0,1
2217,CC:2F:71:3F:1F:24,8116762,7881024631,4904213,7475247299,3212549,405777332,80,1143044,707059802,1134524,706036602,8520,1023200,1090014,619,4908932,497108,80,5672,115556.0,28889.0,-70.0,-65.0,-73.0,-68.0,-70.0,-65.0,-72.0,-68.0,-83.0,-90.0,-83.0,-90.0,13.0,25.0,10.0,22.0,1
2218,F8:59:71:5A:E0:3D,3314876,553140427,102322,147362631,3212554,405777796,0,100240,106049207,95451,105477013,4789,572194,78060,16,105034,2342,0,511,144444.0,43333.0,-67.0,-71.0,-65.0,-70.0,-66.0,-70.0,-65.0,-69.0,-83.0,-90.0,-83.0,-90.0,16.0,19.0,18.0,20.0,1
2219,CC:2F:71:3E:C5:1F,3223927,407169065,11373,1391269,3212554,405777796,6,48570,4067107,40142,3068535,8428,998572,11990,34,16337,186,6,825,144444.0,39000.0,-70.0,-70.0,-68.0,-60.0,-68.0,-69.0,-68.0,-60.0,-83.0,-90.0,-83.0,-90.0,13.0,20.0,15.0,30.0,1
2220,CC:2F:71:3F:1F:24,8117557,7882228243,4905003,7476450447,3212554,405777796,80,1143317,707285136,1134797,706261936,8520,1023200,1090286,619,4909722,497163,80,5672,115556.0,28889.0,-71.0,-65.0,-73.0,-69.0,-70.0,-65.0,-72.0,-68.0,-83.0,-90.0,-83.0,-90.0,12.0,25.0,10.0,21.0,1
2221,F8:59:71:5A:E0:3D,3314945,553242007,102387,147463641,3212558,405778366,0,100309,106155467,95520,105583273,4789,572194,78129,16,105099,2342,0,511,144444.0,43333.0,-67.0,-71.0,-65.0,-70.0,-66.0,-71.0,-65.0,-70.0,-83.0,-90.0,-83.0,-90.0,16.0,19.0,18.0,20.0,1
2222,CC:2F:71:3E:C5:1F,3223931,407169635,11373,1391269,3212558,405778366,6,48570,4067107,40142,3068535,8428,998572,11990,34,16337,186,6,825,144444.0,39000.0,-70.0,-70.0,-68.0,-60.0,-68.0,-69.0,-68.0,-60.0,-83.0,-90.0,-83.0,-90.0,13.0,20.0,15.0,30.0,1
2223,CC:2F:71:3F:1F:24,8118617,7883851853,4906059,7478073487,3212558,405778366,80,1143606,707504026,1135086,706480826,8520,1023200,1090574,619,4910749,497239,80,5672,115556.0,28889.0,-70.0,-65.0,-73.0,-69.0,-70.0,-65.0,-72.0,-69.0,-83.0,-90.0,-83.0,-90.0,13.0,25.0,10.0,21.0,1
2224,F8:59:71:5A:E0:3D,3315015,553342069,102451,147563097,3212564,405778972,0,100372,106252543,95583,105680349,4789,572194,78192,16,105162,2343,0,511,144444.0,43333.0,-66.0,-71.0,-65.0,-71.0,-66.0,-71.0,-65.0,-70.0,-83.0,-90.0,-83.0,-90.0,17.0,19.0,18.0,19.0,1
2225,CC:2F:71:3E:C5:1F,3223937,407170241,11373,1391269,3212564,405778972,6,48570,4067107,40142,3068535,8428,998572,11990,34,16337,186,6,825,144444.0,39000.0,-70.0,-70.0,-68.0,-60.0,-68.0,-69.0,-68.0,-60.0,-83.0,-90.0,-83.0,-90.0,13.0,20.0,15.0,30.0,1
2226,CC:2F:71:3F:1F:24,8119760,7885595960,4907196,7479816988,3212564,405778972,80,1143915,707726969,1135395,706703769,8520,1023200,1090883,619,4911900,497358,80,5674,115556.0,28889.0,-70.0,-65.0,-72.0,-69.0,-70.0,-65.0,-72.0,-68.0,-83.0,-90.0,-83.0,-90.0,13.0,25.0,11.0,21.0,1
2227,F8:59:71:5A:E0:3D,3315083,553443341,102516,147664107,3212567,405779234,0,100437,106352643,95648,105780449,4789,572194,78257,16,105228,2345,0,511,144444.0,43333.0,-67.0,-71.0,-65.0,-71.0,-66.0,-71.0,-65.0,-70.0,-83.0,-90.0,-83.0,-90.0,16.0,19.0,18.0,19.0,1
2228,CC:2F:71:3E:C5:1F,3223940,407170503,11373,1391269,3212567,405779234,6,48570,4067107,40142,3068535,8428,998572,11990,34,16337,186,6,825,144444.0,39000.0,-70.0,-70.0,-68.0,-60.0,-68.0,-69.0,-68.0,-60.0,-83.0,-90.0,-83.0,-90.0,13.0,20.0,15.0,30.0,1
2229,CC:2F:71:3F:1F:24,8120876,7887309232,4908309,7481529998,3212567,405779234,80,1144236,707946515,1135716,706923315,8520,1023200,1091204,619,4913019,497444,80,5674,115556.0,28889.0,-71.0,-65.0,-73.0,-69.0,-70.0,-65.0,-73.0,-68.0,-83.0,-90.0,-83.0,-90.0,12.0,25.0,10.0,21.0,1
2230,F8:59:71:5A:E0:3D,3315153,553543403,102580,147763563,3212573,405779840,0,100501,106451203,95712,105879009,4789,572194,78321,16,105292,2345,0,511,144444.0,43333.0,-67.0,-71.0,-65.0,-70.0,-67.0,-71.0,-65.0,-70.0,-83.0,-90.0,-83.0,-90.0,16.0,19.0,18.0,20.0,1
2231,CC:2F:71:3E:C5:1F,3223946,407171109,11373,1391269,3212573,405779840,6,48570,4067107,40142,3068535,8428,998572,11990,34,16337,186,6,825,144444.0,39000.0,-70.0,-70.0,-68.0,-60.0,-68.0,-69.0,-68.0,-60.0,-83.0,-90.0,-83.0,-90.0,13.0,20.0,15.0,30.0,1
2232,CC:2F:71:3F:1F:24,8121649,7888476836,4909076,7482696996,3212573,405779840,80,1144518,708161535,1135998,707138335,8520,1023200,1091486,619,4913794,497485,80,5674,115556.0,28889.0,-71.0,-65.0,-74.0,-68.0,-70.0,-65.0,-72.0,-68.0,-83.0,-90.0,-83.0,-90.0,12.0,25.0,9.0,22.0,1
2233,F8:59:71:5A:E0:3D,3315217,553639953,102642,147859911,3212575,405780042,0,100563,106546683,95774,105974489,4789,572194,78383,16,105354,2345,0,511,144444.0,43333.0,-67.0,-71.0,-65.0,-71.0,-66.0,-71.0,-65.0,-70.0,-83.0,-90.0,-83.0,-90.0,16.0,19.0,18.0,19.0,1
2234,CC:2F:71:3E:C5:1F,3223948,407171311,11373,1391269,3212575,405780042,6,48570,4067107,40142,3068535,8428,998572,11990,34,16337,186,6,825,144444.0,39000.0,-70.0,-70.0,-68.0,-60.0,-68.0,-69.0,-68.0,-60.0,-83.0,-90.0,-83.0,-90.0,13.0,20.0,15.0,30.0,1
2235,CC:2F:71:3F:1F:24,8122701,7890090812,4910125,7484310710,3212576,405780102,80,1144803,708375369,1136283,707352169,8520,1023200,1091771,619,4914844,497576,80,5674,115556.0,28889.0,-70.0,-65.0,-72.0,-68.0,-70.0,-65.0,-72.0,-68.0,-83.0,-90.0,-83.0,-90.0,13.0,25.0,11.0,22.0,1
2236,F8:59:71:5A:E0:3D,3315286,553739761,102706,147959255,3212580,405780506,0,100627,106645243,95838,106073049,4789,572194,78447,16,105418,2345,0,511,144444.0,39000.0,-67.0,-71.0,-65.0,-70.0,-66.0,-71.0,-65.0,-70.0,-83.0,-90.0,-83.0,-90.0,16.0,19.0,18.0,20.0,1
2237,CC:2F:71:3E:C5:1F,3223953,407171775,11373,1391269,3212580,405780506,6,48570,4067107,40142,3068535,8428,998572,11990,34,16337,186,6,825,144444.0,39000.0,-70.0,-70.0,-68.0,-60.0,-68.0,-69.0,-68.0,-60.0,-83.0,-90.0,-83.0,-90.0,13.0,20.0,15.0,30.0,1
2238,CC:2F:71:3F:1F:24,8123919,7891955991,4911339,7486175485,3212580,405780506,80,1145169,708597574,1136649,707574374,8520,1023200,1092137,619,4916058,497711,80,5674,104000.0,26000.0,-70.0,-65.0,-72.0,-68.0,-70.0,-65.0,-72.0,-68.0,-83.0,-90.0,-83.0,-90.0,13.0,25.0,11.0,22.0,1
2239,F8:59:71:5A:E0:3D,3315353,553838011,102769,148057101,3212584,405780910,0,100690,106742263,95901,106170069,4789,572194,78510,16,105481,2346,0,511,144444.0,43333.0,-67.0,-71.0,-65.0,-70.0,-66.0,-70.0,-65.0,-70.0,-83.0,-90.0,-83.0,-90.0,16.0,19.0,18.0,20.0,1
2240,CC:2F:71:3E:C5:1F,3223958,407172305,11373,1391269,3212585,405781036,6,48570,4067107,40142,3068535,8428,998572,11990,34,16337,186,6,825,144444.0,39000.0,-70.0,-70.0,-68.0,-60.0,-68.0,-69.0,-68.0,-60.0,-83.0,-90.0,-83.0,-90.0,13.0,20.0,15.0,30.0,1
2241,CC:2F:71:3F:1F:24,8125518,7894430037,4912933,7488649001,3212585,405781036,80,1145556,708830096,1137036,707806896,8520,1023200,1092523,619,4917633,497854,80,5674,115556.0,28889.0,-70.0,-65.0,-73.0,-68.0,-70.0,-65.0,-72.0,-68.0,-83.0,-90.0,-83.0,-90.0,13.0,25.0,10.0,22.0,1
2242,F8:59:71:5A:E0:3D,3315424,553941079,102836,148159781,3212588,405781298,0,100759,106847131,95970,106274937,4789,572194,78578,16,105548,2348,0,512,144444.0,43333.0,-67.0,-72.0,-66.0,-71.0,-67.0,-71.0,-65.0,-70.0,-83.0,-90.0,-83.0,-90.0,16.0,18.0,17.0,19.0,1
2243,CC:2F:71:3E:C5:1F,3223963,407172769,11373,1391269,3212590,405781500,6,48570,4067107,40142,3068535,8428,998572,11990,34,16337,186,6,825,144444.0,39000.0,-70.0,-70.0,-68.0,-60.0,-68.0,-69.0,-68.0,-60.0,-83.0,-90.0,-83.0,-90.0,13.0,20.0,15.0,30.0,1
2244,CC:2F:71:3F:1F:24,8127383,7897319375,4914793,7491537875,3212590,405781500,80,1145951,709071096,1137431,708047896,8520,1023200,1092917,619,4919512,498159,80,5674,115556.0,28889.0,-70.0,-65.0,-73.0,-69.0,-70.0,-65.0,-72.0,-68.0,-83.0,-90.0,-83.0,-90.0,13.0,25.0,10.0,21.0,1
2245,F8:59:71:5A:E0:3D,3315493,554042493,102901,148260791,3212592,405781702,0,100824,106947231,96035,106375037,4789,572194,78643,16,105613,2349,0,512,144444.0,43333.0,-67.0,-72.0,-65.0,-71.0,-67.0,-72.0,-65.0,-71.0,-83.0,-90.0,-83.0,-90.0,16.0,18.0,18.0,19.0,1
2246,CC:2F:71:3E:C5:1F,3223967,407173173,11373,1391269,3212594,405781904,6,48570,4067107,40142,3068535,8428,998572,11990,34,16337,186,6,825,144444.0,39000.0,-70.0,-70.0,-68.0,-60.0,-68.0,-69.0,-68.0,-60.0,-83.0,-90.0,-83.0,-90.0,13.0,20.0,15.0,30.0,1
2247,CC:2F:71:3F:1F:24,8128950,7899742737,4916356,7493960833,3212594,405781904,80,1146290,709291690,1137770,708268490,8520,1023200,1093256,619,4921073,498419,80,5676,115556.0,28889.0,-70.0,-65.0,-73.0,-69.0,-70.0,-64.0,-72.0,-68.0,-83.0,-90.0,-83.0,-90.0,13.0,25.0,10.0,21.0,1
2248,F8:59:71:5A:E0:3D,3315564,554145734,102967,148363355,3212597,405782379,0,100890,107048885,96101,106476691,4789,572194,78708,16,105679,2349,0,512,144444.0,43333.0,-67.0,-73.0,-66.0,-71.0,-66.0,-72.0,-65.0,-70.0,-83.0,-90.0,-83.0,-90.0,16.0,17.0,17.0,19.0,1
2249,CC:2F:71:3E:C5:1F,3223970,407173648,11373,1391269,3212597,405782379,6,48570,4067107,40142,3068535,8428,998572,11990,34,16337,186,6,825,144444.0,39000.0,-70.0,-70.0,-68.0,-60.0,-68.0,-69.0,-68.0,-60.0,-83.0,-90.0,-83.0,-90.0,13.0,20.0,15.0,30.0,1
2250,CC:2F:71:3F:1F:24,8130594,7902269132,4917997,7496486753,3212597,405782379,80,1146677,709523242,1138157,708500042,8520,1023200,1093643,619,4922700,498756,80,5676,115556.0,28889.0,-70.0,-63.0,-71.0,-68.0,-70.0,-63.0,-72.0,-68.0,-83.0,-90.0,-83.0,-90.0,13.0,27.0,12.0,22.0,1
2251,F8:59:71:5A:E0:3D,3315633,554245654,103031,148462811,3212602,405782843,0,100956,107150539,96167,106578345,4789,572194,78773,16,105743,2350,0,512,144444.0,43333.0,-67.0,-72.0,-65.0,-71.0,-66.0,-72.0,-65.0,-70.0,-83.0,-90.0,-83.0,-90.0,16.0,18.0,18.0,19.0,1
2252,CC:2F:71:3E:C5:1F,3223975,407174112,11373,1391269,3212602,405782843,6,48570,4067107,40142,3068535,8428,998572,11990,34,16337,186,6,825,144444.0,39000.0,-70.0,-70.0,-68.0,-60.0,-68.0,-69.0,-68.0,-60.0,-83.0,-90.0,-83.0,-90.0,13.0,20.0,15.0,30.0,1
2253,CC:2F:71:3F:1F:24,8131731,7904007610,4919127,7498224565,3212604,405783045,80,1147002,709746034,1138482,708722834,8520,1023200,1093968,619,4923846,499085,80,5677,86667.0,14444.0,-69.0,-64.0,-72.0,-68.0,-69.0,-64.0,-72.0,-68.0,-83.0,-90.0,-83.0,-90.0,14.0,26.0,11.0,22.0,1
2254,F8:59:71:5A:E0:3D,3315698,554343758,103094,148560713,3212604,405783045,0,101018,107246033,96229,106673839,4789,572194,78834,16,105806,2350,0,512,144444.0,43333.0,-67.0,-73.0,-66.0,-71.0,-67.0,-73.0,-65.0,-71.0,-83.0,-90.0,-83.0,-90.0,16.0,17.0,17.0,19.0,1
2255,CC:2F:71:3E:C5:1F,3223977,407174314,11373,1391269,3212604,405783045,6,48570,4067107,40142,3068535,8428,998572,11990,34,16337,186,6,825,144444.0,39000.0,-70.0,-70.0,-68.0,-60.0,-68.0,-69.0,-68.0,-60.0,-83.0,-90.0,-83.0,-90.0,13.0,20.0,15.0,30.0,1
2256,CC:2F:71:3F:1F:24,8132415,7905041436,4919811,7499258391,3212604,405783045,80,1147285,709963792,1138765,708940592,8520,1023200,1094251,619,4924530,499286,80,5678,78000.0,13000.0,-71.0,-64.0,-73.0,-68.0,-71.0,-64.0,-72.0,-68.0,-83.0,-90.0,-83.0,-90.0,12.0,26.0,10.0,22.0,1
2257,F8:59:71:5A:E0:3D,3315768,554443820,103158,148660169,3212610,405783651,0,101085,107349227,96296,106777033,4789,572194,78900,16,105870,2350,0,512,144444.0,43333.0,-68.0,-73.0,-66.0,-72.0,-67.0,-72.0,-65.0,-71.0,-83.0,-90.0,-83.0,-90.0,15.0,17.0,17.0,18.0,1
2258,CC:2F:71:3E:C5:1F,3223983,407174920,11373,1391269,3212610,405783651,6,48570,4067107,40142,3068535,8428,998572,11990,34,16337,186,6,825,144444.0,39000.0,-70.0,-70.0,-68.0,-60.0,-68.0,-69.0,-68.0,-60.0,-83.0,-90.0,-83.0,-90.0,13.0,20.0,15.0,30.0,1
2259,CC:2F:71:3F:1F:24,8133411,7906561494,4920801,7500777843,3212610,405783651,80,1147598,710185080,1139078,709161880,8520,1023200,1094564,619,4925520,499288,80,5678,86667.0,14444.0,-71.0,-64.0,-73.0,-68.0,-71.0,-64.0,-72.0,-68.0,-83.0,-90.0,-83.0,-90.0,12.0,26.0,10.0,22.0,1
2260,F8:59:71:5A:E0:3D,3315836,554545092,103223,148761179,3212613,405783913,0,101149,107447787,96360,106875593,4789,572194,78964,16,105935,2351,0,512,144444.0,43333.0,-67.0,-72.0,-65.0,-71.0,-66.0,-72.0,-65.0,-71.0,-83.0,-90.0,-83.0,-90.0,16.0,18.0,18.0,19.0,1
2261,CC:2F:71:3E:C5:1F,3223986,407175182,11373,1391269,3212613,405783913,6,48570,4067107,40142,3068535,8428,998572,11990,34,16337,186,6,825,144444.0,39000.0,-70.0,-70.0,-68.0,-60.0,-68.0,-69.0,-68.0,-60.0,-83.0,-90.0,-83.0,-90.0,13.0,20.0,15.0,30.0,1
2262,CC:2F:71:3F:1F:24,8134434,7908119630,4921821,7502335717,3212613,405783913,80,1147910,710406678,1139390,709383478,8520,1023200,1094876,619,4926540,499305,80,5679,86667.0,13000.0,-72.0,-63.0,-72.0,-68.0,-71.0,-63.0,-72.0,-68.0,-83.0,-90.0,-83.0,-90.0,11.0,27.0,11.0,22.0,1
2263,F8:59:71:5A:E0:3D,3315909,554649816,103290,148865297,3212619,405784519,0,101218,107554075,96429,106981881,4789,572194,79031,16,106002,2352,0,512,144444.0,43333.0,-67.0,-72.0,-65.0,-70.0,-66.0,-71.0,-65.0,-70.0,-83.0,-90.0,-83.0,-90.0,16.0,18.0,18.0,20.0,1
2264,CC:2F:71:3E:C5:1F,3223992,407175788,11373,1391269,3212619,405784519,6,48570,4067107,40142,3068535,8428,998572,11990,34,16337,186,6,825,144444.0,39000.0,-70.0,-70.0,-68.0,-60.0,-68.0,-69.0,-68.0,-60.0,-83.0,-90.0,-83.0,-90.0,13.0,20.0,15.0,30.0,1
2265,CC:2F:71:3F:1F:24,8135476,7909709452,4922857,7503924933,3212619,405784519,80,1148214,710628508,1139694,709605308,8520,1023200,1095180,619,4927576,499444,80,5679,115556.0,28889.0,-70.0,-66.0,-72.0,-70.0,-70.0,-66.0,-72.0,-70.0,-83.0,-90.0,-83.0,-90.0,13.0,24.0,11.0,20.0,1
2266,F8:59:71:5A:E0:3D,3315976,554749590,103355,148964869,3212621,405784721,0,101282,107652635,96493,107080441,4789,572194,79095,16,106067,2353,0,512,144444.0,43333.0,-67.0,-71.0,-65.0,-70.0,-67.0,-71.0,-65.0,-70.0,-83.0,-90.0,-83.0,-90.0,16.0,19.0,18.0,20.0,1
2267,CC:2F:71:3E:C5:1F,3223995,407176050,11374,1391329,3212621,405784721,6,48572,4067247,40144,3068675,8428,998572,11990,34,16338,186,6,825,144444.0,39000.0,-69.0,-70.0,-69.0,-61.0,-68.0,-69.0,-68.0,-60.0,-83.0,-90.0,-83.0,-90.0,14.0,20.0,14.0,29.0,1
2268,CC:2F:71:3F:1F:24,8136514,7911296943,4923893,7505512222,3212621,405784721,80,1148524,710853609,1140004,709830409,8520,1023200,1095489,619,4928612,499500,80,5679,115556.0,28889.0,-70.0,-65.0,-73.0,-68.0,-69.0,-64.0,-72.0,-67.0,-83.0,-90.0,-83.0,-90.0,13.0,25.0,10.0,22.0,1
2269,F8:59:71:5A:E0:3D,3316050,554852882,103421,149067433,3212629,405785449,0,101349,107754393,96559,107182081,4790,572312,79162,16,106133,2354,0,512,144444.0,43333.0,-66.0,-71.0,-65.0,-70.0,-66.0,-71.0,-65.0,-70.0,-83.0,-90.0,-83.0,-90.0,17.0,19.0,18.0,20.0,1
2270,CC:2F:71:3E:C5:1F,3224003,407176778,11374,1391329,3212629,405785449,6,48572,4067247,40144,3068675,8428,998572,11990,34,16338,186,6,825,144444.0,39000.0,-69.0,-70.0,-69.0,-61.0,-68.0,-69.0,-68.0,-60.0,-83.0,-90.0,-83.0,-90.0,14.0,20.0,14.0,29.0,1
2271,CC:2F:71:3F:1F:24,8138112,7913764395,4925483,7507978946,3212629,405785449,80,1148872,711089133,1140352,710065933,8520,1023200,1095837,619,4930202,499673,80,5679,115556.0,28889.0,-70.0,-65.0,-72.0,-68.0,-70.0,-65.0,-72.0,-68.0,-83.0,-90.0,-83.0,-90.0,13.0,25.0,11.0,22.0,1
2272,F8:59:71:5A:E0:3D,3316122,554957474,103488,149171551,3212634,405785923,0,101416,107857601,96626,107285289,4790,572312,79229,16,106199,2354,0,512,144444.0,43333.0,-67.0,-71.0,-65.0,-70.0,-66.0,-71.0,-65.0,-70.0,-83.0,-90.0,-83.0,-90.0,16.0,19.0,18.0,20.0,1
2273,CC:2F:71:3E:C5:1F,3224008,407177252,11374,1391329,3212634,405785923,6,48576,4067757,40145,3068745,8431,999012,11993,34,16338,186,6,825,144444.0,39000.0,-69.0,-70.0,-69.0,-60.0,-69.0,-70.0,-68.0,-60.0,-83.0,-90.0,-83.0,-90.0,14.0,20.0,14.0,30.0,1
2274,CC:2F:71:3F:1F:24,8139794,7916368023,4927160,7510582100,3212634,405785923,80,1149231,711318627,1140711,710295427,8520,1023200,1096196,619,4931879,499937,80,5679,115556.0,28889.0,-70.0,-65.0,-73.0,-67.0,-70.0,-65.0,-72.0,-67.0,-83.0,-90.0,-83.0,-90.0,13.0,25.0,10.0,23.0,1
2275,F8:59:71:5A:E0:3D,3316201,555070028,103560,149283439,3212641,405786589,0,101488,107968481,96698,107396169,4790,572312,79301,16,106272,2354,0,512,144444.0,43333.0,-67.0,-71.0,-65.0,-71.0,-66.0,-71.0,-65.0,-70.0,-83.0,-89.0,-83.0,-89.0,16.0,18.0,18.0,18.0,1
2276,CC:2F:71:3E:C5:1F,3224016,407177980,11374,1391329,3212642,405786651,6,48576,4067757,40145,3068745,8431,999012,11993,34,16338,186,6,825,144444.0,39000.0,-69.0,-70.0,-69.0,-60.0,-69.0,-70.0,-68.0,-60.0,-83.0,-89.0,-83.0,-89.0,14.0,19.0,14.0,29.0,1
2277,CC:2F:71:3F:1F:24,8141033,7918263152,4928391,7512476501,3212642,405786651,80,1149582,711561872,1141061,710538554,8521,1023318,1096547,619,4933098,500031,80,5680,115556.0,28889.0,-71.0,-65.0,-73.0,-68.0,-70.0,-65.0,-72.0,-67.0,-83.0,-89.0,-83.0,-89.0,12.0,24.0,10.0,21.0,1
2278,F8:59:71:5A:E0:3D,3316267,555168194,103623,149381341,3212644,405786853,0,101551,108065501,96761,107493189,4790,572312,79364,16,106335,2354,0,512,144444.0,43333.0,-67.0,-71.0,-65.0,-70.0,-66.0,-71.0,-65.0,-70.0,-83.0,-89.0,-83.0,-89.0,16.0,18.0,18.0,19.0,1
2279,CC:2F:71:3E:C5:1F,3224018,407178182,11374,1391329,3212644,405786853,6,48576,4067757,40145,3068745,8431,999012,11993,34,16338,186,6,825,144444.0,39000.0,-69.0,-70.0,-69.0,-60.0,-69.0,-70.0,-68.0,-60.0,-83.0,-89.0,-83.0,-89.0,14.0,19.0,14.0,29.0,1
2280,CC:2F:71:3F:1F:24,8142338,7920276256,4929694,7514489403,3212644,405786853,80,1149900,711779414,1141379,710756096,8521,1023318,1096864,619,4934391,500120,80,5680,115556.0,28889.0,-71.0,-65.0,-73.0,-68.0,-70.0,-65.0,-72.0,-68.0,-83.0,-89.0,-83.0,-89.0,12.0,24.0,10.0,21.0,1
2281,F8:59:71:5A:E0:3D,3316334,555266500,103686,149479243,3212648,405787257,0,101614,108162521,96824,107590209,4790,572312,79427,16,106398,2355,0,512,144444.0,43333.0,-67.0,-71.0,-65.0,-71.0,-67.0,-71.0,-65.0,-70.0,-83.0,-89.0,-83.0,-89.0,16.0,18.0,18.0,18.0,1
2282,CC:2F:71:3E:C5:1F,3224022,407178586,11374,1391329,3212648,405787257,6,48576,4067757,40145,3068745,8431,999012,11993,34,16338,186,6,825,144444.0,39000.0,-69.0,-70.0,-69.0,-60.0,-69.0,-70.0,-68.0,-60.0,-83.0,-89.0,-83.0,-89.0,14.0,19.0,14.0,29.0,1
2283,CC:2F:71:3F:1F:24,8143412,7921921816,4930764,7516134559,3212648,405787257,80,1150211,711996308,1141690,710972990,8521,1023318,1097175,619,4935482,500188,80,5680,115556.0,28889.0,-70.0,-65.0,-72.0,-68.0,-70.0,-65.0,-72.0,-68.0,-83.0,-89.0,-83.0,-89.0,13.0,24.0,11.0,21.0,1
2284,F8:59:71:5A:E0:3D,3316401,555363312,103748,149575591,3212653,405787721,0,101675,108256461,96885,107684149,4790,572312,79488,16,106460,2355,0,512,144444.0,43333.0,-67.0,-71.0,-65.0,-70.0,-66.0,-71.0,-65.0,-70.0,-83.0,-89.0,-83.0,-89.0,16.0,18.0,18.0,19.0,1
2285,CC:2F:71:3E:C5:1F,3224027,407179050,11374,1391329,3212653,405787721,6,48576,4067757,40145,3068745,8431,999012,11993,34,16338,186,6,825,144444.0,39000.0,-69.0,-70.0,-69.0,-60.0,-69.0,-70.0,-68.0,-60.0,-83.0,-89.0,-83.0,-89.0,14.0,19.0,14.0,29.0,1
2286,CC:2F:71:3F:1F:24,8144176,7923078398,4931523,7517290677,3212653,405787721,80,1150495,712208708,1141974,711185390,8521,1023318,1097459,619,4936242,500206,80,5680,115556.0,28889.0,-71.0,-65.0,-73.0,-68.0,-70.0,-65.0,-72.0,-68.0,-83.0,-89.0,-83.0,-89.0,12.0,24.0,10.0,21.0,1
2287,F8:59:71:5A:E0:3D,3316468,555461618,103811,149673493,3212657,405788125,0,101739,108355021,96949,107782709,4790,572312,79552,16,106523,2355,0,512,144444.0,43333.0,-67.0,-71.0,-65.0,-70.0,-66.0,-71.0,-65.0,-70.0,-83.0,-89.0,-83.0,-89.0,16.0,18.0,18.0,19.0,1
2288,CC:2F:71:3E:C5:1F,3224031,407179454,11374,1391329,3212657,405788125,6,48576,4067757,40145,3068745,8431,999012,11993,34,16338,186,6,825,144444.0,39000.0,-69.0,-70.0,-69.0,-60.0,-69.0,-70.0,-68.0,-60.0,-83.0,-89.0,-83.0,-89.0,14.0,19.0,14.0,29.0,1
2289,CC:2F:71:3F:1F:24,8145219,7924668763,4932562,7518880638,3212657,405788125,80,1150790,712421269,1142269,711397951,8521,1023318,1097754,619,4937277,500340,80,5680,104000.0,26000.0,-71.0,-65.0,-73.0,-69.0,-71.0,-65.0,-73.0,-68.0,-83.0,-89.0,-83.0,-89.0,12.0,24.0,10.0,20.0,1
2290,F8:59:71:5A:E0:3D,3316536,555560197,103874,149771395,3212662,405788802,0,101803,108453581,97013,107881269,4790,572312,79616,16,106586,2355,0,512,144444.0,43333.0,-67.0,-71.0,-65.0,-70.0,-66.0,-71.0,-65.0,-70.0,-83.0,-89.0,-83.0,-89.0,16.0,18.0,18.0,19.0,1
2291,CC:2F:71:3E:C5:1F,3224036,407180131,11374,1391329,3212662,405788802,6,48576,4067757,40145,3068745,8431,999012,11993,34,16338,186,6,825,144444.0,39000.0,-69.0,-70.0,-69.0,-60.0,-69.0,-70.0,-68.0,-60.0,-83.0,-89.0,-83.0,-89.0,14.0,19.0,14.0,29.0,1
2292,CC:2F:71:3F:1F:24,8146435,7926536998,4933773,7520748196,3212662,405788802,80,1151118,712645813,1142597,711622495,8521,1023318,1098082,619,4938475,500529,80,5680,115556.0,26000.0,-71.0,-65.0,-72.0,-69.0,-70.0,-65.0,-72.0,-68.0,-83.0,-89.0,-83.0,-89.0,12.0,24.0,11.0,20.0,1
2293,F8:59:71:5A:E0:3D,3316600,555658159,103937,149869297,3212663,405788862,0,101865,108549061,97075,107976749,4790,572312,79678,16,106649,2355,0,512,144444.0,43333.0,-67.0,-71.0,-65.0,-70.0,-66.0,-71.0,-65.0,-70.0,-83.0,-89.0,-83.0,-89.0,16.0,18.0,18.0,19.0,1
2294,CC:2F:71:3E:C5:1F,3224037,407180191,11374,1391329,3212663,405788862,6,48576,4067757,40145,3068745,8431,999012,11993,34,16338,186,6,825,144444.0,39000.0,-69.0,-70.0,-69.0,-60.0,-69.0,-70.0,-68.0,-60.0,-83.0,-89.0,-83.0,-89.0,14.0,19.0,14.0,29.0,1
2295,CC:2F:71:3F:1F:24,8147452,7928097218,4934789,7522308356,3212663,405788862,80,1151434,712860513,1142913,711837195,8521,1023318,1098398,619,4939508,500592,80,5681,115556.0,28889.0,-71.0,-65.0,-73.0,-68.0,-70.0,-65.0,-72.0,-68.0,-83.0,-89.0,-83.0,-89.0,12.0,24.0,10.0,21.0,1
2296,F8:59:71:5A:E0:3D,3316672,555758423,104001,149968753,3212671,405789670,0,101928,108646081,97138,108073769,4790,572312,79741,16,106713,2355,0,512,144444.0,43333.0,-67.0,-72.0,-65.0,-71.0,-66.0,-71.0,-65.0,-70.0,-82.0,-89.0,-82.0,-89.0,15.0,17.0,17.0,18.0,1
2297,CC:2F:71:3E:C5:1F,3224045,407180999,11374,1391329,3212671,405789670,6,48576,4067757,40145,3068745,8431,999012,11993,34,16338,186,6,825,144444.0,39000.0,-69.0,-70.0,-69.0,-60.0,-69.0,-70.0,-68.0,-60.0,-82.0,-89.0,-82.0,-89.0,13.0,19.0,13.0,29.0,1
2298,CC:2F:71:3F:1F:24,8148699,7930011560,4936028,7524221890,3212671,405789670,80,1151754,713078199,1143233,712054881,8521,1023318,1098718,619,4940733,500677,80,5681,115556.0,28889.0,-71.0,-65.0,-73.0,-68.0,-71.0,-65.0,-73.0,-68.0,-82.0,-89.0,-82.0,-89.0,11.0,24.0,9.0,21.0,1
2299,F8:59:71:5A:E0:3D,3316734,555854771,104063,150065101,3212671,405789670,0,101991,108743101,97201,108170789,4790,572312,79804,16,106774,2355,0,512,144444.0,43333.0,-67.0,-71.0,-65.0,-70.0,-66.0,-71.0,-65.0,-70.0,-82.0,-89.0,-82.0,-89.0,15.0,18.0,17.0,19.0,1
2300,CC:2F:71:3E:C5:1F,3224045,407180999,11374,1391329,3212671,405789670,6,48576,4067757,40145,3068745,8431,999012,11993,34,16338,186,6,825,144444.0,39000.0,-69.0,-70.0,-69.0,-60.0,-69.0,-70.0,-68.0,-60.0,-82.0,-89.0,-82.0,-89.0,13.0,19.0,13.0,29.0,1
2301,CC:2F:71:3F:1F:24,8149883,7931827443,4937212,7526037773,3212671,405789670,80,1152094,713300478,1143573,712277160,8521,1023318,1099058,619,4941927,500799,80,5681,115556.0,28889.0,-71.0,-65.0,-73.0,-68.0,-71.0,-65.0,-73.0,-68.0,-82.0,-89.0,-82.0,-89.0,11.0,24.0,9.0,21.0,1
2302,F8:59:71:5A:E0:3D,3316802,555953137,104126,150163003,3212676,405790134,0,102054,108840121,97264,108267809,4790,572312,79867,16,106838,2355,0,512,144444.0,43333.0,-67.0,-72.0,-65.0,-70.0,-66.0,-71.0,-65.0,-70.0,-82.0,-89.0,-82.0,-89.0,15.0,17.0,17.0,19.0,1
2303,CC:2F:71:3E:C5:1F,3224052,407181665,11374,1391329,3212678,405790336,6,48576,4067757,40145,3068745,8431,999012,11993,34,16338,186,6,825,144444.0,39000.0,-69.0,-70.0,-69.0,-60.0,-69.0,-70.0,-68.0,-60.0,-82.0,-89.0,-82.0,-89.0,13.0,19.0,13.0,29.0,1
2304,CC:2F:71:3F:1F:24,8151258,7933945109,4938580,7528154773,3212678,405790336,80,1152451,713528384,1143930,712505066,8521,1023318,1099415,619,4943299,500872,80,5681,115556.0,28889.0,-71.0,-65.0,-73.0,-68.0,-70.0,-65.0,-72.0,-68.0,-82.0,-89.0,-82.0,-89.0,11.0,24.0,9.0,21.0,1
2305,F8:59:71:5A:E0:3D,3316872,556054499,104192,150263961,3212680,405790538,0,102120,108940327,97330,108368015,4790,572312,79933,16,106904,2355,0,512,144444.0,43333.0,-66.0,-71.0,-65.0,-70.0,-66.0,-71.0,-65.0,-70.0,-82.0,-89.0,-82.0,-89.0,16.0,18.0,17.0,19.0,1
2306,CC:2F:71:3E:C5:1F,3224054,407181867,11374,1391329,3212680,405790538,6,48576,4067757,40145,3068745,8431,999012,11993,34,16338,186,6,825,144444.0,39000.0,-69.0,-70.0,-69.0,-60.0,-69.0,-70.0,-68.0,-60.0,-82.0,-89.0,-82.0,-89.0,13.0,19.0,13.0,29.0,1
2307,CC:2F:71:3F:1F:24,8152543,7935925415,4939863,7530134877,3212680,405790538,80,1152764,713741236,1144243,712717918,8521,1023318,1099728,619,4944566,500941,80,5681,115556.0,28889.0,-71.0,-65.0,-72.0,-68.0,-71.0,-65.0,-72.0,-68.0,-82.0,-89.0,-82.0,-89.0,11.0,24.0,10.0,21.0,1
2308,F8:59:71:5A:E0:3D,3316937,556149697,104253,150358755,3212684,405790942,0,102181,109034295,97391,108461983,4790,572312,79994,16,106965,2356,0,512,144444.0,43333.0,-67.0,-71.0,-65.0,-70.0,-66.0,-71.0,-65.0,-70.0,-82.0,-88.0,-82.0,-88.0,15.0,17.0,17.0,18.0,1
2309,CC:2F:71:3E:C5:1F,3224058,407182271,11374,1391329,3212684,405790942,6,48576,4067757,40145,3068745,8431,999012,11993,34,16338,186,6,825,144444.0,39000.0,-69.0,-70.0,-69.0,-60.0,-69.0,-70.0,-68.0,-60.0,-82.0,-88.0,-82.0,-88.0,13.0,18.0,13.0,28.0,1
2310,CC:2F:71:3F:1F:24,8153620,7937575557,4940936,7531784615,3212684,405790942,80,1153053,713955694,1144532,712932376,8521,1023318,1100016,619,4945646,500972,80,5681,115556.0,28889.0,-71.0,-65.0,-72.0,-68.0,-70.0,-65.0,-72.0,-68.0,-82.0,-88.0,-82.0,-88.0,11.0,23.0,10.0,20.0,1
2311,F8:59:71:5A:E0:3D,3317006,556249617,104317,150458211,3212689,405791406,0,102245,109132855,97455,108560543,4790,572312,80058,16,107029,2357,0,512,144444.0,43333.0,-67.0,-71.0,-65.0,-71.0,-66.0,-71.0,-65.0,-70.0,-82.0,-88.0,-82.0,-88.0,15.0,17.0,17.0,17.0,1
2312,CC:2F:71:3E:C5:1F,3224063,407182735,11374,1391329,3212689,405791406,6,48576,4067757,40145,3068745,8431,999012,11993,34,16338,186,6,825,144444.0,39000.0,-69.0,-70.0,-69.0,-60.0,-69.0,-70.0,-68.0,-60.0,-82.0,-88.0,-82.0,-88.0,13.0,18.0,13.0,28.0,1
2313,CC:2F:71:3F:1F:24,8154835,7939442297,4942146,7533650891,3212689,405791406,80,1153387,714177456,1144866,713154138,8521,1023318,1100346,619,4946865,501060,80,5684,115556.0,28889.0,-71.0,-65.0,-72.0,-69.0,-71.0,-65.0,-72.0,-68.0,-82.0,-88.0,-82.0,-88.0,11.0,23.0,10.0,19.0,1
2314,F8:59:71:5A:E0:3D,3317073,556347923,104380,150556113,3212693,405791810,0,102309,109231415,97519,108659103,4790,572312,80122,16,107092,2357,0,512,144444.0,43333.0,-67.0,-72.0,-65.0,-70.0,-66.0,-71.0,-65.0,-70.0,-82.0,-88.0,-82.0,-88.0,15.0,16.0,17.0,18.0,1
2315,CC:2F:71:3E:C5:1F,3224067,407183139,11374,1391329,3212693,405791810,6,48576,4067757,40145,3068745,8431,999012,11993,34,16338,186,6,825,144444.0,39000.0,-69.0,-70.0,-69.0,-60.0,-69.0,-70.0,-68.0,-60.0,-82.0,-88.0,-82.0,-88.0,13.0,18.0,13.0,28.0,1
2316,CC:2F:71:3F:1F:24,8155969,7941174988,4943276,7535383178,3212693,405791810,80,1153720,714398933,1145199,713375615,8521,1023318,1100679,619,4947983,501182,80,5686,115556.0,28889.0,-70.0,-65.0,-71.0,-68.0,-70.0,-65.0,-72.0,-68.0,-82.0,-88.0,-82.0,-88.0,12.0,23.0,11.0,20.0,1
2317,F8:59:71:5A:E0:3D,3317140,556446229,104443,150654015,3212697,405792214,0,102371,109326895,97581,108754583,4790,572312,80184,16,107155,2357,0,512,144444.0,43333.0,-66.0,-71.0,-65.0,-71.0,-66.0,-71.0,-65.0,-70.0,-82.0,-88.0,-82.0,-88.0,16.0,17.0,17.0,17.0,1
2318,CC:2F:71:3E:C5:1F,3224071,407183543,11374,1391329,3212697,405792214,6,48576,4067757,40145,3068745,8431,999012,11993,34,16338,186,6,825,144444.0,39000.0,-69.0,-70.0,-69.0,-60.0,-69.0,-70.0,-68.0,-60.0,-82.0,-88.0,-82.0,-88.0,13.0,18.0,13.0,28.0,1
2319,CC:2F:71:3F:1F:24,8157120,7942943798,4944423,7537151584,3212697,405792214,80,1154048,714614749,1145527,713591431,8521,1023318,1101007,619,4949142,501345,80,5686,115556.0,28889.0,-70.0,-65.0,-71.0,-68.0,-70.0,-65.0,-72.0,-67.0,-82.0,-88.0,-82.0,-88.0,12.0,23.0,11.0,20.0,1
2320,F8:59:71:5A:E0:3D,3317206,556544393,104506,150751917,3212700,405792476,0,102435,109425469,97645,108853157,4790,572312,80247,16,107218,2357,0,512,144444.0,43333.0,-67.0,-72.0,-65.0,-70.0,-66.0,-71.0,-65.0,-70.0,-82.0,-88.0,-82.0,-88.0,15.0,16.0,17.0,18.0,1
2321,CC:2F:71:3E:C5:1F,3224075,407183939,11374,1391329,3212701,405792610,6,48576,4067757,40145,3068745,8431,999012,11993,34,16338,186,6,825,144444.0,39000.0,-69.0,-70.0,-69.0,-60.0,-69.0,-70.0,-68.0,-60.0,-82.0,-88.0,-82.0,-88.0,13.0,18.0,13.0,28.0,1
2322,CC:2F:71:3F:1F:24,8157990,7944265904,4945288,7538473226,3212702,405792678,80,1154343,714832579,1145822,713809261,8521,1023318,1101301,619,4950007,501479,80,5686,115556.0,28889.0,-70.0,-65.0,-72.0,-68.0,-70.0,-65.0,-72.0,-68.0,-82.0,-88.0,-82.0,-88.0,12.0,23.0,10.0,20.0,1
2323,F8:59:71:5A:E0:3D,3317274,556641347,104568,150848265,3212706,405793082,0,102497,109520949,97707,108948637,4790,572312,80309,16,107280,2357,0,512,144444.0,43333.0,-67.0,-71.0,-65.0,-70.0,-66.0,-71.0,-65.0,-70.0,-82.0,-88.0,-82.0,-88.0,15.0,17.0,17.0,18.0,1
2324,CC:2F:71:3E:C5:1F,3224080,407184411,11374,1391329,3212706,405793082,6,48576,4067757,40145,3068745,8431,999012,11993,34,16338,186,6,825,144444.0,39000.0,-69.0,-70.0,-69.0,-60.0,-69.0,-70.0,-68.0,-60.0,-82.0,-88.0,-82.0,-88.0,13.0,18.0,13.0,28.0,1
2325,CC:2F:71:3F:1F:24,8158668,7945289768,4945962,7539496686,3212706,405793082,80,1154581,715037871,1146060,714014553,8521,1023318,1101539,619,4950681,501527,80,5686,115556.0,28889.0,-70.0,-65.0,-72.0,-68.0,-70.0,-65.0,-72.0,-68.0,-82.0,-88.0,-82.0,-88.0,12.0,23.0,10.0,20.0,1
2326,F8:59:71:5A:E0:3D,3317337,556739249,104631,150946167,3212706,405793082,0,102561,109619509,97771,109047197,4790,572312,80373,16,107343,2359,0,512,144444.0,43333.0,-66.0,-71.0,-66.0,-70.0,-66.0,-71.0,-65.0,-70.0,-82.0,-88.0,-82.0,-88.0,16.0,17.0,16.0,18.0,1
2327,CC:2F:71:3E:C5:1F,3224080,407184411,11374,1391329,3212706,405793082,6,48576,4067757,40145,3068745,8431,999012,11993,34,16338,186,6,825,144444.0,39000.0,-69.0,-70.0,-69.0,-60.0,-69.0,-70.0,-68.0,-60.0,-82.0,-88.0,-82.0,-88.0,13.0,18.0,13.0,28.0,1
2328,CC:2F:71:3F:1F:24,8159922,7947216445,4947214,7541423161,3212708,405793284,80,1154918,715259532,1146397,714236214,8521,1023318,1101876,619,4951933,501563,80,5687,115556.0,28889.0,-70.0,-65.0,-73.0,-68.0,-70.0,-65.0,-72.0,-68.0,-82.0,-88.0,-82.0,-88.0,12.0,23.0,9.0,20.0,1
2329,F8:59:71:5A:E0:3D,3317410,556839573,104695,151045623,3212715,405793950,0,102624,109716557,97834,109144245,4790,572312,80436,16,107406,2359,0,512,144444.0,43333.0,-66.0,-71.0,-65.0,-71.0,-66.0,-71.0,-65.0,-70.0,-82.0,-88.0,-82.0,-88.0,16.0,17.0,17.0,17.0,1
2330,CC:2F:71:3E:C5:1F,3224089,407185279,11374,1391329,3212715,405793950,6,48576,4067757,40145,3068745,8431,999012,11993,34,16338,186,6,825,144444.0,39000.0,-69.0,-70.0,-69.0,-60.0,-69.0,-70.0,-68.0,-60.0,-82.0,-88.0,-82.0,-88.0,13.0,18.0,13.0,28.0,1
2331,CC:2F:71:3F:1F:24,8161274,7949297593,4948559,7543503643,3212715,405793950,80,1155255,715486694,1146734,714463376,8521,1023318,1102213,619,4953262,501812,80,5687,115556.0,28889.0,-71.0,-65.0,-73.0,-68.0,-70.0,-65.0,-72.0,-68.0,-82.0,-88.0,-82.0,-88.0,11.0,23.0,9.0,20.0,1
2332,F8:59:71:5A:E0:3D,3317474,556937748,104758,151143525,3212716,405794223,0,102687,109813577,97897,109241265,4790,572312,80499,16,107470,2360,0,512,144444.0,43333.0,-67.0,-72.0,-65.0,-70.0,-66.0,-71.0,-65.0,-70.0,-82.0,-88.0,-82.0,-88.0,15.0,16.0,17.0,18.0,1
2333,CC:2F:71:3E:C5:1F,3224090,407185552,11374,1391329,3212716,405794223,6,48576,4067757,40145,3068745,8431,999012,11993,34,16338,186,6,825,144444.0,39000.0,-69.0,-70.0,-69.0,-60.0,-69.0,-70.0,-68.0,-60.0,-82.0,-88.0,-82.0,-88.0,13.0,18.0,13.0,28.0,1
2334,CC:2F:71:3F:1F:24,8162859,7951755690,4950143,7545961467,3212716,405794223,80,1155640,715717560,1147119,714694242,8521,1023318,1102597,619,4954847,501935,80,5687,115556.0,28889.0,-70.0,-65.0,-72.0,-68.0,-70.0,-65.0,-72.0,-68.0,-82.0,-88.0,-82.0,-88.0,12.0,23.0,10.0,20.0,1
2335,F8:59:71:5A:E0:3D,3317548,557042532,104825,151247643,3212723,405794889,0,102754,109916757,97964,109344445,4790,572312,80566,16,107537,2361,0,512,144444.0,43333.0,-67.0,-71.0,-65.0,-71.0,-66.0,-71.0,-65.0,-70.0,-82.0,-88.0,-82.0,-88.0,15.0,17.0,17.0,17.0,1
2336,CC:2F:71:3E:C5:1F,3224099,407186420,11374,1391329,3212725,405795091,6,48576,4067757,40145,3068745,8431,999012,11993,34,16338,186,6,825,144444.0,39000.0,-69.0,-70.0,-69.0,-60.0,-69.0,-70.0,-68.0,-60.0,-82.0,-88.0,-82.0,-88.0,13.0,18.0,13.0,28.0,1
2337,CC:2F:71:3F:1F:24,8164262,7953914386,4951537,7548119295,3212725,405795091,80,1156006,715943696,1147485,714920378,8521,1023318,1102963,619,4956251,502153,80,5687,115556.0,28889.0,-70.0,-65.0,-72.0,-67.0,-70.0,-65.0,-72.0,-67.0,-82.0,-88.0,-82.0,-88.0,12.0,23.0,10.0,21.0,1
2338,F8:59:71:5A:E0:3D,3317614,557142190,104889,151347099,3212725,405795091,0,102818,110015317,98028,109443005,4790,572312,80630,16,107600,2362,0,512,144444.0,43333.0,-66.0,-71.0,-65.0,-71.0,-66.0,-71.0,-65.0,-70.0,-82.0,-88.0,-81.0,-88.0,16.0,17.0,16.0,17.0,1
2339,CC:2F:71:3E:C5:1F,3224099,407186420,11374,1391329,3212725,405795091,6,48576,4067757,40145,3068745,8431,999012,11993,34,16338,186,6,825,144444.0,39000.0,-69.0,-70.0,-69.0,-60.0,-69.0,-70.0,-68.0,-60.0,-82.0,-88.0,-81.0,-88.0,13.0,18.0,12.0,28.0,1
2340,CC:2F:71:3F:1F:24,8165431,7955705509,4952706,7549910418,3212725,405795091,80,1156352,716170561,1147831,715147243,8521,1023318,1103309,619,4957425,502289,80,5687,115556.0,28889.0,-70.0,-65.0,-73.0,-68.0,-70.0,-65.0,-72.0,-68.0,-82.0,-88.0,-81.0,-88.0,12.0,23.0,8.0,20.0,1
2341,F8:59:71:5A:E0:3D,3317686,557245360,104955,151449663,3212731,405795697,0,102883,110115431,98093,109543119,4790,572312,80694,16,107667,2362,0,512,144444.0,43333.0,-66.0,-71.0,-65.0,-70.0,-66.0,-71.0,-65.0,-70.0,-82.0,-88.0,-81.0,-88.0,16.0,17.0,16.0,18.0,1
2342,CC:2F:71:3E:C5:1F,3224105,407187026,11374,1391329,3212731,405795697,6,48576,4067757,40145,3068745,8431,999012,11993,34,16338,186,6,825,144444.0,39000.0,-69.0,-70.0,-69.0,-60.0,-69.0,-70.0,-68.0,-60.0,-82.0,-88.0,-81.0,-88.0,13.0,18.0,12.0,28.0,1
2343,CC:2F:71:3F:1F:24,8167161,7958381705,4954428,7552585806,3212733,405795899,80,1156767,716405013,1148246,715381695,8521,1023318,1103724,619,4959147,502405,80,5687,115556.0,28889.0,-71.0,-65.0,-73.0,-68.0,-70.0,-64.0,-72.0,-68.0,-82.0,-88.0,-81.0,-88.0,11.0,23.0,8.0,20.0,1
2344,F8:59:71:5A:E0:3D,3317752,557343524,105018,151547565,3212734,405795959,0,102949,110217071,98159,109644759,4790,572312,80760,16,107730,2362,0,512,144444.0,43333.0,-67.0,-72.0,-65.0,-70.0,-66.0,-71.0,-65.0,-70.0,-82.0,-88.0,-81.0,-88.0,15.0,16.0,16.0,18.0,1
2345,CC:2F:71:3E:C5:1F,3224108,407187288,11374,1391329,3212734,405795959,6,48576,4067757,40145,3068745,8431,999012,11993,34,16338,186,6,825,144444.0,39000.0,-69.0,-70.0,-69.0,-60.0,-69.0,-70.0,-68.0,-60.0,-82.0,-88.0,-81.0,-88.0,13.0,18.0,12.0,28.0,1
2346,CC:2F:71:3F:1F:24,8168437,7960350435,4955703,7554554476,3212734,405795959,80,1157118,716626345,1148597,715603027,8521,1023318,1104075,619,4960422,502527,80,5687,115556.0,28889.0,-70.0,-65.0,-72.0,-68.0,-70.0,-65.0,-71.0,-67.0,-82.0,-88.0,-81.0,-88.0,12.0,23.0,9.0,20.0,1
2347,F8:59:71:5A:E0:3D,3317820,557443384,105082,151647021,3212738,405796363,0,103012,110314091,98222,109741779,4790,572312,80823,16,107794,2363,0,512,144444.0,43333.0,-66.0,-71.0,-65.0,-70.0,-66.0,-71.0,-65.0,-70.0,-82.0,-88.0,-81.0,-88.0,16.0,17.0,16.0,18.0,1
2348,CC:2F:71:3E:C5:1F,3224114,407187894,11374,1391329,3212740,405796565,6,48576,4067757,40145,3068745,8431,999012,11993,34,16338,186,6,825,144444.0,39000.0,-69.0,-70.0,-69.0,-60.0,-69.0,-70.0,-68.0,-60.0,-82.0,-88.0,-81.0,-88.0,13.0,18.0,12.0,28.0,1
2349,CC:2F:71:3F:1F:24,8169611,7962151089,4956871,7556354524,3212740,405796565,80,1157440,716844325,1148919,715821007,8521,1023318,1104397,619,4961590,502648,80,5687,115556.0,28889.0,-70.0,-64.0,-72.0,-68.0,-70.0,-64.0,-72.0,-67.0,-82.0,-88.0,-81.0,-88.0,12.0,24.0,9.0,20.0,1
2350,F8:59:71:5A:E0:3D,3317890,557542174,105146,151745039,3212744,405797135,0,103076,110412651,98286,109840339,4790,572312,80887,16,107858,2363,0,512,144444.0,43333.0,-66.0,-72.0,-65.0,-70.0,-66.0,-71.0,-65.0,-70.0,-81.0,-87.0,-81.0,-87.0,15.0,15.0,16.0,17.0,1
2351,CC:2F:71:3E:C5:1F,3224119,407188580,11375,1391445,3212744,405797135,6,48578,4067897,40147,3068885,8431,999012,11993,34,16339,186,6,825,144444.0,39000.0,-69.0,-70.0,-68.0,-61.0,-69.0,-70.0,-68.0,-60.0,-81.0,-87.0,-81.0,-87.0,12.0,17.0,13.0,26.0,1
2352,CC:2F:71:3F:1F:24,8170803,7963975400,4958059,7558178265,3212744,405797135,80,1157780,717066353,1149259,716043035,8521,1023318,1104736,619,4962772,502852,80,5687,115556.0,1000.0,-71.0,-65.0,-73.0,-68.0,-70.0,-65.0,-72.0,-68.0,-81.0,-87.0,-81.0,-87.0,10.0,22.0,8.0,19.0,1
2353,F8:59:71:5A:E0:3D,3317959,557642094,105210,151844495,3212749,405797599,0,103139,110509671,98349,109937359,4790,572312,80950,16,107922,2364,0,512,144444.0,43333.0,-66.0,-71.0,-65.0,-70.0,-66.0,-71.0,-65.0,-70.0,-81.0,-87.0,-81.0,-87.0,15.0,16.0,16.0,17.0,1
2354,CC:2F:71:3E:C5:1F,3224124,407189044,11375,1391445,3212749,405797599,6,48578,4067897,40147,3068885,8431,999012,11993,34,16339,186,6,825,144444.0,39000.0,-69.0,-70.0,-68.0,-61.0,-69.0,-70.0,-68.0,-60.0,-81.0,-87.0,-81.0,-87.0,12.0,17.0,13.0,26.0,1
2355,CC:2F:71:3F:1F:24,8172219,7966158990,4959470,7560361391,3212749,405797599,80,1158159,717296695,1149638,716273377,8521,1023318,1105115,619,4964167,503207,80,5687,115556.0,28889.0,-71.0,-65.0,-73.0,-68.0,-70.0,-65.0,-72.0,-68.0,-81.0,-87.0,-81.0,-87.0,10.0,22.0,8.0,19.0,1
2356,F8:59:71:5A:E0:3D,3318027,557741954,105274,151943951,3212753,405798003,0,103203,110608231,98413,110035919,4790,572312,81014,16,107986,2365,0,512,144444.0,43333.0,-66.0,-71.0,-65.0,-70.0,-66.0,-71.0,-65.0,-70.0,-81.0,-87.0,-80.0,-87.0,15.0,16.0,15.0,17.0,1
2357,CC:2F:71:3E:C5:1F,3224128,407189448,11375,1391445,3212753,405798003,6,48578,4067897,40147,3068885,8431,999012,11993,34,16339,186,6,825,144444.0,39000.0,-69.0,-70.0,-68.0,-61.0,-69.0,-70.0,-68.0,-60.0,-81.0,-87.0,-80.0,-87.0,12.0,17.0,12.0,26.0,1
2358,CC:2F:71:3F:1F:24,8173273,7967773334,4960520,7561975331,3212753,405798003,80,1158469,717509131,1149948,716485813,8521,1023318,1105425,619,4965239,503297,80,5687,115556.0,28889.0,-71.0,-65.0,-73.0,-68.0,-70.0,-65.0,-72.0,-68.0,-81.0,-87.0,-80.0,-87.0,10.0,22.0,7.0,19.0,1
2359,F8:59:71:5A:E0:3D,3318091,557838504,105336,152040299,3212755,405798205,0,103267,110706805,98477,110134493,4790,572312,81077,16,108048,2365,0,512,144444.0,43333.0,-66.0,-71.0,-65.0,-70.0,-66.0,-71.0,-65.0,-70.0,-81.0,-87.0,-80.0,-87.0,15.0,16.0,15.0,17.0,1
2360,CC:2F:71:3E:C5:1F,3224132,407189852,11375,1391445,3212757,405798407,6,48578,4067897,40147,3068885,8431,999012,11993,34,16339,186,6,825,144444.0,39000.0,-69.0,-70.0,-68.0,-61.0,-69.0,-70.0,-68.0,-60.0,-81.0,-87.0,-80.0,-87.0,12.0,17.0,12.0,26.0,1
2361,CC:2F:71:3F:1F:24,8174080,7968997544,4961323,7563199137,3212757,405798407,80,1158736,717723689,1150215,716700371,8521,1023318,1105691,619,4966034,503392,80,5687,115556.0,28889.0,-71.0,-65.0,-73.0,-68.0,-70.0,-65.0,-72.0,-68.0,-81.0,-87.0,-80.0,-87.0,10.0,22.0,7.0,19.0,1
2362,F8:59:71:5A:E0:3D,3318164,557941734,105402,152142863,3212762,405798871,0,103332,110807031,98542,110234719,4790,572312,81142,16,108114,2366,0,512,144444.0,43333.0,-66.0,-71.0,-65.0,-70.0,-66.0,-71.0,-65.0,-70.0,-81.0,-87.0,-80.0,-87.0,15.0,16.0,15.0,17.0,1
2363,CC:2F:71:3E:C5:1F,3224137,407190316,11375,1391445,3212762,405798871,6,48578,4067897,40147,3068885,8431,999012,11993,34,16339,186,6,825,144444.0,39000.0,-69.0,-70.0,-68.0,-61.0,-69.0,-70.0,-68.0,-60.0,-81.0,-87.0,-80.0,-87.0,12.0,17.0,12.0,26.0,1
2364,CC:2F:71:3F:1F:24,8175045,7970470968,4962283,7564672097,3212762,405798871,80,1159037,717948303,1150516,716924985,8521,1023318,1105992,619,4966995,503556,80,5688,115556.0,26000.0,-70.0,-65.0,-72.0,-68.0,-69.0,-65.0,-72.0,-67.0,-81.0,-87.0,-80.0,-87.0,11.0,22.0,8.0,19.0,1
2365,F8:59:71:5A:E0:3D,3318226,558038082,105464,152239211,3212762,405798871,0,103395,110904051,98605,110331739,4790,572312,81205,16,108176,2366,0,512,144444.0,43333.0,-66.0,-71.0,-65.0,-70.0,-66.0,-71.0,-65.0,-70.0,-81.0,-87.0,-80.0,-87.0,15.0,16.0,15.0,17.0,1
2366,CC:2F:71:3E:C5:1F,3224137,407190316,11375,1391445,3212762,405798871,6,48578,4067897,40147,3068885,8431,999012,11993,34,16339,186,6,825,144444.0,39000.0,-69.0,-70.0,-68.0,-61.0,-69.0,-70.0,-68.0,-60.0,-81.0,-87.0,-80.0,-87.0,12.0,17.0,12.0,26.0,1
2367,CC:2F:71:3F:1F:24,8175948,7971843759,4963184,7566044686,3212764,405799073,80,1159326,718162979,1150805,717139661,8521,1023318,1106280,619,4967903,503598,80,5689,115556.0,28889.0,-70.0,-65.0,-72.0,-68.0,-69.0,-64.0,-71.0,-67.0,-81.0,-87.0,-80.0,-87.0,11.0,22.0,8.0,19.0,1
2368,F8:59:71:5A:E0:3D,3318298,558138346,105528,152338667,3212770,405799679,0,103458,111001071,98668,110428759,4790,572312,81268,16,108240,2367,0,512,144444.0,43333.0,-66.0,-71.0,-65.0,-70.0,-66.0,-71.0,-65.0,-70.0,-81.0,-87.0,-80.0,-87.0,15.0,16.0,15.0,17.0,1
2369,CC:2F:71:3E:C5:1F,3224145,407191124,11375,1391445,3212770,405799679,6,48578,4067897,40147,3068885,8431,999012,11993,34,16339,186,6,825,144444.0,39000.0,-69.0,-70.0,-68.0,-61.0,-69.0,-70.0,-68.0,-60.0,-81.0,-87.0,-80.0,-87.0,12.0,17.0,12.0,26.0,1
2370,CC:2F:71:3F:1F:24,8176959,7973375027,4964178,7567569924,3212781,405805103,80,1159638,718376905,1151117,717353587,8521,1023318,1106592,619,4968896,503680,80,5689,115556.0,28889.0,-70.0,-65.0,-72.0,-67.0,-70.0,-65.0,-72.0,-67.0,-81.0,-87.0,-80.0,-87.0,11.0,22.0,8.0,20.0,1
2371,F8:59:71:5A:E0:3D,3318384,558247156,105591,152436569,3212793,405810587,0,103521,111098217,98731,110525905,4790,572312,81331,16,108303,2368,0,512,130000.0,39000.0,-66.0,-71.0,-65.0,-70.0,-66.0,-71.0,-65.0,-70.0,-81.0,-87.0,-80.0,-87.0,15.0,16.0,15.0,17.0,1
2372,CC:2F:71:3E:C5:1F,3224169,407202094,11375,1391445,3212794,405810649,6,48578,4067897,40147,3068885,8431,999012,11993,34,16339,186,6,825,144444.0,39000.0,-69.0,-70.0,-68.0,-61.0,-69.0,-70.0,-68.0,-60.0,-81.0,-88.0,-81.0,-87.0,12.0,18.0,13.0,26.0,1
2373,CC:2F:71:3F:1F:24,8178078,7975082537,4965284,7569271888,3212794,405810649,80,1159934,718597709,1151413,717574391,8521,1023318,1106888,619,4969996,503927,80,5689,117000.0,39000.0,-70.0,-65.0,-72.0,-67.0,-70.0,-65.0,-72.0,-67.0,-81.0,-88.0,-81.0,-87.0,11.0,23.0,9.0,20.0,1
2374,F8:59:71:5A:E0:3D,3318455,558347112,105655,152535857,3212800,405811255,0,103587,111198435,98796,110626005,4791,572430,81397,16,108367,2368,0,512,144444.0,43333.0,-66.0,-71.0,-65.0,-70.0,-66.0,-71.0,-65.0,-70.0,-81.0,-88.0,-81.0,-87.0,15.0,17.0,16.0,17.0,1
2375,CC:2F:71:3E:C5:1F,3224176,407202973,11375,1391445,3212801,405811528,6,48578,4067897,40147,3068885,8431,999012,11993,34,16339,186,6,825,144444.0,39000.0,-69.0,-70.0,-68.0,-61.0,-69.0,-70.0,-68.0,-60.0,-81.0,-88.0,-81.0,-87.0,12.0,18.0,13.0,26.0,1
2376,CC:2F:71:3F:1F:24,8179051,7976561586,4966248,7570749856,3212803,405811730,80,1160225,718812209,1151704,717788891,8521,1023318,1107179,619,4970965,504197,80,5689,115556.0,28889.0,-70.0,-65.0,-73.0,-68.0,-70.0,-65.0,-72.0,-68.0,-81.0,-88.0,-81.0,-87.0,11.0,23.0,8.0,19.0,1
2377,F8:59:71:5A:E0:3D,3318520,558443935,105717,152632205,3212803,405811730,0,103648,111292375,98857,110719945,4791,572430,81458,16,108429,2368,0,512,144444.0,43333.0,-67.0,-71.0,-65.0,-70.0,-66.0,-71.0,-65.0,-70.0,-81.0,-88.0,-81.0,-87.0,14.0,17.0,16.0,17.0,1
2378,CC:2F:71:3E:C5:1F,3224178,407203175,11375,1391445,3212803,405811730,6,48578,4067897,40147,3068885,8431,999012,11993,34,16339,186,6,825,144444.0,39000.0,-69.0,-70.0,-68.0,-61.0,-69.0,-70.0,-68.0,-60.0,-81.0,-88.0,-81.0,-87.0,12.0,18.0,13.0,26.0,1
2379,CC:2F:71:3F:1F:24,8180060,7978103207,4967257,7572291477,3212803,405811730,80,1160548,719028006,1152027,718004688,8521,1023318,1107502,619,4971976,504249,80,5689,115556.0,28889.0,-71.0,-65.0,-73.0,-68.0,-70.0,-65.0,-72.0,-68.0,-81.0,-88.0,-81.0,-87.0,10.0,23.0,8.0,19.0,1
2380,F8:59:71:5A:E0:3D,3318592,558544119,105781,152731661,3212811,405812458,0,103710,111387855,98919,110815425,4791,572430,81520,16,108493,2370,0,512,144444.0,43333.0,-67.0,-71.0,-65.0,-70.0,-66.0,-71.0,-65.0,-70.0,-81.0,-88.0,-81.0,-87.0,14.0,17.0,16.0,17.0,1
2381,CC:2F:71:3E:C5:1F,3224186,407203903,11375,1391445,3212811,405812458,6,48580,4068085,40148,3068955,8432,999130,11994,34,16339,186,6,825,144444.0,39000.0,-69.0,-70.0,-68.0,-61.0,-69.0,-70.0,-68.0,-60.0,-81.0,-88.0,-81.0,-87.0,12.0,18.0,13.0,26.0,1
2382,CC:2F:71:3F:1F:24,8181341,7980069353,4968530,7574256895,3212811,405812458,80,1160869,719251594,1152348,718228276,8521,1023318,1107823,619,4973249,504335,80,5690,115556.0,28889.0,-71.0,-65.0,-73.0,-68.0,-70.0,-65.0,-72.0,-68.0,-81.0,-88.0,-81.0,-87.0,10.0,23.0,8.0,19.0,1
2383,F8:59:71:5A:E0:3D,3318660,558646885,105847,152834225,3212813,405812660,0,103778,111492575,98987,110920145,4791,572430,81588,16,108559,2370,0,512,144444.0,43333.0,-66.0,-71.0,-65.0,-70.0,-66.0,-71.0,-65.0,-70.0,-81.0,-88.0,-81.0,-87.0,15.0,17.0,16.0,17.0,1
2384,CC:2F:71:3E:C5:1F,3224188,407204105,11375,1391445,3212813,405812660,6,48580,4068085,40148,3068955,8432,999130,11994,34,16339,186,6,825,144444.0,39000.0,-69.0,-70.0,-68.0,-61.0,-69.0,-70.0,-68.0,-60.0,-81.0,-88.0,-81.0,-87.0,12.0,18.0,13.0,26.0,1
2385,CC:2F:71:3F:1F:24,8182787,7982304811,4969974,7576492151,3212813,405812660,80,1161226,719479366,1152705,718456048,8521,1023318,1108180,619,4974693,504493,80,5690,115556.0,28889.0,-70.0,-65.0,-72.0,-68.0,-70.0,-65.0,-72.0,-68.0,-81.0,-88.0,-81.0,-87.0,11.0,23.0,9.0,19.0,1
2386,F8:59:71:5A:E0:3D,3318731,558745515,105910,152932127,3212821,405813388,0,103841,111589595,99050,111017165,4791,572430,81651,16,108621,2372,0,512,144444.0,43333.0,-67.0,-71.0,-65.0,-71.0,-66.0,-71.0,-65.0,-70.0,-81.0,-88.0,-81.0,-87.0,14.0,17.0,16.0,16.0,1
2387,CC:2F:71:3E:C5:1F,3224196,407204833,11375,1391445,3212821,405813388,6,48580,4068085,40148,3068955,8432,999130,11994,34,16339,186,6,825,144444.0,39000.0,-69.0,-70.0,-68.0,-61.0,-69.0,-70.0,-68.0,-60.0,-81.0,-88.0,-81.0,-87.0,12.0,18.0,13.0,26.0,1
2388,CC:2F:71:3F:1F:24,8183917,7984032999,4971096,7578219611,3212821,405813388,80,1161533,719695584,1153011,718672148,8522,1023436,1108487,619,4975791,504542,80,5690,115556.0,28889.0,-70.0,-65.0,-72.0,-68.0,-70.0,-65.0,-72.0,-67.0,-81.0,-88.0,-81.0,-87.0,11.0,23.0,9.0,19.0,1
2389,F8:59:71:5A:E0:3D,3318797,558845173,105974,153031583,3212823,405813590,0,103905,111688155,99114,111115725,4791,572430,81715,16,108686,2372,0,512,144444.0,43333.0,-67.0,-71.0,-65.0,-70.0,-66.0,-71.0,-65.0,-70.0,-81.0,-88.0,-81.0,-87.0,14.0,17.0,16.0,17.0,1
2390,CC:2F:71:3E:C5:1F,3224198,407205035,11375,1391445,3212823,405813590,6,48580,4068085,40148,3068955,8432,999130,11994,34,16339,186,6,825,144444.0,39000.0,-69.0,-70.0,-68.0,-61.0,-69.0,-70.0,-68.0,-60.0,-81.0,-88.0,-81.0,-87.0,12.0,18.0,13.0,26.0,1
2391,CC:2F:71:3F:1F:24,8185312,7986177656,4972489,7580364066,3212823,405813590,80,1161904,719925489,1153382,718902053,8522,1023436,1108858,619,4977208,504729,80,5690,115556.0,28889.0,-71.0,-65.0,-73.0,-68.0,-70.0,-65.0,-72.0,-68.0,-81.0,-88.0,-81.0,-87.0,10.0,23.0,8.0,19.0,1
2392,F8:59:71:5A:E0:3D,3318864,558944899,106038,153131039,3212826,405813860,0,103969,111786715,99178,111214285,4791,572430,81779,16,108750,2372,0,512,144444.0,43333.0,-67.0,-71.0,-65.0,-70.0,-67.0,-71.0,-65.0,-70.0,-81.0,-88.0,-81.0,-87.0,14.0,17.0,16.0,17.0,1
2393,CC:2F:71:3E:C5:1F,3224204,407205641,11375,1391445,3212829,405814196,6,48580,4068085,40148,3068955,8432,999130,11994,34,16339,186,6,825,144444.0,39000.0,-69.0,-70.0,-68.0,-61.0,-69.0,-70.0,-68.0,-60.0,-81.0,-87.0,-81.0,-87.0,12.0,17.0,13.0,26.0,1
2394,CC:2F:71:3F:1F:24,8186915,7988656432,4974086,7582842236,3212829,405814196,80,1162282,720167189,1153760,719143753,8522,1023436,1109236,619,4978804,504879,80,5690,115556.0,28889.0,-71.0,-66.0,-73.0,-69.0,-70.0,-65.0,-72.0,-68.0,-81.0,-87.0,-81.0,-87.0,10.0,21.0,8.0,18.0,1
2395,F8:59:71:5A:E0:3D,3318939,559052723,106107,153238265,3212832,405814458,0,104039,111894543,99248,111322113,4791,572430,81849,16,108819,2372,0,512,144444.0,43333.0,-66.0,-71.0,-65.0,-70.0,-66.0,-71.0,-65.0,-70.0,-81.0,-87.0,-81.0,-87.0,15.0,16.0,16.0,17.0,1
2396,CC:2F:71:3E:C5:1F,3224207,407205903,11375,1391445,3212832,405814458,6,48580,4068085,40148,3068955,8432,999130,11994,34,16339,186,6,825,144444.0,39000.0,-69.0,-70.0,-68.0,-61.0,-69.0,-70.0,-68.0,-60.0,-81.0,-87.0,-81.0,-87.0,12.0,17.0,13.0,26.0,1
2397,CC:2F:71:3F:1F:24,8187989,7990302108,4975157,7584487650,3212832,405814458,80,1162627,720388019,1154105,719364583,8522,1023436,1109581,619,4979876,505025,80,5690,115556.0,28889.0,-70.0,-65.0,-73.0,-68.0,-70.0,-65.0,-72.0,-68.0,-81.0,-87.0,-81.0,-87.0,11.0,22.0,8.0,19.0,1
2398,F8:59:71:5A:E0:3D,3319004,559150827,106170,153336167,3212834,405814660,0,104102,111991563,99311,111419133,4791,572430,81912,16,108882,2373,0,512,144444.0,43333.0,-66.0,-71.0,-65.0,-70.0,-66.0,-71.0,-65.0,-70.0,-81.0,-87.0,-81.0,-87.0,15.0,16.0,16.0,17.0,1
2399,CC:2F:71:3E:C5:1F,3224211,407206307,11375,1391445,3212836,405814862,6,48580,4068085,40148,3068955,8432,999130,11994,34,16339,186,6,825,144444.0,39000.0,-69.0,-70.0,-68.0,-61.0,-69.0,-70.0,-68.0,-60.0,-81.0,-87.0,-81.0,-87.0,12.0,17.0,13.0,26.0,1
2400,CC:2F:71:3F:1F:24,8189159,7992096450,4976321,7586281386,3212838,405815064,80,1162939,720606191,1154417,719582755,8522,1023436,1109893,619,4981040,505221,80,5690,115556.0,28889.0,-70.0,-65.0,-72.0,-68.0,-70.0,-65.0,-72.0,-68.0,-81.0,-87.0,-81.0,-87.0,11.0,22.0,9.0,19.0,1
2401,F8:59:71:5A:E0:3D,3319073,559249335,106233,153434069,3212840,405815266,0,104164,112087043,99373,111514613,4791,572430,81974,16,108945,2374,0,512,144444.0,43333.0,-67.0,-71.0,-65.0,-71.0,-66.0,-71.0,-65.0,-70.0,-81.0,-87.0,-81.0,-87.0,14.0,16.0,16.0,16.0,1
2402,CC:2F:71:3E:C5:1F,3224215,407206711,11375,1391445,3212840,405815266,6,48580,4068085,40148,3068955,8432,999130,11994,34,16339,186,6,825,144444.0,39000.0,-69.0,-70.0,-68.0,-61.0,-69.0,-70.0,-68.0,-60.0,-81.0,-87.0,-81.0,-87.0,12.0,17.0,13.0,26.0,1
2403,CC:2F:71:3F:1F:24,8190276,7993811332,4977436,7587996066,3212840,405815266,80,1163278,720828999,1154756,719805563,8522,1023436,1110229,619,4982154,505312,80,5690,115556.0,28889.0,-70.0,-64.0,-71.0,-68.0,-69.0,-64.0,-72.0,-68.0,-81.0,-87.0,-81.0,-87.0,11.0,23.0,10.0,19.0,1
2404,F8:59:71:5A:E0:3D,3319141,559350607,106298,153535079,3212843,405815528,0,104229,112187171,99438,111614741,4791,572430,82039,16,109010,2374,0,513,144444.0,43333.0,-66.0,-71.0,-65.0,-70.0,-67.0,-71.0,-65.0,-70.0,-81.0,-87.0,-81.0,-87.0,15.0,16.0,16.0,17.0,1
2405,CC:2F:71:3E:C5:1F,3224218,407206973,11375,1391445,3212843,405815528,6,48580,4068085,40148,3068955,8432,999130,11994,34,16339,186,6,825,144444.0,39000.0,-69.0,-70.0,-68.0,-61.0,-69.0,-70.0,-68.0,-60.0,-81.0,-87.0,-81.0,-87.0,12.0,17.0,13.0,26.0,1
2406,CC:2F:71:3F:1F:24,8191611,7995862797,4978768,7590047269,3212843,405815528,80,1163629,721065422,1155107,720041986,8522,1023436,1110578,619,4983487,505428,80,5690,115556.0,28889.0,-71.0,-65.0,-72.0,-68.0,-70.0,-65.0,-72.0,-68.0,-81.0,-87.0,-81.0,-87.0,10.0,22.0,9.0,19.0,1
2407,F8:59:71:5A:E0:3D,3319215,559456885,106366,153640751,3212849,405816134,0,104297,112291891,99506,111719461,4791,572430,82107,16,109078,2376,0,513,144444.0,43333.0,-67.0,-72.0,-65.0,-70.0,-66.0,-71.0,-65.0,-70.0,-81.0,-87.0,-80.0,-87.0,14.0,15.0,15.0,17.0,1
2408,CC:2F:71:3E:C5:1F,3224224,407207579,11375,1391445,3212849,405816134,6,48580,4068085,40148,3068955,8432,999130,11994,34,16339,186,6,825,144444.0,39000.0,-69.0,-70.0,-68.0,-61.0,-69.0,-70.0,-68.0,-60.0,-81.0,-87.0,-80.0,-87.0,12.0,17.0,12.0,26.0,1
2409,CC:2F:71:3F:1F:24,8193071,7998115911,4980222,7592299777,3212849,405816134,80,1163968,721289706,1155446,720266270,8522,1023436,1110917,619,4984923,505602,80,5690,115556.0,28889.0,-70.0,-65.0,-72.0,-68.0,-70.0,-65.0,-72.0,-68.0,-81.0,-87.0,-80.0,-87.0,11.0,22.0,8.0,19.0,1
2410,F8:59:71:5A:E0:3D,3319278,559554787,106429,153738653,3212849,405816134,0,104362,112392019,99571,111819589,4791,572430,82170,16,109141,2377,0,513,144444.0,43333.0,-67.0,-71.0,-65.0,-71.0,-66.0,-71.0,-65.0,-70.0,-81.0,-87.0,-80.0,-87.0,14.0,16.0,15.0,16.0,1
2411,CC:2F:71:3E:C5:1F,3224226,407207781,11375,1391445,3212851,405816336,6,48580,4068085,40148,3068955,8432,999130,11994,34,16339,186,6,825,144444.0,39000.0,-69.0,-70.0,-68.0,-61.0,-69.0,-70.0,-68.0,-60.0,-81.0,-87.0,-80.0,-87.0,12.0,17.0,12.0,26.0,1
2412,CC:2F:71:3F:1F:24,8194273,7999968025,4981422,7594151689,3212851,405816336,80,1164308,721512866,1155786,720489430,8522,1023436,1111257,619,4986141,505709,80,5690,117000.0,39000.0,-71.0,-65.0,-72.0,-68.0,-70.0,-65.0,-72.0,-68.0,-81.0,-87.0,-80.0,-87.0,10.0,22.0,8.0,19.0,1
2413,F8:59:71:5A:E0:3D,3319349,559654909,106493,153838109,3212856,405816800,0,104428,112493673,99637,111921243,4791,572430,82235,16,109205,2379,0,513,144444.0,43333.0,-67.0,-71.0,-65.0,-70.0,-67.0,-71.0,-65.0,-70.0,-81.0,-87.0,-80.0,-87.0,14.0,16.0,15.0,17.0,1
2414,CC:2F:71:3E:C5:1F,3224231,407208245,11375,1391445,3212856,405816800,6,48580,4068085,40148,3068955,8432,999130,11994,34,16339,186,6,825,144444.0,39000.0,-69.0,-70.0,-68.0,-61.0,-69.0,-70.0,-68.0,-60.0,-81.0,-87.0,-80.0,-87.0,12.0,17.0,12.0,26.0,1
2415,CC:2F:71:3F:1F:24,8195364,8001635947,4982506,7595818945,3212858,405817002,80,1164603,721730634,1156081,720707198,8522,1023436,1111552,619,4987225,505874,80,5690,115556.0,28889.0,-71.0,-65.0,-72.0,-68.0,-71.0,-65.0,-72.0,-68.0,-81.0,-87.0,-80.0,-87.0,10.0,22.0,8.0,19.0,1
2416,F8:59:71:5A:E0:3D,3319415,559754567,106557,153937565,3212858,405817002,0,104492,112592247,99701,112019817,4791,572430,82298,16,109269,2379,0,513,144444.0,43333.0,-67.0,-72.0,-65.0,-70.0,-66.0,-71.0,-65.0,-70.0,-81.0,-87.0,-80.0,-87.0,14.0,15.0,15.0,17.0,1
2417,CC:2F:71:3E:C5:1F,3224233,407208447,11375,1391445,3212858,405817002,6,48580,4068085,40148,3068955,8432,999130,11994,34,16339,186,6,825,144444.0,39000.0,-69.0,-70.0,-68.0,-61.0,-69.0,-70.0,-68.0,-60.0,-81.0,-87.0,-80.0,-87.0,12.0,17.0,12.0,26.0,1
2418,CC:2F:71:3F:1F:24,8196324,8003100367,4983465,7597283092,3212859,405817275,80,1164895,721942896,1156373,720919460,8522,1023436,1111844,619,4988184,505936,80,5690,115556.0,28889.0,-71.0,-66.0,-73.0,-69.0,-71.0,-66.0,-73.0,-69.0,-81.0,-87.0,-80.0,-87.0,10.0,21.0,7.0,18.0,1
2419,F8:59:71:5A:E0:3D,3319484,559851794,106619,154033913,3212865,405817881,0,104554,112687727,99763,112115297,4791,572430,82360,16,109331,2380,0,513,144444.0,43333.0,-67.0,-71.0,-65.0,-70.0,-66.0,-71.0,-65.0,-70.0,-81.0,-87.0,-80.0,-87.0,14.0,16.0,15.0,17.0,1
2420,CC:2F:71:3E:C5:1F,3224240,407209326,11375,1391445,3212865,405817881,6,48580,4068085,40148,3068955,8432,999130,11994,34,16339,186,6,825,144444.0,39000.0,-69.0,-70.0,-68.0,-61.0,-69.0,-70.0,-68.0,-60.0,-81.0,-87.0,-80.0,-87.0,12.0,17.0,12.0,26.0,1
2421,CC:2F:71:3F:1F:24,8197461,8004838909,4984595,7599020968,3212866,405817941,80,1165232,722175676,1156710,721152240,8522,1023436,1112181,619,4989289,506047,80,5690,115556.0,28889.0,-70.0,-65.0,-72.0,-68.0,-70.0,-65.0,-72.0,-68.0,-81.0,-87.0,-80.0,-87.0,11.0,22.0,8.0,19.0,1
2422,F8:59:71:5A:E0:3D,3319555,559957728,106687,154139585,3212868,405818143,0,104624,112795555,99833,112223125,4791,572430,82428,16,109399,2381,0,513,144444.0,43333.0,-68.0,-72.0,-66.0,-71.0,-67.0,-72.0,-65.0,-71.0,-81.0,-87.0,-80.0,-87.0,13.0,15.0,14.0,16.0,1
2423,CC:2F:71:3E:C5:1F,3224243,407209588,11375,1391445,3212868,405818143,6,48580,4068085,40148,3068955,8432,999130,11994,34,16339,186,6,825,144444.0,39000.0,-69.0,-70.0,-68.0,-61.0,-69.0,-70.0,-68.0,-60.0,-81.0,-87.0,-80.0,-87.0,12.0,17.0,12.0,26.0,1
2424,CC:2F:71:3F:1F:24,8198496,8006425929,4985628,7600607786,3212868,405818143,80,1165535,722388746,1157013,721365310,8522,1023436,1112484,619,4990347,506209,80,5691,115556.0,28889.0,-71.0,-65.0,-73.0,-69.0,-71.0,-65.0,-73.0,-68.0,-81.0,-87.0,-80.0,-87.0,10.0,22.0,7.0,18.0,1
2425,F8:59:71:5A:E0:3D,3319625,560057790,106751,154239041,3212874,405818749,0,104691,112898763,99900,112326333,4791,572430,82493,16,109463,2382,0,513,144444.0,43333.0,-67.0,-70.0,-65.0,-71.0,-66.0,-71.0,-65.0,-70.0,-81.0,-87.0,-80.0,-87.0,14.0,17.0,15.0,16.0,1
2426,CC:2F:71:3E:C5:1F,3224249,407210194,11375,1391445,3212874,405818749,6,48580,4068085,40148,3068955,8432,999130,11994,34,16339,186,6,825,144444.0,39000.0,-69.0,-70.0,-68.0,-61.0,-69.0,-70.0,-68.0,-60.0,-81.0,-87.0,-80.0,-87.0,12.0,17.0,12.0,26.0,1
2427,CC:2F:71:3F:1F:24,8199741,8008338477,4986867,7602519728,3212874,405818749,80,1165887,722620278,1157365,721596842,8522,1023436,1112836,619,4991569,506432,80,5691,115556.0,28889.0,-71.0,-65.0,-72.0,-68.0,-70.0,-65.0,-72.0,-68.0,-81.0,-87.0,-80.0,-87.0,10.0,22.0,8.0,19.0,1
2428,F8:59:71:5A:E0:3D,3319691,560157448,106815,154338497,3212876,405818951,0,104755,112997337,99964,112424907,4791,572430,82556,16,109527,2382,0,513,144444.0,43333.0,-67.0,-72.0,-66.0,-71.0,-67.0,-72.0,-66.0,-71.0,-81.0,-87.0,-80.0,-87.0,14.0,15.0,14.0,16.0,1
2429,CC:2F:71:3E:C5:1F,3224252,407210456,11375,1391445,3212877,405819011,6,48580,4068085,40148,3068955,8432,999130,11994,34,16339,186,6,825,144444.0,39000.0,-69.0,-70.0,-68.0,-61.0,-69.0,-70.0,-68.0,-60.0,-81.0,-87.0,-80.0,-87.0,12.0,17.0,12.0,26.0,1
2430,CC:2F:71:3F:1F:24,8200758,8009884970,4987881,7604065959,3212877,405819011,80,1166240,722845265,1157718,721821829,8522,1023436,1113189,619,4992600,506583,80,5691,115556.0,28889.0,-72.0,-65.0,-73.0,-68.0,-71.0,-65.0,-72.0,-68.0,-81.0,-87.0,-80.0,-87.0,9.0,22.0,7.0,19.0,1
2431,F8:59:71:5A:E0:3D,3319762,560257570,106879,154437953,3212883,405819617,0,104820,113097451,100029,112525021,4791,572430,82620,16,109591,2382,0,513,144444.0,43333.0,-67.0,-72.0,-66.0,-71.0,-66.0,-71.0,-65.0,-71.0,-81.0,-87.0,-80.0,-87.0,14.0,15.0,14.0,16.0,1
2432,CC:2F:71:3E:C5:1F,3224258,407211062,11375,1391445,3212883,405819617,6,48580,4068085,40148,3068955,8432,999130,11994,34,16339,186,6,825,144444.0,39000.0,-69.0,-70.0,-68.0,-61.0,-69.0,-70.0,-68.0,-60.0,-81.0,-87.0,-80.0,-87.0,12.0,17.0,12.0,26.0,1
2433,CC:2F:71:3F:1F:24,8201933,8011687130,4989050,7605867513,3212883,405819617,80,1166576,723069149,1158054,722045713,8522,1023436,1113519,619,4993747,506668,80,5692,115556.0,28889.0,-71.0,-65.0,-73.0,-68.0,-71.0,-65.0,-72.0,-68.0,-81.0,-87.0,-80.0,-87.0,10.0,22.0,7.0,19.0,1
2434,F8:59:71:5A:E0:3D,3319829,560357344,106944,154537525,3212885,405819819,0,104887,113200673,100096,112628243,4791,572430,82684,16,109656,2382,0,513,144444.0,43333.0,-67.0,-72.0,-66.0,-71.0,-67.0,-72.0,-65.0,-70.0,-81.0,-87.0,-80.0,-87.0,14.0,15.0,14.0,16.0,1
2435,CC:2F:71:3E:C5:1F,3224261,407211380,11376,1391561,3212885,405819819,6,48582,4068225,40150,3069095,8432,999130,11994,34,16340,186,6,825,144444.0,39000.0,-66.0,-62.0,-67.0,-59.0,-68.0,-69.0,-68.0,-60.0,-81.0,-87.0,-80.0,-87.0,15.0,25.0,13.0,28.0,1
2436,CC:2F:71:3F:1F:24,8203014,8013345340,4990129,7607525521,3212885,405819819,80,1166850,723281567,1158328,722258131,8522,1023436,1113793,619,4994839,506832,80,5693,104000.0,26000.0,-70.0,-65.0,-72.0,-68.0,-70.0,-65.0,-72.0,-68.0,-81.0,-87.0,-80.0,-87.0,11.0,22.0,8.0,19.0,1
2437,F8:59:71:5A:E0:3D,3319902,560457672,107008,154636981,3212894,405820691,0,104952,113300829,100161,112728399,4791,572430,82749,16,109720,2382,0,513,144444.0,43333.0,-66.0,-72.0,-66.0,-70.0,-66.0,-72.0,-65.0,-70.0,-81.0,-87.0,-80.0,-87.0,15.0,15.0,14.0,17.0,1
2438,CC:2F:71:3E:C5:1F,3224270,407212252,11376,1391561,3212894,405820691,6,48582,4068225,40150,3069095,8432,999130,11994,34,16340,186,6,825,144444.0,39000.0,-66.0,-62.0,-67.0,-59.0,-68.0,-69.0,-68.0,-60.0,-81.0,-87.0,-80.0,-87.0,15.0,25.0,13.0,28.0,1
2439,CC:2F:71:3F:1F:24,8204362,8015417058,4991468,7609596367,3212894,405820691,80,1167146,723502871,1158624,722479435,8522,1023436,1114089,619,4996156,507057,80,5695,115556.0,28889.0,-70.0,-64.0,-73.0,-71.0,-69.0,-63.0,-72.0,-70.0,-81.0,-87.0,-80.0,-87.0,11.0,23.0,7.0,16.0,1
2440,F8:59:71:5A:E0:3D,3319974,560560600,107074,154739377,3212900,405821223,0,105017,113400929,100226,112828499,4791,572430,82814,16,109786,2382,0,513,144444.0,43333.0,-66.0,-72.0,-66.0,-71.0,-66.0,-72.0,-66.0,-70.0,-81.0,-87.0,-80.0,-87.0,15.0,15.0,14.0,16.0,1
2441,CC:2F:71:3E:C5:1F,3224276,407212784,11376,1391561,3212900,405821223,6,48584,4068413,40151,3069165,8433,999248,11995,34,16340,186,6,825,144444.0,39000.0,-70.0,-70.0,-67.0,-60.0,-68.0,-69.0,-67.0,-60.0,-81.0,-87.0,-80.0,-87.0,11.0,17.0,13.0,27.0,1
2442,CC:2F:71:3F:1F:24,8206238,8018316085,4993338,7612494862,3212900,405821223,80,1167528,723746456,1159005,722722902,8523,1023554,1114471,619,4998057,507255,80,5696,115556.0,28889.0,-68.0,-64.0,-72.0,-70.0,-68.0,-64.0,-72.0,-70.0,-81.0,-87.0,-80.0,-87.0,13.0,23.0,8.0,17.0,1
2443,F8:59:71:5A:E0:3D,3320048,560666878,107142,154845049,3212906,405821829,0,105085,113505649,100294,112933219,4791,572430,82882,16,109854,2383,0,513,144444.0,43333.0,-67.0,-72.0,-66.0,-71.0,-66.0,-72.0,-65.0,-71.0,-81.0,-87.0,-80.0,-87.0,14.0,15.0,14.0,16.0,1
2444,CC:2F:71:3E:C5:1F,3224282,407213390,11376,1391561,3212906,405821829,6,48584,4068413,40151,3069165,8433,999248,11995,34,16340,186,6,825,144444.0,39000.0,-70.0,-70.0,-67.0,-60.0,-68.0,-69.0,-67.0,-60.0,-81.0,-87.0,-80.0,-87.0,11.0,17.0,13.0,27.0,1
2445,CC:2F:71:3F:1F:24,8207748,8020648051,4994842,7614826222,3212906,405821829,80,1167840,723970732,1159317,722947178,8523,1023554,1114783,619,4999560,507427,80,5696,115556.0,28889.0,-68.0,-64.0,-72.0,-70.0,-68.0,-63.0,-72.0,-70.0,-81.0,-87.0,-80.0,-87.0,13.0,23.0,8.0,17.0,1
2446,F8:59:71:5A:E0:3D,3320115,560766596,107206,154944505,3212909,405822091,0,105151,113607303,100360,113034873,4791,572430,82947,16,109918,2383,0,513,144444.0,43333.0,-67.0,-72.0,-66.0,-71.0,-66.0,-72.0,-66.0,-70.0,-81.0,-87.0,-80.0,-87.0,14.0,15.0,14.0,16.0,1
2447,CC:2F:71:3E:C5:1F,3224285,407213652,11376,1391561,3212909,405822091,6,48584,4068413,40151,3069165,8433,999248,11995,34,16340,186,6,825,144444.0,39000.0,-70.0,-70.0,-67.0,-60.0,-68.0,-69.0,-67.0,-60.0,-81.0,-87.0,-80.0,-87.0,11.0,17.0,13.0,27.0,1
2448,CC:2F:71:3F:1F:24,8208837,8022320437,4995928,7616498346,3212909,405822091,80,1168160,724190086,1159637,723166532,8523,1023554,1115103,619,5000647,507509,80,5696,115556.0,28889.0,-68.0,-64.0,-73.0,-70.0,-67.0,-63.0,-72.0,-69.0,-81.0,-87.0,-80.0,-87.0,13.0,23.0,7.0,17.0,1
2449,F8:59:71:5A:E0:3D,3320181,560866254,107270,155043961,3212911,405822293,0,105214,113704323,100423,113131893,4791,572430,83010,16,109982,2383,0,513,144444.0,43333.0,-67.0,-72.0,-66.0,-71.0,-66.0,-72.0,-65.0,-70.0,-81.0,-87.0,-80.0,-87.0,14.0,15.0,14.0,16.0,1
2450,CC:2F:71:3E:C5:1F,3224291,407214258,11376,1391561,3212915,405822697,6,48584,4068413,40151,3069165,8433,999248,11995,34,16340,186,6,825,144444.0,39000.0,-70.0,-70.0,-67.0,-60.0,-68.0,-69.0,-67.0,-60.0,-81.0,-87.0,-80.0,-87.0,11.0,17.0,13.0,27.0,1
2451,CC:2F:71:3F:1F:24,8209830,8023832568,4996915,7618009871,3212915,405822697,80,1168428,724401859,1159905,723378305,8523,1023554,1115371,619,5001634,507530,80,5696,115556.0,28889.0,-68.0,-63.0,-73.0,-70.0,-68.0,-63.0,-72.0,-69.0,-81.0,-87.0,-80.0,-87.0,13.0,24.0,7.0,17.0,1
2452,F8:59:71:5A:E0:3D,3320250,560966230,107335,155143533,3212915,405822697,0,105279,113802989,100488,113230559,4791,572430,83075,16,110047,2383,0,513,144444.0,43333.0,-67.0,-72.0,-66.0,-71.0,-66.0,-72.0,-65.0,-70.0,-81.0,-87.0,-80.0,-87.0,14.0,15.0,14.0,16.0,1
2453,CC:2F:71:3E:C5:1F,3224293,407214460,11376,1391561,3212917,405822899,6,48584,4068413,40151,3069165,8433,999248,11995,34,16340,186,6,825,144444.0,39000.0,-70.0,-70.0,-67.0,-60.0,-68.0,-69.0,-67.0,-60.0,-81.0,-87.0,-80.0,-87.0,11.0,17.0,13.0,27.0,1
2454,CC:2F:71:3F:1F:24,8210856,8025398789,4997939,7619575890,3212917,405822899,80,1168726,724623286,1160203,723599732,8523,1023554,1115669,619,5002658,507645,80,5698,130000.0,39000.0,-68.0,-64.0,-73.0,-69.0,-68.0,-64.0,-73.0,-69.0,-81.0,-87.0,-80.0,-87.0,13.0,23.0,7.0,18.0,1
2455,F8:59:71:5A:E0:3D,3320317,561065948,107399,155242989,3212918,405822959,0,105343,113901549,100552,113329119,4791,572430,83139,16,110110,2383,0,513,144444.0,43333.0,-66.0,-72.0,-65.0,-70.0,-66.0,-72.0,-65.0,-70.0,-81.0,-87.0,-80.0,-87.0,15.0,15.0,15.0,17.0,1
2456,CC:2F:71:3E:C5:1F,3224294,407214520,11376,1391561,3212918,405822959,6,48584,4068413,40151,3069165,8433,999248,11995,34,16340,186,6,825,144444.0,39000.0,-70.0,-70.0,-67.0,-60.0,-68.0,-69.0,-67.0,-60.0,-81.0,-87.0,-80.0,-87.0,11.0,17.0,13.0,27.0,1
2457,CC:2F:71:3F:1F:24,8211907,8027009731,4998987,7621186570,3212920,405823161,80,1169006,724834946,1160483,723811392,8523,1023554,1115949,619,5003680,507672,80,5698,130000.0,43333.0,-67.0,-63.0,-72.0,-69.0,-68.0,-63.0,-72.0,-68.0,-81.0,-87.0,-80.0,-87.0,14.0,24.0,8.0,18.0,1
2458,F8:59:71:5A:E0:3D,3320386,561164456,107462,155340891,3212924,405823565,0,105406,113998569,100615,113426139,4791,572430,83202,16,110174,2385,0,513,144444.0,43333.0,-66.0,-72.0,-66.0,-71.0,-66.0,-72.0,-65.0,-70.0,-81.0,-87.0,-80.0,-87.0,15.0,15.0,14.0,16.0,1
2459,CC:2F:71:3E:C5:1F,3224300,407215126,11376,1391561,3212924,405823565,6,48584,4068413,40151,3069165,8433,999248,11995,34,16340,186,6,825,144444.0,39000.0,-70.0,-70.0,-67.0,-60.0,-68.0,-69.0,-67.0,-60.0,-81.0,-87.0,-80.0,-87.0,11.0,17.0,13.0,27.0,1
2460,CC:2F:71:3F:1F:24,8213110,8028860477,5000186,7623036912,3212924,405823565,80,1169311,725052330,1160788,724028776,8523,1023554,1116254,619,5004904,507693,80,5698,130000.0,43333.0,-68.0,-63.0,-73.0,-69.0,-68.0,-63.0,-72.0,-69.0,-81.0,-87.0,-80.0,-87.0,13.0,24.0,7.0,18.0,1
2461,F8:59:71:5A:E0:3D,3320453,561264387,107526,155440347,3212927,405824040,0,105470,114097227,100679,113524797,4791,572430,83266,16,110238,2385,0,513,144444.0,43333.0,-67.0,-72.0,-66.0,-70.0,-66.0,-72.0,-65.0,-70.0,-81.0,-87.0,-80.0,-87.0,14.0,15.0,14.0,17.0,1
2462,CC:2F:71:3E:C5:1F,3224303,407215601,11376,1391561,3212927,405824040,6,48584,4068413,40151,3069165,8433,999248,11995,34,16340,186,6,825,144444.0,39000.0,-70.0,-70.0,-67.0,-60.0,-68.0,-69.0,-67.0,-60.0,-81.0,-87.0,-80.0,-87.0,11.0,17.0,13.0,27.0,1
2463,CC:2F:71:3F:1F:24,8214398,8030845426,5001471,7625021386,3212927,405824040,80,1169620,725270430,1161097,724246876,8523,1023554,1116563,619,5006190,507875,80,5698,130000.0,43333.0,-68.0,-64.0,-72.0,-70.0,-67.0,-64.0,-72.0,-70.0,-81.0,-87.0,-80.0,-87.0,13.0,23.0,8.0,17.0,1
2464,F8:59:71:5A:E0:3D,3320523,561362955,107589,155538249,3212934,405824706,0,105533,114194247,100742,113621817,4791,572430,83329,16,110301,2386,0,513,144444.0,43333.0,-66.0,-72.0,-66.0,-71.0,-66.0,-72.0,-65.0,-70.0,-81.0,-87.0,-80.0,-87.0,15.0,15.0,14.0,16.0,1
2465,CC:2F:71:3E:C5:1F,3224310,407216267,11376,1391561,3212934,405824706,6,48584,4068413,40151,3069165,8433,999248,11995,34,16340,186,6,825,144444.0,39000.0,-70.0,-70.0,-67.0,-60.0,-68.0,-69.0,-67.0,-60.0,-81.0,-87.0,-80.0,-87.0,11.0,17.0,13.0,27.0,1
2466,CC:2F:71:3F:1F:24,8215621,8032723132,5002687,7626898426,3212934,405824706,80,1169911,725483548,1161388,724459994,8523,1023554,1116854,619,5007401,507897,80,5698,130000.0,43333.0,-68.0,-64.0,-72.0,-70.0,-68.0,-63.0,-71.0,-70.0,-81.0,-87.0,-80.0,-87.0,13.0,23.0,8.0,17.0,1
2467,F8:59:71:5A:E0:3D,3320589,561462613,107653,155637705,3212936,405824908,0,105597,114292807,100806,113720377,4791,572430,83393,16,110365,2387,0,513,144444.0,43333.0,-67.0,-72.0,-65.0,-70.0,-66.0,-71.0,-65.0,-70.0,-81.0,-87.0,-80.0,-87.0,14.0,15.0,15.0,17.0,1
2468,CC:2F:71:3E:C5:1F,3224312,407216469,11376,1391561,3212936,405824908,6,48584,4068413,40151,3069165,8433,999248,11995,34,16340,186,6,825,144444.0,39000.0,-70.0,-70.0,-67.0,-60.0,-68.0,-69.0,-67.0,-60.0,-81.0,-87.0,-80.0,-87.0,11.0,17.0,13.0,27.0,1
2469,CC:2F:71:3F:1F:24,8217065,8034946291,5004129,7629121383,3212936,405824908,80,1170273,725728228,1161750,724704674,8523,1023554,1117216,619,5008847,508096,80,5698,115556.0,28889.0,-69.0,-65.0,-71.0,-68.0,-68.0,-65.0,-71.0,-68.0,-81.0,-87.0,-80.0,-87.0,12.0,22.0,9.0,19.0,1
2470,F8:59:71:5A:E0:3D,3320664,561570445,107722,155744931,3212942,405825514,0,105667,114400663,100876,113828233,4791,572430,83463,16,110434,2387,0,513,144444.0,43333.0,-66.0,-71.0,-65.0,-70.0,-66.0,-71.0,-65.0,-70.0,-81.0,-87.0,-80.0,-87.0,15.0,16.0,15.0,17.0,1
2471,CC:2F:71:3E:C5:1F,3224319,407217135,11376,1391561,3212943,405825574,6,48584,4068413,40151,3069165,8433,999248,11995,34,16340,186,6,825,144444.0,39000.0,-70.0,-70.0,-67.0,-60.0,-68.0,-69.0,-67.0,-60.0,-81.0,-87.0,-80.0,-87.0,11.0,17.0,13.0,27.0,1
2472,CC:2F:71:3F:1F:24,8218121,8036558831,5005178,7630733257,3212943,405825574,80,1170607,725954844,1162084,724931290,8523,1023554,1117548,619,5009897,508383,80,5698,115556.0,28889.0,-69.0,-65.0,-72.0,-68.0,-69.0,-65.0,-72.0,-67.0,-81.0,-87.0,-80.0,-87.0,12.0,22.0,8.0,19.0,1
2473,F8:59:71:5A:E0:3D,3320732,561671717,107787,155845941,3212945,405825776,0,105731,114499223,100940,113926793,4791,572430,83527,16,110499,2388,0,513,144444.0,43333.0,-67.0,-72.0,-65.0,-71.0,-66.0,-71.0,-65.0,-70.0,-81.0,-87.0,-80.0,-87.0,14.0,15.0,15.0,16.0,1
2474,CC:2F:71:3E:C5:1F,3224321,407217337,11376,1391561,3212945,405825776,6,48584,4068413,40151,3069165,8433,999248,11995,34,16340,186,6,825,144444.0,39000.0,-70.0,-70.0,-67.0,-60.0,-68.0,-69.0,-67.0,-60.0,-81.0,-87.0,-80.0,-87.0,11.0,17.0,13.0,27.0,1
2475,CC:2F:71:3F:1F:24,8219175,8038175985,5006230,7632350209,3212945,405825776,80,1170917,726175752,1162394,725152198,8523,1023554,1117858,619,5010949,508875,80,5698,115556.0,28889.0,-70.0,-65.0,-72.0,-68.0,-69.0,-65.0,-71.0,-67.0,-81.0,-87.0,-80.0,-87.0,11.0,22.0,8.0,19.0,1
2476,F8:59:71:5A:E0:3D,3320805,561772209,107851,155945397,3212954,405826812,0,105794,114594821,101002,114022273,4792,572548,83590,16,110563,2389,0,513,144444.0,43333.0,-67.0,-72.0,-65.0,-70.0,-66.0,-71.0,-65.0,-70.0,-81.0,-87.0,-80.0,-87.0,14.0,15.0,15.0,17.0,1
2477,CC:2F:71:3E:C5:1F,3224330,407218373,11376,1391561,3212954,405826812,6,48584,4068413,40151,3069165,8433,999248,11995,34,16340,186,6,825,144444.0,39000.0,-70.0,-70.0,-67.0,-60.0,-68.0,-69.0,-67.0,-60.0,-81.0,-87.0,-80.0,-87.0,11.0,17.0,13.0,27.0,1
2478,CC:2F:71:3F:1F:24,8220541,8040275103,5007587,7634448291,3212954,405826812,80,1171285,726403434,1162762,725379880,8523,1023554,1118226,619,5012281,509330,80,5698,104000.0,26000.0,-69.0,-65.0,-72.0,-67.0,-69.0,-65.0,-72.0,-67.0,-81.0,-87.0,-81.0,-87.0,12.0,22.0,9.0,20.0,1
2479,F8:59:71:5A:E0:3D,3320875,561876589,107918,156049515,3212957,405827074,0,105863,114701081,101071,114128533,4792,572548,83659,16,110630,2391,0,513,144444.0,43333.0,-67.0,-72.0,-65.0,-70.0,-66.0,-71.0,-65.0,-70.0,-81.0,-87.0,-81.0,-87.0,14.0,15.0,16.0,17.0,1
2480,CC:2F:71:3E:C5:1F,3224333,407218635,11376,1391561,3212957,405827074,6,48584,4068413,40151,3069165,8433,999248,11995,34,16340,186,6,825,144444.0,39000.0,-70.0,-70.0,-67.0,-60.0,-68.0,-69.0,-67.0,-60.0,-81.0,-87.0,-81.0,-87.0,11.0,17.0,14.0,27.0,1
2481,CC:2F:71:3F:1F:24,8222005,8042525393,5009048,7636698319,3212957,405827074,80,1171671,726640889,1163148,725617335,8523,1023554,1118612,619,5013761,509572,80,5698,86667.0,14444.0,-70.0,-65.0,-73.0,-68.0,-69.0,-65.0,-72.0,-67.0,-81.0,-87.0,-81.0,-87.0,11.0,22.0,8.0,19.0,1
2482,F8:59:71:5A:E0:3D,3320945,561976539,107982,156148859,3212963,405827680,0,105925,114796561,101133,114224013,4792,572548,83721,16,110695,2403,0,513,144444.0,43333.0,-66.0,-71.0,-66.0,-70.0,-66.0,-71.0,-65.0,-70.0,-81.0,-87.0,-81.0,-87.0,15.0,16.0,15.0,17.0,1
2483,CC:2F:71:3E:C5:1F,3224339,407219241,11376,1391561,3212963,405827680,6,48584,4068413,40151,3069165,8433,999248,11995,34,16340,186,6,825,144444.0,39000.0,-70.0,-70.0,-67.0,-60.0,-68.0,-69.0,-67.0,-60.0,-81.0,-87.0,-81.0,-87.0,11.0,17.0,14.0,27.0,1
2484,CC:2F:71:3F:1F:24,8223023,8044080783,5010060,7638253103,3212963,405827680,80,1171974,726865539,1163451,725841985,8523,1023554,1118915,619,5014778,510017,80,5698,115556.0,28889.0,-70.0,-65.0,-72.0,-68.0,-70.0,-65.0,-72.0,-67.0,-81.0,-87.0,-81.0,-87.0,11.0,22.0,9.0,19.0,1
2485,F8:59:71:5A:E0:3D,3321015,562082413,108050,156254531,3212965,405827882,0,105995,114904417,101203,114331869,4792,572548,83791,16,110763,2403,0,513,144444.0,43333.0,-66.0,-71.0,-65.0,-70.0,-66.0,-71.0,-65.0,-70.0,-81.0,-87.0,-81.0,-87.0,15.0,16.0,16.0,17.0,1
2486,CC:2F:71:3E:C5:1F,3224341,407219443,11376,1391561,3212965,405827882,6,48584,4068413,40151,3069165,8433,999248,11995,34,16340,186,6,825,144444.0,39000.0,-70.0,-70.0,-67.0,-60.0,-68.0,-69.0,-67.0,-60.0,-81.0,-87.0,-81.0,-87.0,11.0,17.0,14.0,27.0,1
2487,CC:2F:71:3F:1F:24,8224527,8046406821,5011562,7640578939,3212965,405827882,80,1172355,727099039,1163832,726075485,8523,1023554,1119296,619,5016280,510454,80,5698,115556.0,28889.0,-70.0,-65.0,-72.0,-68.0,-70.0,-65.0,-72.0,-67.0,-81.0,-87.0,-81.0,-87.0,11.0,22.0,9.0,19.0,1
2488,F8:59:71:5A:E0:3D,3321084,562182333,108114,156353987,3212970,405828346,0,106059,115002977,101267,114430429,4792,572548,83855,16,110827,2403,0,513,144444.0,43333.0,-66.0,-72.0,-65.0,-71.0,-66.0,-71.0,-65.0,-70.0,-81.0,-87.0,-81.0,-87.0,15.0,15.0,16.0,16.0,1
2489,CC:2F:71:3E:C5:1F,3224348,407220109,11376,1391561,3212972,405828548,6,48584,4068413,40151,3069165,8433,999248,11995,34,16340,186,6,825,144444.0,39000.0,-70.0,-70.0,-67.0,-60.0,-68.0,-69.0,-67.0,-60.0,-81.0,-87.0,-81.0,-87.0,11.0,17.0,14.0,27.0,1
2490,CC:2F:71:3F:1F:24,8225753,8048286981,5012781,7642458433,3212972,405828548,80,1172701,727347243,1164178,726323689,8523,1023554,1119642,619,5017492,510914,80,5698,86667.0,14444.0,-70.0,-65.0,-73.0,-67.0,-69.0,-65.0,-72.0,-67.0,-81.0,-87.0,-81.0,-87.0,11.0,22.0,8.0,20.0,1
2491,F8:59:71:5A:E0:3D,3321162,562296239,108187,156467429,3212975,405828810,0,106132,115115397,101340,114542849,4792,572548,83928,16,110900,2404,0,513,144444.0,43333.0,-66.0,-72.0,-65.0,-71.0,-66.0,-71.0,-65.0,-70.0,-81.0,-87.0,-81.0,-87.0,15.0,15.0,16.0,16.0,1
2492,CC:2F:71:3E:C5:1F,3224351,407220371,11376,1391561,3212975,405828810,6,48584,4068413,40151,3069165,8433,999248,11995,34,16340,186,6,825,144444.0,39000.0,-70.0,-70.0,-67.0,-60.0,-68.0,-69.0,-67.0,-60.0,-81.0,-87.0,-81.0,-87.0,11.0,17.0,14.0,27.0,1
2493,CC:2F:71:3F:1F:24,8227057,8050286991,5014082,7644458181,3212975,405828810,80,1173077,727579299,1164554,726555745,8523,1023554,1120018,619,5018800,510921,80,5698,86667.0,14444.0,-70.0,-65.0,-73.0,-68.0,-69.0,-65.0,-72.0,-67.0,-81.0,-87.0,-81.0,-87.0,11.0,22.0,8.0,19.0,1
2494,F8:59:71:5A:E0:3D,3321231,562397637,108252,156568439,3212979,405829198,0,106197,115215497,101405,114642949,4792,572548,83993,16,110965,2404,0,513,144444.0,43333.0,-67.0,-72.0,-66.0,-70.0,-67.0,-71.0,-65.0,-70.0,-81.0,-88.0,-81.0,-88.0,14.0,16.0,15.0,18.0,1
2495,CC:2F:71:3E:C5:1F,3224357,407220961,11376,1391561,3212981,405829400,6,48584,4068413,40151,3069165,8433,999248,11995,34,16340,186,6,825,144444.0,39000.0,-70.0,-70.0,-67.0,-60.0,-68.0,-69.0,-67.0,-60.0,-81.0,-88.0,-81.0,-88.0,11.0,18.0,14.0,28.0,1
2496,CC:2F:71:3F:1F:24,8228170,8051986120,5015187,7646156518,3212983,405829602,80,1173404,727802182,1164881,726778628,8523,1023554,1120345,619,5019906,511007,80,5698,115556.0,28889.0,-69.0,-64.0,-72.0,-70.0,-69.0,-64.0,-72.0,-70.0,-81.0,-88.0,-81.0,-88.0,12.0,24.0,9.0,18.0,1
2497,F8:59:71:5A:E0:3D,3321303,562499313,108317,156669449,3212986,405829864,0,106262,115315597,101470,114743049,4792,572548,84058,16,111030,2405,0,513,144444.0,43333.0,-67.0,-72.0,-65.0,-70.0,-66.0,-72.0,-65.0,-70.0,-81.0,-88.0,-81.0,-88.0,14.0,16.0,16.0,18.0,1
2498,CC:2F:71:3E:C5:1F,3224363,407221485,11376,1391561,3212987,405829924,6,48584,4068413,40151,3069165,8433,999248,11995,34,16340,186,6,825,144444.0,39000.0,-70.0,-70.0,-67.0,-60.0,-68.0,-69.0,-67.0,-60.0,-81.0,-88.0,-81.0,-88.0,11.0,18.0,14.0,28.0,1
2499,CC:2F:71:3F:1F:24,8229628,8054237486,5016641,7648407562,3212987,405829924,80,1173758,728030966,1165235,727007412,8523,1023554,1120699,619,5021347,511298,80,5698,115556.0,26000.0,-68.0,-64.0,-72.0,-70.0,-68.0,-64.0,-72.0,-69.0,-81.0,-88.0,-81.0,-88.0,13.0,24.0,9.0,18.0,1
2500,F8:59:71:5A:E0:3D,3321373,562602412,108383,156772013,3212990,405830399,0,106329,115418791,101537,114846243,4792,572548,84124,16,111096,2406,0,513,144444.0,43333.0,-67.0,-72.0,-65.0,-71.0,-66.0,-71.0,-65.0,-70.0,-81.0,-88.0,-81.0,-88.0,14.0,16.0,16.0,17.0,1
2501,CC:2F:71:3E:C5:1F,3224366,407221960,11376,1391561,3212990,405830399,6,48584,4068413,40151,3069165,8433,999248,11995,34,16340,186,6,825,144444.0,39000.0,-70.0,-70.0,-67.0,-60.0,-68.0,-69.0,-67.0,-60.0,-81.0,-88.0,-81.0,-88.0,11.0,18.0,14.0,28.0,1
2502,CC:2F:71:3F:1F:24,8230672,8055838723,5017682,7650008324,3212990,405830399,80,1174087,728254186,1165564,727230632,8523,1023554,1121028,619,5022401,511535,80,5699,115556.0,28889.0,-69.0,-64.0,-72.0,-70.0,-69.0,-64.0,-72.0,-70.0,-81.0,-88.0,-81.0,-88.0,12.0,24.0,9.0,18.0,1
2503,F8:59:71:5A:E0:3D,3321442,562702388,108448,156871585,3212994,405830803,0,106395,115518997,101603,114946449,4792,572548,84190,16,111161,2406,0,513,144444.0,43333.0,-67.0,-72.0,-65.0,-71.0,-67.0,-71.0,-65.0,-70.0,-81.0,-88.0,-81.0,-88.0,14.0,16.0,16.0,17.0,1
2504,CC:2F:71:3E:C5:1F,3224373,407222626,11376,1391561,3212997,405831065,6,48584,4068413,40151,3069165,8433,999248,11995,34,16340,186,6,825,144444.0,39000.0,-70.0,-70.0,-67.0,-60.0,-68.0,-69.0,-67.0,-60.0,-81.0,-88.0,-81.0,-88.0,11.0,18.0,14.0,28.0,1
2505,CC:2F:71:3F:1F:24,8231886,8057679481,5018889,7651848416,3212997,405831065,80,1174449,728485502,1165926,727461948,8523,1023554,1121389,619,5023602,512068,80,5699,115556.0,28889.0,-70.0,-65.0,-72.0,-70.0,-69.0,-65.0,-72.0,-69.0,-81.0,-88.0,-81.0,-88.0,11.0,23.0,9.0,18.0,1
2506,F8:59:71:5A:E0:3D,3321515,562808412,108516,156977145,3212999,405831267,0,106462,115622177,101670,115049629,4792,572548,84257,16,111229,2406,0,513,144444.0,39000.0,-67.0,-72.0,-66.0,-71.0,-67.0,-72.0,-65.0,-70.0,-81.0,-88.0,-81.0,-88.0,14.0,16.0,15.0,17.0,1
2507,CC:2F:71:3E:C5:1F,3224375,407222828,11376,1391561,3212999,405831267,6,48584,4068413,40151,3069165,8433,999248,11995,34,16340,186,6,825,144444.0,39000.0,-70.0,-70.0,-67.0,-60.0,-68.0,-69.0,-67.0,-60.0,-81.0,-88.0,-81.0,-88.0,11.0,18.0,14.0,28.0,1
2508,CC:2F:71:3F:1F:24,8233196,8059699179,5020197,7653867912,3212999,405831267,80,1174794,728723428,1166271,727699874,8523,1023554,1121734,619,5024887,512630,80,5700,86667.0,13000.0,-69.0,-64.0,-73.0,-70.0,-68.0,-64.0,-72.0,-70.0,-81.0,-88.0,-81.0,-88.0,12.0,24.0,8.0,18.0,1
2509,F8:59:71:5A:E0:3D,3321587,562914432,108584,157082761,3213003,405831671,0,106530,115726897,101738,115154349,4792,572548,84325,16,111297,2406,0,513,144444.0,43333.0,-67.0,-72.0,-65.0,-71.0,-66.0,-71.0,-65.0,-70.0,-81.0,-88.0,-81.0,-88.0,14.0,16.0,16.0,17.0,1
2510,CC:2F:71:3E:C5:1F,3224379,407223232,11376,1391561,3213003,405831671,6,48584,4068413,40151,3069165,8433,999248,11995,34,16340,186,6,825,144444.0,39000.0,-70.0,-70.0,-67.0,-60.0,-68.0,-69.0,-67.0,-60.0,-81.0,-88.0,-81.0,-88.0,11.0,18.0,14.0,28.0,1
2511,CC:2F:71:3F:1F:24,8234576,8061823309,5021571,7655991436,3213005,405831873,80,1175149,728954286,1166626,727930732,8523,1023554,1122089,619,5026290,512678,80,5701,86667.0,14444.0,-70.0,-65.0,-73.0,-70.0,-69.0,-64.0,-73.0,-69.0,-81.0,-88.0,-81.0,-88.0,11.0,23.0,8.0,18.0,1
2512,F8:59:71:5A:E0:3D,3321659,563019014,108651,157186879,3213008,405832135,0,106597,115830077,101805,115257529,4792,572548,84392,16,111363,2409,0,513,144444.0,43333.0,-66.0,-71.0,-66.0,-70.0,-66.0,-71.0,-65.0,-70.0,-81.0,-88.0,-81.0,-88.0,15.0,17.0,15.0,18.0,1
2513,CC:2F:71:3E:C5:1F,3224384,407223696,11376,1391561,3213008,405832135,6,48584,4068413,40151,3069165,8433,999248,11995,34,16340,186,6,825,144444.0,39000.0,-70.0,-70.0,-67.0,-60.0,-68.0,-69.0,-67.0,-60.0,-81.0,-88.0,-81.0,-88.0,11.0,18.0,14.0,28.0,1
2514,CC:2F:71:3F:1F:24,8236079,8064143802,5023071,7658311667,3213008,405832135,80,1175532,729190171,1167009,728166617,8523,1023554,1122472,619,5027780,512738,80,5701,86667.0,14444.0,-69.0,-65.0,-73.0,-70.0,-69.0,-64.0,-72.0,-69.0,-81.0,-88.0,-81.0,-88.0,12.0,23.0,8.0,18.0,1
2515,F8:59:71:5A:E0:3D,3321727,563118874,108715,157286335,3213012,405832539,0,106661,115928637,101869,115356089,4792,572548,84456,16,111428,2409,0,513,144444.0,43333.0,-67.0,-72.0,-65.0,-71.0,-67.0,-71.0,-65.0,-70.0,-81.0,-88.0,-81.0,-88.0,14.0,16.0,16.0,17.0,1
2516,CC:2F:71:3E:C5:1F,3224388,407224100,11376,1391561,3213012,405832539,6,48584,4068413,40151,3069165,8433,999248,11995,34,16340,186,6,825,144444.0,39000.0,-70.0,-70.0,-67.0,-60.0,-68.0,-69.0,-67.0,-60.0,-81.0,-88.0,-81.0,-88.0,11.0,18.0,14.0,28.0,1
2517,CC:2F:71:3F:1F:24,8237364,8066114379,5024352,7660281840,3213012,405832539,80,1175872,729409512,1167349,728385958,8523,1023554,1122812,619,5029049,512835,80,5701,115556.0,28889.0,-69.0,-65.0,-72.0,-70.0,-69.0,-65.0,-72.0,-70.0,-81.0,-88.0,-81.0,-88.0,12.0,23.0,9.0,18.0,1
2518,F8:59:71:5A:E0:3D,3321795,563217296,108779,157384353,3213016,405832943,0,106723,116024117,101931,115451569,4792,572548,84518,16,111492,2411,0,513,144444.0,43333.0,-67.0,-72.0,-65.0,-70.0,-66.0,-71.0,-65.0,-70.0,-81.0,-88.0,-81.0,-88.0,14.0,16.0,16.0,18.0,1
2519,CC:2F:71:3E:C5:1F,3224393,407224620,11377,1391677,3213016,405832943,6,48586,4068553,40153,3069305,8433,999248,11995,34,16341,186,6,825,144444.0,39000.0,-70.0,-71.0,-68.0,-60.0,-68.0,-68.0,-67.0,-60.0,-81.0,-88.0,-81.0,-88.0,11.0,17.0,13.0,28.0,1
2520,CC:2F:71:3F:1F:24,8238821,8068362827,5025805,7662529884,3213016,405832943,80,1176209,729633510,1167686,728609956,8523,1023554,1123149,619,5030524,512927,80,5701,115556.0,28889.0,-69.0,-65.0,-72.0,-68.0,-69.0,-65.0,-72.0,-68.0,-81.0,-88.0,-81.0,-88.0,12.0,23.0,9.0,20.0,1
2521,F8:59:71:5A:E0:3D,3321863,563315662,108842,157482255,3213021,405833407,0,106787,116122677,101995,115550129,4792,572548,84582,16,111555,2411,0,513,144444.0,43333.0,-67.0,-71.0,-65.0,-71.0,-66.0,-71.0,-65.0,-70.0,-81.0,-88.0,-81.0,-88.0,14.0,17.0,16.0,17.0,1
2522,CC:2F:71:3E:C5:1F,3224398,407225084,11377,1391677,3213021,405833407,6,48586,4068553,40153,3069305,8433,999248,11995,34,16341,186,6,825,144444.0,39000.0,-70.0,-71.0,-68.0,-60.0,-68.0,-68.0,-67.0,-60.0,-81.0,-88.0,-81.0,-88.0,11.0,17.0,13.0,28.0,1
2523,CC:2F:71:3F:1F:24,8240259,8070581509,5027238,7664748102,3213021,405833407,80,1176616,729862858,1168093,728839304,8523,1023554,1123556,619,5031957,513075,80,5701,115556.0,28889.0,-70.0,-65.0,-72.0,-69.0,-70.0,-64.0,-72.0,-68.0,-81.0,-88.0,-81.0,-88.0,11.0,23.0,9.0,19.0,1
2524,F8:59:71:5A:E0:3D,3321930,563416874,108907,157583265,3213023,405833609,0,106852,116222819,102060,115650271,4792,572548,84647,16,111620,2411,0,514,144444.0,43333.0,-67.0,-71.0,-65.0,-70.0,-66.0,-71.0,-65.0,-70.0,-81.0,-88.0,-81.0,-88.0,14.0,17.0,16.0,18.0,1
2525,CC:2F:71:3E:C5:1F,3224402,407225488,11377,1391677,3213025,405833811,6,48586,4068553,40153,3069305,8433,999248,11995,34,16341,186,6,825,144444.0,39000.0,-70.0,-71.0,-68.0,-60.0,-68.0,-68.0,-67.0,-60.0,-81.0,-88.0,-81.0,-88.0,11.0,17.0,13.0,28.0,1
2526,CC:2F:71:3F:1F:24,8241096,8071854187,5028071,7666020376,3213025,405833811,80,1176874,730079388,1168351,729055834,8523,1023554,1123814,619,5032790,513157,80,5702,115556.0,28889.0,-70.0,-65.0,-72.0,-69.0,-70.0,-65.0,-73.0,-68.0,-81.0,-88.0,-81.0,-88.0,11.0,23.0,9.0,19.0,1
2527,F8:59:71:5A:E0:3D,3322000,563516936,108971,157682721,3213029,405834215,0,106916,116321379,102124,115748831,4792,572548,84711,16,111684,2411,0,514,144444.0,43333.0,-67.0,-72.0,-65.0,-70.0,-66.0,-71.0,-65.0,-70.0,-81.0,-88.0,-81.0,-88.0,14.0,16.0,16.0,18.0,1
2528,CC:2F:71:3E:C5:1F,3224406,407225892,11377,1391677,3213029,405834215,6,48586,4068553,40153,3069305,8433,999248,11995,34,16341,186,6,825,144444.0,39000.0,-70.0,-71.0,-68.0,-60.0,-68.0,-68.0,-67.0,-60.0,-81.0,-88.0,-81.0,-88.0,11.0,17.0,13.0,28.0,1
2529,CC:2F:71:3F:1F:24,8241875,8073034533,5028846,7667200318,3213029,405834215,80,1177127,730286432,1168604,729262878,8523,1023554,1124067,619,5033565,513187,80,5702,115556.0,28889.0,-70.0,-64.0,-73.0,-68.0,-70.0,-64.0,-72.0,-68.0,-81.0,-88.0,-81.0,-88.0,11.0,24.0,8.0,20.0,1
2530,F8:59:71:5A:E0:3D,3322065,563613546,109033,157779069,3213032,405834477,0,106978,116416859,102186,115844311,4792,572548,84773,16,111746,2413,0,514,144444.0,43333.0,-67.0,-71.0,-65.0,-70.0,-66.0,-71.0,-65.0,-70.0,-81.0,-88.0,-81.0,-88.0,14.0,17.0,16.0,18.0,1
2531,CC:2F:71:3E:C5:1F,3224409,407226154,11377,1391677,3213032,405834477,6,48586,4068553,40153,3069305,8433,999248,11995,34,16341,186,6,825,144444.0,39000.0,-70.0,-71.0,-68.0,-60.0,-68.0,-68.0,-67.0,-60.0,-81.0,-88.0,-81.0,-88.0,11.0,17.0,13.0,28.0,1
2532,CC:2F:71:3F:1F:24,8242775,8074395118,5029741,7668560439,3213034,405834679,80,1177410,730502091,1168887,729478537,8523,1023554,1124350,619,5034460,513240,80,5703,104000.0,26000.0,-71.0,-65.0,-73.0,-69.0,-70.0,-65.0,-72.0,-69.0,-81.0,-88.0,-81.0,-88.0,10.0,23.0,8.0,19.0,1
2533,F8:59:71:5A:E0:3D,3322130,563711650,109096,157876971,3213034,405834679,0,107041,116513879,102249,115941331,4792,572548,84836,16,111809,2414,0,514,144444.0,43333.0,-67.0,-72.0,-65.0,-71.0,-66.0,-71.0,-65.0,-70.0,-81.0,-88.0,-81.0,-88.0,14.0,16.0,16.0,17.0,1
2534,CC:2F:71:3E:C5:1F,3224413,407226558,11377,1391677,3213036,405834881,6,48586,4068553,40153,3069305,8433,999248,11995,34,16341,186,6,825,144444.0,39000.0,-70.0,-71.0,-68.0,-60.0,-68.0,-68.0,-67.0,-60.0,-81.0,-88.0,-81.0,-88.0,11.0,17.0,13.0,28.0,1
2535,CC:2F:71:3F:1F:24,8244118,8076469698,5031082,7670634817,3213036,405834881,80,1177779,730724099,1169256,729700545,8523,1023554,1124719,619,5035800,513290,80,5703,115556.0,28889.0,-71.0,-65.0,-74.0,-69.0,-70.0,-65.0,-73.0,-69.0,-81.0,-88.0,-81.0,-88.0,10.0,23.0,7.0,19.0,1
2536,F8:59:71:5A:E0:3D,3322202,563813328,109161,157977981,3213041,405835347,0,107106,116613993,102314,116041445,4792,572548,84900,16,111873,2415,0,514,144444.0,43333.0,-67.0,-72.0,-65.0,-71.0,-66.0,-71.0,-65.0,-70.0,-81.0,-88.0,-81.0,-88.0,14.0,16.0,16.0,17.0,1
2537,CC:2F:71:3E:C5:1F,3224418,407227024,11377,1391677,3213041,405835347,6,48586,4068553,40153,3069305,8433,999248,11995,34,16341,186,6,825,144444.0,39000.0,-70.0,-71.0,-68.0,-60.0,-68.0,-68.0,-67.0,-60.0,-81.0,-88.0,-81.0,-88.0,11.0,17.0,13.0,28.0,1
2538,CC:2F:71:3F:1F:24,8245694,8078904004,5032652,7673068597,3213042,405835407,80,1178168,730967081,1169644,729943409,8524,1023672,1125108,619,5037371,513591,80,5703,115556.0,28889.0,-70.0,-65.0,-72.0,-69.0,-70.0,-64.0,-72.0,-68.0,-81.0,-88.0,-81.0,-88.0,11.0,23.0,9.0,19.0,1
2539,F8:59:71:5A:E0:3D,3322273,563919262,109229,158083653,3213044,405835609,0,107175,116720253,102383,116147705,4792,572548,84969,16,111942,2416,0,514,144444.0,43333.0,-67.0,-72.0,-65.0,-71.0,-66.0,-71.0,-65.0,-70.0,-81.0,-88.0,-81.0,-88.0,14.0,16.0,16.0,17.0,1
2540,CC:2F:71:3E:C5:1F,3224421,407227286,11377,1391677,3213044,405835609,6,48586,4068553,40153,3069305,8433,999248,11995,34,16341,186,6,825,144444.0,39000.0,-70.0,-71.0,-68.0,-60.0,-68.0,-68.0,-67.0,-60.0,-81.0,-88.0,-81.0,-88.0,11.0,17.0,13.0,28.0,1
2541,CC:2F:71:3F:1F:24,8247227,8081274042,5034181,7675438231,3213046,405835811,80,1178512,731193301,1169988,730169629,8524,1023672,1125452,619,5038895,513819,80,5703,115556.0,28889.0,-70.0,-65.0,-72.0,-68.0,-70.0,-64.0,-72.0,-68.0,-81.0,-88.0,-81.0,-88.0,11.0,23.0,9.0,20.0,1
2542,F8:59:71:5A:E0:3D,3322346,564022705,109295,158186217,3213051,405836488,0,107241,116821893,102449,116249345,4792,572548,85035,16,112008,2416,0,514,144444.0,43333.0,-67.0,-71.0,-65.0,-70.0,-66.0,-71.0,-65.0,-70.0,-81.0,-88.0,-81.0,-88.0,14.0,17.0,16.0,18.0,1
2543,CC:2F:71:3E:C5:1F,3224428,407228165,11377,1391677,3213051,405836488,6,48586,4068553,40153,3069305,8433,999248,11995,34,16341,186,6,825,144444.0,39000.0,-70.0,-71.0,-68.0,-60.0,-68.0,-68.0,-67.0,-60.0,-81.0,-88.0,-81.0,-88.0,11.0,17.0,13.0,28.0,1
2544,CC:2F:71:3F:1F:24,8248570,8083336782,5035519,7677500294,3213051,405836488,80,1178858,731420332,1170334,730396660,8524,1023672,1125797,619,5040238,513910,80,5703,115556.0,28889.0,-71.0,-65.0,-73.0,-69.0,-70.0,-65.0,-73.0,-69.0,-81.0,-88.0,-81.0,-88.0,10.0,23.0,8.0,19.0,1
2545,F8:59:71:5A:E0:3D,3322414,564123977,109360,158287227,3213054,405836750,0,107307,116923533,102515,116350985,4792,572548,85101,16,112073,2416,0,514,144444.0,43333.0,-67.0,-72.0,-65.0,-71.0,-66.0,-71.0,-65.0,-70.0,-81.0,-88.0,-81.0,-88.0,14.0,16.0,16.0,17.0,1
2546,CC:2F:71:3E:C5:1F,3224432,407228489,11377,1391677,3213055,405836812,6,48587,4068671,40153,3069305,8434,999366,11996,34,16341,186,6,825,144444.0,39000.0,-69.0,-70.0,-68.0,-60.0,-68.0,-68.0,-67.0,-60.0,-81.0,-88.0,-81.0,-88.0,12.0,18.0,13.0,28.0,1
2547,CC:2F:71:3F:1F:24,8250061,8085640120,5037006,7679803308,3213055,405836812,80,1179206,731652954,1170682,730629282,8524,1023672,1126145,619,5041724,514021,80,5703,115556.0,28889.0,-71.0,-65.0,-73.0,-69.0,-71.0,-65.0,-73.0,-69.0,-81.0,-88.0,-81.0,-88.0,10.0,23.0,8.0,19.0,1
2548,F8:59:71:5A:E0:3D,3322486,564227069,109426,158389791,3213060,405837278,0,107373,117023751,102580,116451085,4793,572666,85167,16,112138,2416,0,514,144444.0,43333.0,-67.0,-71.0,-65.0,-71.0,-66.0,-71.0,-65.0,-70.0,-81.0,-88.0,-81.0,-88.0,14.0,17.0,16.0,17.0,1
2549,CC:2F:71:3E:C5:1F,3224439,407229157,11377,1391677,3213062,405837480,6,48588,4068741,40154,3069375,8434,999366,11996,34,16341,186,6,825,144444.0,39000.0,-69.0,-71.0,-67.0,-60.0,-68.0,-68.0,-67.0,-60.0,-81.0,-88.0,-81.0,-88.0,12.0,17.0,14.0,28.0,1
2550,CC:2F:71:3F:1F:24,8251684,8088147460,5038622,7682309980,3213062,405837480,80,1179568,731882712,1171044,730859040,8524,1023672,1126507,619,5043341,514177,80,5703,115556.0,28889.0,-70.0,-65.0,-73.0,-69.0,-70.0,-65.0,-72.0,-68.0,-81.0,-88.0,-81.0,-88.0,11.0,23.0,8.0,19.0,1
2551,F8:59:71:5A:E0:3D,3322554,564326929,109490,158489247,3213064,405837682,0,107437,117122311,102644,116549645,4793,572666,85231,16,112203,2417,0,514,144444.0,43333.0,-66.0,-71.0,-65.0,-71.0,-66.0,-71.0,-65.0,-70.0,-81.0,-88.0,-81.0,-88.0,15.0,17.0,16.0,17.0,1
2552,CC:2F:71:3E:C5:1F,3224441,407229359,11377,1391677,3213064,405837682,6,48588,4068741,40154,3069375,8434,999366,11996,34,16341,186,6,825,144444.0,39000.0,-69.0,-71.0,-67.0,-60.0,-68.0,-68.0,-67.0,-60.0,-81.0,-89.0,-81.0,-88.0,12.0,18.0,14.0,28.0,1
2553,CC:2F:71:3F:1F:24,8253243,8090559912,5040179,7684722230,3213064,405837682,80,1179931,732112622,1171407,731088950,8524,1023672,1126870,619,5044898,514275,80,5703,115556.0,28889.0,-69.0,-64.0,-71.0,-68.0,-69.0,-64.0,-71.0,-68.0,-81.0,-89.0,-81.0,-88.0,12.0,25.0,10.0,20.0,1
2554,F8:59:71:5A:E0:3D,3322625,564429957,109556,158591811,3213069,405838146,0,107503,117223951,102710,116651285,4793,572666,85297,16,112269,2417,0,514,144444.0,43333.0,-66.0,-71.0,-65.0,-70.0,-66.0,-71.0,-65.0,-70.0,-81.0,-89.0,-81.0,-88.0,15.0,18.0,16.0,18.0,1
2555,CC:2F:71:3E:C5:1F,3224446,407229823,11377,1391677,3213069,405838146,6,48588,4068741,40154,3069375,8434,999366,11996,34,16341,186,6,825,144444.0,39000.0,-69.0,-71.0,-67.0,-60.0,-68.0,-68.0,-67.0,-60.0,-81.0,-89.0,-81.0,-88.0,12.0,18.0,14.0,28.0,1
2556,CC:2F:71:3F:1F:24,8254736,8092854785,5041665,7687016437,3213071,405838348,80,1180288,732338125,1171764,731314453,8524,1023672,1127227,619,5046384,514327,80,5703,115556.0,28889.0,-70.0,-65.0,-73.0,-68.0,-69.0,-64.0,-71.0,-67.0,-81.0,-89.0,-81.0,-88.0,11.0,24.0,8.0,20.0,1
2557,F8:59:71:5A:E0:3D,3322693,564529817,109620,158691267,3213073,405838550,0,107567,117322511,102774,116749845,4793,572666,85361,16,112333,2418,0,514,144444.0,43333.0,-66.0,-72.0,-65.0,-71.0,-66.0,-71.0,-65.0,-71.0,-81.0,-89.0,-81.0,-88.0,15.0,17.0,16.0,17.0,1
2558,CC:2F:71:3E:C5:1F,3224450,407230227,11377,1391677,3213073,405838550,6,48588,4068741,40154,3069375,8434,999366,11996,34,16341,186,6,825,144444.0,39000.0,-69.0,-71.0,-67.0,-60.0,-68.0,-68.0,-67.0,-60.0,-81.0,-89.0,-81.0,-88.0,12.0,18.0,14.0,28.0,1
2559,CC:2F:71:3F:1F:24,8256031,8094852005,5042958,7689013455,3213073,405838550,80,1180659,732561657,1172135,731537985,8524,1023672,1127598,619,5047663,514471,80,5703,115556.0,28889.0,-70.0,-64.0,-73.0,-68.0,-69.0,-64.0,-72.0,-68.0,-81.0,-89.0,-81.0,-88.0,11.0,25.0,8.0,20.0,1
2560,F8:59:71:5A:E0:3D,3322762,564631231,109685,158792277,3213077,405838954,0,107632,117422611,102839,116849945,4793,572666,85426,16,112398,2418,0,514,144444.0,43333.0,-67.0,-72.0,-65.0,-71.0,-66.0,-71.0,-65.0,-71.0,-81.0,-89.0,-81.0,-88.0,14.0,17.0,16.0,17.0,1
2561,CC:2F:71:3E:C5:1F,3224454,407230631,11377,1391677,3213077,405838954,6,48588,4068741,40154,3069375,8434,999366,11996,34,16341,186,6,825,144444.0,39000.0,-69.0,-71.0,-67.0,-60.0,-68.0,-68.0,-67.0,-60.0,-81.0,-89.0,-81.0,-88.0,12.0,18.0,14.0,28.0,1
2562,CC:2F:71:3F:1F:24,8257668,8097386011,5044591,7691547057,3213077,405838954,80,1181065,732800833,1172541,731777161,8524,1023672,1128004,619,5049310,514643,80,5703,115556.0,28889.0,-70.0,-65.0,-72.0,-68.0,-69.0,-64.0,-72.0,-68.0,-81.0,-89.0,-81.0,-88.0,11.0,24.0,9.0,20.0,1
2563,F8:59:71:5A:E0:3D,3322832,564732705,109750,158893287,3213082,405839418,0,107697,117522711,102904,116950045,4793,572666,85491,16,112463,2418,0,514,144444.0,43333.0,-67.0,-72.0,-65.0,-70.0,-66.0,-71.0,-64.0,-70.0,-81.0,-89.0,-81.0,-88.0,14.0,17.0,16.0,18.0,1
2564,CC:2F:71:3E:C5:1F,3224459,407231095,11377,1391677,3213082,405839418,6,48588,4068741,40154,3069375,8434,999366,11996,34,16341,186,6,825,144444.0,39000.0,-69.0,-71.0,-67.0,-60.0,-68.0,-68.0,-67.0,-60.0,-81.0,-89.0,-81.0,-88.0,12.0,18.0,14.0,28.0,1
2565,CC:2F:71:3F:1F:24,8259075,8099555775,5045993,7693716357,3213082,405839418,80,1181426,733023533,1172902,731999861,8524,1023672,1128365,619,5050711,514889,80,5703,115556.0,28889.0,-70.0,-65.0,-73.0,-68.0,-70.0,-64.0,-72.0,-68.0,-81.0,-89.0,-81.0,-88.0,11.0,24.0,8.0,20.0,1
2566,F8:59:71:5A:E0:3D,3322901,564834119,109815,158994297,3213086,405839822,0,107763,117624351,102970,117051685,4793,572666,85557,16,112528,2418,0,514,144444.0,43333.0,-66.0,-71.0,-65.0,-70.0,-66.0,-71.0,-65.0,-70.0,-81.0,-89.0,-81.0,-88.0,15.0,18.0,16.0,18.0,1
2567,CC:2F:71:3E:C5:1F,3224463,407231499,11377,1391677,3213086,405839822,6,48588,4068741,40154,3069375,8434,999366,11996,34,16341,186,6,825,144444.0,39000.0,-69.0,-71.0,-67.0,-60.0,-68.0,-68.0,-67.0,-60.0,-81.0,-89.0,-81.0,-88.0,12.0,18.0,14.0,28.0,1
2568,CC:2F:71:3F:1F:24,8260303,8101436486,5047217,7695596664,3213086,405839822,80,1181772,733253584,1173248,732229912,8524,1023672,1128711,619,5051936,515016,80,5704,115556.0,28889.0,-70.0,-65.0,-72.0,-68.0,-69.0,-65.0,-72.0,-68.0,-81.0,-89.0,-81.0,-88.0,11.0,24.0,9.0,20.0,1
2569,F8:59:71:5A:E0:3D,3322970,564935533,109880,159095307,3213090,405840226,0,107827,117722911,103034,117150245,4793,572666,85621,16,112593,2420,0,514,144444.0,43333.0,-66.0,-71.0,-65.0,-70.0,-66.0,-71.0,-65.0,-70.0,-81.0,-89.0,-81.0,-88.0,15.0,18.0,16.0,18.0,1
2570,CC:2F:71:3E:C5:1F,3224467,407231903,11377,1391677,3213090,405840226,6,48588,4068741,40154,3069375,8434,999366,11996,34,16341,186,6,825,144444.0,39000.0,-69.0,-71.0,-67.0,-60.0,-68.0,-68.0,-67.0,-60.0,-81.0,-89.0,-81.0,-88.0,12.0,18.0,14.0,28.0,1
2571,CC:2F:71:3F:1F:24,8261635,8103489370,5048545,7697649144,3213090,405840226,80,1182130,733480272,1173606,732456600,8524,1023672,1129069,619,5053264,515163,80,5704,115556.0,28889.0,-69.0,-64.0,-72.0,-68.0,-69.0,-64.0,-71.0,-67.0,-81.0,-89.0,-81.0,-88.0,12.0,25.0,9.0,20.0,1
2572,F8:59:71:5A:E0:3D,3323040,565037007,109945,159196317,3213095,405840690,0,107892,117823011,103099,117250345,4793,572666,85686,16,112658,2420,0,514,144444.0,43333.0,-67.0,-71.0,-65.0,-71.0,-66.0,-71.0,-65.0,-70.0,-81.0,-89.0,-81.0,-88.0,14.0,18.0,16.0,17.0,1
2573,CC:2F:71:3E:C5:1F,3224472,407232367,11377,1391677,3213095,405840690,6,48588,4068741,40154,3069375,8434,999366,11996,34,16341,186,6,825,144444.0,39000.0,-69.0,-71.0,-67.0,-60.0,-68.0,-68.0,-67.0,-60.0,-81.0,-89.0,-81.0,-88.0,12.0,18.0,14.0,28.0,1
2574,CC:2F:71:3F:1F:24,8263265,8106010564,5050170,7700169874,3213095,405840690,80,1182549,733724158,1174025,732700486,8524,1023672,1129488,619,5054889,515504,80,5705,115556.0,28889.0,-69.0,-65.0,-72.0,-68.0,-70.0,-65.0,-72.0,-68.0,-81.0,-89.0,-81.0,-88.0,12.0,24.0,9.0,20.0,1
2575,F8:59:71:5A:E0:3D,3323112,565142915,110013,159301821,3213099,405841094,0,107960,117927731,103167,117355065,4793,572666,85754,16,112726,2420,0,514,144444.0,43333.0,-66.0,-71.0,-65.0,-70.0,-66.0,-71.0,-65.0,-70.0,-81.0,-89.0,-81.0,-88.0,15.0,18.0,16.0,18.0,1
2576,CC:2F:71:3E:C5:1F,3224476,407232771,11377,1391677,3213099,405841094,6,48588,4068741,40154,3069375,8434,999366,11996,34,16341,186,6,825,144444.0,39000.0,-69.0,-71.0,-67.0,-60.0,-68.0,-68.0,-67.0,-60.0,-81.0,-89.0,-81.0,-88.0,12.0,18.0,14.0,28.0,1
2577,CC:2F:71:3F:1F:24,8264693,8108216136,5051594,7702375042,3213099,405841094,80,1182878,733947714,1174354,732924042,8524,1023672,1129817,619,5056313,515878,80,5705,115556.0,28889.0,-70.0,-65.0,-72.0,-68.0,-69.0,-65.0,-72.0,-68.0,-81.0,-89.0,-81.0,-88.0,11.0,24.0,9.0,20.0,1
2578,F8:59:71:5A:E0:3D,3323178,565242573,110077,159401277,3213101,405841296,0,108024,118026291,103231,117453625,4793,572666,85818,16,112790,2420,0,514,144444.0,43333.0,-66.0,-71.0,-65.0,-70.0,-66.0,-71.0,-65.0,-70.0,-81.0,-89.0,-81.0,-88.0,15.0,18.0,16.0,18.0,1
2579,CC:2F:71:3E:C5:1F,3224481,407233235,11377,1391677,3213104,405841558,6,48588,4068741,40154,3069375,8434,999366,11996,34,16341,186,6,825,144444.0,39000.0,-69.0,-71.0,-67.0,-60.0,-68.0,-68.0,-67.0,-60.0,-81.0,-89.0,-81.0,-88.0,12.0,18.0,14.0,28.0,1
2580,CC:2F:71:3F:1F:24,8266020,8110252039,5052916,7704410481,3213104,405841558,80,1183221,734171707,1174697,733148035,8524,1023672,1130160,619,5057633,516097,80,5706,115556.0,28889.0,-70.0,-65.0,-73.0,-68.0,-70.0,-65.0,-72.0,-68.0,-81.0,-89.0,-81.0,-88.0,11.0,24.0,8.0,20.0,1
2581,F8:59:71:5A:E0:3D,3323251,565345803,110143,159503841,3213108,405841962,0,108090,118127931,103297,117555265,4793,572666,85884,16,112856,2420,0,514,144444.0,43333.0,-67.0,-72.0,-65.0,-71.0,-66.0,-72.0,-65.0,-70.0,-81.0,-89.0,-81.0,-88.0,14.0,17.0,16.0,17.0,1
2582,CC:2F:71:3E:C5:1F,3224485,407233639,11377,1391677,3213108,405841962,6,48588,4068741,40154,3069375,8434,999366,11996,34,16341,186,6,825,144444.0,39000.0,-69.0,-71.0,-67.0,-60.0,-68.0,-68.0,-67.0,-60.0,-81.0,-89.0,-81.0,-88.0,12.0,18.0,14.0,28.0,1
2583,CC:2F:71:3F:1F:24,8267778,8112976583,5054670,7707134621,3213108,405841962,80,1183629,734409833,1175105,733386161,8524,1023672,1130568,619,5059364,516433,80,5706,104000.0,26000.0,-70.0,-65.0,-73.0,-69.0,-70.0,-65.0,-72.0,-68.0,-81.0,-89.0,-81.0,-88.0,11.0,24.0,8.0,19.0,1
2584,F8:59:71:5A:E0:3D,3323318,565445734,110207,159603297,3213111,405842437,0,108154,118226491,103361,117653825,4793,572666,85948,16,112920,2421,0,514,144444.0,43333.0,-67.0,-72.0,-65.0,-71.0,-67.0,-71.0,-65.0,-70.0,-81.0,-89.0,-81.0,-88.0,14.0,17.0,16.0,17.0,1
2585,CC:2F:71:3E:C5:1F,3224488,407234114,11377,1391677,3213111,405842437,6,48588,4068741,40154,3069375,8434,999366,11996,34,16341,186,6,825,144444.0,39000.0,-69.0,-71.0,-67.0,-60.0,-68.0,-68.0,-67.0,-60.0,-81.0,-89.0,-81.0,-88.0,12.0,18.0,14.0,28.0,1
2586,CC:2F:71:3F:1F:24,8269229,8115220234,5056118,7709377797,3213111,405842437,80,1183978,734634009,1175454,733610337,8524,1023672,1130917,619,5060837,516628,80,5706,115556.0,28889.0,-70.0,-65.0,-72.0,-68.0,-70.0,-65.0,-72.0,-68.0,-81.0,-89.0,-81.0,-88.0,11.0,24.0,9.0,20.0,1
2587,F8:59:71:5A:E0:3D,3323390,565547410,110272,159704307,3213118,405843103,0,108220,118328145,103427,117755479,4793,572666,86013,16,112985,2421,0,514,144444.0,43333.0,-67.0,-72.0,-65.0,-71.0,-67.0,-72.0,-65.0,-71.0,-81.0,-89.0,-81.0,-88.0,14.0,17.0,16.0,17.0,1
2588,CC:2F:71:3E:C5:1F,3224495,407234780,11377,1391677,3213118,405843103,6,48588,4068741,40154,3069375,8434,999366,11996,34,16341,186,6,825,144444.0,39000.0,-69.0,-71.0,-67.0,-60.0,-68.0,-68.0,-67.0,-60.0,-81.0,-89.0,-81.0,-88.0,12.0,18.0,14.0,28.0,1
2589,CC:2F:71:3F:1F:24,8270240,8116763508,5057122,7710920405,3213118,405843103,80,1184274,734853435,1175750,733829763,8524,1023672,1131213,619,5061841,516754,80,5706,115556.0,28889.0,-70.0,-65.0,-73.0,-69.0,-70.0,-65.0,-73.0,-69.0,-81.0,-89.0,-81.0,-88.0,11.0,24.0,8.0,19.0,1
2590,F8:59:71:5A:E0:3D,3323455,565648420,110337,159805317,3213118,405843103,0,108285,118428245,103492,117855579,4793,572666,86078,16,113049,2421,0,514,144444.0,43333.0,-67.0,-72.0,-66.0,-71.0,-66.0,-71.0,-65.0,-71.0,-81.0,-88.0,-81.0,-88.0,14.0,16.0,15.0,17.0,1
2591,CC:2F:71:3E:C5:1F,3224495,407234780,11377,1391677,3213118,405843103,6,48588,4068741,40154,3069375,8434,999366,11996,34,16341,186,6,825,144444.0,39000.0,-69.0,-71.0,-67.0,-60.0,-68.0,-68.0,-67.0,-60.0,-81.0,-88.0,-81.0,-88.0,12.0,17.0,14.0,28.0,1
2592,CC:2F:71:3F:1F:24,8271260,8118328006,5058142,7712484903,3213118,405843103,80,1184576,735077767,1176052,734054095,8524,1023672,1131513,619,5062861,516889,80,5706,115556.0,28889.0,-70.0,-65.0,-73.0,-69.0,-69.0,-65.0,-72.0,-68.0,-81.0,-88.0,-81.0,-88.0,11.0,23.0,8.0,19.0,1
2593,F8:59:71:5A:E0:3D,3323523,565745374,110399,159901665,3213124,405843709,0,108348,118525265,103555,117952599,4793,572666,86141,16,113112,2423,0,514,144444.0,43333.0,-67.0,-72.0,-65.0,-70.0,-67.0,-72.0,-65.0,-71.0,-81.0,-88.0,-81.0,-88.0,14.0,16.0,16.0,18.0,1
2594,CC:2F:71:3E:C5:1F,3224501,407235386,11377,1391677,3213124,405843709,6,48588,4068741,40154,3069375,8434,999366,11996,34,16341,186,6,825,144444.0,39000.0,-69.0,-71.0,-67.0,-60.0,-68.0,-68.0,-67.0,-60.0,-81.0,-88.0,-81.0,-88.0,12.0,17.0,14.0,28.0,1
2595,CC:2F:71:3F:1F:24,8272482,8120192267,5059356,7714348356,3213126,405843911,80,1184884,735295994,1176360,734272322,8524,1023672,1131821,619,5064059,517137,80,5707,115556.0,28889.0,-70.0,-65.0,-72.0,-69.0,-70.0,-65.0,-72.0,-68.0,-81.0,-88.0,-81.0,-88.0,11.0,23.0,9.0,19.0,1
2596,F8:59:71:5A:E0:3D,3323591,565846646,110464,160002675,3213127,405843971,0,108412,118623825,103619,118051159,4793,572666,86205,16,113177,2424,0,514,144444.0,43333.0,-67.0,-72.0,-66.0,-71.0,-67.0,-72.0,-65.0,-71.0,-81.0,-88.0,-81.0,-88.0,14.0,16.0,15.0,17.0,1
2597,CC:2F:71:3E:C5:1F,3224504,407235648,11377,1391677,3213127,405843971,6,48588,4068741,40154,3069375,8434,999366,11996,34,16341,186,6,825,144444.0,39000.0,-69.0,-71.0,-67.0,-60.0,-68.0,-68.0,-67.0,-60.0,-81.0,-88.0,-81.0,-88.0,12.0,17.0,14.0,28.0,1
2598,CC:2F:71:3F:1F:24,8273978,8122508333,5060851,7716664362,3213127,405843971,80,1185239,735519388,1176715,734495716,8524,1023672,1132176,619,5065570,517186,80,5707,115556.0,28889.0,-70.0,-65.0,-73.0,-69.0,-70.0,-65.0,-72.0,-69.0,-81.0,-88.0,-81.0,-88.0,11.0,23.0,8.0,19.0,1
2599,F8:59:71:5A:E0:3D,3323661,565946708,110528,160102131,3213133,405844577,0,108478,118725521,103685,118152855,4793,572666,86270,16,113241,2425,0,515,144444.0,43333.0,-67.0,-72.0,-65.0,-71.0,-67.0,-72.0,-65.0,-71.0,-81.0,-88.0,-81.0,-88.0,14.0,16.0,16.0,17.0,1
2600,CC:2F:71:3E:C5:1F,3224510,407236254,11377,1391677,3213133,405844577,6,48588,4068741,40154,3069375,8434,999366,11996,34,16341,186,6,825,144444.0,39000.0,-69.0,-71.0,-67.0,-60.0,-68.0,-68.0,-67.0,-60.0,-81.0,-88.0,-81.0,-88.0,12.0,17.0,14.0,28.0,1
2601,CC:2F:71:3F:1F:24,8275071,8124180825,5061938,7718336248,3213133,405844577,80,1185541,735742260,1177017,734718588,8524,1023672,1132478,619,5066656,517353,80,5708,115556.0,28889.0,-69.0,-65.0,-72.0,-68.0,-69.0,-64.0,-72.0,-68.0,-81.0,-88.0,-81.0,-88.0,12.0,23.0,9.0,20.0,1
2602,F8:59:71:5A:E0:3D,3323731,566048404,110594,160203257,3213137,405845147,0,108542,118824081,103749,118251415,4793,572666,86334,16,113307,2425,0,515,144444.0,43333.0,-67.0,-72.0,-65.0,-70.0,-67.0,-72.0,-65.0,-70.0,-81.0,-88.0,-81.0,-88.0,14.0,16.0,16.0,18.0,1
2603,CC:2F:71:3E:C5:1F,3224515,407236940,11378,1391793,3213137,405845147,6,48591,4068951,40157,3069585,8434,999366,11996,34,16342,186,6,825,144444.0,39000.0,-70.0,-70.0,-68.0,-61.0,-69.0,-70.0,-68.0,-61.0,-81.0,-88.0,-81.0,-88.0,11.0,18.0,13.0,27.0,1
2604,CC:2F:71:3F:1F:24,8276671,8126655389,5063534,7720810242,3213137,405845147,80,1185929,735966622,1177405,734942950,8524,1023672,1132866,619,5068232,517522,80,5708,115556.0,28889.0,-69.0,-64.0,-72.0,-69.0,-69.0,-64.0,-72.0,-68.0,-81.0,-88.0,-81.0,-88.0,12.0,24.0,9.0,19.0,1
2605,F8:59:71:5A:E0:3D,3323800,566146832,110657,160301159,3213143,405845673,0,108607,118922759,103813,118349975,4794,572784,86399,16,113370,2426,0,516,144444.0,43333.0,-67.0,-72.0,-66.0,-71.0,-67.0,-72.0,-65.0,-71.0,-81.0,-88.0,-81.0,-88.0,14.0,16.0,15.0,17.0,1
2606,CC:2F:71:3E:C5:1F,3224523,407237668,11378,1391793,3213145,405845875,6,48591,4068951,40157,3069585,8434,999366,11996,34,16342,186,6,825,144444.0,39000.0,-70.0,-70.0,-68.0,-61.0,-69.0,-70.0,-68.0,-61.0,-81.0,-88.0,-81.0,-88.0,11.0,18.0,13.0,27.0,1
2607,CC:2F:71:3F:1F:24,8278070,8128800376,5064925,7722954501,3213145,405845875,80,1186295,736194520,1177771,735170848,8524,1023672,1133232,619,5069644,517682,80,5708,115556.0,28889.0,-69.0,-64.0,-72.0,-68.0,-69.0,-64.0,-72.0,-68.0,-81.0,-88.0,-81.0,-88.0,12.0,24.0,9.0,20.0,1
2608,F8:59:71:5A:E0:3D,3323870,566249800,110723,160403723,3213147,405846077,0,108675,119027521,103881,118454737,4794,572784,86464,16,113436,2427,0,516,144444.0,43333.0,-66.0,-71.0,-65.0,-70.0,-66.0,-71.0,-65.0,-70.0,-81.0,-88.0,-81.0,-88.0,15.0,17.0,16.0,18.0,1
2609,CC:2F:71:3E:C5:1F,3224525,407237870,11378,1391793,3213147,405846077,6,48591,4068951,40157,3069585,8434,999366,11996,34,16342,186,6,825,144444.0,39000.0,-70.0,-70.0,-68.0,-61.0,-69.0,-70.0,-68.0,-61.0,-81.0,-88.0,-81.0,-88.0,11.0,18.0,13.0,27.0,1
2610,CC:2F:71:3F:1F:24,8279144,8130448842,5065997,7724602765,3213147,405846077,80,1186620,736418886,1178096,735395214,8524,1023672,1133557,619,5070716,517794,80,5708,115556.0,28889.0,-70.0,-64.0,-72.0,-68.0,-69.0,-64.0,-72.0,-68.0,-81.0,-88.0,-81.0,-88.0,11.0,24.0,9.0,20.0,1
2611,F8:59:71:5A:E0:3D,3323937,566348106,110786,160501625,3213151,405846481,0,108738,119124541,103944,118551757,4794,572784,86527,16,113499,2428,0,516,144444.0,43333.0,-67.0,-72.0,-65.0,-71.0,-66.0,-71.0,-65.0,-70.0,-81.0,-88.0,-81.0,-88.0,14.0,16.0,16.0,17.0,1
2612,CC:2F:71:3E:C5:1F,3224529,407238274,11378,1391793,3213151,405846481,6,48591,4068951,40157,3069585,8434,999366,11996,34,16342,186,6,825,144444.0,39000.0,-70.0,-70.0,-68.0,-61.0,-69.0,-70.0,-68.0,-61.0,-81.0,-88.0,-81.0,-88.0,11.0,18.0,13.0,27.0,1
2613,CC:2F:71:3F:1F:24,8280270,8132176634,5067119,7726330153,3213151,405846481,80,1186948,736640428,1178424,735616756,8524,1023672,1133885,619,5071838,517853,80,5708,115556.0,28889.0,-70.0,-65.0,-72.0,-69.0,-70.0,-65.0,-72.0,-69.0,-81.0,-88.0,-81.0,-88.0,11.0,23.0,9.0,19.0,1
2614,F8:59:71:5A:E0:3D,3324007,566449580,110851,160602635,3213156,405846945,0,108803,119224641,104009,118651857,4794,572784,86592,16,113563,2428,0,516,144444.0,43333.0,-67.0,-71.0,-65.0,-70.0,-66.0,-71.0,-65.0,-70.0,-81.0,-88.0,-81.0,-88.0,14.0,17.0,16.0,18.0,1
2615,CC:2F:71:3E:C5:1F,3224534,407238738,11378,1391793,3213156,405846945,6,48591,4068951,40157,3069585,8434,999366,11996,34,16342,186,6,825,144444.0,39000.0,-70.0,-70.0,-68.0,-61.0,-69.0,-70.0,-68.0,-61.0,-81.0,-88.0,-81.0,-88.0,11.0,18.0,13.0,27.0,1
2616,CC:2F:71:3F:1F:24,8281153,8133519262,5067997,7727672317,3213156,405846945,80,1187219,736858532,1178695,735834860,8524,1023672,1134156,619,5072716,517972,80,5710,115556.0,26000.0,-70.0,-64.0,-72.0,-68.0,-69.0,-64.0,-72.0,-68.0,-81.0,-88.0,-81.0,-88.0,11.0,24.0,9.0,20.0,1
2617,F8:59:71:5A:E0:3D,3324073,566549238,110915,160702091,3213158,405847147,0,108867,119323201,104073,118750417,4794,572784,86656,16,113628,2430,0,516,144444.0,43333.0,-67.0,-71.0,-65.0,-70.0,-66.0,-71.0,-65.0,-70.0,-81.0,-88.0,-81.0,-88.0,14.0,17.0,16.0,18.0,1
2618,CC:2F:71:3E:C5:1F,3224538,407239142,11378,1391793,3213160,405847349,6,48591,4068951,40157,3069585,8434,999366,11996,34,16342,186,6,825,144444.0,39000.0,-70.0,-70.0,-68.0,-61.0,-69.0,-70.0,-68.0,-61.0,-81.0,-88.0,-81.0,-88.0,11.0,18.0,13.0,27.0,1
2619,CC:2F:71:3F:1F:24,8282260,8135210739,5069100,7729363390,3213160,405847349,80,1187529,737075617,1179005,736051945,8524,1023672,1134466,619,5073819,518054,80,5711,115556.0,28889.0,-69.0,-64.0,-72.0,-68.0,-69.0,-64.0,-72.0,-68.0,-81.0,-88.0,-81.0,-88.0,12.0,24.0,9.0,20.0,1
2620,F8:59:71:5A:E0:3D,3324153,566651678,110977,160798439,3213176,405853239,0,108930,119420221,104136,118847437,4794,572784,86719,16,113690,2430,0,516,144444.0,43333.0,-67.0,-71.0,-65.0,-71.0,-67.0,-71.0,-65.0,-70.0,-81.0,-89.0,-81.0,-89.0,14.0,18.0,16.0,18.0,1
2621,CC:2F:71:3E:C5:1F,3224555,407245092,11378,1391793,3213177,405853299,6,48591,4068951,40157,3069585,8434,999366,11996,34,16342,186,6,825,144444.0,39000.0,-70.0,-70.0,-68.0,-61.0,-69.0,-70.0,-68.0,-61.0,-81.0,-89.0,-81.0,-89.0,11.0,19.0,13.0,28.0,1
2622,CC:2F:71:3F:1F:24,8283536,8137160215,5070359,7731306916,3213177,405853299,80,1187865,737303737,1179340,736279947,8525,1023790,1134802,619,5075078,518119,80,5711,115556.0,28889.0,-69.0,-64.0,-72.0,-68.0,-69.0,-64.0,-71.0,-68.0,-81.0,-89.0,-81.0,-89.0,12.0,25.0,9.0,21.0,1
2623,F8:59:71:5A:E0:3D,3324235,566765942,111047,160907219,3213188,405858723,0,108999,119526481,104205,118953697,4794,572784,86788,16,113759,2433,0,516,144444.0,43333.0,-67.0,-72.0,-65.0,-70.0,-66.0,-71.0,-65.0,-70.0,-81.0,-89.0,-81.0,-89.0,14.0,17.0,16.0,19.0,1
2624,CC:2F:71:3E:C5:1F,3224566,407250516,11378,1391793,3213188,405858723,6,48591,4068951,40157,3069585,8434,999366,11996,34,16342,186,6,825,144444.0,39000.0,-70.0,-70.0,-68.0,-61.0,-69.0,-70.0,-68.0,-61.0,-81.0,-89.0,-81.0,-89.0,11.0,19.0,13.0,28.0,1
2625,CC:2F:71:3F:1F:24,8284728,8138980029,5071536,7733120902,3213192,405859127,80,1188169,737529785,1179644,736505995,8525,1023790,1135105,619,5076255,518278,80,5712,115556.0,28889.0,-69.0,-64.0,-72.0,-68.0,-69.0,-64.0,-71.0,-68.0,-81.0,-89.0,-81.0,-89.0,12.0,25.0,9.0,21.0,1
2626,F8:59:71:5A:E0:3D,3324309,566868033,111112,161008229,3213197,405859804,0,109064,119626581,104270,119053797,4794,572784,86853,16,113825,2433,0,516,144444.0,43333.0,-67.0,-71.0,-65.0,-71.0,-66.0,-71.0,-65.0,-70.0,-81.0,-89.0,-81.0,-89.0,14.0,18.0,16.0,18.0,1
2627,CC:2F:71:3E:C5:1F,3224575,407251597,11378,1391793,3213197,405859804,6,48591,4068951,40157,3069585,8434,999366,11996,34,16342,186,6,825,144444.0,39000.0,-70.0,-70.0,-68.0,-61.0,-69.0,-70.0,-68.0,-61.0,-81.0,-89.0,-81.0,-89.0,11.0,19.0,13.0,28.0,1
2628,CC:2F:71:3F:1F:24,8285899,8140776206,5072702,7734916402,3213197,405859804,80,1188482,737752463,1179957,736728673,8525,1023790,1135418,619,5077412,518360,80,5712,115556.0,28889.0,-69.0,-64.0,-72.0,-68.0,-69.0,-64.0,-72.0,-68.0,-81.0,-89.0,-81.0,-89.0,12.0,25.0,9.0,21.0,1
2629,F8:59:71:5A:E0:3D,3324373,566965995,111175,161106131,3213198,405859864,0,109127,119723601,104333,119150817,4794,572784,86916,16,113888,2434,0,516,144444.0,43333.0,-67.0,-71.0,-65.0,-71.0,-66.0,-71.0,-65.0,-70.0,-81.0,-89.0,-81.0,-89.0,14.0,18.0,16.0,18.0,1
2630,CC:2F:71:3E:C5:1F,3224576,407251657,11378,1391793,3213198,405859864,6,48591,4068951,40157,3069585,8434,999366,11996,34,16342,186,6,825,144444.0,39000.0,-70.0,-70.0,-68.0,-61.0,-69.0,-70.0,-68.0,-61.0,-81.0,-89.0,-81.0,-89.0,11.0,19.0,13.0,28.0,1
2631,CC:2F:71:3F:1F:24,8287213,8142794839,5074015,7736934975,3213198,405859864,80,1188840,737979431,1180315,736955641,8525,1023790,1135775,619,5078724,518461,80,5713,115556.0,28889.0,-70.0,-65.0,-73.0,-69.0,-70.0,-65.0,-72.0,-69.0,-81.0,-89.0,-81.0,-89.0,11.0,24.0,8.0,20.0,1
2632,F8:59:71:5A:E0:3D,3324446,567066321,111239,161205587,3213207,405860734,0,109191,119822161,104397,119249377,4794,572784,86980,16,113952,2434,0,516,144444.0,43333.0,-67.0,-71.0,-65.0,-71.0,-66.0,-71.0,-65.0,-71.0,-81.0,-89.0,-81.0,-89.0,14.0,18.0,16.0,18.0,1
2633,CC:2F:71:3E:C5:1F,3224585,407252527,11378,1391793,3213207,405860734,6,48593,4069139,40158,3069655,8435,999484,11997,34,16342,186,6,825,144444.0,39000.0,-69.0,-70.0,-68.0,-60.0,-69.0,-71.0,-68.0,-61.0,-81.0,-89.0,-81.0,-89.0,12.0,19.0,13.0,29.0,1
2634,CC:2F:71:3F:1F:24,8288164,8144237854,5074957,7738377120,3213207,405860734,80,1189133,738194285,1180608,737170495,8525,1023790,1136067,619,5079676,518590,80,5713,115556.0,28889.0,-70.0,-65.0,-73.0,-69.0,-70.0,-65.0,-72.0,-68.0,-81.0,-89.0,-81.0,-89.0,11.0,24.0,8.0,20.0,1
2635,F8:59:71:5A:E0:3D,3324510,567164894,111303,161304160,3213207,405860734,0,109256,119920885,104462,119348101,4794,572784,87044,16,114016,2435,0,516,144444.0,43333.0,-68.0,-72.0,-65.0,-71.0,-67.0,-72.0,-65.0,-71.0,-81.0,-89.0,-81.0,-89.0,13.0,17.0,16.0,18.0,1
2636,CC:2F:71:3E:C5:1F,3224585,407252527,11378,1391793,3213207,405860734,6,48593,4069139,40158,3069655,8435,999484,11997,34,16342,186,6,825,144444.0,39000.0,-69.0,-70.0,-68.0,-60.0,-69.0,-71.0,-68.0,-61.0,-81.0,-89.0,-81.0,-89.0,12.0,19.0,13.0,29.0,1
2637,CC:2F:71:3F:1F:24,8289079,8145632937,5075872,7739772203,3213207,405860734,80,1189444,738414026,1180919,737390236,8525,1023790,1136378,619,5080591,518675,80,5713,104000.0,26000.0,-70.0,-65.0,-72.0,-69.0,-70.0,-65.0,-72.0,-69.0,-81.0,-89.0,-81.0,-89.0,11.0,24.0,9.0,20.0,1
2638,F8:59:71:5A:E0:3D,3324584,567266772,111368,161405170,3213216,405861602,0,109321,120021027,104527,119448243,4794,572784,87109,16,114081,2435,0,517,144444.0,43333.0,-68.0,-73.0,-67.0,-72.0,-67.0,-71.0,-66.0,-71.0,-81.0,-89.0,-81.0,-89.0,13.0,16.0,14.0,17.0,1
2639,CC:2F:71:3E:C5:1F,3224594,407253395,11378,1391793,3213216,405861602,6,48593,4069139,40158,3069655,8435,999484,11997,34,16342,186,6,825,144444.0,39000.0,-69.0,-70.0,-68.0,-60.0,-69.0,-71.0,-68.0,-61.0,-81.0,-89.0,-81.0,-89.0,12.0,19.0,13.0,29.0,1
2640,CC:2F:71:3F:1F:24,8290265,8147447895,5077049,7741586293,3213216,405861602,80,1189785,738637266,1181260,737613476,8525,1023790,1136719,619,5081755,518755,80,5713,115556.0,28889.0,-70.0,-65.0,-72.0,-69.0,-70.0,-65.0,-73.0,-69.0,-81.0,-89.0,-81.0,-89.0,11.0,24.0,9.0,20.0,1
2641,F8:59:71:5A:E0:3D,3324646,567362952,111430,161501350,3213216,405861602,0,109383,120116507,104589,119543723,4794,572784,87171,16,114143,2435,0,517,144444.0,43333.0,-68.0,-72.0,-66.0,-71.0,-67.0,-72.0,-65.0,-71.0,-81.0,-89.0,-81.0,-89.0,13.0,17.0,15.0,18.0,1
2642,CC:2F:71:3E:C5:1F,3224594,407253395,11378,1391793,3213216,405861602,6,48593,4069139,40158,3069655,8435,999484,11997,34,16342,186,6,825,144444.0,39000.0,-69.0,-70.0,-68.0,-60.0,-69.0,-71.0,-68.0,-61.0,-81.0,-89.0,-81.0,-89.0,12.0,19.0,13.0,29.0,1
2643,CC:2F:71:3F:1F:24,8291857,8149916943,5078641,7744055341,3213216,405861602,80,1190153,738865036,1181628,737841246,8525,1023790,1137086,619,5083348,518957,80,5713,115556.0,28889.0,-70.0,-65.0,-73.0,-69.0,-69.0,-65.0,-72.0,-69.0,-81.0,-89.0,-81.0,-89.0,11.0,24.0,8.0,20.0,1
2644,F8:59:71:5A:E0:3D,3324720,567469230,111498,161607022,3213222,405862208,0,109453,120224321,104659,119651537,4794,572784,87240,16,114211,2436,0,517,144444.0,43333.0,-67.0,-72.0,-66.0,-71.0,-67.0,-72.0,-66.0,-71.0,-81.0,-89.0,-81.0,-89.0,14.0,17.0,15.0,18.0,1
2645,CC:2F:71:3E:C5:1F,3224602,407254203,11378,1391793,3213224,405862410,6,48593,4069139,40158,3069655,8435,999484,11997,34,16342,186,6,825,144444.0,39000.0,-69.0,-70.0,-68.0,-60.0,-69.0,-71.0,-68.0,-61.0,-81.0,-89.0,-81.0,-89.0,12.0,19.0,13.0,29.0,1
2646,CC:2F:71:3F:1F:24,8293107,8151828078,5079883,7745965668,3213224,405862410,80,1190462,739092309,1181937,738068519,8525,1023790,1137395,619,5084602,519055,80,5713,115556.0,28889.0,-70.0,-65.0,-72.0,-69.0,-70.0,-65.0,-73.0,-69.0,-81.0,-89.0,-81.0,-89.0,11.0,24.0,9.0,20.0,1
2647,F8:59:71:5A:E0:3D,3324787,567568948,111562,161706478,3213225,405862470,0,109519,120325989,104725,119753205,4794,572784,87304,16,114275,2436,0,517,144444.0,43333.0,-67.0,-72.0,-66.0,-71.0,-67.0,-72.0,-66.0,-71.0,-81.0,-89.0,-81.0,-89.0,14.0,17.0,15.0,18.0,1
2648,CC:2F:71:3E:C5:1F,3224603,407254263,11378,1391793,3213225,405862470,6,48593,4069139,40158,3069655,8435,999484,11997,34,16342,186,6,825,144444.0,39000.0,-69.0,-70.0,-68.0,-60.0,-69.0,-71.0,-68.0,-61.0,-81.0,-89.0,-81.0,-89.0,12.0,19.0,13.0,29.0,1
2649,CC:2F:71:3F:1F:24,8294053,8153276244,5080828,7747413774,3213225,405862470,80,1190761,739310737,1182236,738286947,8525,1023790,1137693,619,5085547,519068,80,5713,115556.0,28889.0,-70.0,-65.0,-73.0,-69.0,-70.0,-65.0,-73.0,-69.0,-81.0,-89.0,-81.0,-89.0,11.0,24.0,8.0,20.0,1
2650,F8:59:71:5A:E0:3D,3324855,567668808,111626,161805934,3213229,405862874,0,109582,120423009,104788,119850225,4794,572784,87367,16,114339,2436,0,517,144444.0,43333.0,-67.0,-72.0,-66.0,-71.0,-67.0,-72.0,-65.0,-71.0,-81.0,-89.0,-81.0,-89.0,14.0,17.0,15.0,18.0,1
2651,CC:2F:71:3E:C5:1F,3224607,407254667,11378,1391793,3213229,405862874,6,48593,4069139,40158,3069655,8435,999484,11997,34,16342,186,6,825,144444.0,39000.0,-69.0,-70.0,-68.0,-60.0,-69.0,-71.0,-68.0,-61.0,-81.0,-89.0,-81.0,-89.0,12.0,19.0,13.0,29.0,1
2652,CC:2F:71:3F:1F:24,8295122,8154907934,5081889,7749044656,3213233,405863278,80,1191034,739526133,1182509,738502343,8525,1023790,1137965,619,5086606,519264,80,5716,115556.0,28889.0,-72.0,-68.0,-74.0,-72.0,-70.0,-65.0,-73.0,-69.0,-81.0,-89.0,-81.0,-89.0,9.0,21.0,7.0,17.0,1
2653,F8:59:71:5A:E0:3D,3324922,567767114,111689,161903836,3213233,405863278,0,109645,120520071,104851,119947287,4794,572784,87430,16,114402,2436,0,518,144444.0,43333.0,-67.0,-72.0,-65.0,-70.0,-67.0,-72.0,-65.0,-70.0,-81.0,-89.0,-81.0,-89.0,14.0,17.0,16.0,19.0,1
2654,CC:2F:71:3E:C5:1F,3224611,407255071,11378,1391793,3213233,405863278,6,48593,4069139,40158,3069655,8435,999484,11997,34,16342,186,6,825,144444.0,39000.0,-69.0,-70.0,-68.0,-60.0,-69.0,-71.0,-68.0,-61.0,-81.0,-89.0,-81.0,-89.0,12.0,19.0,13.0,29.0,1
2655,CC:2F:71:3F:1F:24,8296235,8156621168,5083002,7750757890,3213233,405863278,80,1191330,739745667,1182805,738721877,8525,1023790,1138261,619,5087721,519354,80,5717,115556.0,28889.0,-70.0,-65.0,-74.0,-69.0,-70.0,-65.0,-73.0,-69.0,-81.0,-89.0,-81.0,-89.0,11.0,24.0,7.0,20.0,1
2656,F8:59:71:5A:E0:3D,3324996,567870490,111758,162006748,3213238,405863742,0,109714,120622029,104920,120049245,4794,572784,87499,16,114471,2437,0,518,144444.0,43333.0,-67.0,-72.0,-66.0,-71.0,-67.0,-72.0,-66.0,-71.0,-81.0,-89.0,-81.0,-89.0,14.0,17.0,15.0,18.0,1
2657,CC:2F:71:3E:C5:1F,3224616,407255535,11378,1391793,3213238,405863742,6,48593,4069139,40158,3069655,8435,999484,11997,34,16342,186,6,825,144444.0,39000.0,-69.0,-70.0,-68.0,-60.0,-69.0,-71.0,-68.0,-61.0,-81.0,-89.0,-81.0,-89.0,12.0,19.0,13.0,29.0,1
2658,CC:2F:71:3F:1F:24,8297310,8158256331,5084072,7752392589,3213238,405863742,80,1191635,739967793,1183110,738944003,8525,1023790,1138566,619,5088791,519465,80,5717,115556.0,26000.0,-70.0,-65.0,-72.0,-69.0,-69.0,-65.0,-72.0,-69.0,-81.0,-89.0,-81.0,-89.0,11.0,24.0,9.0,20.0,1
2659,F8:59:71:5A:E0:3D,3325064,567968912,111822,162104766,3213242,405864146,0,109780,120722249,104986,120149465,4794,572784,87564,16,114535,2439,0,518,144444.0,43333.0,-67.0,-72.0,-66.0,-71.0,-67.0,-72.0,-66.0,-71.0,-81.0,-89.0,-81.0,-89.0,14.0,17.0,15.0,18.0,1
2660,CC:2F:71:3E:C5:1F,3224620,407255939,11378,1391793,3213242,405864146,6,48593,4069139,40158,3069655,8435,999484,11997,34,16342,186,6,825,144444.0,39000.0,-69.0,-70.0,-68.0,-60.0,-69.0,-71.0,-68.0,-61.0,-81.0,-89.0,-81.0,-89.0,12.0,19.0,13.0,29.0,1
2661,CC:2F:71:3F:1F:24,8298694,8160391063,5085452,7754526917,3213242,405864146,80,1191957,740184411,1183432,739160621,8525,1023790,1138888,619,5090171,519536,80,5717,115556.0,28889.0,-70.0,-65.0,-72.0,-69.0,-70.0,-64.0,-72.0,-69.0,-81.0,-89.0,-81.0,-89.0,11.0,24.0,9.0,20.0,1
2662,F8:59:71:5A:E0:3D,3325131,568068790,111886,162204222,3213245,405864568,0,109844,120820823,105050,120248039,4794,572784,87627,16,114599,2439,0,518,144444.0,43333.0,-67.0,-72.0,-66.0,-71.0,-67.0,-72.0,-66.0,-71.0,-81.0,-89.0,-81.0,-88.0,14.0,17.0,15.0,17.0,1
2663,CC:2F:71:3E:C5:1F,3224623,407256361,11378,1391793,3213245,405864568,6,48593,4069139,40158,3069655,8435,999484,11997,34,16342,186,6,825,144444.0,39000.0,-69.0,-70.0,-68.0,-60.0,-69.0,-71.0,-68.0,-61.0,-81.0,-89.0,-81.0,-88.0,12.0,19.0,13.0,28.0,1
2664,CC:2F:71:3F:1F:24,8300055,8162488351,5086808,7756623581,3213247,405864770,80,1192297,740405895,1183772,739382105,8525,1023790,1139228,619,5091527,519622,80,5717,115556.0,28889.0,-70.0,-65.0,-73.0,-69.0,-70.0,-65.0,-72.0,-69.0,-81.0,-89.0,-81.0,-88.0,11.0,24.0,8.0,19.0,1
2665,F8:59:71:5A:E0:3D,3325202,568168912,111950,162303678,3213252,405865234,0,109908,120919383,105114,120346599,4794,572784,87691,16,114663,2439,0,518,144444.0,43333.0,-67.0,-72.0,-66.0,-71.0,-67.0,-72.0,-65.0,-71.0,-81.0,-89.0,-81.0,-88.0,14.0,17.0,15.0,17.0,1
2666,CC:2F:71:3E:C5:1F,3224630,407257027,11378,1391793,3213252,405865234,6,48593,4069139,40158,3069655,8435,999484,11997,34,16342,186,6,825,144444.0,39000.0,-69.0,-70.0,-68.0,-60.0,-69.0,-71.0,-68.0,-61.0,-81.0,-89.0,-81.0,-88.0,12.0,19.0,13.0,28.0,1
2667,CC:2F:71:3F:1F:24,8301434,8164613587,5088182,7758748353,3213252,405865234,80,1192628,740634121,1184103,739610331,8525,1023790,1139559,619,5092884,519735,80,5721,115556.0,28889.0,-71.0,-65.0,-73.0,-70.0,-70.0,-65.0,-72.0,-69.0,-81.0,-89.0,-81.0,-88.0,10.0,24.0,8.0,18.0,1
2668,F8:59:71:5A:E0:3D,3325269,568271749,112016,162406242,3213253,405865507,0,109977,121025685,105183,120452901,4794,572784,87757,16,114729,2439,0,518,144444.0,43333.0,-67.0,-72.0,-66.0,-72.0,-67.0,-72.0,-65.0,-71.0,-81.0,-89.0,-81.0,-88.0,14.0,17.0,15.0,16.0,1
2669,CC:2F:71:3E:C5:1F,3224631,407257300,11378,1391793,3213253,405865507,6,48593,4069139,40158,3069655,8435,999484,11997,34,16342,186,6,825,144444.0,39000.0,-69.0,-70.0,-68.0,-60.0,-69.0,-71.0,-68.0,-61.0,-81.0,-89.0,-81.0,-88.0,12.0,19.0,13.0,28.0,1
2670,CC:2F:71:3F:1F:24,8303328,8167544985,5090073,7761679276,3213255,405865709,80,1193031,740864858,1184506,739841068,8525,1023790,1139962,619,5094762,519982,80,5721,115556.0,28889.0,-70.0,-64.0,-73.0,-69.0,-70.0,-64.0,-72.0,-69.0,-81.0,-89.0,-81.0,-88.0,11.0,25.0,8.0,19.0,1
2671,F8:59:71:5A:E0:3D,3325342,568372073,112080,162505698,3213262,405866375,0,110041,121124245,105247,120551461,4794,572784,87821,16,114793,2439,0,518,144444.0,43333.0,-67.0,-72.0,-66.0,-71.0,-67.0,-72.0,-65.0,-71.0,-81.0,-89.0,-81.0,-89.0,14.0,17.0,15.0,18.0,1
2672,CC:2F:71:3E:C5:1F,3224640,407258168,11378,1391793,3213262,405866375,6,48593,4069139,40158,3069655,8435,999484,11997,34,16342,186,6,825,144444.0,39000.0,-69.0,-70.0,-68.0,-60.0,-69.0,-71.0,-68.0,-61.0,-81.0,-89.0,-81.0,-89.0,12.0,19.0,13.0,29.0,1
2673,CC:2F:71:3F:1F:24,8304853,8169897951,5091591,7764031576,3213262,405866375,80,1193376,741089856,1184851,740066066,8525,1023790,1140307,619,5096294,520149,80,5721,115556.0,28889.0,-69.0,-64.0,-73.0,-69.0,-68.0,-64.0,-72.0,-69.0,-81.0,-89.0,-81.0,-89.0,12.0,25.0,8.0,20.0,1
2674,F8:59:71:5A:E0:3D,3325407,568473083,112145,162606708,3213262,405866375,0,110106,121224345,105312,120651561,4794,572784,87886,16,114858,2439,0,518,144444.0,43333.0,-67.0,-72.0,-67.0,-71.0,-67.0,-72.0,-66.0,-70.0,-81.0,-89.0,-81.0,-89.0,14.0,17.0,14.0,18.0,1
2675,CC:2F:71:3E:C5:1F,3224640,407258168,11378,1391793,3213262,405866375,6,48593,4069139,40158,3069655,8435,999484,11997,34,16342,186,6,825,144444.0,39000.0,-69.0,-70.0,-68.0,-60.0,-69.0,-71.0,-68.0,-61.0,-81.0,-89.0,-81.0,-89.0,12.0,19.0,13.0,29.0,1
2676,CC:2F:71:3F:1F:24,8306335,8172191243,5093073,7766324868,3213262,405866375,80,1193736,741320928,1185211,740297138,8525,1023790,1140666,619,5097791,520463,80,5722,86667.0,14444.0,-69.0,-65.0,-72.0,-70.0,-69.0,-64.0,-72.0,-70.0,-81.0,-89.0,-81.0,-89.0,12.0,24.0,9.0,19.0,1
2677,F8:59:71:5A:E0:3D,3325479,568573347,112209,162706164,3213270,405867183,0,110171,121324459,105377,120751675,4794,572784,87950,16,114922,2442,0,518,144444.0,43333.0,-66.0,-72.0,-65.0,-70.0,-66.0,-71.0,-65.0,-70.0,-81.0,-89.0,-81.0,-89.0,15.0,17.0,16.0,19.0,1
2678,CC:2F:71:3E:C5:1F,3224648,407258976,11378,1391793,3213270,405867183,6,48593,4069139,40158,3069655,8435,999484,11997,34,16342,186,6,825,144444.0,39000.0,-69.0,-70.0,-68.0,-60.0,-69.0,-71.0,-68.0,-61.0,-81.0,-89.0,-81.0,-89.0,12.0,19.0,13.0,29.0,1
2679,CC:2F:71:3F:1F:24,8307354,8173744753,5094084,7767877570,3213270,405867183,80,1194047,741543356,1185522,740519566,8525,1023790,1140975,619,5098787,520475,80,5722,104000.0,26000.0,-69.0,-64.0,-72.0,-70.0,-68.0,-64.0,-72.0,-70.0,-81.0,-89.0,-81.0,-89.0,12.0,25.0,9.0,19.0,1
2680,F8:59:71:5A:E0:3D,3325545,568674417,112274,162807174,3213271,405867243,0,110236,121424559,105442,120851775,4794,572784,88015,16,114987,2442,0,518,144444.0,43333.0,-66.0,-72.0,-66.0,-70.0,-67.0,-72.0,-66.0,-71.0,-81.0,-89.0,-81.0,-89.0,15.0,17.0,15.0,19.0,1
2681,CC:2F:71:3E:C5:1F,3224649,407259036,11378,1391793,3213271,405867243,6,48593,4069139,40158,3069655,8435,999484,11997,34,16342,186,6,825,144444.0,39000.0,-69.0,-70.0,-68.0,-60.0,-69.0,-71.0,-68.0,-61.0,-81.0,-89.0,-81.0,-89.0,12.0,19.0,13.0,29.0,1
2682,CC:2F:71:3F:1F:24,8308275,8175143319,5095004,7769276076,3213271,405867243,80,1194355,741761735,1185830,740737945,8525,1023790,1141283,619,5099711,520537,80,5722,86667.0,14444.0,-69.0,-64.0,-72.0,-69.0,-68.0,-64.0,-72.0,-69.0,-81.0,-89.0,-81.0,-89.0,12.0,25.0,9.0,20.0,1
2683,F8:59:71:5A:E0:3D,3325615,568774479,112338,162906630,3213277,405867849,0,110300,121523119,105506,120950335,4794,572784,88079,16,115051,2443,0,518,144444.0,43333.0,-67.0,-72.0,-66.0,-71.0,-66.0,-72.0,-66.0,-71.0,-81.0,-89.0,-81.0,-88.0,14.0,17.0,15.0,17.0,1
2684,CC:2F:71:3E:C5:1F,3224655,407259642,11378,1391793,3213277,405867849,6,48593,4069139,40158,3069655,8435,999484,11997,34,16342,186,6,825,144444.0,39000.0,-69.0,-70.0,-68.0,-60.0,-69.0,-71.0,-68.0,-61.0,-81.0,-89.0,-81.0,-88.0,12.0,19.0,13.0,28.0,1
2685,CC:2F:71:3F:1F:24,8309200,8176547009,5095921,7770678958,3213279,405868051,80,1194660,741982015,1186135,740958225,8525,1023790,1141587,619,5100631,520664,80,5722,86667.0,14444.0,-69.0,-64.0,-72.0,-70.0,-68.0,-64.0,-72.0,-70.0,-81.0,-89.0,-81.0,-88.0,12.0,25.0,9.0,18.0,1
2686,F8:59:71:5A:E0:3D,3325681,568872699,112402,163004648,3213279,405868051,0,110363,121620139,105569,121047355,4794,572784,88142,16,115115,2443,0,518,144444.0,43333.0,-67.0,-72.0,-66.0,-71.0,-67.0,-72.0,-65.0,-71.0,-81.0,-89.0,-81.0,-88.0,14.0,17.0,15.0,17.0,1
2687,CC:2F:71:3E:C5:1F,3224658,407259960,11379,1391909,3213279,405868051,6,48595,4069279,40160,3069795,8435,999484,11997,34,16343,186,6,825,144444.0,39000.0,-70.0,-71.0,-67.0,-61.0,-70.0,-71.0,-68.0,-61.0,-81.0,-89.0,-81.0,-88.0,11.0,18.0,14.0,27.0,1
2688,CC:2F:71:3F:1F:24,8310340,8178300267,5097061,7772432216,3213279,405868051,80,1194983,742200067,1186458,741176277,8525,1023790,1141910,619,5101780,520675,80,5723,86667.0,14444.0,-69.0,-64.0,-72.0,-68.0,-68.0,-64.0,-72.0,-68.0,-81.0,-89.0,-81.0,-88.0,12.0,25.0,9.0,20.0,1
2689,F8:59:71:5A:E0:3D,3325752,568972821,112466,163104104,3213286,405868717,0,110425,121715619,105631,121142835,4794,572784,88204,16,115179,2443,0,518,144444.0,43333.0,-67.0,-73.0,-66.0,-71.0,-67.0,-72.0,-66.0,-71.0,-81.0,-89.0,-81.0,-88.0,14.0,16.0,15.0,17.0,1
2690,CC:2F:71:3E:C5:1F,3224665,407260626,11379,1391909,3213286,405868717,6,48595,4069279,40160,3069795,8435,999484,11997,34,16343,186,6,825,144444.0,39000.0,-70.0,-71.0,-67.0,-61.0,-70.0,-71.0,-68.0,-61.0,-81.0,-89.0,-81.0,-88.0,11.0,18.0,14.0,27.0,1
2691,CC:2F:71:3F:1F:24,8311632,8180282655,5098346,7774413938,3213286,405868717,80,1195345,742440021,1186820,741416231,8525,1023790,1142272,619,5103065,521002,80,5723,78000.0,13000.0,-69.0,-64.0,-73.0,-69.0,-69.0,-64.0,-73.0,-69.0,-81.0,-89.0,-81.0,-88.0,12.0,25.0,8.0,19.0,1
2692,F8:59:71:5A:E0:3D,3325823,569080249,112535,163211330,3213288,405868919,0,110498,121828053,105704,121255269,4794,572784,88276,16,115248,2443,0,518,144444.0,43333.0,-68.0,-73.0,-66.0,-72.0,-67.0,-73.0,-66.0,-71.0,-81.0,-89.0,-81.0,-88.0,13.0,16.0,15.0,16.0,1
2693,CC:2F:71:3E:C5:1F,3224667,407260828,11379,1391909,3213288,405868919,6,48595,4069279,40160,3069795,8435,999484,11997,34,16343,186,6,825,144444.0,39000.0,-70.0,-71.0,-67.0,-61.0,-70.0,-71.0,-68.0,-61.0,-81.0,-89.0,-81.0,-88.0,11.0,18.0,14.0,27.0,1
2694,CC:2F:71:3F:1F:24,8312706,8181929929,5099418,7776061010,3213288,405868919,80,1195666,742666369,1187141,741642579,8525,1023790,1142593,619,5104106,521135,80,5723,86667.0,14444.0,-69.0,-64.0,-74.0,-70.0,-68.0,-64.0,-73.0,-69.0,-81.0,-89.0,-81.0,-88.0,12.0,25.0,7.0,18.0,1
2695,F8:59:71:5A:E0:3D,3325898,569185422,112602,163315448,3213296,405869974,0,110565,121931233,105771,121358449,4794,572784,88343,16,115315,2443,0,518,144444.0,43333.0,-68.0,-73.0,-67.0,-72.0,-67.0,-72.0,-66.0,-71.0,-81.0,-89.0,-81.0,-88.0,13.0,16.0,14.0,16.0,1
2696,CC:2F:71:3E:C5:1F,3224675,407261883,11379,1391909,3213296,405869974,6,48595,4069279,40160,3069795,8435,999484,11997,34,16343,186,6,825,144444.0,39000.0,-70.0,-71.0,-67.0,-61.0,-70.0,-71.0,-68.0,-61.0,-81.0,-89.0,-81.0,-88.0,11.0,18.0,14.0,27.0,1
2697,CC:2F:71:3F:1F:24,8313957,8183839199,5100661,7777969225,3213296,405869974,80,1196009,742900200,1187484,741876410,8525,1023790,1142935,619,5105366,521190,80,5723,86667.0,14444.0,-69.0,-64.0,-72.0,-70.0,-68.0,-64.0,-72.0,-70.0,-81.0,-89.0,-81.0,-88.0,12.0,25.0,9.0,18.0,1
2698,F8:59:71:5A:E0:3D,3325969,569288697,112668,163418012,3213301,405870685,0,110632,122034441,105838,121461657,4794,572784,88408,16,115381,2444,0,518,144444.0,43333.0,-67.0,-72.0,-66.0,-72.0,-67.0,-72.0,-65.0,-71.0,-81.0,-89.0,-81.0,-88.0,14.0,17.0,15.0,16.0,1
2699,CC:2F:71:3E:C5:1F,3224684,407263307,11383,1392622,3213301,405870685,6,48601,4070094,40166,3070610,8435,999484,12002,34,16347,186,6,825,144444.0,39000.0,-70.0,-71.0,-67.0,-61.0,-69.0,-70.0,-67.0,-60.0,-81.0,-89.0,-81.0,-88.0,11.0,18.0,14.0,27.0,1
2700,CC:2F:71:3F:1F:24,8315474,8186183190,5102173,7780312505,3213301,405870685,80,1196402,743135074,1187877,742111284,8525,1023790,1143328,619,5106892,521251,80,5723,86667.0,13000.0,-68.0,-64.0,-73.0,-69.0,-68.0,-64.0,-73.0,-69.0,-81.0,-89.0,-81.0,-88.0,13.0,25.0,8.0,19.0,1
2701,F8:59:71:5A:E0:3D,3326040,569388821,112732,163517468,3213308,405871353,0,110696,122133001,105902,121560217,4794,572784,88472,16,115445,2444,0,518,144444.0,43333.0,-67.0,-73.0,-66.0,-71.0,-67.0,-72.0,-65.0,-70.0,-81.0,-89.0,-81.0,-88.0,14.0,16.0,15.0,17.0,1
2702,CC:2F:71:3E:C5:1F,3224693,407264424,11383,1392622,3213310,405871802,6,48603,4070282,40167,3070680,8436,999602,12003,34,16347,186,6,825,144444.0,39000.0,-70.0,-71.0,-67.0,-61.0,-69.0,-70.0,-67.0,-60.0,-81.0,-89.0,-81.0,-88.0,11.0,18.0,14.0,27.0,1
2703,CC:2F:71:3F:1F:24,8316663,8188000605,5103353,7782128803,3213310,405871802,80,1196747,743358780,1188222,742334990,8525,1023790,1143673,619,5108072,521455,80,5723,86667.0,14444.0,-69.0,-64.0,-73.0,-70.0,-68.0,-64.0,-72.0,-69.0,-81.0,-89.0,-81.0,-88.0,12.0,25.0,8.0,18.0,1
2704,F8:59:71:5A:E0:3D,3326108,569488928,112796,163616924,3213312,405872004,0,110762,122234655,105968,121661871,4794,572784,88537,16,115509,2445,0,518,144444.0,43333.0,-67.0,-73.0,-66.0,-71.0,-67.0,-72.0,-65.0,-71.0,-81.0,-89.0,-81.0,-88.0,14.0,16.0,15.0,17.0,1
2705,CC:2F:71:3E:C5:1F,3224695,407264626,11383,1392622,3213312,405872004,6,48603,4070282,40167,3070680,8436,999602,12003,34,16347,186,6,825,144444.0,39000.0,-70.0,-71.0,-67.0,-61.0,-69.0,-70.0,-67.0,-60.0,-81.0,-89.0,-81.0,-88.0,11.0,18.0,14.0,27.0,1
2706,CC:2F:71:3F:1F:24,8317719,8189619637,5104406,7783747573,3213313,405872064,80,1197075,743577620,1188550,742553830,8525,1023790,1144000,619,5109111,521550,80,5723,86667.0,14444.0,-69.0,-65.0,-73.0,-70.0,-69.0,-64.0,-73.0,-69.0,-81.0,-89.0,-81.0,-88.0,12.0,24.0,8.0,18.0,1
2707,F8:59:71:5A:E0:3D,3326177,569589039,112860,163716324,3213317,405872715,0,110827,122334783,106033,121761999,4794,572784,88600,16,115573,2445,0,518,130000.0,39000.0,-67.0,-73.0,-66.0,-72.0,-67.0,-72.0,-66.0,-71.0,-81.0,-89.0,-81.0,-88.0,14.0,16.0,15.0,16.0,1
2708,CC:2F:71:3E:C5:1F,3224700,407265337,11383,1392622,3213317,405872715,6,48603,4070282,40167,3070680,8436,999602,12003,34,16347,186,6,825,144444.0,39000.0,-70.0,-71.0,-67.0,-61.0,-69.0,-70.0,-67.0,-60.0,-81.0,-89.0,-81.0,-88.0,11.0,18.0,14.0,27.0,1
2709,CC:2F:71:3F:1F:24,8319255,8191980054,5105934,7786106935,3213321,405873119,80,1197450,743806565,1188925,742782775,8525,1023790,1144375,619,5110643,521741,80,5723,115556.0,26000.0,-69.0,-65.0,-73.0,-71.0,-69.0,-65.0,-72.0,-70.0,-81.0,-89.0,-81.0,-88.0,12.0,24.0,8.0,17.0,1
2710,F8:59:71:5A:E0:3D,3326255,569698648,112930,163824992,3213325,405873656,0,110900,122445809,106105,121872907,4795,572902,88671,16,115643,2445,0,518,144444.0,43333.0,-67.0,-73.0,-66.0,-71.0,-66.0,-72.0,-65.0,-71.0,-81.0,-89.0,-81.0,-88.0,14.0,16.0,15.0,17.0,1
2711,CC:2F:71:3E:C5:1F,3224708,407266278,11383,1392622,3213325,405873656,6,48603,4070282,40167,3070680,8436,999602,12003,34,16347,186,6,825,144444.0,39000.0,-70.0,-71.0,-67.0,-61.0,-69.0,-70.0,-67.0,-60.0,-81.0,-89.0,-81.0,-88.0,11.0,18.0,14.0,27.0,1
2712,CC:2F:71:3F:1F:24,8320377,8193698899,5107052,7787825243,3213325,405873656,80,1197786,744043655,1189261,743019865,8525,1023790,1144711,619,5111771,521894,80,5723,86667.0,14444.0,-69.0,-65.0,-72.0,-70.0,-68.0,-64.0,-71.0,-69.0,-81.0,-89.0,-81.0,-88.0,12.0,24.0,9.0,18.0,1
2713,F8:59:71:5A:E0:3D,3326318,569795056,112992,163921340,3213326,405873716,0,110964,122544397,106169,121971495,4795,572902,88733,16,115705,2445,0,518,144444.0,43333.0,-67.0,-73.0,-66.0,-71.0,-67.0,-73.0,-66.0,-71.0,-81.0,-89.0,-81.0,-88.0,14.0,16.0,15.0,17.0,1
2714,CC:2F:71:3E:C5:1F,3224711,407266540,11383,1392622,3213328,405873918,6,48603,4070282,40167,3070680,8436,999602,12003,34,16347,186,6,825,144444.0,39000.0,-70.0,-71.0,-67.0,-61.0,-69.0,-70.0,-67.0,-60.0,-81.0,-89.0,-81.0,-88.0,11.0,18.0,14.0,27.0,1
2715,CC:2F:71:3F:1F:24,8321305,8195114747,5107977,7789240829,3213328,405873918,80,1198079,744261219,1189554,743237429,8525,1023790,1145003,619,5112690,521901,80,5723,86667.0,14444.0,-69.0,-65.0,-74.0,-70.0,-69.0,-65.0,-73.0,-70.0,-81.0,-89.0,-81.0,-88.0,12.0,24.0,7.0,18.0,1
2716,F8:59:71:5A:E0:3D,3326391,569896874,113057,164022350,3213334,405874524,0,111031,122647605,106236,122074703,4795,572902,88798,16,115769,2447,0,518,144444.0,43333.0,-67.0,-72.0,-66.0,-71.0,-67.0,-72.0,-66.0,-71.0,-81.0,-89.0,-81.0,-88.0,14.0,17.0,15.0,17.0,1
2717,CC:2F:71:3E:C5:1F,3224717,407267146,11383,1392622,3213334,405874524,6,48603,4070282,40167,3070680,8436,999602,12003,34,16347,186,6,825,144444.0,39000.0,-70.0,-71.0,-67.0,-61.0,-69.0,-70.0,-67.0,-60.0,-81.0,-89.0,-81.0,-88.0,11.0,18.0,14.0,27.0,1
2718,CC:2F:71:3F:1F:24,8322175,8196436017,5108841,7790561493,3213334,405874524,80,1198395,744477161,1189870,743453371,8525,1023790,1145319,619,5113558,521965,80,5724,86667.0,14444.0,-70.0,-65.0,-74.0,-71.0,-69.0,-65.0,-73.0,-70.0,-81.0,-89.0,-81.0,-88.0,11.0,24.0,7.0,17.0,1
2719,F8:59:71:5A:E0:3D,3326454,569994776,113120,164120252,3213334,405874524,0,111094,122744625,106299,122171723,4795,572902,88861,16,115833,2448,0,518,144444.0,43333.0,-67.0,-73.0,-66.0,-71.0,-67.0,-72.0,-65.0,-70.0,-81.0,-89.0,-81.0,-88.0,14.0,16.0,15.0,17.0,1
2720,CC:2F:71:3E:C5:1F,3224718,407267262,11384,1392738,3213334,405874524,6,48604,4070388,40168,3070786,8436,999602,12004,34,16348,186,6,825,144444.0,43333.0,-70.0,-70.0,-67.0,-60.0,-69.0,-70.0,-67.0,-60.0,-81.0,-89.0,-81.0,-88.0,11.0,19.0,14.0,28.0,1
2721,CC:2F:71:3F:1F:24,8323043,8197755257,5109709,7791880733,3213334,405874524,80,1198706,744697131,1190181,743673341,8525,1023790,1145630,619,5114418,521986,80,5724,86667.0,14444.0,-69.0,-64.0,-73.0,-71.0,-69.0,-64.0,-73.0,-70.0,-81.0,-89.0,-81.0,-88.0,12.0,25.0,8.0,17.0,1
2722,F8:59:71:5A:E0:3D,3326524,570093344,113183,164218154,3213341,405875190,0,111157,122841645,106362,122268743,4795,572902,88924,16,115896,2448,0,518,144444.0,43333.0,-67.0,-73.0,-66.0,-71.0,-66.0,-72.0,-65.0,-70.0,-81.0,-89.0,-81.0,-88.0,14.0,16.0,15.0,17.0,1
2723,CC:2F:71:3E:C5:1F,3224728,407268190,11385,1392798,3213343,405875392,6,48608,4070704,40172,3071102,8436,999602,12005,34,16349,186,6,825,144444.0,43333.0,-70.0,-69.0,-66.0,-60.0,-69.0,-70.0,-66.0,-60.0,-81.0,-89.0,-81.0,-88.0,11.0,20.0,15.0,28.0,1
2724,CC:2F:71:3F:1F:24,8324165,8199466851,5110821,7793591397,3213344,405875454,80,1199032,744931493,1190506,743907585,8526,1023908,1145956,619,5115540,522056,80,5725,86667.0,14444.0,-68.0,-65.0,-73.0,-70.0,-68.0,-64.0,-72.0,-69.0,-81.0,-89.0,-81.0,-88.0,13.0,24.0,8.0,18.0,1
2725,F8:59:71:5A:E0:3D,3326598,570203942,113254,164328488,3213344,405875454,0,111229,122952525,106434,122379623,4795,572902,88996,16,115967,2450,0,518,144444.0,43333.0,-67.0,-73.0,-65.0,-70.0,-67.0,-72.0,-65.0,-70.0,-81.0,-89.0,-81.0,-88.0,14.0,16.0,16.0,18.0,1
2726,CC:2F:71:3E:C5:1F,3224729,407268252,11385,1392798,3213344,405875454,6,48608,4070704,40172,3071102,8436,999602,12005,34,16349,186,6,825,144444.0,43333.0,-70.0,-69.0,-66.0,-60.0,-69.0,-70.0,-66.0,-60.0,-81.0,-89.0,-81.0,-88.0,11.0,20.0,15.0,28.0,1
2727,CC:2F:71:3F:1F:24,8325632,8201737177,5112288,7795861723,3213344,405875454,80,1199400,745166481,1190874,744142573,8526,1023908,1146324,619,5117007,522195,80,5725,86667.0,14444.0,-69.0,-65.0,-73.0,-70.0,-69.0,-65.0,-73.0,-70.0,-81.0,-89.0,-81.0,-88.0,12.0,24.0,8.0,18.0,1
2728,F8:59:71:5A:E0:3D,3326671,570305926,113319,164429498,3213352,405876428,0,111295,123054179,106500,122481277,4795,572902,89061,16,116032,2451,0,518,144444.0,43333.0,-67.0,-72.0,-66.0,-71.0,-67.0,-72.0,-65.0,-71.0,-81.0,-89.0,-81.0,-88.0,14.0,17.0,15.0,17.0,1
2729,CC:2F:71:3E:C5:1F,3224739,407269428,11385,1392798,3213354,405876630,6,48608,4070704,40172,3071102,8436,999602,12005,34,16349,186,6,825,144444.0,43333.0,-70.0,-69.0,-66.0,-60.0,-69.0,-70.0,-66.0,-60.0,-81.0,-89.0,-81.0,-88.0,11.0,20.0,15.0,28.0,1
2730,CC:2F:71:3F:1F:24,8327371,8204423795,5114017,7798547165,3213354,405876630,80,1199820,745407313,1191294,744383405,8526,1023908,1146742,619,5118702,522255,80,5725,86667.0,14444.0,-70.0,-65.0,-73.0,-70.0,-70.0,-65.0,-73.0,-70.0,-81.0,-89.0,-81.0,-88.0,11.0,24.0,8.0,18.0,1
2731,F8:59:71:5A:E0:3D,3326742,570411860,113387,164535170,3213355,405876690,0,111362,123157359,106567,122584457,4795,572902,89128,16,116100,2451,0,518,144444.0,43333.0,-67.0,-72.0,-65.0,-71.0,-67.0,-72.0,-65.0,-71.0,-81.0,-89.0,-81.0,-88.0,14.0,17.0,16.0,17.0,1
2732,CC:2F:71:3E:C5:1F,3224740,407269488,11385,1392798,3213355,405876690,6,48608,4070704,40172,3071102,8436,999602,12005,34,16349,186,6,825,144444.0,43333.0,-70.0,-69.0,-66.0,-60.0,-69.0,-70.0,-66.0,-60.0,-81.0,-89.0,-81.0,-88.0,11.0,20.0,15.0,28.0,1
2733,CC:2F:71:3F:1F:24,8329156,8207188505,5115801,7801311815,3213355,405876690,80,1200246,745648183,1191720,744624275,8526,1023908,1147167,619,5120516,522262,80,5726,104000.0,26000.0,-68.0,-65.0,-72.0,-68.0,-67.0,-64.0,-72.0,-68.0,-81.0,-89.0,-81.0,-88.0,13.0,24.0,9.0,20.0,1
2734,F8:59:71:5A:E0:3D,3326812,570511922,113451,164634626,3213361,405877296,0,111427,123257473,106632,122684571,4795,572902,89192,16,116164,2451,0,518,144444.0,43333.0,-67.0,-72.0,-65.0,-72.0,-66.0,-72.0,-65.0,-71.0,-81.0,-89.0,-81.0,-88.0,14.0,17.0,16.0,16.0,1
2735,CC:2F:71:3E:C5:1F,3224746,407270094,11385,1392798,3213361,405877296,6,48608,4070704,40172,3071102,8436,999602,12005,34,16349,186,6,825,144444.0,43333.0,-70.0,-69.0,-66.0,-60.0,-69.0,-70.0,-66.0,-60.0,-81.0,-89.0,-81.0,-88.0,11.0,20.0,15.0,28.0,1
2736,CC:2F:71:3F:1F:24,8330519,8209285559,5117156,7803408061,3213363,405877498,80,1200567,745866093,1192041,744842185,8526,1023908,1147488,619,5121873,522337,80,5727,115556.0,28889.0,-70.0,-64.0,-72.0,-69.0,-70.0,-64.0,-71.0,-68.0,-81.0,-89.0,-81.0,-88.0,11.0,25.0,9.0,19.0,1
2737,F8:59:71:5A:E0:3D,3326877,570610026,113514,164732528,3213363,405877498,0,111490,123354493,106695,122781591,4795,572902,89255,16,116227,2454,0,518,144444.0,43333.0,-67.0,-72.0,-66.0,-71.0,-66.0,-72.0,-65.0,-70.0,-81.0,-89.0,-81.0,-88.0,14.0,17.0,15.0,17.0,1
2738,CC:2F:71:3E:C5:1F,3224748,407270296,11385,1392798,3213363,405877498,6,48608,4070704,40172,3071102,8436,999602,12005,34,16349,186,6,825,144444.0,43333.0,-70.0,-69.0,-66.0,-60.0,-69.0,-70.0,-66.0,-60.0,-81.0,-89.0,-81.0,-88.0,11.0,20.0,15.0,28.0,1
2739,CC:2F:71:3F:1F:24,8331664,8211046465,5118301,7805168967,3213363,405877498,80,1200852,746078828,1192326,745054920,8526,1023908,1147773,619,5123004,522357,80,5729,115556.0,28889.0,-71.0,-65.0,-72.0,-69.0,-70.0,-64.0,-72.0,-69.0,-81.0,-89.0,-81.0,-88.0,10.0,24.0,9.0,19.0,1
2740,F8:59:71:5A:E0:3D,3326946,570707040,113576,164828876,3213370,405878164,0,111552,123449973,106757,122877071,4795,572902,89317,16,116289,2455,0,518,144444.0,43333.0,-67.0,-72.0,-66.0,-71.0,-66.0,-72.0,-65.0,-71.0,-81.0,-89.0,-81.0,-88.0,14.0,17.0,15.0,17.0,1
2741,CC:2F:71:3E:C5:1F,3224755,407270962,11385,1392798,3213370,405878164,6,48608,4070704,40172,3071102,8436,999602,12005,34,16349,186,6,825,144444.0,43333.0,-70.0,-69.0,-66.0,-60.0,-69.0,-70.0,-66.0,-60.0,-81.0,-89.0,-81.0,-88.0,11.0,20.0,15.0,28.0,1
2742,CC:2F:71:3F:1F:24,8332796,8212779157,5119426,7806900993,3213370,405878164,80,1201121,746291964,1192595,745268056,8526,1023908,1148042,619,5124129,522391,80,5729,115556.0,26000.0,-71.0,-65.0,-73.0,-69.0,-70.0,-65.0,-72.0,-69.0,-81.0,-89.0,-81.0,-88.0,10.0,24.0,8.0,19.0,1
2743,F8:59:71:5A:E0:3D,3327013,570808252,113641,164929886,3213372,405878366,0,111618,123551627,106823,122978725,4795,572902,89382,16,116354,2456,0,518,144444.0,43333.0,-68.0,-72.0,-66.0,-72.0,-67.0,-71.0,-65.0,-71.0,-81.0,-89.0,-81.0,-88.0,13.0,17.0,15.0,16.0,1
2744,CC:2F:71:3E:C5:1F,3224757,407271164,11385,1392798,3213372,405878366,6,48608,4070704,40172,3071102,8436,999602,12005,34,16349,186,6,825,144444.0,43333.0,-70.0,-69.0,-66.0,-60.0,-69.0,-70.0,-66.0,-60.0,-81.0,-89.0,-81.0,-88.0,11.0,20.0,15.0,28.0,1
2745,CC:2F:71:3F:1F:24,8333941,8214532008,5120569,7808653642,3213372,405878366,80,1201421,746511017,1192895,745487109,8526,1023908,1148342,619,5125273,522453,80,5730,115556.0,28889.0,-70.0,-65.0,-73.0,-69.0,-70.0,-65.0,-72.0,-69.0,-81.0,-89.0,-81.0,-88.0,11.0,24.0,8.0,19.0,1
2746,F8:59:71:5A:E0:3D,3327082,570908238,113705,165029342,3213377,405878896,0,111680,123647107,106885,123074205,4795,572902,89444,16,116418,2456,0,518,144444.0,43333.0,-67.0,-71.0,-66.0,-71.0,-67.0,-71.0,-65.0,-71.0,-81.0,-88.0,-81.0,-88.0,14.0,17.0,15.0,17.0,1
2747,CC:2F:71:3E:C5:1F,3224763,407271754,11385,1392798,3213378,405878956,6,48608,4070704,40172,3071102,8436,999602,12005,34,16349,186,6,825,144444.0,43333.0,-70.0,-69.0,-66.0,-60.0,-69.0,-70.0,-66.0,-60.0,-81.0,-88.0,-81.0,-88.0,11.0,19.0,15.0,28.0,1
2748,CC:2F:71:3F:1F:24,8334651,8215597500,5121271,7809718342,3213380,405879158,80,1201660,746720937,1193134,745697029,8526,1023908,1148580,619,5125990,522460,80,5731,115556.0,28889.0,-70.0,-65.0,-73.0,-69.0,-70.0,-65.0,-72.0,-69.0,-81.0,-88.0,-81.0,-88.0,11.0,23.0,8.0,19.0,1
2749,F8:59:71:5A:E0:3D,3327149,571005050,113767,165125690,3213382,405879360,0,111744,123745667,106949,123172765,4795,572902,89508,16,116480,2456,0,518,144444.0,43333.0,-67.0,-72.0,-66.0,-71.0,-66.0,-71.0,-65.0,-71.0,-81.0,-88.0,-81.0,-88.0,14.0,16.0,15.0,17.0,1
2750,CC:2F:71:3E:C5:1F,3224767,407272158,11385,1392798,3213382,405879360,6,48608,4070704,40172,3071102,8436,999602,12005,34,16349,186,6,825,144444.0,43333.0,-70.0,-69.0,-66.0,-60.0,-69.0,-70.0,-66.0,-60.0,-81.0,-88.0,-81.0,-88.0,11.0,19.0,15.0,28.0,1
2751,CC:2F:71:3F:1F:24,8335598,8217044111,5122216,7811164751,3213382,405879360,80,1201931,746932992,1193405,745909084,8526,1023908,1148851,619,5126924,522577,80,5731,130000.0,39000.0,-70.0,-65.0,-73.0,-69.0,-70.0,-65.0,-72.0,-69.0,-81.0,-88.0,-81.0,-88.0,11.0,23.0,8.0,19.0,1
2752,F8:59:71:5A:E0:3D,3327216,571104869,113831,165225034,3213385,405879835,0,111809,123845823,107014,123272921,4795,572902,89572,16,116545,2465,0,518,144444.0,43333.0,-67.0,-72.0,-66.0,-71.0,-67.0,-71.0,-65.0,-71.0,-81.0,-88.0,-81.0,-88.0,14.0,16.0,15.0,17.0,1
2753,CC:2F:71:3E:C5:1F,3224770,407272633,11385,1392798,3213385,405879835,6,48608,4070704,40172,3071102,8436,999602,12005,34,16349,186,6,825,144444.0,43333.0,-70.0,-69.0,-66.0,-60.0,-69.0,-70.0,-66.0,-60.0,-81.0,-88.0,-81.0,-88.0,11.0,19.0,15.0,28.0,1
2754,CC:2F:71:3F:1F:24,8336592,8218561654,5123205,7812681617,3213387,405880037,80,1202187,747147520,1193661,746123612,8526,1023908,1149107,619,5127907,522929,80,5731,130000.0,39000.0,-70.0,-65.0,-73.0,-69.0,-70.0,-65.0,-73.0,-69.0,-81.0,-88.0,-81.0,-88.0,11.0,23.0,8.0,19.0,1
2755,F8:59:71:5A:E0:3D,3327287,571204991,113895,165324490,3213392,405880501,0,111873,123944383,107078,123371481,4795,572902,89636,16,116609,2465,0,518,144444.0,43333.0,-67.0,-72.0,-66.0,-72.0,-67.0,-72.0,-65.0,-71.0,-81.0,-88.0,-81.0,-88.0,14.0,16.0,15.0,16.0,1
2756,CC:2F:71:3E:C5:1F,3224777,407273299,11385,1392798,3213392,405880501,6,48608,4070704,40172,3071102,8436,999602,12005,34,16349,186,6,825,144444.0,43333.0,-70.0,-69.0,-66.0,-60.0,-69.0,-70.0,-66.0,-60.0,-81.0,-88.0,-81.0,-88.0,11.0,19.0,15.0,28.0,1
2757,CC:2F:71:3F:1F:24,8337500,8219943420,5124108,7814062919,3213392,405880501,80,1202453,747366116,1193927,746342208,8526,1023908,1149373,619,5128827,523340,80,5731,115556.0,28889.0,-71.0,-65.0,-73.0,-69.0,-70.0,-64.0,-73.0,-68.0,-81.0,-88.0,-81.0,-88.0,10.0,23.0,8.0,19.0,1
2758,F8:59:71:5A:E0:3D,3327355,571307757,113961,165427054,3213394,405880703,0,111939,124046023,107144,123473121,4795,572902,89702,16,116675,2468,0,518,144444.0,43333.0,-66.0,-72.0,-65.0,-71.0,-66.0,-71.0,-65.0,-70.0,-81.0,-88.0,-81.0,-88.0,15.0,16.0,16.0,17.0,1
2759,CC:2F:71:3E:C5:1F,3224779,407273501,11385,1392798,3213394,405880703,6,48608,4070704,40172,3071102,8436,999602,12005,34,16349,186,6,825,144444.0,43333.0,-70.0,-69.0,-66.0,-60.0,-69.0,-70.0,-66.0,-60.0,-81.0,-88.0,-81.0,-88.0,11.0,19.0,15.0,28.0,1
2760,CC:2F:71:3F:1F:24,8338679,8221735594,5125285,7815854891,3213394,405880703,80,1202748,747583904,1194222,746559996,8526,1023908,1149668,619,5129981,523438,80,5731,115556.0,28889.0,-70.0,-65.0,-72.0,-69.0,-70.0,-65.0,-72.0,-69.0,-81.0,-88.0,-81.0,-88.0,11.0,23.0,9.0,19.0,1
2761,F8:59:71:5A:E0:3D,3327424,571406265,114024,165524956,3213400,405881309,0,112002,124143043,107207,123570141,4795,572902,89765,16,116738,2468,0,518,144444.0,43333.0,-67.0,-72.0,-66.0,-71.0,-67.0,-72.0,-65.0,-71.0,-81.0,-88.0,-81.0,-88.0,14.0,16.0,15.0,17.0,1
2762,CC:2F:71:3E:C5:1F,3224785,407274107,11385,1392798,3213400,405881309,6,48608,4070704,40172,3071102,8436,999602,12005,34,16349,186,6,825,144444.0,43333.0,-70.0,-69.0,-66.0,-60.0,-69.0,-70.0,-66.0,-60.0,-81.0,-88.0,-81.0,-88.0,11.0,19.0,15.0,28.0,1
2763,CC:2F:71:3F:1F:24,8339960,8223706390,5126560,7817825081,3213400,405881309,80,1203066,747807436,1194540,746783528,8526,1023908,1149985,619,5131278,523489,80,5732,117000.0,39000.0,-71.0,-65.0,-73.0,-69.0,-70.0,-65.0,-72.0,-69.0,-81.0,-88.0,-81.0,-88.0,10.0,23.0,8.0,19.0,1
2764,F8:59:71:5A:E0:3D,3327489,571505781,114088,165624412,3213401,405881369,0,112069,124246265,107274,123673363,4795,572902,89829,16,116802,2468,0,518,144444.0,43333.0,-67.0,-72.0,-66.0,-71.0,-67.0,-72.0,-65.0,-70.0,-81.0,-88.0,-81.0,-88.0,14.0,16.0,15.0,17.0,1
2765,CC:2F:71:3E:C5:1F,3224786,407274167,11385,1392798,3213401,405881369,6,48608,4070704,40172,3071102,8436,999602,12005,34,16349,186,6,825,144444.0,43333.0,-70.0,-69.0,-66.0,-60.0,-69.0,-70.0,-66.0,-60.0,-81.0,-88.0,-81.0,-88.0,11.0,19.0,15.0,28.0,1
2766,CC:2F:71:3F:1F:24,8340901,8225143224,5127498,7819261653,3213403,405881571,80,1203345,748020604,1194819,746996696,8526,1023908,1150264,619,5132217,523815,80,5732,130000.0,43333.0,-71.0,-65.0,-74.0,-70.0,-70.0,-64.0,-73.0,-69.0,-81.0,-88.0,-81.0,-88.0,10.0,23.0,7.0,18.0,1
2767,F8:59:71:5A:E0:3D,3327558,571604289,114151,165722314,3213407,405881975,0,112133,124344867,107338,123771965,4795,572902,89892,16,116865,2468,0,518,144444.0,43333.0,-67.0,-71.0,-66.0,-71.0,-67.0,-71.0,-65.0,-70.0,-81.0,-89.0,-81.0,-88.0,14.0,18.0,15.0,17.0,1
2768,CC:2F:71:3E:C5:1F,3224794,407274975,11385,1392798,3213409,405882177,6,48608,4070704,40172,3071102,8436,999602,12005,34,16349,186,6,825,144444.0,43333.0,-70.0,-69.0,-66.0,-60.0,-69.0,-70.0,-66.0,-60.0,-81.0,-89.0,-81.0,-88.0,11.0,20.0,15.0,28.0,1
2769,CC:2F:71:3F:1F:24,8341836,8226566664,5128427,7820684487,3213409,405882177,80,1203626,748236684,1195100,747212776,8526,1023908,1150545,619,5133146,524001,80,5732,130000.0,43333.0,-70.0,-64.0,-72.0,-69.0,-69.0,-64.0,-72.0,-68.0,-81.0,-89.0,-81.0,-88.0,11.0,25.0,9.0,19.0,1
2770,F8:59:71:5A:E0:3D,3327628,571708725,114219,165826548,3213409,405882177,0,112200,124448047,107405,123875145,4795,572902,89959,16,116933,2468,0,518,144444.0,43333.0,-67.0,-72.0,-65.0,-70.0,-66.0,-71.0,-65.0,-70.0,-81.0,-89.0,-81.0,-88.0,14.0,17.0,16.0,18.0,1
2771,CC:2F:71:3E:C5:1F,3224795,407275091,11386,1392914,3213409,405882177,6,48610,4070844,40174,3071242,8436,999602,12005,34,16350,186,6,825,144444.0,43333.0,-70.0,-71.0,-68.0,-61.0,-69.0,-70.0,-67.0,-60.0,-81.0,-89.0,-81.0,-88.0,11.0,18.0,13.0,27.0,1
2772,CC:2F:71:3F:1F:24,8343328,8228868547,5129919,7822986370,3213409,405882177,80,1203986,748468081,1195460,747444173,8526,1023908,1150905,619,5134637,524422,80,5732,115556.0,28889.0,-70.0,-64.0,-73.0,-69.0,-69.0,-64.0,-72.0,-69.0,-81.0,-89.0,-81.0,-88.0,11.0,25.0,8.0,19.0,1
2773,F8:59:71:5A:E0:3D,3327697,571805739,114281,165922896,3213416,405882843,0,112263,124545081,107468,123972179,4795,572902,90021,16,116995,2468,0,518,144444.0,43333.0,-67.0,-72.0,-65.0,-70.0,-66.0,-71.0,-65.0,-70.0,-81.0,-89.0,-81.0,-88.0,14.0,17.0,16.0,18.0,1
2774,CC:2F:71:3E:C5:1F,3224802,407275757,11386,1392914,3213416,405882843,6,48610,4070844,40174,3071242,8436,999602,12005,34,16350,186,6,825,144444.0,43333.0,-70.0,-71.0,-68.0,-61.0,-69.0,-70.0,-67.0,-60.0,-81.0,-89.0,-81.0,-88.0,11.0,18.0,13.0,27.0,1
2775,CC:2F:71:3F:1F:24,8344610,8230839627,5131194,7824956784,3213416,405882843,80,1204330,748684451,1195804,747660543,8526,1023908,1151249,619,5135913,524431,80,5732,115556.0,28889.0,-70.0,-64.0,-72.0,-69.0,-69.0,-64.0,-72.0,-69.0,-81.0,-89.0,-81.0,-88.0,11.0,25.0,9.0,19.0,1
2776,F8:59:71:5A:E0:3D,3327763,571903737,114344,166020630,3213419,405883107,0,112327,124643641,107532,124070739,4795,572902,90085,16,117058,2468,0,518,144444.0,43333.0,-67.0,-72.0,-65.0,-71.0,-66.0,-71.0,-65.0,-70.0,-82.0,-89.0,-82.0,-88.0,15.0,17.0,17.0,17.0,1
2777,CC:2F:71:3E:C5:1F,3224805,407276021,11386,1392914,3213419,405883107,6,48610,4070844,40174,3071242,8436,999602,12005,34,16350,186,6,825,144444.0,43333.0,-70.0,-71.0,-68.0,-61.0,-69.0,-70.0,-67.0,-60.0,-82.0,-89.0,-82.0,-88.0,12.0,18.0,14.0,27.0,1
2778,CC:2F:71:3F:1F:24,8345660,8232450153,5132241,7826567046,3213419,405883107,80,1204600,748899429,1196073,747875403,8527,1024026,1151519,619,5136935,524633,80,5733,115556.0,28889.0,-69.0,-64.0,-72.0,-69.0,-69.0,-64.0,-72.0,-69.0,-82.0,-89.0,-82.0,-88.0,13.0,25.0,10.0,19.0,1
2779,F8:59:71:5A:E0:3D,3327833,572003799,114408,166120086,3213425,405883713,0,112391,124742201,107596,124169299,4795,572902,90149,16,117122,2468,0,518,144444.0,43333.0,-67.0,-72.0,-65.0,-71.0,-66.0,-72.0,-65.0,-70.0,-82.0,-89.0,-82.0,-88.0,15.0,17.0,17.0,17.0,1
2780,CC:2F:71:3E:C5:1F,3224811,407276627,11386,1392914,3213425,405883713,6,48610,4070844,40174,3071242,8436,999602,12005,34,16350,186,6,825,144444.0,43333.0,-70.0,-71.0,-68.0,-61.0,-69.0,-70.0,-67.0,-60.0,-82.0,-89.0,-82.0,-88.0,12.0,18.0,14.0,27.0,1
2781,CC:2F:71:3F:1F:24,8346711,8234056689,5133286,7828172976,3213425,405883713,80,1204853,749116661,1196326,748092635,8527,1024026,1151772,619,5138005,524780,80,5734,115556.0,28889.0,-70.0,-64.0,-72.0,-69.0,-70.0,-64.0,-72.0,-69.0,-82.0,-89.0,-82.0,-88.0,12.0,25.0,10.0,19.0,1
2782,F8:59:71:5A:E0:3D,3327902,572106625,114474,166222650,3213428,405883975,0,112456,124842301,107661,124269399,4795,572902,90214,16,117188,2469,0,518,144444.0,43333.0,-67.0,-72.0,-65.0,-70.0,-66.0,-72.0,-65.0,-70.0,-82.0,-89.0,-82.0,-88.0,15.0,17.0,17.0,18.0,1
2783,CC:2F:71:3E:C5:1F,3224814,407276889,11386,1392914,3213428,405883975,6,48610,4070844,40174,3071242,8436,999602,12005,34,16350,186,6,825,144444.0,43333.0,-70.0,-71.0,-68.0,-61.0,-69.0,-70.0,-67.0,-60.0,-82.0,-89.0,-82.0,-88.0,12.0,18.0,14.0,27.0,1
2784,CC:2F:71:3F:1F:24,8348293,8236499288,5134865,7830615313,3213428,405883975,80,1205186,749340821,1196659,748316795,8527,1024026,1152105,619,5139563,524866,80,5736,115556.0,28889.0,-70.0,-64.0,-73.0,-69.0,-69.0,-64.0,-72.0,-69.0,-82.0,-89.0,-82.0,-88.0,12.0,25.0,9.0,19.0,1
2785,F8:59:71:5A:E0:3D,3327971,572208039,114539,166323660,3213432,405884379,0,112522,124943941,107727,124371039,4795,572902,90280,16,117253,2469,0,518,144444.0,43333.0,-67.0,-72.0,-65.0,-70.0,-66.0,-71.0,-65.0,-70.0,-82.0,-89.0,-82.0,-88.0,15.0,17.0,17.0,18.0,1
2786,CC:2F:71:3E:C5:1F,3224820,407277495,11386,1392914,3213434,405884581,6,48610,4070844,40174,3071242,8436,999602,12005,34,16350,186,6,825,144444.0,43333.0,-70.0,-71.0,-68.0,-61.0,-69.0,-70.0,-67.0,-60.0,-82.0,-89.0,-82.0,-88.0,12.0,18.0,14.0,27.0,1
2787,CC:2F:71:3F:1F:24,8349882,8238955668,5136448,7833071087,3213434,405884581,80,1205537,749569285,1197010,748545259,8527,1024026,1152456,619,5141163,524943,80,5736,115556.0,28889.0,-69.0,-64.0,-72.0,-70.0,-69.0,-64.0,-72.0,-69.0,-82.0,-89.0,-82.0,-88.0,13.0,25.0,10.0,18.0,1
2788,F8:59:71:5A:E0:3D,3328040,572309453,114604,166424670,3213436,405884783,0,112586,125042501,107791,124469599,4795,572902,90344,16,117318,2469,0,518,144444.0,43333.0,-67.0,-72.0,-65.0,-71.0,-66.0,-71.0,-65.0,-70.0,-82.0,-89.0,-82.0,-88.0,15.0,17.0,17.0,17.0,1
2789,CC:2F:71:3E:C5:1F,3224822,407277697,11386,1392914,3213436,405884783,6,48610,4070844,40174,3071242,8436,999602,12005,34,16350,186,6,825,144444.0,43333.0,-70.0,-71.0,-68.0,-61.0,-69.0,-70.0,-67.0,-60.0,-82.0,-89.0,-82.0,-88.0,12.0,18.0,14.0,27.0,1
2790,CC:2F:71:3F:1F:24,8351150,8240908820,5137713,7835023977,3213437,405884843,80,1205849,749789019,1197322,748764993,8527,1024026,1152768,619,5142432,525003,80,5737,115556.0,28889.0,-70.0,-64.0,-72.0,-69.0,-69.0,-64.0,-72.0,-69.0,-82.0,-89.0,-82.0,-88.0,12.0,25.0,10.0,19.0,1
2791,F8:59:71:5A:E0:3D,3328106,572406125,114666,166521018,3213440,405885107,0,112649,125139521,107854,124566619,4795,572902,90407,16,117380,2469,0,518,144444.0,43333.0,-66.0,-71.0,-65.0,-71.0,-66.0,-71.0,-64.0,-70.0,-82.0,-89.0,-82.0,-88.0,16.0,18.0,17.0,17.0,1
2792,CC:2F:71:3E:C5:1F,3224826,407278021,11386,1392914,3213440,405885107,6,48612,4071032,40175,3071312,8437,999720,12006,34,16350,186,6,825,144444.0,43333.0,-69.0,-71.0,-67.0,-60.0,-69.0,-70.0,-67.0,-60.0,-82.0,-89.0,-82.0,-88.0,13.0,18.0,15.0,28.0,1
2793,CC:2F:71:3F:1F:24,8352376,8242794144,5138934,7836908835,3213442,405885309,80,1206156,750005175,1197629,748981149,8527,1024026,1153075,619,5143639,525104,80,5737,130000.0,39000.0,-69.0,-64.0,-72.0,-69.0,-69.0,-64.0,-72.0,-69.0,-82.0,-89.0,-82.0,-88.0,13.0,25.0,10.0,19.0,1
2794,F8:59:71:5A:E0:3D,3328180,572511122,114733,166625136,3213447,405885986,0,112716,125242701,107921,124669799,4795,572902,90474,16,117447,2470,0,518,144444.0,43333.0,-67.0,-72.0,-65.0,-71.0,-66.0,-71.0,-65.0,-70.0,-82.0,-89.0,-82.0,-88.0,15.0,17.0,17.0,17.0,1
2795,CC:2F:71:3E:C5:1F,3224833,407278900,11386,1392914,3213447,405885986,6,48612,4071032,40175,3071312,8437,999720,12006,34,16350,186,6,825,144444.0,43333.0,-69.0,-71.0,-67.0,-60.0,-69.0,-70.0,-67.0,-60.0,-82.0,-89.0,-82.0,-88.0,13.0,18.0,15.0,28.0,1
2796,CC:2F:71:3F:1F:24,8354050,8245385159,5140603,7839499173,3213447,405885986,80,1206514,750240173,1197987,749216147,8527,1024026,1153433,619,5145322,525467,80,5737,115556.0,28889.0,-69.0,-64.0,-72.0,-69.0,-69.0,-64.0,-71.0,-69.0,-82.0,-89.0,-82.0,-88.0,13.0,25.0,10.0,19.0,1
2797,F8:59:71:5A:E0:3D,3328247,572610840,114797,166724592,3213450,405886248,0,112780,125341261,107985,124768359,4795,572902,90538,16,117511,2470,0,518,144444.0,43333.0,-67.0,-72.0,-65.0,-70.0,-66.0,-71.0,-65.0,-70.0,-82.0,-89.0,-82.0,-88.0,15.0,17.0,17.0,18.0,1
2798,CC:2F:71:3E:C5:1F,3224836,407279162,11386,1392914,3213450,405886248,6,48612,4071032,40175,3071312,8437,999720,12006,34,16350,186,6,825,144444.0,43333.0,-69.0,-71.0,-67.0,-60.0,-69.0,-70.0,-67.0,-60.0,-82.0,-89.0,-82.0,-88.0,13.0,18.0,15.0,28.0,1
2799,CC:2F:71:3F:1F:24,8355402,8247461998,5141951,7841575688,3213451,405886310,80,1206852,750460592,1198325,749436566,8527,1024026,1153771,619,5146670,525529,80,5737,115556.0,28889.0,-70.0,-64.0,-72.0,-70.0,-69.0,-64.0,-72.0,-70.0,-82.0,-89.0,-82.0,-88.0,12.0,25.0,10.0,18.0,1
2800,F8:59:71:5A:E0:3D,3328316,572710762,114861,166824048,3213455,405886714,0,112844,125438399,108048,124865379,4796,573020,90602,16,117575,2472,0,518,144444.0,43333.0,-67.0,-72.0,-65.0,-71.0,-66.0,-71.0,-65.0,-70.0,-82.0,-89.0,-82.0,-88.0,15.0,17.0,17.0,17.0,1
2801,CC:2F:71:3E:C5:1F,3224843,407279830,11386,1392914,3213457,405886916,6,48612,4071032,40175,3071312,8437,999720,12006,34,16350,186,6,825,144444.0,43333.0,-69.0,-71.0,-67.0,-60.0,-69.0,-70.0,-67.0,-60.0,-82.0,-89.0,-82.0,-88.0,13.0,18.0,15.0,28.0,1
2802,CC:2F:71:3F:1F:24,8356959,8249868042,5143502,7843981126,3213457,405886916,80,1207192,750685038,1198665,749661012,8527,1024026,1154111,619,5148221,525670,80,5737,104000.0,26000.0,-70.0,-65.0,-73.0,-70.0,-69.0,-65.0,-72.0,-70.0,-82.0,-89.0,-82.0,-88.0,12.0,24.0,9.0,18.0,1
2803,F8:59:71:5A:E0:3D,3328386,572813730,114927,166926612,3213459,405887118,0,112910,125540039,108114,124967019,4796,573020,90668,16,117641,2473,0,518,144444.0,43333.0,-67.0,-72.0,-65.0,-71.0,-66.0,-71.0,-65.0,-70.0,-82.0,-89.0,-82.0,-88.0,15.0,17.0,17.0,17.0,1
2804,CC:2F:71:3E:C5:1F,3224845,407280032,11386,1392914,3213459,405887118,6,48612,4071032,40175,3071312,8437,999720,12006,34,16350,186,6,825,144444.0,43333.0,-69.0,-71.0,-67.0,-60.0,-69.0,-70.0,-67.0,-60.0,-82.0,-89.0,-82.0,-88.0,13.0,18.0,15.0,28.0,1
2805,CC:2F:71:3F:1F:24,8358757,8252658524,5145298,7846771406,3213459,405887118,80,1207548,750918560,1199021,749894534,8527,1024026,1154467,619,5150016,525867,80,5737,115556.0,28889.0,-70.0,-65.0,-72.0,-70.0,-69.0,-65.0,-72.0,-70.0,-82.0,-89.0,-82.0,-88.0,12.0,24.0,10.0,18.0,1
2806,F8:59:71:5A:E0:3D,3328456,572915204,114992,167027622,3213464,405887582,0,112975,125640139,108179,125067119,4796,573020,90733,16,117706,2473,0,518,144444.0,43333.0,-67.0,-71.0,-65.0,-70.0,-66.0,-71.0,-65.0,-70.0,-82.0,-89.0,-82.0,-88.0,15.0,18.0,17.0,18.0,1
2807,CC:2F:71:3E:C5:1F,3224850,407280496,11386,1392914,3213464,405887582,6,48612,4071032,40175,3071312,8437,999720,12006,34,16350,186,6,825,144444.0,43333.0,-69.0,-71.0,-67.0,-60.0,-69.0,-70.0,-67.0,-60.0,-82.0,-89.0,-82.0,-88.0,13.0,18.0,15.0,28.0,1
2808,CC:2F:71:3F:1F:24,8359852,8254335976,5146388,7848448394,3213464,405887582,80,1207814,751130172,1199287,750106146,8527,1024026,1154733,619,5151107,525896,80,5737,115556.0,28889.0,-69.0,-64.0,-73.0,-70.0,-69.0,-64.0,-72.0,-70.0,-82.0,-89.0,-82.0,-88.0,13.0,25.0,9.0,18.0,1
2809,F8:59:71:5A:E0:3D,3328522,573011956,115054,167123970,3213468,405887986,0,113037,125735619,108241,125162599,4796,573020,90795,16,117768,2473,0,518,144444.0,43333.0,-67.0,-72.0,-65.0,-71.0,-66.0,-71.0,-65.0,-70.0,-82.0,-89.0,-82.0,-88.0,15.0,17.0,17.0,17.0,1
2810,CC:2F:71:3E:C5:1F,3224854,407280900,11386,1392914,3213468,405887986,6,48612,4071032,40175,3071312,8437,999720,12006,34,16350,186,6,825,144444.0,43333.0,-69.0,-71.0,-67.0,-60.0,-69.0,-70.0,-67.0,-60.0,-82.0,-89.0,-82.0,-88.0,13.0,18.0,15.0,28.0,1
2811,CC:2F:71:3F:1F:24,8360837,8255833089,5147369,7849945103,3213468,405887986,80,1208105,751356759,1199578,750332733,8527,1024026,1155024,619,5152067,525984,80,5738,130000.0,43333.0,-70.0,-65.0,-72.0,-71.0,-69.0,-65.0,-73.0,-71.0,-82.0,-89.0,-82.0,-88.0,12.0,24.0,10.0,17.0,1
2812,F8:59:71:5A:E0:3D,3328595,573118148,115123,167229758,3213472,405888390,0,113106,125840445,108310,125267425,4796,573020,90864,16,117837,2473,0,518,144444.0,43333.0,-66.0,-72.0,-65.0,-70.0,-66.0,-72.0,-65.0,-70.0,-82.0,-89.0,-82.0,-88.0,16.0,17.0,17.0,18.0,1
2813,CC:2F:71:3E:C5:1F,3224858,407281304,11386,1392914,3213472,405888390,6,48612,4071032,40175,3071312,8437,999720,12006,34,16350,186,6,825,144444.0,43333.0,-69.0,-71.0,-67.0,-60.0,-69.0,-70.0,-67.0,-60.0,-82.0,-89.0,-82.0,-88.0,13.0,18.0,15.0,28.0,1
2814,CC:2F:71:3F:1F:24,8361885,8257434673,5148413,7851546283,3213472,405888390,80,1208389,751570527,1199862,750546501,8527,1024026,1155307,619,5153131,526246,80,5739,115556.0,28889.0,-69.0,-65.0,-71.0,-70.0,-68.0,-64.0,-71.0,-70.0,-82.0,-89.0,-82.0,-88.0,13.0,24.0,11.0,18.0,1
2815,F8:59:71:5A:E0:3D,3328666,573221176,115189,167332322,3213477,405888854,0,113172,125942085,108376,125369065,4796,573020,90930,16,117903,2473,0,518,144444.0,43333.0,-66.0,-72.0,-65.0,-71.0,-66.0,-72.0,-65.0,-70.0,-82.0,-89.0,-82.0,-88.0,16.0,17.0,17.0,17.0,1
2816,CC:2F:71:3E:C5:1F,3224863,407281768,11386,1392914,3213477,405888854,6,48612,4071032,40175,3071312,8437,999720,12006,34,16350,186,6,825,144444.0,43333.0,-69.0,-71.0,-67.0,-60.0,-69.0,-70.0,-67.0,-60.0,-82.0,-89.0,-82.0,-88.0,13.0,18.0,15.0,28.0,1
2817,CC:2F:71:3F:1F:24,8363140,8259360791,5149663,7853471937,3213477,405888854,80,1208750,751804523,1200223,750780497,8527,1024026,1155668,619,5154375,526923,80,5739,78000.0,13000.0,-69.0,-65.0,-72.0,-70.0,-69.0,-64.0,-71.0,-70.0,-82.0,-89.0,-82.0,-88.0,13.0,24.0,10.0,18.0,1
2818,F8:59:71:5A:E0:3D,3328737,573325698,115256,167436440,3213481,405889258,0,113239,126045265,108443,125472245,4796,573020,90997,16,117970,2473,0,518,144444.0,43333.0,-66.0,-72.0,-66.0,-71.0,-66.0,-72.0,-65.0,-70.0,-82.0,-89.0,-82.0,-88.0,16.0,17.0,16.0,17.0,1
2819,CC:2F:71:3E:C5:1F,3224867,407282172,11386,1392914,3213481,405889258,6,48612,4071032,40175,3071312,8437,999720,12006,34,16350,186,6,825,144444.0,43333.0,-69.0,-71.0,-67.0,-60.0,-69.0,-70.0,-67.0,-60.0,-82.0,-89.0,-82.0,-88.0,13.0,18.0,15.0,28.0,1
2820,CC:2F:71:3F:1F:24,8364651,8261694897,5151170,7855805639,3213481,405889258,80,1209128,752040639,1200601,751016613,8527,1024026,1156046,619,5155889,526959,80,5739,86667.0,14444.0,-68.0,-65.0,-72.0,-68.0,-68.0,-64.0,-72.0,-67.0,-82.0,-89.0,-82.0,-88.0,14.0,24.0,10.0,20.0,1
2821,F8:59:71:5A:E0:3D,3328804,573426910,115321,167537450,3213483,405889460,0,113302,126142285,108506,125569265,4796,573020,91060,16,118035,2476,0,518,144444.0,43333.0,-66.0,-72.0,-65.0,-71.0,-66.0,-72.0,-64.0,-71.0,-82.0,-89.0,-82.0,-88.0,16.0,17.0,17.0,17.0,1
2822,CC:2F:71:3E:C5:1F,3224871,407282576,11386,1392914,3213485,405889662,6,48612,4071032,40175,3071312,8437,999720,12006,34,16350,186,6,825,144444.0,43333.0,-69.0,-71.0,-67.0,-60.0,-69.0,-70.0,-67.0,-60.0,-82.0,-89.0,-82.0,-88.0,13.0,18.0,15.0,28.0,1
2823,CC:2F:71:3F:1F:24,8365853,8263532563,5152368,7857642901,3213485,405889662,80,1209467,752271330,1200940,751247304,8527,1024026,1156385,619,5157087,526986,80,5739,117000.0,39000.0,-67.0,-64.0,-73.0,-68.0,-67.0,-64.0,-72.0,-68.0,-82.0,-89.0,-82.0,-88.0,15.0,25.0,9.0,20.0,1
2824,F8:59:71:5A:E0:3D,3328876,573528586,115386,167638460,3213490,405890126,0,113369,126245535,108573,125672515,4796,573020,91127,16,118100,2476,0,518,144444.0,43333.0,-66.0,-72.0,-65.0,-71.0,-66.0,-72.0,-64.0,-71.0,-82.0,-89.0,-82.0,-88.0,16.0,17.0,17.0,17.0,1
2825,CC:2F:71:3E:C5:1F,3224876,407283040,11386,1392914,3213490,405890126,6,48612,4071032,40175,3071312,8437,999720,12006,34,16350,186,6,825,144444.0,43333.0,-69.0,-71.0,-67.0,-60.0,-69.0,-70.0,-67.0,-60.0,-82.0,-89.0,-82.0,-88.0,13.0,18.0,15.0,28.0,1
2826,CC:2F:71:3F:1F:24,8367166,8265553363,5153676,7859663237,3213490,405890126,80,1209787,752493386,1201260,751469360,8527,1024026,1156705,619,5158395,527288,80,5740,130000.0,43333.0,-68.0,-64.0,-73.0,-68.0,-67.0,-64.0,-73.0,-68.0,-82.0,-89.0,-82.0,-88.0,14.0,25.0,9.0,20.0,1
2827,F8:59:71:5A:E0:3D,3328943,573629798,115451,167739470,3213492,405890328,0,113434,126345635,108638,125772615,4796,573020,91192,16,118165,2476,0,518,144444.0,43333.0,-66.0,-72.0,-65.0,-71.0,-66.0,-72.0,-65.0,-71.0,-82.0,-89.0,-82.0,-88.0,16.0,17.0,17.0,17.0,1
2828,CC:2F:71:3E:C5:1F,3224878,407283242,11386,1392914,3213492,405890328,6,48612,4071032,40175,3071312,8437,999720,12006,34,16350,186,6,825,144444.0,43333.0,-69.0,-71.0,-67.0,-60.0,-69.0,-70.0,-67.0,-60.0,-82.0,-89.0,-82.0,-88.0,13.0,18.0,15.0,28.0,1
2829,CC:2F:71:3F:1F:24,8368377,8267416853,5154883,7861526323,3213494,405890530,80,1210087,752706344,1201560,751682318,8527,1024026,1157005,619,5159601,527383,80,5742,130000.0,43333.0,-68.0,-64.0,-73.0,-68.0,-68.0,-64.0,-72.0,-68.0,-82.0,-89.0,-82.0,-88.0,14.0,25.0,9.0,20.0,1
2830,F8:59:71:5A:E0:3D,3329012,573731212,115516,167840480,3213496,405890732,0,113500,126447289,108704,125874269,4796,573020,91257,16,118230,2476,0,518,144444.0,43333.0,-66.0,-72.0,-65.0,-71.0,-66.0,-72.0,-65.0,-70.0,-82.0,-89.0,-82.0,-88.0,16.0,17.0,17.0,17.0,1
2831,CC:2F:71:3E:C5:1F,3224885,407283908,11386,1392914,3213499,405890994,6,48612,4071032,40175,3071312,8437,999720,12006,34,16350,186,6,825,144444.0,43333.0,-69.0,-71.0,-67.0,-60.0,-69.0,-70.0,-67.0,-60.0,-82.0,-89.0,-82.0,-88.0,13.0,18.0,15.0,28.0,1
2832,CC:2F:71:3F:1F:24,8369593,8269284331,5156094,7863393337,3213499,405890994,80,1210381,752935702,1201854,751911676,8527,1024026,1157298,619,5160813,527793,80,5742,130000.0,43333.0,-69.0,-65.0,-74.0,-69.0,-69.0,-65.0,-73.0,-69.0,-82.0,-89.0,-82.0,-88.0,13.0,24.0,8.0,19.0,1
2833,F8:59:71:5A:E0:3D,3329083,573834240,115582,167943044,3213501,405891196,0,113567,126550483,108771,125977463,4796,573020,91323,16,118296,2478,0,518,144444.0,43333.0,-66.0,-72.0,-65.0,-71.0,-66.0,-72.0,-65.0,-71.0,-82.0,-89.0,-82.0,-88.0,16.0,17.0,17.0,17.0,1
2834,CC:2F:71:3E:C5:1F,3224887,407284110,11386,1392914,3213501,405891196,6,48612,4071032,40175,3071312,8437,999720,12006,34,16350,186,6,825,144444.0,43333.0,-69.0,-71.0,-67.0,-60.0,-69.0,-70.0,-67.0,-60.0,-82.0,-89.0,-82.0,-88.0,13.0,18.0,15.0,28.0,1
2835,CC:2F:71:3F:1F:24,8370581,8270792212,5157080,7864901016,3213501,405891196,80,1210670,753161929,1202143,752137903,8527,1024026,1157587,619,5161798,527975,80,5742,115556.0,28889.0,-68.0,-64.0,-74.0,-68.0,-68.0,-64.0,-73.0,-68.0,-82.0,-89.0,-82.0,-88.0,14.0,25.0,8.0,20.0,1
2836,F8:59:71:5A:E0:3D,3329152,573937279,115648,168045608,3213504,405891671,0,113634,126653747,108838,126080727,4796,573020,91390,16,118362,2480,0,518,144444.0,43333.0,-67.0,-72.0,-64.0,-71.0,-66.0,-72.0,-64.0,-71.0,-82.0,-89.0,-82.0,-88.0,15.0,17.0,18.0,17.0,1
2837,CC:2F:71:3E:C5:1F,3224892,407284787,11386,1392914,3213506,405891873,6,48612,4071032,40175,3071312,8437,999720,12006,34,16350,186,6,825,144444.0,43333.0,-69.0,-71.0,-67.0,-60.0,-69.0,-70.0,-67.0,-60.0,-82.0,-89.0,-82.0,-88.0,13.0,18.0,15.0,28.0,1
2838,CC:2F:71:3F:1F:24,8371826,8272703575,5158318,7866811500,3213508,405892075,80,1210949,753377871,1202422,752353845,8527,1024026,1157866,619,5163037,528017,80,5742,115556.0,28889.0,-68.0,-64.0,-73.0,-68.0,-68.0,-64.0,-73.0,-68.0,-82.0,-89.0,-82.0,-88.0,14.0,25.0,9.0,20.0,1
2839,F8:59:71:5A:E0:3D,3329224,574038955,115713,168146618,3213511,405892337,0,113699,126753861,108903,126180841,4796,573020,91454,16,118427,2481,0,518,144444.0,43333.0,-66.0,-72.0,-65.0,-71.0,-66.0,-72.0,-65.0,-71.0,-82.0,-89.0,-82.0,-88.0,16.0,17.0,17.0,17.0,1
2840,CC:2F:71:3E:C5:1F,3224897,407285251,11386,1392914,3213511,405892337,6,48612,4071032,40175,3071312,8437,999720,12006,34,16350,186,6,825,144444.0,43333.0,-69.0,-71.0,-67.0,-60.0,-69.0,-70.0,-67.0,-60.0,-82.0,-89.0,-82.0,-88.0,13.0,18.0,15.0,28.0,1
2841,CC:2F:71:3F:1F:24,8373269,8274932165,5159758,7869039828,3213511,405892337,80,1211275,753603707,1202748,752579681,8527,1024026,1158192,619,5164477,528447,80,5743,130000.0,43333.0,-69.0,-65.0,-73.0,-69.0,-69.0,-65.0,-73.0,-69.0,-82.0,-89.0,-82.0,-88.0,13.0,24.0,9.0,19.0,1
2842,F8:59:71:5A:E0:3D,3329290,574138501,115777,168245962,3213513,405892539,0,113764,126853975,108968,126280955,4796,573020,91518,16,118491,2481,0,518,144444.0,39000.0,-66.0,-72.0,-65.0,-71.0,-66.0,-71.0,-65.0,-70.0,-82.0,-89.0,-82.0,-88.0,16.0,17.0,17.0,17.0,1
2843,CC:2F:71:3E:C5:1F,3224899,407285453,11386,1392914,3213513,405892539,6,48612,4071032,40175,3071312,8437,999720,12006,34,16350,186,6,825,144444.0,43333.0,-69.0,-71.0,-67.0,-60.0,-69.0,-70.0,-67.0,-60.0,-82.0,-89.0,-82.0,-88.0,13.0,18.0,15.0,28.0,1
2844,CC:2F:71:3F:1F:24,8374247,8276430839,5160734,7870538300,3213513,405892539,80,1211557,753817105,1203030,752793079,8527,1024026,1158474,619,5165453,528619,80,5744,130000.0,43333.0,-69.0,-65.0,-73.0,-69.0,-68.0,-64.0,-73.0,-68.0,-82.0,-89.0,-82.0,-88.0,13.0,24.0,9.0,19.0,1
2845,F8:59:71:5A:E0:3D,3329357,574236751,115840,168343808,3213517,405892943,0,113827,126950995,109031,126377975,4796,573020,91581,16,118554,2481,0,518,144444.0,43333.0,-66.0,-72.0,-65.0,-71.0,-66.0,-72.0,-65.0,-71.0,-82.0,-89.0,-82.0,-88.0,16.0,17.0,17.0,17.0,1
2846,CC:2F:71:3E:C5:1F,3224905,407286059,11386,1392914,3213519,405893145,6,48612,4071032,40175,3071312,8437,999720,12006,34,16350,186,6,825,144444.0,43333.0,-69.0,-71.0,-67.0,-60.0,-69.0,-70.0,-67.0,-60.0,-82.0,-89.0,-82.0,-88.0,13.0,18.0,15.0,28.0,1
2847,CC:2F:71:3F:1F:24,8375586,8278481246,5162067,7872588101,3213519,405893145,80,1211895,754044738,1203368,753020712,8527,1024026,1158809,619,5166786,529052,80,5744,117000.0,39000.0,-69.0,-65.0,-73.0,-69.0,-68.0,-64.0,-73.0,-68.0,-82.0,-89.0,-82.0,-88.0,13.0,24.0,9.0,19.0,1
2848,F8:59:71:5A:E0:3D,3329429,574341333,115907,168447926,3213522,405893407,0,113894,127054175,109098,126481155,4796,573020,91648,16,118621,2481,0,518,144444.0,43333.0,-66.0,-72.0,-65.0,-71.0,-66.0,-72.0,-64.0,-71.0,-82.0,-89.0,-82.0,-88.0,16.0,17.0,17.0,17.0,1
2849,CC:2F:71:3E:C5:1F,3224908,407286321,11386,1392914,3213522,405893407,6,48612,4071032,40175,3071312,8437,999720,12006,34,16350,186,6,825,144444.0,43333.0,-69.0,-71.0,-67.0,-60.0,-69.0,-70.0,-67.0,-60.0,-82.0,-89.0,-82.0,-88.0,13.0,18.0,15.0,28.0,1
2850,CC:2F:71:3F:1F:24,8376881,8280476972,5163359,7874583565,3213522,405893407,80,1212224,754269430,1203697,753245404,8527,1024026,1159138,619,5168070,529286,80,5745,130000.0,43333.0,-68.0,-64.0,-73.0,-68.0,-68.0,-64.0,-73.0,-68.0,-82.0,-89.0,-82.0,-88.0,14.0,25.0,9.0,20.0,1
2851,F8:59:71:5A:E0:3D,3329498,574442747,115972,168548936,3213526,405893811,0,113959,127154275,109163,126581255,4796,573020,91713,16,118686,2481,0,518,144444.0,43333.0,-66.0,-72.0,-65.0,-71.0,-66.0,-72.0,-65.0,-71.0,-82.0,-89.0,-81.0,-88.0,16.0,17.0,16.0,17.0,1
2852,CC:2F:71:3E:C5:1F,3224912,407286725,11386,1392914,3213526,405893811,6,48612,4071032,40175,3071312,8437,999720,12006,34,16350,186,6,825,144444.0,43333.0,-69.0,-71.0,-67.0,-60.0,-69.0,-70.0,-67.0,-60.0,-82.0,-89.0,-81.0,-88.0,13.0,18.0,14.0,28.0,1
2853,CC:2F:71:3F:1F:24,8378102,8282354746,5164576,7876460935,3213526,405893811,80,1212522,754486100,1203995,753462074,8527,1024026,1159436,619,5169265,529484,80,5745,130000.0,43333.0,-68.0,-64.0,-72.0,-69.0,-67.0,-64.0,-72.0,-68.0,-82.0,-89.0,-81.0,-88.0,14.0,25.0,9.0,19.0,1
2854,F8:59:71:5A:E0:3D,3329568,574541537,116036,168646954,3213532,405894583,0,114022,127251295,109226,126678275,4796,573020,91776,16,118750,2481,0,518,144444.0,43333.0,-66.0,-72.0,-64.0,-71.0,-66.0,-71.0,-64.0,-70.0,-82.0,-89.0,-81.0,-88.0,16.0,17.0,17.0,17.0,1
2855,CC:2F:71:3E:C5:1F,3224919,407287613,11387,1393030,3213532,405894583,6,48614,4071172,40177,3071452,8437,999720,12006,34,16351,186,6,825,130000.0,39000.0,-70.0,-70.0,-67.0,-61.0,-69.0,-70.0,-67.0,-60.0,-82.0,-89.0,-81.0,-88.0,12.0,19.0,14.0,27.0,1
2856,CC:2F:71:3F:1F:24,8379540,8284568960,5166008,7878674377,3213532,405894583,80,1212863,754719596,1204336,753695570,8527,1024026,1159777,619,5170727,529946,80,5748,130000.0,43333.0,-68.0,-64.0,-73.0,-68.0,-67.0,-64.0,-71.0,-68.0,-82.0,-89.0,-81.0,-88.0,14.0,25.0,8.0,20.0,1
2857,F8:59:71:5A:E0:3D,3329640,574646119,116103,168751072,3213537,405895047,0,114089,127354475,109293,126781455,4796,573020,91843,16,118817,2481,0,518,144444.0,43333.0,-68.0,-73.0,-65.0,-71.0,-66.0,-72.0,-65.0,-71.0,-82.0,-89.0,-81.0,-88.0,14.0,16.0,16.0,17.0,1
2858,CC:2F:71:3E:C5:1F,3224924,407288077,11387,1393030,3213537,405895047,6,48614,4071172,40177,3071452,8437,999720,12006,34,16351,186,6,825,130000.0,39000.0,-70.0,-70.0,-67.0,-61.0,-69.0,-70.0,-67.0,-60.0,-82.0,-89.0,-81.0,-88.0,12.0,19.0,14.0,27.0,1
2859,CC:2F:71:3F:1F:24,8380930,8286711626,5167393,7880816579,3213537,405895047,80,1213190,754941114,1204663,753917088,8527,1024026,1160104,619,5172086,530226,80,5748,130000.0,43333.0,-68.0,-64.0,-72.0,-69.0,-67.0,-64.0,-72.0,-68.0,-82.0,-89.0,-81.0,-88.0,14.0,25.0,9.0,19.0,1
2860,F8:59:71:5A:E0:3D,3329708,574745979,116167,168850528,3213541,405895451,0,114154,127454575,109358,126881555,4796,573020,91908,16,118881,2481,0,518,144444.0,43333.0,-66.0,-72.0,-64.0,-71.0,-66.0,-72.0,-64.0,-70.0,-82.0,-89.0,-81.0,-88.0,16.0,17.0,17.0,17.0,1
2861,CC:2F:71:3E:C5:1F,3224928,407288481,11387,1393030,3213541,405895451,6,48614,4071172,40177,3071452,8437,999720,12006,34,16351,186,6,825,130000.0,39000.0,-70.0,-70.0,-67.0,-61.0,-69.0,-70.0,-67.0,-60.0,-82.0,-89.0,-81.0,-88.0,12.0,19.0,14.0,27.0,1
2862,CC:2F:71:3F:1F:24,8381901,8288187277,5168360,7882291826,3213541,405895451,80,1213481,755157601,1204954,754133575,8527,1024026,1160391,619,5173070,530349,80,5748,130000.0,43333.0,-68.0,-64.0,-73.0,-68.0,-67.0,-64.0,-72.0,-68.0,-82.0,-89.0,-81.0,-88.0,14.0,25.0,8.0,20.0,1
2863,F8:59:71:5A:E0:3D,3329776,574844401,116231,168948546,3213545,405895855,0,114218,127551701,109422,126978681,4796,573020,91972,16,118945,2483,0,518,144444.0,43333.0,-66.0,-72.0,-65.0,-71.0,-66.0,-71.0,-64.0,-70.0,-82.0,-89.0,-81.0,-88.0,16.0,17.0,16.0,17.0,1
2864,CC:2F:71:3E:C5:1F,3224932,407288885,11387,1393030,3213545,405895855,6,48614,4071172,40177,3071452,8437,999720,12006,34,16351,186,6,825,130000.0,39000.0,-70.0,-70.0,-67.0,-61.0,-69.0,-70.0,-67.0,-60.0,-82.0,-89.0,-81.0,-88.0,12.0,19.0,14.0,27.0,1
2865,CC:2F:71:3F:1F:24,8383022,8289907013,5169477,7884011158,3213545,405895855,80,1213781,755376031,1205254,754352005,8527,1024026,1160688,619,5174194,530556,80,5748,130000.0,43333.0,-67.0,-64.0,-70.0,-68.0,-67.0,-64.0,-72.0,-68.0,-82.0,-89.0,-81.0,-88.0,15.0,25.0,11.0,20.0,1
2866,F8:59:71:5A:E0:3D,3329845,574944321,116295,169048002,3213550,405896319,0,114281,127648721,109485,127075701,4796,573020,92035,16,119009,2483,0,518,144444.0,43333.0,-66.0,-72.0,-65.0,-71.0,-66.0,-72.0,-64.0,-71.0,-82.0,-89.0,-81.0,-88.0,16.0,17.0,16.0,17.0,1
2867,CC:2F:71:3E:C5:1F,3224937,407289349,11387,1393030,3213550,405896319,6,48614,4071172,40177,3071452,8437,999720,12006,34,16351,186,6,825,130000.0,39000.0,-70.0,-70.0,-67.0,-61.0,-69.0,-70.0,-67.0,-60.0,-82.0,-89.0,-81.0,-88.0,12.0,19.0,14.0,27.0,1
2868,CC:2F:71:3F:1F:24,8384484,8292164495,5170934,7886268176,3213550,405896319,80,1214124,755602571,1205597,754578545,8527,1024026,1161030,619,5175642,530938,80,5749,130000.0,43333.0,-68.0,-65.0,-73.0,-69.0,-68.0,-64.0,-72.0,-68.0,-82.0,-89.0,-81.0,-88.0,14.0,24.0,8.0,19.0,1
2869,F8:59:71:5A:E0:3D,3329914,575045623,116360,169148900,3213554,405896723,0,114347,127750375,109551,127177355,4796,573020,92100,16,119074,2484,0,518,144444.0,43333.0,-66.0,-72.0,-65.0,-71.0,-66.0,-72.0,-64.0,-71.0,-82.0,-89.0,-81.0,-88.0,16.0,17.0,16.0,17.0,1
2870,CC:2F:71:3E:C5:1F,3224941,407289753,11387,1393030,3213554,405896723,6,48614,4071172,40177,3071452,8437,999720,12006,34,16351,186,6,825,130000.0,39000.0,-70.0,-70.0,-67.0,-61.0,-69.0,-70.0,-67.0,-60.0,-82.0,-89.0,-81.0,-88.0,12.0,19.0,14.0,27.0,1
2871,CC:2F:71:3F:1F:24,8385671,8293988345,5172117,7888091622,3213554,405896723,80,1214431,755823861,1205904,754799835,8527,1024026,1161332,619,5176809,531299,80,5752,130000.0,43333.0,-69.0,-64.0,-75.0,-69.0,-68.0,-64.0,-73.0,-69.0,-82.0,-89.0,-81.0,-88.0,13.0,25.0,6.0,19.0,1
2872,F8:59:71:5A:E0:3D,3329994,575152461,116425,169249910,3213569,405902551,0,114414,127853569,109618,127280549,4796,573020,92166,16,119139,2486,0,518,144444.0,43333.0,-66.0,-72.0,-65.0,-71.0,-66.0,-72.0,-65.0,-71.0,-81.0,-89.0,-81.0,-88.0,15.0,17.0,16.0,17.0,1
2873,CC:2F:71:3E:C5:1F,3224957,407295641,11387,1393030,3213570,405902611,6,48614,4071172,40177,3071452,8437,999720,12006,34,16351,186,6,825,130000.0,39000.0,-70.0,-70.0,-67.0,-61.0,-69.0,-70.0,-67.0,-60.0,-81.0,-89.0,-81.0,-88.0,11.0,19.0,14.0,27.0,1
2874,CC:2F:71:3F:1F:24,8386772,8295655324,5173202,7889752713,3213570,405902611,80,1214749,756064995,1206222,755040969,8527,1024026,1161650,619,5177920,531434,80,5753,130000.0,43333.0,-69.0,-64.0,-75.0,-69.0,-68.0,-64.0,-73.0,-69.0,-81.0,-89.0,-81.0,-88.0,12.0,25.0,6.0,19.0,1
2875,F8:59:71:5A:E0:3D,3330078,575266927,116495,169358690,3213583,405908237,0,114483,127959829,109687,127386809,4796,573020,92235,16,119209,2487,0,518,144444.0,43333.0,-66.0,-71.0,-65.0,-71.0,-66.0,-71.0,-65.0,-71.0,-81.0,-89.0,-81.0,-88.0,15.0,18.0,16.0,17.0,1
2876,CC:2F:71:3E:C5:1F,3224970,407301267,11387,1393030,3213583,405908237,6,48614,4071172,40177,3071452,8437,999720,12006,34,16351,186,6,825,130000.0,39000.0,-70.0,-70.0,-67.0,-61.0,-69.0,-70.0,-67.0,-60.0,-81.0,-89.0,-81.0,-88.0,11.0,19.0,14.0,27.0,1
2877,CC:2F:71:3F:1F:24,8387986,8297511270,5174401,7891602831,3213585,405908439,80,1215019,756282791,1206492,755258765,8527,1024026,1161920,619,5179120,531647,80,5754,130000.0,43333.0,-68.0,-64.0,-74.0,-69.0,-67.0,-64.0,-72.0,-68.0,-81.0,-89.0,-81.0,-88.0,13.0,25.0,7.0,19.0,1
2878,F8:59:71:5A:E0:3D,3330149,575367262,116559,169458146,3213590,405909116,0,114548,128059943,109752,127486923,4796,573020,92299,16,119273,2487,0,518,144444.0,43333.0,-66.0,-72.0,-65.0,-71.0,-66.0,-71.0,-64.0,-70.0,-81.0,-89.0,-81.0,-88.0,15.0,17.0,16.0,17.0,1
2879,CC:2F:71:3E:C5:1F,3224977,407302146,11387,1393030,3213590,405909116,6,48614,4071172,40177,3071452,8437,999720,12006,34,16351,186,6,825,130000.0,39000.0,-70.0,-70.0,-67.0,-61.0,-69.0,-70.0,-67.0,-60.0,-81.0,-89.0,-81.0,-88.0,11.0,19.0,14.0,27.0,1
2880,CC:2F:71:3F:1F:24,8389277,8299497999,5175687,7893588883,3213590,405909116,80,1215378,756512467,1206851,755488441,8527,1024026,1162264,619,5180406,531785,80,5754,130000.0,43333.0,-67.0,-64.0,-72.0,-70.0,-67.0,-64.0,-72.0,-69.0,-81.0,-89.0,-81.0,-88.0,14.0,25.0,9.0,18.0,1
2881,F8:59:71:5A:E0:3D,3330214,575466778,116623,169557602,3213591,405909176,0,114612,128158503,109816,127585483,4796,573020,92363,16,119337,2487,0,518,144444.0,43333.0,-66.0,-72.0,-65.0,-70.0,-66.0,-72.0,-65.0,-70.0,-81.0,-89.0,-81.0,-88.0,15.0,17.0,16.0,18.0,1
2882,CC:2F:71:3E:C5:1F,3224981,407302470,11387,1393030,3213594,405909440,6,48615,4071290,40177,3071452,8438,999838,12007,34,16351,186,6,825,130000.0,39000.0,-71.0,-70.0,-67.0,-60.0,-69.0,-70.0,-67.0,-60.0,-81.0,-89.0,-81.0,-88.0,10.0,19.0,14.0,28.0,1
2883,CC:2F:71:3F:1F:24,8390413,8301241467,5176819,7895332027,3213594,405909440,80,1215652,756739339,1207125,755715313,8527,1024026,1162530,619,5181538,531904,80,5754,130000.0,43333.0,-69.0,-64.0,-73.0,-70.0,-68.0,-64.0,-72.0,-70.0,-81.0,-89.0,-81.0,-88.0,12.0,25.0,8.0,18.0,1
2884,F8:59:71:5A:E0:3D,3330284,575565348,116686,169655504,3213598,405909844,0,114675,128255523,109879,127682503,4796,573020,92426,16,119400,2488,0,518,144444.0,43333.0,-67.0,-72.0,-65.0,-71.0,-67.0,-71.0,-65.0,-71.0,-81.0,-89.0,-81.0,-88.0,14.0,17.0,16.0,17.0,1
2885,CC:2F:71:3E:C5:1F,3224987,407303076,11387,1393030,3213600,405910046,6,48616,4071360,40178,3071522,8438,999838,12007,34,16351,186,6,825,130000.0,39000.0,-70.0,-70.0,-67.0,-61.0,-69.0,-70.0,-67.0,-60.0,-81.0,-89.0,-81.0,-88.0,11.0,19.0,14.0,27.0,1
2886,CC:2F:71:3F:1F:24,8391545,8302969427,5177944,7897059319,3213601,405910108,80,1215935,756959091,1207407,755934947,8528,1024144,1162807,619,5182663,532046,80,5754,130000.0,43333.0,-67.0,-64.0,-73.0,-69.0,-67.0,-64.0,-73.0,-69.0,-81.0,-89.0,-81.0,-88.0,14.0,25.0,8.0,19.0,1
2887,F8:59:71:5A:E0:3D,3330351,575665068,116750,169754960,3213601,405910108,0,114741,128357191,109945,127784171,4796,573020,92490,16,119464,2489,0,518,144444.0,43333.0,-67.0,-72.0,-65.0,-72.0,-67.0,-72.0,-65.0,-71.0,-81.0,-89.0,-81.0,-88.0,14.0,17.0,16.0,16.0,1
2888,CC:2F:71:3E:C5:1F,3224988,407303138,11387,1393030,3213601,405910108,6,48616,4071360,40178,3071522,8438,999838,12007,34,16351,186,6,825,130000.0,39000.0,-70.0,-70.0,-67.0,-61.0,-69.0,-70.0,-67.0,-60.0,-81.0,-89.0,-81.0,-88.0,11.0,19.0,14.0,27.0,1
2889,CC:2F:71:3F:1F:24,8392377,8304239019,5178776,7898328911,3213601,405910108,80,1216201,757176609,1207673,756152465,8528,1024144,1163065,619,5183474,532106,80,5754,130000.0,43333.0,-68.0,-64.0,-72.0,-69.0,-67.0,-64.0,-73.0,-68.0,-81.0,-89.0,-81.0,-88.0,13.0,25.0,9.0,19.0,1
2890,F8:59:71:5A:E0:3D,3330419,575763434,116813,169852862,3213606,405910572,0,114804,128454211,110008,127881191,4796,573020,92553,16,119527,2490,0,518,144444.0,43333.0,-67.0,-72.0,-65.0,-71.0,-66.0,-72.0,-65.0,-71.0,-81.0,-89.0,-81.0,-88.0,14.0,17.0,16.0,17.0,1
2891,CC:2F:71:3E:C5:1F,3224993,407303602,11387,1393030,3213606,405910572,6,48616,4071360,40178,3071522,8438,999838,12007,34,16351,186,6,825,130000.0,39000.0,-70.0,-70.0,-67.0,-61.0,-69.0,-70.0,-67.0,-60.0,-81.0,-89.0,-81.0,-88.0,11.0,19.0,14.0,27.0,1
2892,CC:2F:71:3F:1F:24,8393386,8305770646,5179780,7899860074,3213606,405910572,80,1216495,757330544,1207967,756306400,8528,1024144,1163351,619,5184499,532208,80,5754,130000.0,43333.0,-68.0,-64.0,-74.0,-69.0,-67.0,-64.0,-73.0,-69.0,-81.0,-89.0,-81.0,-88.0,13.0,25.0,7.0,19.0,1
2893,F8:59:71:5A:E0:3D,3330487,575861802,116876,169950764,3213611,405911038,0,114869,128552903,110072,127979765,4797,573138,92617,16,119590,2491,0,518,144444.0,43333.0,-67.0,-72.0,-65.0,-71.0,-66.0,-72.0,-65.0,-71.0,-81.0,-89.0,-81.0,-88.0,14.0,17.0,16.0,17.0,1
2894,CC:2F:71:3E:C5:1F,3224998,407304068,11387,1393030,3213611,405911038,6,48616,4071360,40178,3071522,8438,999838,12007,34,16351,186,6,825,130000.0,39000.0,-70.0,-70.0,-67.0,-61.0,-69.0,-70.0,-67.0,-60.0,-81.0,-89.0,-81.0,-88.0,11.0,19.0,14.0,27.0,1
2895,CC:2F:71:3F:1F:24,8394537,8307538836,5180926,7901627798,3213611,405911038,80,1216743,757465982,1208215,756441838,8528,1024144,1163590,619,5185645,532404,80,5754,130000.0,43333.0,-68.0,-64.0,-72.0,-69.0,-67.0,-64.0,-72.0,-69.0,-81.0,-89.0,-81.0,-88.0,13.0,25.0,9.0,19.0,1
2896,F8:59:71:5A:E0:3D,3330559,575967878,116944,170056436,3213615,405911442,0,114937,128657693,110140,128084555,4797,573138,92685,16,119658,2493,0,520,144444.0,43333.0,-67.0,-72.0,-65.0,-71.0,-66.0,-71.0,-65.0,-71.0,-81.0,-88.0,-81.0,-88.0,14.0,16.0,16.0,17.0,1
2897,CC:2F:71:3E:C5:1F,3225002,407304472,11387,1393030,3213615,405911442,6,48616,4071360,40178,3071522,8438,999838,12007,34,16351,186,6,825,130000.0,39000.0,-70.0,-70.0,-67.0,-61.0,-69.0,-70.0,-67.0,-60.0,-81.0,-88.0,-81.0,-88.0,11.0,18.0,14.0,27.0,1
2898,CC:2F:71:3F:1F:24,8395768,8309426351,5182153,7903514909,3213615,405911442,80,1216998,757587193,1208470,756563049,8528,1024144,1163840,619,5186872,532526,80,5754,130000.0,43333.0,-68.0,-64.0,-72.0,-69.0,-67.0,-64.0,-72.0,-69.0,-81.0,-88.0,-81.0,-88.0,13.0,24.0,9.0,19.0,1
2899,F8:59:71:5A:E0:3D,3330627,576066244,117007,170154338,3213620,405911906,0,115001,128756267,110204,128183129,4797,573138,92748,16,119721,2494,0,520,144444.0,43333.0,-67.0,-72.0,-65.0,-71.0,-66.0,-71.0,-65.0,-71.0,-81.0,-88.0,-81.0,-88.0,14.0,16.0,16.0,17.0,1
2900,CC:2F:71:3E:C5:1F,3225007,407304936,11387,1393030,3213620,405911906,6,48616,4071360,40178,3071522,8438,999838,12007,34,16351,186,6,825,130000.0,39000.0,-70.0,-70.0,-67.0,-61.0,-69.0,-70.0,-67.0,-60.0,-81.0,-88.0,-81.0,-88.0,11.0,18.0,14.0,27.0,1
2901,CC:2F:71:3F:1F:24,8397174,8311596025,5183554,7905684119,3213620,405911906,80,1217276,757711861,1208748,756687717,8528,1024144,1164118,619,5188273,532660,80,5754,130000.0,43333.0,-67.0,-64.0,-72.0,-69.0,-67.0,-64.0,-72.0,-69.0,-81.0,-88.0,-81.0,-88.0,14.0,24.0,9.0,19.0,1
2902,F8:59:71:5A:E0:3D,3330694,576164550,117070,170252240,3213624,405912310,0,115066,128856395,110269,128283257,4797,573138,92811,16,119784,2494,0,520,144444.0,43333.0,-66.0,-72.0,-65.0,-71.0,-66.0,-72.0,-65.0,-71.0,-81.0,-88.0,-81.0,-88.0,15.0,16.0,16.0,17.0,1
2903,CC:2F:71:3E:C5:1F,3225011,407305340,11387,1393030,3213624,405912310,6,48616,4071360,40178,3071522,8438,999838,12007,34,16351,186,6,825,130000.0,39000.0,-70.0,-70.0,-67.0,-61.0,-69.0,-70.0,-67.0,-60.0,-81.0,-88.0,-81.0,-88.0,11.0,18.0,14.0,27.0,1
2904,CC:2F:71:3F:1F:24,8398588,8313780977,5184964,7907868667,3213624,405912310,80,1217540,757833507,1209012,756809363,8528,1024144,1164382,619,5189648,532982,80,5754,117000.0,39000.0,-68.0,-64.0,-73.0,-69.0,-68.0,-64.0,-72.0,-69.0,-81.0,-88.0,-81.0,-88.0,13.0,24.0,8.0,19.0,1
2905,F8:59:71:5A:E0:3D,3330761,576262856,117133,170350142,3213628,405912714,0,115130,128954969,110333,128381831,4797,573138,92874,16,119847,2494,0,520,144444.0,43333.0,-66.0,-72.0,-65.0,-71.0,-66.0,-72.0,-65.0,-71.0,-81.0,-88.0,-81.0,-88.0,15.0,16.0,16.0,17.0,1
2906,CC:2F:71:3E:C5:1F,3225015,407305744,11387,1393030,3213628,405912714,6,48616,4071360,40178,3071522,8438,999838,12007,34,16351,186,6,825,130000.0,39000.0,-70.0,-70.0,-67.0,-61.0,-69.0,-70.0,-67.0,-60.0,-81.0,-88.0,-81.0,-88.0,11.0,18.0,14.0,27.0,1
2907,CC:2F:71:3F:1F:24,8399658,8315421873,5186030,7909509159,3213628,405912714,80,1217771,757951453,1209243,756927309,8528,1024144,1164613,619,5190724,533117,80,5756,130000.0,43333.0,-67.0,-64.0,-72.0,-69.0,-67.0,-64.0,-72.0,-69.0,-81.0,-88.0,-81.0,-88.0,14.0,24.0,9.0,19.0,1
2908,F8:59:71:5A:E0:3D,3330828,576359668,117195,170446490,3213633,405913178,0,115194,129053543,110397,128480405,4797,573138,92937,16,119909,2494,0,520,144444.0,43333.0,-66.0,-71.0,-65.0,-70.0,-66.0,-71.0,-64.0,-70.0,-81.0,-88.0,-81.0,-88.0,15.0,17.0,16.0,18.0,1
2909,CC:2F:71:3E:C5:1F,3225020,407306208,11387,1393030,3213633,405913178,6,48616,4071360,40178,3071522,8438,999838,12007,34,16351,186,6,825,130000.0,39000.0,-70.0,-70.0,-67.0,-61.0,-69.0,-70.0,-67.0,-60.0,-81.0,-88.0,-81.0,-88.0,11.0,18.0,14.0,27.0,1
2910,CC:2F:71:3F:1F:24,8401055,8317577369,5187422,7911664191,3213633,405913178,80,1218028,758073587,1209500,757049443,8528,1024144,1164870,619,5192141,533203,80,5756,130000.0,43333.0,-68.0,-64.0,-72.0,-70.0,-68.0,-64.0,-71.0,-69.0,-81.0,-88.0,-81.0,-88.0,13.0,24.0,9.0,18.0,1
2911,F8:59:71:5A:E0:3D,3330897,576460914,117260,170547332,3213637,405913582,0,115259,129153657,110462,128580519,4797,573138,93001,16,119974,2494,0,520,144444.0,43333.0,-67.0,-72.0,-64.0,-71.0,-66.0,-72.0,-64.0,-70.0,-81.0,-89.0,-81.0,-88.0,14.0,17.0,17.0,17.0,1
2912,CC:2F:71:3E:C5:1F,3225024,407306612,11387,1393030,3213637,405913582,6,48616,4071360,40178,3071522,8438,999838,12007,34,16351,186,6,825,130000.0,39000.0,-70.0,-70.0,-67.0,-61.0,-69.0,-70.0,-67.0,-60.0,-81.0,-89.0,-81.0,-88.0,11.0,19.0,14.0,27.0,1
2913,CC:2F:71:3F:1F:24,8402255,8319415446,5188618,7913501864,3213637,405913582,80,1218238,758190765,1209710,757166621,8528,1024144,1165080,619,5193337,533369,80,5757,130000.0,43333.0,-68.0,-64.0,-72.0,-71.0,-67.0,-64.0,-71.0,-71.0,-81.0,-89.0,-81.0,-88.0,13.0,25.0,9.0,17.0,1
2914,F8:59:71:5A:E0:3D,3330963,576560572,117324,170646788,3213639,405913784,0,115324,129253771,110527,128680633,4797,573138,93065,16,120038,2495,0,520,144444.0,43333.0,-67.0,-72.0,-65.0,-70.0,-66.0,-71.0,-64.0,-70.0,-81.0,-89.0,-81.0,-88.0,14.0,17.0,16.0,18.0,1
2915,CC:2F:71:3E:C5:1F,3225026,407306814,11387,1393030,3213639,405913784,6,48616,4071360,40178,3071522,8438,999838,12007,34,16351,186,6,825,130000.0,39000.0,-70.0,-70.0,-67.0,-61.0,-69.0,-70.0,-67.0,-60.0,-81.0,-89.0,-81.0,-88.0,11.0,19.0,14.0,27.0,1
2916,CC:2F:71:3F:1F:24,8403449,8321253138,5189809,7915339294,3213640,405913844,80,1218461,758306257,1209933,757282113,8528,1024144,1165303,619,5194516,533690,80,5757,130000.0,43333.0,-67.0,-64.0,-72.0,-71.0,-67.0,-64.0,-71.0,-70.0,-81.0,-89.0,-81.0,-88.0,14.0,25.0,9.0,17.0,1
2917,F8:59:71:5A:E0:3D,3331031,576658938,117387,170744690,3213644,405914248,0,115389,129353899,110592,128780761,4797,573138,93128,16,120101,2495,0,520,144444.0,43333.0,-66.0,-72.0,-65.0,-70.0,-66.0,-71.0,-64.0,-70.0,-81.0,-89.0,-81.0,-88.0,15.0,17.0,16.0,18.0,1
2918,CC:2F:71:3E:C5:1F,3225033,407307480,11387,1393030,3213646,405914450,6,48616,4071360,40178,3071522,8438,999838,12007,34,16351,186,6,825,130000.0,39000.0,-70.0,-70.0,-67.0,-61.0,-69.0,-70.0,-67.0,-60.0,-81.0,-89.0,-81.0,-88.0,11.0,19.0,14.0,27.0,1
2919,CC:2F:71:3F:1F:24,8404595,8323006856,5190949,7917092406,3213646,405914450,80,1218718,758429872,1210190,757405728,8528,1024144,1165560,619,5195668,534031,80,5757,130000.0,43333.0,-68.0,-64.0,-72.0,-70.0,-68.0,-64.0,-71.0,-70.0,-81.0,-89.0,-81.0,-88.0,13.0,25.0,9.0,18.0,1
2920,F8:59:71:5A:E0:3D,3331099,576760423,117452,170845700,3213647,405914723,0,115454,129453999,110657,128880861,4797,573138,93193,16,120166,2497,0,520,144444.0,43333.0,-67.0,-72.0,-64.0,-70.0,-66.0,-71.0,-64.0,-70.0,-81.0,-89.0,-81.0,-88.0,14.0,17.0,17.0,18.0,1
2921,CC:2F:71:3E:C5:1F,3225036,407307955,11387,1393030,3213649,405914925,6,48616,4071360,40178,3071522,8438,999838,12007,34,16351,186,6,825,130000.0,39000.0,-70.0,-70.0,-67.0,-61.0,-69.0,-70.0,-67.0,-60.0,-81.0,-89.0,-81.0,-88.0,11.0,19.0,14.0,27.0,1
2922,CC:2F:71:3F:1F:24,8405907,8325029669,5192258,7919114744,3213649,405914925,80,1218990,758555182,1210462,757531038,8528,1024144,1165832,619,5196961,534544,80,5757,130000.0,43333.0,-67.0,-64.0,-71.0,-70.0,-67.0,-64.0,-71.0,-70.0,-81.0,-89.0,-81.0,-88.0,14.0,25.0,10.0,18.0,1
2923,F8:59:71:5A:E0:3D,3331154,576824700,117500,170909311,3213654,405915389,0,115501,129516921,110704,128943783,4797,573138,93240,16,120214,2497,0,520,144444.0,43333.0,-67.0,-72.0,-65.0,-71.0,-66.0,-72.0,-64.0,-70.0,-81.0,-89.0,-81.0,-88.0,14.0,17.0,16.0,17.0,1
2924,CC:2F:71:3E:C5:1F,3225041,407308419,11387,1393030,3213654,405915389,6,48616,4071360,40178,3071522,8438,999838,12007,34,16351,186,6,825,130000.0,39000.0,-70.0,-70.0,-67.0,-61.0,-69.0,-70.0,-67.0,-60.0,-81.0,-89.0,-81.0,-88.0,11.0,19.0,14.0,27.0,1
2925,CC:2F:71:3F:1F:24,8407480,8327443298,5193824,7921527707,3213656,405915591,80,1219244,758626654,1210716,757602510,8528,1024144,1166086,619,5198517,535167,80,5757,115556.0,28889.0,-68.0,-64.0,-72.0,-70.0,-67.0,-64.0,-71.0,-70.0,-81.0,-89.0,-81.0,-88.0,13.0,25.0,9.0,18.0,1
2926,F8:59:71:5A:E0:3D,3331156,576824902,117500,170909311,3213656,405915591,0,115501,129516921,110704,128943783,4797,573138,93240,16,120214,2497,0,520,144444.0,43333.0,-67.0,-72.0,-65.0,-71.0,-66.0,-72.0,-64.0,-70.0,-81.0,-89.0,-81.0,-88.0,14.0,17.0,16.0,17.0,1
2927,CC:2F:71:3E:C5:1F,3225043,407308621,11387,1393030,3213656,405915591,6,48616,4071360,40178,3071522,8438,999838,12007,34,16351,186,6,825,130000.0,39000.0,-70.0,-70.0,-67.0,-61.0,-69.0,-70.0,-67.0,-60.0,-81.0,-89.0,-81.0,-88.0,11.0,19.0,14.0,27.0,1
2928,CC:2F:71:3F:1F:24,8409395,8330422182,5195737,7924506389,3213658,405915793,80,1219475,758654728,1210947,757630584,8528,1024144,1166317,619,5200430,535262,80,5757,115556.0,28889.0,-68.0,-64.0,-71.0,-71.0,-68.0,-64.0,-70.0,-71.0,-81.0,-89.0,-81.0,-88.0,13.0,25.0,10.0,17.0,1
2929,F8:59:71:5A:E0:3D,3331162,576825508,117500,170909311,3213662,405916197,0,115501,129516921,110704,128943783,4797,573138,93240,16,120214,2497,0,520,144444.0,43333.0,-67.0,-72.0,-65.0,-71.0,-66.0,-72.0,-64.0,-70.0,-81.0,-89.0,-81.0,-88.0,14.0,17.0,16.0,17.0,1
2930,CC:2F:71:3E:C5:1F,3225049,407309227,11387,1393030,3213662,405916197,6,48616,4071360,40178,3071522,8438,999838,12007,34,16351,186,6,825,130000.0,39000.0,-70.0,-70.0,-67.0,-61.0,-69.0,-70.0,-67.0,-60.0,-81.0,-89.0,-81.0,-88.0,11.0,19.0,14.0,27.0,1
2931,CC:2F:71:3F:1F:24,8410832,8332642284,5197170,7926726087,3213662,405916197,80,1219713,758683528,1211185,757659384,8528,1024144,1166555,619,5201889,536157,80,5757,115556.0,28889.0,-69.0,-65.0,-73.0,-71.0,-69.0,-64.0,-72.0,-70.0,-81.0,-89.0,-81.0,-88.0,12.0,24.0,8.0,17.0,1
2932,F8:59:71:5A:E0:3D,3331175,576828655,117510,170912196,3213665,405916459,0,115512,129519593,110715,128946455,4797,573138,93251,16,120224,2497,0,520,144444.0,43333.0,-67.0,-72.0,-66.0,-71.0,-66.0,-71.0,-65.0,-70.0,-81.0,-89.0,-81.0,-88.0,14.0,17.0,15.0,17.0,1
2933,CC:2F:71:3E:C5:1F,3225052,407309489,11387,1393030,3213665,405916459,6,48616,4071360,40178,3071522,8438,999838,12007,34,16351,186,6,825,130000.0,39000.0,-70.0,-70.0,-67.0,-61.0,-69.0,-70.0,-67.0,-60.0,-81.0,-89.0,-81.0,-88.0,11.0,19.0,14.0,27.0,1
2934,CC:2F:71:3F:1F:24,8411987,8334404410,5198322,7928487951,3213665,405916459,80,1219947,758733601,1211419,757709457,8528,1024144,1166789,619,5203041,536602,80,5757,86667.0,14444.0,-69.0,-64.0,-72.0,-70.0,-68.0,-64.0,-72.0,-70.0,-81.0,-89.0,-81.0,-88.0,12.0,25.0,9.0,18.0,1
2935,F8:59:71:5A:E0:3D,3331246,576931753,117577,171014890,3213669,405916863,0,115579,129622773,110782,129049635,4797,573138,93318,16,120291,2497,0,520,144444.0,43333.0,-66.0,-72.0,-65.0,-70.0,-66.0,-71.0,-65.0,-70.0,-81.0,-89.0,-81.0,-88.0,15.0,17.0,16.0,18.0,1
2936,CC:2F:71:3E:C5:1F,3225058,407310095,11387,1393030,3213671,405917065,6,48616,4071360,40178,3071522,8438,999838,12007,34,16351,186,6,825,130000.0,39000.0,-70.0,-70.0,-67.0,-61.0,-69.0,-70.0,-67.0,-60.0,-81.0,-89.0,-81.0,-88.0,11.0,19.0,14.0,27.0,1
2937,CC:2F:71:3F:1F:24,8413046,8336016724,5199375,7930099659,3213671,405917065,80,1220214,758857393,1211686,757833249,8528,1024144,1167056,619,5204079,536605,80,5757,86667.0,14444.0,-68.0,-64.0,-72.0,-69.0,-68.0,-64.0,-71.0,-69.0,-81.0,-89.0,-81.0,-88.0,13.0,25.0,9.0,19.0,1
2938,F8:59:71:5A:E0:3D,3331315,577031729,117642,171114462,3213673,405917267,0,115643,129721347,110846,129148209,4797,573138,93381,16,120356,2497,0,520,144444.0,43333.0,-66.0,-72.0,-65.0,-71.0,-66.0,-72.0,-64.0,-70.0,-81.0,-89.0,-81.0,-88.0,15.0,17.0,16.0,17.0,1
2939,CC:2F:71:3E:C5:1F,3225061,407310357,11388,1393090,3213673,405917267,6,48618,4071500,40180,3071662,8438,999838,12007,34,16352,186,6,825,130000.0,39000.0,-70.0,-70.0,-67.0,-61.0,-69.0,-70.0,-67.0,-60.0,-81.0,-89.0,-81.0,-88.0,11.0,19.0,14.0,27.0,1
2940,CC:2F:71:3F:1F:24,8414387,8338087446,5200714,7932170179,3213673,405917267,80,1220509,758982751,1211981,757958607,8528,1024144,1167351,619,5205421,536671,80,5757,104000.0,26000.0,-70.0,-64.0,-71.0,-70.0,-70.0,-64.0,-71.0,-70.0,-80.0,-88.0,-80.0,-88.0,10.0,24.0,9.0,18.0,1
2941,F8:59:71:5A:E0:3D,3331389,577136435,117709,171218580,3213680,405917855,0,115710,129824527,110913,129251389,4797,573138,93448,16,120423,2497,0,520,144444.0,43333.0,-66.0,-73.0,-65.0,-70.0,-66.0,-72.0,-64.0,-70.0,-80.0,-88.0,-80.0,-88.0,14.0,15.0,15.0,18.0,1
2942,CC:2F:71:3E:C5:1F,3225068,407310945,11388,1393090,3213680,405917855,6,48620,4071688,40181,3071732,8439,999956,12008,34,16352,186,6,826,130000.0,39000.0,-69.0,-70.0,-67.0,-60.0,-69.0,-70.0,-67.0,-60.0,-80.0,-88.0,-80.0,-88.0,11.0,18.0,13.0,28.0,1
2943,CC:2F:71:3F:1F:24,8415464,8339730748,5201782,7933812691,3213682,405918057,80,1220766,759113719,1212237,758089457,8529,1024262,1167608,619,5206501,537031,80,5758,86667.0,14444.0,-69.0,-64.0,-71.0,-70.0,-69.0,-64.0,-70.0,-70.0,-80.0,-88.0,-80.0,-88.0,11.0,24.0,9.0,18.0,1
2944,F8:59:71:5A:E0:3D,3331460,577240957,117776,171322698,3213684,405918259,0,115777,129927707,110980,129354569,4797,573138,93515,16,120490,2497,0,520,144444.0,43333.0,-67.0,-72.0,-65.0,-70.0,-66.0,-72.0,-64.0,-70.0,-80.0,-88.0,-80.0,-88.0,13.0,16.0,15.0,18.0,1
2945,CC:2F:71:3E:C5:1F,3225072,407311349,11388,1393090,3213684,405918259,6,48620,4071688,40181,3071732,8439,999956,12008,34,16352,186,6,826,130000.0,39000.0,-69.0,-70.0,-67.0,-60.0,-69.0,-70.0,-67.0,-60.0,-80.0,-88.0,-80.0,-88.0,11.0,18.0,13.0,28.0,1
2946,CC:2F:71:3F:1F:24,8416527,8341362720,5202843,7935444461,3213684,405918259,80,1221043,759239671,1212514,758215409,8529,1024262,1167884,619,5207562,537095,80,5758,86667.0,14444.0,-68.0,-65.0,-69.0,-67.0,-68.0,-65.0,-71.0,-67.0,-80.0,-88.0,-80.0,-88.0,12.0,23.0,11.0,21.0,1
2947,F8:59:71:5A:E0:3D,3331528,577340817,117840,171422154,3213688,405918663,0,115842,130027821,111045,129454683,4797,573138,93579,16,120554,2497,0,520,144444.0,43333.0,-66.0,-71.0,-66.0,-70.0,-66.0,-71.0,-65.0,-70.0,-80.0,-88.0,-80.0,-88.0,14.0,17.0,14.0,18.0,1
2948,CC:2F:71:3E:C5:1F,3225076,407311753,11388,1393090,3213688,405918663,6,48620,4071688,40181,3071732,8439,999956,12008,34,16352,186,6,826,130000.0,39000.0,-69.0,-70.0,-67.0,-60.0,-69.0,-70.0,-67.0,-60.0,-80.0,-88.0,-80.0,-88.0,11.0,18.0,13.0,28.0,1
2949,CC:2F:71:3F:1F:24,8417162,8342308908,5203474,7936390245,3213688,405918663,80,1221246,759354674,1212717,758330412,8529,1024262,1168087,619,5208193,537112,80,5758,115556.0,26000.0,-69.0,-64.0,-71.0,-69.0,-68.0,-64.0,-71.0,-69.0,-80.0,-88.0,-80.0,-88.0,11.0,24.0,9.0,19.0,1
2950,F8:59:71:5A:E0:3D,3331593,577437427,117902,171518502,3213691,405918925,0,115905,130124841,111108,129551703,4797,573138,93642,16,120616,2498,0,520,144444.0,43333.0,-67.0,-71.0,-66.0,-70.0,-67.0,-71.0,-65.0,-70.0,-80.0,-88.0,-80.0,-88.0,13.0,17.0,14.0,18.0,1
2951,CC:2F:71:3E:C5:1F,3225081,407312217,11388,1393090,3213693,405919127,6,48620,4071688,40181,3071732,8439,999956,12008,34,16352,186,6,826,130000.0,39000.0,-69.0,-70.0,-67.0,-60.0,-69.0,-70.0,-67.0,-60.0,-80.0,-88.0,-80.0,-88.0,11.0,18.0,13.0,28.0,1
2952,CC:2F:71:3F:1F:24,8418273,8344012456,5204580,7938093329,3213693,405919127,80,1221495,759474440,1212966,758450178,8529,1024262,1168336,619,5209299,537190,80,5758,104000.0,26000.0,-69.0,-64.0,-72.0,-69.0,-69.0,-64.0,-71.0,-69.0,-80.0,-88.0,-80.0,-88.0,11.0,24.0,8.0,19.0,1
2953,F8:59:71:5A:E0:3D,3331661,577537287,117966,171617958,3213695,405919329,0,115968,130221861,111171,129648723,4797,573138,93705,16,120680,2498,0,520,144444.0,43333.0,-67.0,-71.0,-65.0,-70.0,-67.0,-71.0,-65.0,-70.0,-80.0,-88.0,-80.0,-88.0,13.0,17.0,15.0,18.0,1
2954,CC:2F:71:3E:C5:1F,3225085,407312621,11388,1393090,3213697,405919531,6,48620,4071688,40181,3071732,8439,999956,12008,34,16352,186,6,826,130000.0,39000.0,-69.0,-70.0,-67.0,-60.0,-69.0,-70.0,-67.0,-60.0,-80.0,-88.0,-80.0,-88.0,11.0,18.0,13.0,28.0,1
2955,CC:2F:71:3F:1F:24,8419530,8345948438,5205833,7940028907,3213697,405919531,80,1221776,759598018,1213247,758573756,8529,1024262,1168617,619,5210552,537227,80,5758,115556.0,28889.0,-69.0,-64.0,-72.0,-70.0,-68.0,-64.0,-71.0,-69.0,-80.0,-88.0,-80.0,-88.0,11.0,24.0,8.0,18.0,1
2956,F8:59:71:5A:E0:3D,3331727,577633927,118028,171714194,3213699,405919733,0,116030,130317341,111233,129744203,4797,573138,93767,16,120742,2498,0,520,144444.0,43333.0,-67.0,-71.0,-66.0,-70.0,-66.0,-71.0,-65.0,-70.0,-80.0,-88.0,-80.0,-88.0,13.0,17.0,14.0,18.0,1
2957,CC:2F:71:3E:C5:1F,3225087,407312823,11388,1393090,3213699,405919733,6,48620,4071688,40181,3071732,8439,999956,12008,34,16352,186,6,826,130000.0,39000.0,-69.0,-70.0,-67.0,-60.0,-69.0,-70.0,-67.0,-60.0,-80.0,-88.0,-80.0,-88.0,11.0,18.0,13.0,28.0,1
2958,CC:2F:71:3F:1F:24,8420520,8347467352,5206821,7941547619,3213699,405919733,80,1222010,759714812,1213481,758690550,8529,1024262,1168851,619,5211530,537294,80,5758,117000.0,39000.0,-69.0,-64.0,-71.0,-70.0,-69.0,-64.0,-72.0,-69.0,-80.0,-88.0,-80.0,-88.0,11.0,24.0,9.0,18.0,1
2959,F8:59:71:5A:E0:3D,3331793,577732091,118091,171812096,3213702,405919995,0,116093,130414361,111296,129841223,4797,573138,93830,16,120805,2499,0,520,144444.0,43333.0,-67.0,-71.0,-65.0,-70.0,-67.0,-71.0,-65.0,-70.0,-80.0,-88.0,-80.0,-88.0,13.0,17.0,15.0,18.0,1
2960,CC:2F:71:3E:C5:1F,3225092,407313287,11388,1393090,3213704,405920197,6,48620,4071688,40181,3071732,8439,999956,12008,34,16352,186,6,826,130000.0,39000.0,-69.0,-70.0,-67.0,-60.0,-69.0,-70.0,-67.0,-60.0,-80.0,-88.0,-80.0,-88.0,11.0,18.0,13.0,28.0,1
2961,CC:2F:71:3F:1F:24,8421479,8348931516,5207775,7943011319,3213704,405920197,80,1222243,759834192,1213714,758809930,8529,1024262,1169084,619,5212486,537367,80,5758,115556.0,28889.0,-69.0,-65.0,-72.0,-70.0,-68.0,-64.0,-71.0,-69.0,-80.0,-88.0,-80.0,-88.0,11.0,23.0,8.0,18.0,1
2962,F8:59:71:5A:E0:3D,3331863,577832153,118155,171911552,3213708,405920601,0,116157,130512921,111360,129939783,4797,573138,93894,16,120869,2500,0,520,144444.0,43333.0,-66.0,-71.0,-66.0,-70.0,-66.0,-71.0,-65.0,-70.0,-80.0,-88.0,-80.0,-88.0,14.0,17.0,14.0,18.0,1
2963,CC:2F:71:3E:C5:1F,3225097,407313964,11388,1393090,3213709,405920874,6,48620,4071688,40181,3071732,8439,999956,12008,34,16352,186,6,826,130000.0,39000.0,-69.0,-70.0,-67.0,-60.0,-69.0,-70.0,-67.0,-60.0,-80.0,-88.0,-80.0,-88.0,11.0,18.0,13.0,28.0,1
2964,CC:2F:71:3F:1F:24,8422574,8350603072,5208865,7944682198,3213709,405920874,80,1222484,759955071,1213955,758930809,8529,1024262,1169325,619,5213584,537414,80,5759,115556.0,28889.0,-68.0,-64.0,-71.0,-69.0,-68.0,-64.0,-71.0,-69.0,-80.0,-88.0,-80.0,-88.0,12.0,24.0,9.0,19.0,1
2965,F8:59:71:5A:E0:3D,3331929,577930530,118218,172009454,3213711,405921076,0,116220,130609941,111423,130036803,4797,573138,93957,16,120932,2500,0,520,144444.0,43333.0,-67.0,-71.0,-65.0,-70.0,-66.0,-71.0,-65.0,-70.0,-79.0,-88.0,-80.0,-88.0,12.0,17.0,15.0,18.0,1
2966,CC:2F:71:3E:C5:1F,3225099,407314166,11388,1393090,3213711,405921076,6,48620,4071688,40181,3071732,8439,999956,12008,34,16352,186,6,826,130000.0,39000.0,-69.0,-70.0,-67.0,-60.0,-69.0,-70.0,-67.0,-60.0,-79.0,-88.0,-80.0,-88.0,10.0,18.0,13.0,28.0,1
2967,CC:2F:71:3F:1F:24,8423754,8352418872,5210042,7946497736,3213712,405921136,80,1222734,760073555,1214205,759049293,8529,1024262,1169575,619,5214755,537484,80,5759,115556.0,28889.0,-69.0,-64.0,-72.0,-70.0,-68.0,-64.0,-71.0,-69.0,-79.0,-88.0,-80.0,-88.0,10.0,24.0,8.0,18.0,1
2968,F8:59:71:5A:E0:3D,3331998,578027544,118280,172105802,3213718,405921742,0,116284,130708515,111487,130135377,4797,573138,94020,16,120994,2500,0,520,144444.0,43333.0,-67.0,-72.0,-65.0,-70.0,-67.0,-71.0,-65.0,-70.0,-79.0,-88.0,-80.0,-88.0,12.0,16.0,15.0,18.0,1
2969,CC:2F:71:3E:C5:1F,3225106,407314832,11388,1393090,3213718,405921742,6,48620,4071688,40181,3071732,8439,999956,12008,34,16352,186,6,826,130000.0,39000.0,-69.0,-70.0,-67.0,-60.0,-69.0,-70.0,-67.0,-60.0,-79.0,-88.0,-80.0,-88.0,10.0,18.0,13.0,28.0,1
2970,CC:2F:71:3F:1F:24,8424716,8353886302,5210998,7947964560,3213718,405921742,80,1222966,760191371,1214437,759167109,8529,1024262,1169807,619,5215717,537545,80,5759,115556.0,28889.0,-68.0,-64.0,-71.0,-70.0,-68.0,-64.0,-71.0,-69.0,-79.0,-88.0,-80.0,-88.0,11.0,24.0,9.0,18.0,1
2971,F8:59:71:5A:E0:3D,3332065,578128756,118345,172206812,3213720,405921944,0,116349,130808615,111552,130235477,4797,573138,94085,16,121059,2500,0,520,144444.0,43333.0,-67.0,-71.0,-65.0,-70.0,-67.0,-71.0,-65.0,-70.0,-79.0,-88.0,-80.0,-88.0,12.0,17.0,15.0,18.0,1
2972,CC:2F:71:3E:C5:1F,3225108,407315034,11388,1393090,3213720,405921944,6,48620,4071688,40181,3071732,8439,999956,12008,34,16352,186,6,826,130000.0,39000.0,-69.0,-70.0,-67.0,-60.0,-69.0,-70.0,-67.0,-60.0,-79.0,-88.0,-80.0,-88.0,10.0,18.0,13.0,28.0,1
2973,CC:2F:71:3F:1F:24,8425751,8355474962,5212031,7949553018,3213720,405921944,80,1223208,760313147,1214679,759288885,8529,1024262,1170049,619,5216750,537552,80,5759,115556.0,28889.0,-68.0,-64.0,-72.0,-70.0,-68.0,-64.0,-71.0,-69.0,-79.0,-88.0,-80.0,-88.0,11.0,24.0,8.0,18.0,1
2974,F8:59:71:5A:E0:3D,3332138,578231986,118411,172309376,3213727,405922610,0,116415,130910255,111618,130337117,4797,573138,94151,16,121125,2501,0,520,144444.0,43333.0,-67.0,-72.0,-65.0,-70.0,-66.0,-71.0,-65.0,-70.0,-79.0,-88.0,-79.0,-87.0,12.0,16.0,14.0,17.0,1
2975,CC:2F:71:3E:C5:1F,3225115,407315700,11388,1393090,3213727,405922610,6,48620,4071688,40181,3071732,8439,999956,12008,34,16352,186,6,826,130000.0,39000.0,-69.0,-70.0,-67.0,-60.0,-69.0,-70.0,-67.0,-60.0,-79.0,-88.0,-79.0,-87.0,10.0,18.0,12.0,27.0,1
2976,CC:2F:71:3F:1F:24,8427402,8358019034,5213675,7952096424,3213727,405922610,80,1223500,760444290,1214971,759420028,8529,1024262,1170341,619,5218394,537636,80,5759,115556.0,28889.0,-69.0,-64.0,-72.0,-69.0,-68.0,-64.0,-72.0,-69.0,-79.0,-88.0,-79.0,-87.0,10.0,24.0,7.0,18.0,1
2977,F8:59:71:5A:E0:3D,3332205,578333142,118476,172410330,3213729,405922812,0,116482,131013463,111685,130440325,4797,573138,94216,16,121190,2503,0,520,130000.0,39000.0,-67.0,-72.0,-65.0,-70.0,-66.0,-71.0,-65.0,-70.0,-79.0,-88.0,-79.0,-87.0,12.0,16.0,14.0,17.0,1
2978,CC:2F:71:3E:C5:1F,3225117,407315902,11388,1393090,3213729,405922812,6,48620,4071688,40181,3071732,8439,999956,12008,34,16352,186,6,826,130000.0,39000.0,-69.0,-70.0,-67.0,-60.0,-69.0,-70.0,-67.0,-60.0,-79.0,-88.0,-79.0,-87.0,10.0,18.0,12.0,27.0,1
2979,CC:2F:71:3F:1F:24,8429172,8360767572,5215443,7954844760,3213729,405922812,80,1223795,760572498,1215266,759548236,8529,1024262,1170636,619,5220162,537711,80,5759,115556.0,28889.0,-69.0,-64.0,-72.0,-69.0,-69.0,-64.0,-71.0,-69.0,-79.0,-88.0,-79.0,-87.0,10.0,24.0,7.0,18.0,1
2980,F8:59:71:5A:E0:3D,3332279,578435076,118541,172511228,3213738,405923848,0,116548,131113695,111750,130540439,4798,573256,94281,16,121255,2503,0,521,144444.0,43333.0,-67.0,-72.0,-66.0,-70.0,-67.0,-71.0,-65.0,-70.0,-79.0,-88.0,-79.0,-87.0,12.0,16.0,13.0,17.0,1
2981,CC:2F:71:3E:C5:1F,3225126,407316938,11388,1393090,3213738,405923848,6,48620,4071688,40181,3071732,8439,999956,12008,34,16352,186,6,826,130000.0,39000.0,-69.0,-70.0,-67.0,-60.0,-69.0,-70.0,-67.0,-60.0,-79.0,-88.0,-79.0,-87.0,10.0,18.0,12.0,27.0,1
2982,CC:2F:71:3F:1F:24,8430735,8363180700,5216997,7957256852,3213738,405923848,80,1224069,760696550,1215540,759672288,8529,1024262,1170910,619,5221694,537780,80,5759,115556.0,28889.0,-69.0,-64.0,-73.0,-70.0,-68.0,-64.0,-71.0,-70.0,-79.0,-88.0,-79.0,-87.0,10.0,24.0,6.0,17.0,1
2983,F8:59:71:5A:E0:3D,3332343,578531618,118603,172607576,3213740,405924042,0,116611,131210715,111813,130637459,4798,573256,94344,16,121317,2504,0,521,144444.0,43333.0,-67.0,-71.0,-66.0,-70.0,-66.0,-71.0,-65.0,-70.0,-79.0,-88.0,-79.0,-87.0,12.0,17.0,13.0,17.0,1
2984,CC:2F:71:3E:C5:1F,3225129,407317200,11388,1393090,3213741,405924110,6,48620,4071688,40181,3071732,8439,999956,12008,34,16352,186,6,826,130000.0,39000.0,-69.0,-70.0,-67.0,-60.0,-69.0,-70.0,-67.0,-60.0,-79.0,-88.0,-79.0,-87.0,10.0,18.0,12.0,27.0,1
2985,CC:2F:71:3F:1F:24,8432350,8365683058,5218609,7959758948,3213741,405924110,80,1224347,760819654,1215818,759795392,8529,1024262,1171188,619,5223307,537978,80,5759,115556.0,28889.0,-69.0,-64.0,-71.0,-70.0,-68.0,-64.0,-71.0,-69.0,-79.0,-88.0,-79.0,-87.0,10.0,24.0,8.0,17.0,1
2986,F8:59:71:5A:E0:3D,3332414,578634654,118669,172710140,3213745,405924514,0,116675,131309331,111877,130736075,4798,573256,94408,16,121383,2505,0,521,144444.0,43333.0,-67.0,-72.0,-65.0,-71.0,-66.0,-71.0,-65.0,-70.0,-79.0,-88.0,-79.0,-87.0,12.0,16.0,14.0,16.0,1
2987,CC:2F:71:3E:C5:1F,3225133,407317604,11388,1393090,3213745,405924514,6,48620,4071688,40181,3071732,8439,999956,12008,34,16352,186,6,826,130000.0,39000.0,-69.0,-70.0,-67.0,-60.0,-69.0,-70.0,-67.0,-60.0,-79.0,-88.0,-79.0,-87.0,10.0,18.0,12.0,27.0,1
2988,CC:2F:71:3F:1F:24,8433743,8367824388,5219996,7961899672,3213747,405924716,80,1224611,760944645,1216082,759920383,8529,1024262,1171452,619,5224687,538164,80,5759,115556.0,28889.0,-69.0,-64.0,-71.0,-69.0,-69.0,-64.0,-71.0,-69.0,-79.0,-88.0,-79.0,-87.0,10.0,24.0,8.0,18.0,1
2989,F8:59:71:5A:E0:3D,3332480,578734312,118733,172809596,3213747,405924716,0,116740,131409431,111942,130836175,4798,573256,94473,16,121447,2505,0,521,144444.0,43333.0,-67.0,-71.0,-65.0,-71.0,-66.0,-71.0,-65.0,-70.0,-79.0,-88.0,-79.0,-87.0,12.0,17.0,14.0,16.0,1
2990,CC:2F:71:3E:C5:1F,3225135,407317806,11388,1393090,3213747,405924716,6,48620,4071688,40181,3071732,8439,999956,12008,34,16352,186,6,826,130000.0,39000.0,-69.0,-70.0,-67.0,-60.0,-69.0,-70.0,-67.0,-60.0,-79.0,-88.0,-79.0,-87.0,10.0,18.0,12.0,27.0,1
2991,CC:2F:71:3F:1F:24,8434786,8369426720,5221037,7963501802,3213749,405924918,80,1224877,761070717,1216348,760046455,8529,1024262,1171716,619,5225749,538522,80,5759,86667.0,13000.0,-69.0,-64.0,-72.0,-70.0,-68.0,-64.0,-71.0,-70.0,-79.0,-88.0,-79.0,-87.0,10.0,24.0,7.0,17.0,1
2992,F8:59:71:5A:E0:3D,3332552,578835988,118798,172910606,3213754,405925382,0,116805,131509531,112007,130936275,4798,573256,94538,16,121512,2506,0,521,144444.0,43333.0,-66.0,-72.0,-65.0,-70.0,-66.0,-72.0,-65.0,-70.0,-79.0,-88.0,-79.0,-87.0,13.0,16.0,14.0,17.0,1
2993,CC:2F:71:3E:C5:1F,3225142,407318472,11388,1393090,3213754,405925382,6,48620,4071688,40181,3071732,8439,999956,12008,34,16352,186,6,826,130000.0,39000.0,-69.0,-70.0,-67.0,-60.0,-69.0,-70.0,-67.0,-60.0,-79.0,-88.0,-79.0,-87.0,10.0,18.0,12.0,27.0,1
2994,CC:2F:71:3F:1F:24,8435898,8371131262,5222144,7965205880,3213754,405925382,80,1225163,761196341,1216634,760172079,8529,1024262,1172002,619,5226863,538781,80,5759,78000.0,13000.0,-69.0,-64.0,-73.0,-71.0,-68.0,-64.0,-72.0,-70.0,-79.0,-88.0,-79.0,-87.0,10.0,24.0,6.0,16.0,1
2995,F8:59:71:5A:E0:3D,3332618,578935646,118862,173010062,3213756,405925584,0,116869,131608091,112071,131034835,4798,573256,94602,16,121576,2506,0,521,144444.0,43333.0,-66.0,-72.0,-65.0,-71.0,-66.0,-71.0,-65.0,-70.0,-79.0,-88.0,-79.0,-87.0,13.0,16.0,14.0,16.0,1
2996,CC:2F:71:3E:C5:1F,3225144,407318674,11388,1393090,3213756,405925584,6,48620,4071688,40181,3071732,8439,999956,12008,34,16352,186,6,826,130000.0,39000.0,-69.0,-70.0,-67.0,-60.0,-69.0,-70.0,-67.0,-60.0,-79.0,-88.0,-79.0,-87.0,10.0,18.0,12.0,27.0,1
2997,CC:2F:71:3F:1F:24,8436773,8372467874,5223017,7966542290,3213756,405925584,80,1225408,761318531,1216879,760294269,8529,1024262,1172247,619,5227736,538794,80,5759,86667.0,14444.0,-69.0,-64.0,-72.0,-70.0,-69.0,-64.0,-72.0,-70.0,-79.0,-88.0,-79.0,-87.0,10.0,24.0,7.0,17.0,1
2998,F8:59:71:5A:E0:3D,3332684,579035304,118926,173109518,3213758,405925786,0,116936,131711299,112138,131138043,4798,573256,94667,16,121640,2506,0,521,144444.0,43333.0,-67.0,-72.0,-65.0,-70.0,-66.0,-72.0,-65.0,-70.0,-79.0,-88.0,-79.0,-87.0,12.0,16.0,14.0,17.0,1
2999,CC:2F:71:3E:C5:1F,3225149,407319204,11388,1393090,3213761,405926114,6,48620,4071688,40181,3071732,8439,999956,12008,34,16352,186,6,826,130000.0,39000.0,-69.0,-70.0,-67.0,-60.0,-69.0,-70.0,-67.0,-60.0,-79.0,-88.0,-79.0,-87.0,10.0,18.0,12.0,27.0,1
3000,CC:2F:71:3F:1F:24,8437773,8373983987,5224010,7968057671,3213763,405926316,80,1225669,761440254,1217140,760415992,8529,1024262,1172508,619,5228700,538843,80,5759,115556.0,26000.0,-69.0,-64.0,-71.0,-70.0,-68.0,-64.0,-71.0,-70.0,-79.0,-88.0,-79.0,-87.0,10.0,24.0,8.0,17.0,1
3001,F8:59:71:5A:E0:3D,3332757,579135612,118990,173208974,3213767,405926638,0,117001,131811469,112203,131238213,4798,573256,94731,16,121704,2506,0,521,144444.0,43333.0,-67.0,-72.0,-66.0,-71.0,-66.0,-72.0,-65.0,-71.0,-79.0,-88.0,-79.0,-87.0,12.0,16.0,13.0,16.0,1
3002,CC:2F:71:3E:C5:1F,3225155,407319728,11388,1393090,3213767,405926638,6,48620,4071688,40181,3071732,8439,999956,12008,34,16352,186,6,826,130000.0,39000.0,-69.0,-70.0,-67.0,-60.0,-69.0,-70.0,-67.0,-60.0,-79.0,-88.0,-79.0,-87.0,10.0,18.0,12.0,27.0,1
3003,CC:2F:71:3F:1F:24,8439106,8376039940,5225339,7970113302,3213767,405926638,80,1225940,761562864,1217411,760538602,8529,1024262,1172779,619,5230017,538963,80,5760,115556.0,28889.0,-70.0,-65.0,-72.0,-68.0,-69.0,-65.0,-72.0,-68.0,-79.0,-88.0,-79.0,-87.0,9.0,23.0,7.0,19.0,1
3004,F8:59:71:5A:E0:3D,3332823,579233776,119053,173306876,3213770,405926900,0,117064,131908503,112266,131335247,4798,573256,94793,16,121767,2506,0,521,144444.0,43333.0,-66.0,-72.0,-66.0,-71.0,-66.0,-72.0,-65.0,-70.0,-79.0,-88.0,-79.0,-87.0,13.0,16.0,13.0,16.0,1
3005,CC:2F:71:3E:C5:1F,3225158,407319990,11388,1393090,3213770,405926900,6,48620,4071688,40181,3071732,8439,999956,12008,34,16352,186,6,826,130000.0,39000.0,-69.0,-70.0,-67.0,-60.0,-69.0,-70.0,-67.0,-60.0,-79.0,-88.0,-79.0,-87.0,10.0,18.0,12.0,27.0,1
3006,CC:2F:71:3F:1F:24,8440559,8378286797,5226789,7972359897,3213770,405926900,80,1226234,761689535,1217705,760665273,8529,1024262,1173069,619,5231489,538986,80,5761,115556.0,28889.0,-70.0,-65.0,-72.0,-68.0,-70.0,-64.0,-71.0,-68.0,-79.0,-88.0,-79.0,-87.0,9.0,23.0,7.0,19.0,1
3007,F8:59:71:5A:E0:3D,3332893,579331063,119115,173403224,3213778,405927839,0,117129,132008631,112331,131435375,4798,573256,94856,16,121829,2506,0,521,144444.0,43333.0,-67.0,-72.0,-65.0,-71.0,-66.0,-71.0,-65.0,-70.0,-79.0,-88.0,-79.0,-87.0,12.0,16.0,14.0,16.0,1
3008,CC:2F:71:3E:C5:1F,3225166,407320929,11388,1393090,3213778,405927839,6,48620,4071688,40181,3071732,8439,999956,12008,34,16352,186,6,826,130000.0,39000.0,-69.0,-70.0,-67.0,-60.0,-69.0,-70.0,-67.0,-60.0,-79.0,-88.0,-79.0,-87.0,10.0,18.0,12.0,27.0,1
3009,CC:2F:71:3F:1F:24,8441788,8380174010,5228010,7974246171,3213778,405927839,80,1226500,761811319,1217971,760787057,8529,1024262,1173335,619,5232729,539045,80,5761,130000.0,43333.0,-70.0,-65.0,-72.0,-68.0,-69.0,-64.0,-71.0,-68.0,-79.0,-88.0,-79.0,-87.0,9.0,23.0,7.0,19.0,1
3010,F8:59:71:5A:E0:3D,3332959,579429227,119178,173501126,3213781,405928101,0,117192,132105651,112394,131532395,4798,573256,94919,16,121892,2506,0,521,144444.0,43333.0,-67.0,-72.0,-66.0,-71.0,-67.0,-72.0,-65.0,-71.0,-79.0,-88.0,-79.0,-87.0,12.0,16.0,13.0,16.0,1
3011,CC:2F:71:3E:C5:1F,3225169,407321191,11388,1393090,3213781,405928101,6,48620,4071688,40181,3071732,8439,999956,12008,34,16352,186,6,826,130000.0,39000.0,-69.0,-70.0,-67.0,-60.0,-69.0,-70.0,-67.0,-60.0,-79.0,-88.0,-79.0,-87.0,10.0,18.0,12.0,27.0,1
3012,CC:2F:71:3F:1F:24,8442694,8381557638,5228913,7975629537,3213781,405928101,80,1226728,761928683,1218199,760904421,8529,1024262,1173563,619,5233632,539049,80,5761,130000.0,43333.0,-70.0,-65.0,-72.0,-68.0,-70.0,-64.0,-71.0,-68.0,-79.0,-88.0,-79.0,-87.0,9.0,23.0,7.0,19.0,1
3013,F8:59:71:5A:E0:3D,3333030,579528400,119243,173599693,3213787,405928707,0,117260,132204818,112462,131631562,4798,573256,94986,16,121957,2507,0,521,144444.0,43333.0,-66.0,-71.0,-65.0,-71.0,-66.0,-71.0,-65.0,-71.0,-79.0,-88.0,-79.0,-87.0,13.0,17.0,14.0,16.0,1
3014,CC:2F:71:3E:C5:1F,3225175,407321797,11388,1393090,3213787,405928707,6,48620,4071688,40181,3071732,8439,999956,12008,34,16352,186,6,826,130000.0,39000.0,-69.0,-70.0,-67.0,-60.0,-69.0,-70.0,-67.0,-60.0,-79.0,-88.0,-79.0,-87.0,10.0,18.0,12.0,27.0,1
3015,CC:2F:71:3F:1F:24,8443681,8383044191,5229894,7977115484,3213787,405928707,80,1227013,762053796,1218484,761029534,8529,1024262,1173848,619,5234613,539160,80,5761,130000.0,43333.0,-70.0,-65.0,-72.0,-68.0,-70.0,-65.0,-71.0,-68.0,-79.0,-88.0,-79.0,-87.0,9.0,23.0,7.0,19.0,1
3016,F8:59:71:5A:E0:3D,3333099,579628637,119310,173699728,3213789,405928909,0,117326,132303610,112528,131730354,4798,573256,95052,16,122024,2507,0,521,144444.0,43333.0,-67.0,-72.0,-66.0,-71.0,-66.0,-71.0,-65.0,-71.0,-79.0,-87.0,-79.0,-87.0,12.0,15.0,13.0,16.0,1
3017,CC:2F:71:3E:C5:1F,3225178,407322059,11388,1393090,3213790,405928969,6,48620,4071688,40181,3071732,8439,999956,12008,34,16352,186,6,826,130000.0,39000.0,-69.0,-70.0,-67.0,-60.0,-69.0,-70.0,-67.0,-60.0,-79.0,-87.0,-79.0,-87.0,10.0,17.0,12.0,27.0,1
3018,CC:2F:71:3F:1F:24,8444836,8384820493,5231046,7978891524,3213790,405928969,80,1227232,762171492,1218703,761147230,8529,1024262,1174067,619,5235726,539429,80,5761,130000.0,43333.0,-69.0,-64.0,-71.0,-68.0,-69.0,-64.0,-71.0,-68.0,-79.0,-87.0,-79.0,-87.0,10.0,23.0,8.0,19.0,1
3019,F8:59:71:5A:E0:3D,3333170,579728759,119374,173799184,3213796,405929575,0,117390,132402170,112592,131828914,4798,573256,95116,16,122088,2507,0,521,144444.0,43333.0,-67.0,-72.0,-65.0,-71.0,-66.0,-71.0,-65.0,-70.0,-79.0,-87.0,-79.0,-87.0,12.0,15.0,14.0,16.0,1
3020,CC:2F:71:3E:C5:1F,3225184,407322665,11388,1393090,3213796,405929575,6,48620,4071688,40181,3071732,8439,999956,12008,34,16352,186,6,826,130000.0,39000.0,-69.0,-70.0,-67.0,-60.0,-69.0,-70.0,-67.0,-60.0,-79.0,-87.0,-79.0,-87.0,10.0,17.0,12.0,27.0,1
3021,CC:2F:71:3F:1F:24,8446256,8387010951,5232460,7981081376,3213796,405929575,80,1227486,762294856,1218957,761270594,8529,1024262,1174321,619,5237179,539587,80,5761,130000.0,43333.0,-70.0,-64.0,-71.0,-68.0,-69.0,-64.0,-71.0,-68.0,-79.0,-87.0,-79.0,-87.0,9.0,23.0,8.0,19.0,1
3022,F8:59:71:5A:E0:3D,3333235,579828331,119439,173898756,3213796,405929575,0,117454,132500744,112656,131927488,4798,573256,95179,16,122152,2507,0,521,144444.0,43333.0,-67.0,-72.0,-65.0,-71.0,-66.0,-72.0,-65.0,-71.0,-79.0,-87.0,-79.0,-87.0,12.0,15.0,14.0,16.0,1
3023,CC:2F:71:3E:C5:1F,3225185,407322781,11389,1393206,3213796,405929575,6,48622,4071828,40183,3071872,8439,999956,12008,34,16353,186,6,826,130000.0,39000.0,-69.0,-71.0,-67.0,-61.0,-69.0,-70.0,-67.0,-60.0,-79.0,-87.0,-79.0,-87.0,10.0,16.0,12.0,26.0,1
3024,CC:2F:71:3F:1F:24,8447157,8388391195,5233361,7982461620,3213796,405929575,80,1227710,762410416,1219181,761386154,8529,1024262,1174542,619,5238080,539625,80,5761,130000.0,43333.0,-69.0,-65.0,-71.0,-69.0,-69.0,-64.0,-71.0,-68.0,-79.0,-87.0,-79.0,-87.0,10.0,22.0,8.0,18.0,1
3025,F8:59:71:5A:E0:3D,3333306,579925547,119501,173995104,3213805,405930443,0,117517,132597764,112719,132024508,4798,573256,95242,16,122215,2507,0,521,144444.0,43333.0,-67.0,-72.0,-65.0,-71.0,-66.0,-71.0,-65.0,-70.0,-79.0,-87.0,-79.0,-87.0,12.0,15.0,14.0,16.0,1
3026,CC:2F:71:3E:C5:1F,3225194,407323649,11389,1393206,3213805,405930443,6,48622,4071828,40183,3071872,8439,999956,12008,34,16353,186,6,826,130000.0,39000.0,-69.0,-71.0,-67.0,-61.0,-69.0,-70.0,-67.0,-60.0,-79.0,-87.0,-79.0,-87.0,10.0,16.0,12.0,26.0,1
3027,CC:2F:71:3F:1F:24,8448312,8390153983,5234507,7984223540,3213805,405930443,80,1227980,762534526,1219451,761510264,8529,1024262,1174811,619,5239226,539734,80,5761,130000.0,43333.0,-70.0,-64.0,-71.0,-68.0,-69.0,-64.0,-71.0,-68.0,-79.0,-87.0,-79.0,-87.0,9.0,23.0,8.0,19.0,1
3028,F8:59:71:5A:E0:3D,3333370,580025003,119565,174094560,3213805,405930443,0,117581,132696324,112783,132123068,4798,573256,95306,16,122279,2507,0,521,144444.0,43333.0,-66.0,-71.0,-65.0,-70.0,-66.0,-71.0,-65.0,-70.0,-79.0,-87.0,-79.0,-87.0,13.0,16.0,14.0,17.0,1
3029,CC:2F:71:3E:C5:1F,3225194,407323649,11389,1393206,3213805,405930443,6,48622,4071828,40183,3071872,8439,999956,12008,34,16353,186,6,826,130000.0,39000.0,-69.0,-71.0,-67.0,-61.0,-69.0,-70.0,-67.0,-60.0,-79.0,-87.0,-79.0,-87.0,10.0,16.0,12.0,26.0,1
3030,CC:2F:71:3F:1F:24,8449247,8391589069,5235442,7985658626,3213805,405930443,80,1228211,762653850,1219682,761629588,8529,1024262,1175042,619,5240161,539900,80,5761,130000.0,43333.0,-70.0,-65.0,-72.0,-69.0,-69.0,-64.0,-71.0,-68.0,-79.0,-87.0,-79.0,-87.0,9.0,22.0,7.0,18.0,1
3031,F8:59:71:5A:E0:3D,3333439,580123511,119628,174192462,3213811,405931049,0,117645,132794940,112847,132221684,4798,573256,95368,16,122342,2508,0,522,144444.0,43333.0,-67.0,-71.0,-65.0,-71.0,-66.0,-71.0,-65.0,-70.0,-79.0,-87.0,-79.0,-87.0,12.0,16.0,14.0,16.0,1
3032,CC:2F:71:3E:C5:1F,3225200,407324255,11389,1393206,3213811,405931049,6,48622,4071828,40183,3071872,8439,999956,12008,34,16353,186,6,826,130000.0,39000.0,-69.0,-71.0,-67.0,-61.0,-69.0,-70.0,-67.0,-60.0,-79.0,-87.0,-79.0,-87.0,10.0,16.0,12.0,26.0,1
3033,CC:2F:71:3F:1F:24,8450228,8393083727,5236415,7987152476,3213813,405931251,80,1228444,762773176,1219915,761748914,8529,1024262,1175275,619,5241134,539932,80,5761,130000.0,43333.0,-70.0,-65.0,-71.0,-68.0,-69.0,-64.0,-71.0,-68.0,-79.0,-87.0,-79.0,-87.0,9.0,22.0,8.0,19.0,1
3034,F8:59:71:5A:E0:3D,3333506,580221737,119691,174290364,3213815,405931373,0,117710,132895040,112912,132321784,4798,573256,95433,16,122405,2509,0,522,144444.0,43333.0,-67.0,-71.0,-65.0,-70.0,-66.0,-71.0,-65.0,-70.0,-79.0,-87.0,-79.0,-87.0,12.0,16.0,14.0,17.0,1
3035,CC:2F:71:3E:C5:1F,3225204,407324579,11389,1393206,3213815,405931373,6,48622,4071828,40183,3071872,8439,999956,12008,34,16353,186,6,826,130000.0,39000.0,-69.0,-71.0,-67.0,-61.0,-69.0,-70.0,-67.0,-60.0,-79.0,-87.0,-79.0,-87.0,10.0,16.0,12.0,26.0,1
3036,CC:2F:71:3F:1F:24,8451725,8395404087,5237910,7989472714,3213815,405931373,80,1228705,762895872,1220175,761871492,8530,1024380,1175535,619,5242591,540165,80,5761,130000.0,43333.0,-69.0,-65.0,-71.0,-69.0,-69.0,-64.0,-71.0,-68.0,-79.0,-87.0,-79.0,-87.0,10.0,22.0,8.0,18.0,1
3037,F8:59:71:5A:E0:3D,3333575,580323127,119757,174391490,3213818,405931637,0,117776,132993824,112977,132420450,4799,573374,95499,16,122471,2511,0,522,144444.0,43333.0,-67.0,-72.0,-65.0,-71.0,-67.0,-71.0,-65.0,-70.0,-79.0,-87.0,-79.0,-87.0,12.0,15.0,14.0,16.0,1
3038,CC:2F:71:3E:C5:1F,3225207,407324843,11389,1393206,3213818,405931637,6,48622,4071828,40183,3071872,8439,999956,12008,34,16353,186,6,826,130000.0,39000.0,-69.0,-71.0,-67.0,-61.0,-69.0,-70.0,-67.0,-60.0,-79.0,-87.0,-79.0,-87.0,10.0,16.0,12.0,26.0,1
3039,CC:2F:71:3F:1F:24,8453776,8398583919,5239954,7992651878,3213822,405932041,80,1229039,763027435,1220509,762003055,8530,1024380,1175869,619,5244673,540325,80,5761,130000.0,43333.0,-70.0,-64.0,-72.0,-68.0,-69.0,-64.0,-71.0,-68.0,-79.0,-87.0,-79.0,-87.0,9.0,23.0,7.0,19.0,1
3040,F8:59:71:5A:E0:3D,3333646,580424743,119822,174492500,3213824,405932243,0,117841,133093938,113042,132520564,4799,573374,95563,16,122536,2511,0,522,144444.0,43333.0,-67.0,-71.0,-66.0,-71.0,-67.0,-71.0,-65.0,-71.0,-79.0,-87.0,-79.0,-87.0,12.0,16.0,13.0,16.0,1
3041,CC:2F:71:3E:C5:1F,3225213,407325449,11389,1393206,3213824,405932243,6,48622,4071828,40183,3071872,8439,999956,12008,34,16353,186,6,826,130000.0,39000.0,-69.0,-71.0,-67.0,-61.0,-69.0,-70.0,-67.0,-60.0,-79.0,-87.0,-79.0,-87.0,10.0,16.0,12.0,26.0,1
3042,CC:2F:71:3F:1F:24,8455712,8401595773,5241888,7995663530,3213824,405932243,80,1229330,763155109,1220800,762130729,8530,1024380,1176160,619,5246607,540403,80,5761,130000.0,39000.0,-70.0,-64.0,-71.0,-69.0,-69.0,-64.0,-71.0,-68.0,-79.0,-87.0,-79.0,-87.0,9.0,23.0,8.0,18.0,1
3043,F8:59:71:5A:E0:3D,3333715,580526077,119887,174593510,3213828,405932567,0,117908,133197146,113109,132623772,4799,573374,95628,16,122601,2511,0,522,144444.0,43333.0,-67.0,-72.0,-66.0,-71.0,-67.0,-71.0,-65.0,-71.0,-79.0,-87.0,-79.0,-87.0,12.0,15.0,13.0,16.0,1
3044,CC:2F:71:3E:C5:1F,3225217,407325773,11389,1393206,3213828,405932567,6,48624,4072016,40184,3071942,8440,1000074,12009,34,16353,186,6,826,130000.0,39000.0,-69.0,-71.0,-68.0,-60.0,-69.0,-70.0,-67.0,-60.0,-79.0,-87.0,-79.0,-87.0,10.0,16.0,11.0,27.0,1
3045,CC:2F:71:3F:1F:24,8457954,8405087349,5244126,7999154782,3213828,405932567,80,1229637,763284709,1221107,762260329,8530,1024380,1176467,619,5248844,540589,80,5761,130000.0,43333.0,-69.0,-64.0,-71.0,-69.0,-69.0,-64.0,-71.0,-69.0,-79.0,-87.0,-79.0,-87.0,10.0,23.0,8.0,18.0,1
3046,F8:59:71:5A:E0:3D,3333784,580624417,119950,174691244,3213834,405933173,0,117972,133295706,113173,132722332,4799,573374,95692,16,122664,2511,0,522,144444.0,43333.0,-66.0,-71.0,-66.0,-71.0,-66.0,-71.0,-65.0,-71.0,-79.0,-87.0,-79.0,-87.0,13.0,16.0,13.0,16.0,1
3047,CC:2F:71:3E:C5:1F,3225223,407326379,11389,1393206,3213834,405933173,6,48624,4072016,40184,3071942,8440,1000074,12009,34,16353,186,6,826,130000.0,39000.0,-69.0,-71.0,-68.0,-60.0,-69.0,-70.0,-67.0,-60.0,-79.0,-87.0,-79.0,-87.0,10.0,16.0,11.0,27.0,1
3048,CC:2F:71:3F:1F:24,8459381,8407288773,5245547,8001355600,3213834,405933173,80,1229904,763406745,1221374,762382365,8530,1024380,1176734,619,5250266,540627,80,5762,130000.0,43333.0,-69.0,-64.0,-71.0,-69.0,-69.0,-64.0,-71.0,-69.0,-79.0,-87.0,-79.0,-87.0,10.0,23.0,8.0,18.0,1
3049,F8:59:71:5A:E0:3D,3333850,580722794,120013,174789146,3213837,405933648,0,118034,133391186,113235,132817812,4799,573374,95754,16,122727,2512,0,522,144444.0,43333.0,-66.0,-72.0,-65.0,-71.0,-66.0,-72.0,-65.0,-70.0,-79.0,-87.0,-79.0,-87.0,13.0,15.0,14.0,16.0,1
3050,CC:2F:71:3E:C5:1F,3225226,407326854,11389,1393206,3213837,405933648,6,48624,4072016,40184,3071942,8440,1000074,12009,34,16353,186,6,826,130000.0,39000.0,-69.0,-71.0,-68.0,-60.0,-69.0,-70.0,-67.0,-60.0,-79.0,-87.0,-79.0,-87.0,10.0,16.0,11.0,27.0,1
3051,CC:2F:71:3F:1F:24,8460458,8408942308,5246621,8003008660,3213837,405933648,80,1230158,763527109,1221628,762502729,8530,1024380,1176988,619,5251340,540764,80,5762,130000.0,39000.0,-69.0,-63.0,-72.0,-68.0,-68.0,-63.0,-71.0,-68.0,-79.0,-87.0,-79.0,-87.0,10.0,24.0,7.0,19.0,1
3052,F8:59:71:5A:E0:3D,3333921,580822916,120077,174888602,3213844,405934314,0,118099,133491286,113300,132917912,4799,573374,95819,16,122791,2514,0,522,144444.0,43333.0,-67.0,-72.0,-65.0,-71.0,-66.0,-72.0,-65.0,-70.0,-79.0,-87.0,-79.0,-87.0,12.0,15.0,14.0,16.0,1
3053,CC:2F:71:3E:C5:1F,3225233,407327520,11389,1393206,3213844,405934314,6,48624,4072016,40184,3071942,8440,1000074,12009,34,16353,186,6,826,130000.0,39000.0,-69.0,-71.0,-68.0,-60.0,-69.0,-70.0,-67.0,-60.0,-79.0,-87.0,-79.0,-87.0,10.0,16.0,11.0,27.0,1
3054,CC:2F:71:3F:1F:24,8461507,8410539502,5247663,8004605188,3213844,405934314,80,1230369,763644473,1221839,762620093,8530,1024380,1177199,619,5252382,540824,80,5762,130000.0,43333.0,-69.0,-63.0,-72.0,-69.0,-69.0,-63.0,-71.0,-69.0,-79.0,-87.0,-79.0,-87.0,10.0,24.0,7.0,18.0,1
3055,F8:59:71:5A:E0:3D,3333984,580920818,120140,174986504,3213844,405934314,0,118161,133586766,113362,133013392,4799,573374,95881,16,122853,2514,0,522,144444.0,43333.0,-67.0,-72.0,-65.0,-71.0,-66.0,-72.0,-65.0,-70.0,-79.0,-87.0,-79.0,-87.0,12.0,15.0,14.0,16.0,1
3056,CC:2F:71:3E:C5:1F,3225235,407327722,11389,1393206,3213846,405934516,6,48624,4072016,40184,3071942,8440,1000074,12009,34,16353,186,6,826,130000.0,39000.0,-69.0,-71.0,-68.0,-60.0,-69.0,-70.0,-67.0,-60.0,-79.0,-87.0,-79.0,-87.0,10.0,16.0,11.0,27.0,1
3057,CC:2F:71:3F:1F:24,8462971,8412806620,5249125,8006872104,3213846,405934516,80,1230666,763771221,1222136,762746841,8530,1024380,1177496,619,5253844,540927,80,5762,130000.0,43333.0,-70.0,-64.0,-71.0,-69.0,-69.0,-63.0,-71.0,-69.0,-79.0,-87.0,-79.0,-87.0,9.0,23.0,8.0,18.0,1
3058,F8:59:71:5A:E0:3D,3334058,581024190,120206,175089068,3213852,405935122,0,118227,133688406,113428,133115032,4799,573374,95947,16,122920,2514,0,522,144444.0,43333.0,-66.0,-72.0,-66.0,-71.0,-66.0,-72.0,-65.0,-70.0,-79.0,-87.0,-79.0,-87.0,13.0,15.0,13.0,16.0,1
3059,CC:2F:71:3E:C5:1F,3225241,407328328,11389,1393206,3213852,405935122,6,48624,4072016,40184,3071942,8440,1000074,12009,34,16353,186,6,826,130000.0,39000.0,-69.0,-71.0,-68.0,-60.0,-69.0,-70.0,-67.0,-60.0,-79.0,-87.0,-79.0,-87.0,10.0,16.0,11.0,27.0,1
3060,CC:2F:71:3F:1F:24,8464436,8415067712,5250584,8009132590,3213852,405935122,80,1230931,763895725,1222401,762871345,8530,1024380,1177761,619,5255303,541098,80,5762,130000.0,43333.0,-70.0,-64.0,-72.0,-69.0,-69.0,-64.0,-71.0,-69.0,-79.0,-87.0,-79.0,-87.0,9.0,23.0,7.0,18.0,1
3061,F8:59:71:5A:E0:3D,3334122,581122152,120269,175186970,3213853,405935182,0,118291,133786966,113492,133213592,4799,573374,96011,16,122983,2514,0,522,144444.0,43333.0,-66.0,-72.0,-65.0,-70.0,-66.0,-72.0,-65.0,-70.0,-79.0,-87.0,-79.0,-87.0,13.0,15.0,14.0,17.0,1
3062,CC:2F:71:3E:C5:1F,3225242,407328388,11389,1393206,3213853,405935182,6,48624,4072016,40184,3071942,8440,1000074,12009,34,16353,186,6,826,130000.0,39000.0,-69.0,-71.0,-68.0,-60.0,-69.0,-70.0,-67.0,-60.0,-79.0,-87.0,-79.0,-87.0,10.0,16.0,11.0,27.0,1
3063,CC:2F:71:3F:1F:24,8465723,8417052310,5251868,8011116926,3213855,405935384,80,1231217,764022803,1222687,762998423,8530,1024380,1178047,619,5256587,541209,80,5762,130000.0,43333.0,-70.0,-64.0,-72.0,-69.0,-69.0,-64.0,-71.0,-69.0,-79.0,-87.0,-79.0,-87.0,9.0,23.0,7.0,18.0,1
3064,F8:59:71:5A:E0:3D,3334195,581223970,120334,175287980,3213861,405935990,0,118355,133885526,113556,133312152,4799,573374,96075,16,123048,2514,0,522,144444.0,43333.0,-66.0,-72.0,-65.0,-71.0,-66.0,-71.0,-65.0,-70.0,-79.0,-87.0,-79.0,-87.0,13.0,15.0,14.0,16.0,1
3065,CC:2F:71:3E:C5:1F,3225250,407329196,11389,1393206,3213861,405935990,6,48624,4072016,40184,3071942,8440,1000074,12009,34,16353,186,6,826,130000.0,39000.0,-69.0,-71.0,-68.0,-60.0,-69.0,-70.0,-67.0,-60.0,-79.0,-87.0,-79.0,-87.0,10.0,16.0,11.0,27.0,1
3066,CC:2F:71:3F:1F:24,8466818,8418721992,5252957,8012786002,3213861,405935990,80,1231452,764141562,1222922,763117182,8530,1024380,1178282,619,5257675,541291,80,5762,130000.0,43333.0,-69.0,-64.0,-71.0,-69.0,-68.0,-63.0,-71.0,-69.0,-79.0,-87.0,-79.0,-87.0,10.0,23.0,8.0,18.0,1
3067,F8:59:71:5A:E0:3D,3334258,581321872,120397,175385882,3213861,405935990,0,118419,133984086,113620,133410712,4799,573374,96139,16,123111,2514,0,522,144444.0,43333.0,-66.0,-72.0,-66.0,-71.0,-66.0,-72.0,-65.0,-70.0,-79.0,-87.0,-79.0,-87.0,13.0,15.0,13.0,16.0,1
3068,CC:2F:71:3E:C5:1F,3225250,407329196,11389,1393206,3213861,405935990,6,48624,4072016,40184,3071942,8440,1000074,12009,34,16353,186,6,826,130000.0,39000.0,-69.0,-71.0,-68.0,-60.0,-69.0,-70.0,-67.0,-60.0,-79.0,-87.0,-79.0,-87.0,10.0,16.0,11.0,27.0,1
3069,CC:2F:71:3F:1F:24,8468051,8420624604,5254189,8014688554,3213862,405936050,80,1231708,764262154,1223178,763237774,8530,1024380,1178538,619,5258884,541417,80,5762,130000.0,43333.0,-69.0,-64.0,-71.0,-69.0,-69.0,-64.0,-71.0,-69.0,-79.0,-87.0,-79.0,-87.0,10.0,23.0,8.0,18.0,1
3070,F8:59:71:5A:E0:3D,3334333,581422406,120461,175485338,3213872,405937068,0,118485,134082982,113684,133509286,4801,573696,96204,16,123175,2514,0,522,144444.0,43333.0,-67.0,-73.0,-66.0,-71.0,-66.0,-72.0,-65.0,-70.0,-79.0,-87.0,-79.0,-87.0,12.0,14.0,13.0,16.0,1
3071,CC:2F:71:3E:C5:1F,3225261,407330274,11389,1393206,3213872,405937068,6,48624,4072016,40184,3071942,8440,1000074,12009,34,16353,186,6,826,130000.0,39000.0,-69.0,-71.0,-68.0,-60.0,-69.0,-70.0,-67.0,-60.0,-79.0,-87.0,-79.0,-87.0,10.0,16.0,11.0,27.0,1
3072,CC:2F:71:3F:1F:24,8469326,8422580112,5255454,8016643044,3213872,405937068,80,1231983,764386438,1223453,763362058,8530,1024380,1178813,619,5260173,541515,80,5762,117000.0,39000.0,-68.0,-64.0,-71.0,-69.0,-68.0,-63.0,-71.0,-69.0,-79.0,-87.0,-79.0,-87.0,11.0,23.0,8.0,18.0,1
3073,F8:59:71:5A:E0:3D,3334396,581520308,120524,175583240,3213872,405937068,0,118549,134181542,113748,133607846,4801,573696,96268,16,123238,2515,0,522,144444.0,43333.0,-66.0,-72.0,-65.0,-70.0,-66.0,-72.0,-65.0,-70.0,-79.0,-87.0,-79.0,-87.0,13.0,15.0,14.0,17.0,1
3074,CC:2F:71:3E:C5:1F,3225261,407330274,11389,1393206,3213872,405937068,6,48624,4072016,40184,3071942,8440,1000074,12009,34,16353,186,6,826,130000.0,39000.0,-69.0,-71.0,-68.0,-60.0,-69.0,-70.0,-67.0,-60.0,-79.0,-87.0,-79.0,-87.0,10.0,16.0,11.0,27.0,1
3075,CC:2F:71:3F:1F:24,8470443,8424300634,5256571,8018363566,3213872,405937068,80,1232232,764507694,1223702,763483314,8530,1024380,1179062,619,5261290,541638,80,5762,130000.0,43333.0,-70.0,-64.0,-72.0,-70.0,-69.0,-64.0,-71.0,-70.0,-79.0,-87.0,-79.0,-87.0,9.0,23.0,7.0,17.0,1
3076,F8:59:71:5A:E0:3D,3334467,581623336,120590,175685804,3213877,405937532,0,118614,134281642,113813,133707946,4801,573696,96333,16,123304,2515,0,522,144444.0,43333.0,-66.0,-72.0,-65.0,-70.0,-66.0,-72.0,-65.0,-70.0,-79.0,-87.0,-79.0,-87.0,13.0,15.0,14.0,17.0,1
3077,CC:2F:71:3E:C5:1F,3225270,407331142,11389,1393206,3213881,405937936,6,48624,4072016,40184,3071942,8440,1000074,12009,34,16353,186,6,826,130000.0,39000.0,-69.0,-71.0,-68.0,-60.0,-69.0,-70.0,-67.0,-60.0,-79.0,-87.0,-79.0,-87.0,10.0,16.0,11.0,27.0,1
3078,CC:2F:71:3F:1F:24,8471566,8426010308,5257685,8020072372,3213881,405937936,80,1232482,764633870,1223952,763609490,8530,1024380,1179312,619,5262404,541715,80,5762,130000.0,43333.0,-70.0,-64.0,-71.0,-70.0,-69.0,-64.0,-71.0,-69.0,-79.0,-87.0,-79.0,-87.0,9.0,23.0,8.0,17.0,1
3079,F8:59:71:5A:E0:3D,3334536,581724750,120655,175786814,3213881,405937936,0,118680,134383282,113879,133809586,4801,573696,96399,16,123369,2516,0,522,144444.0,43333.0,-66.0,-72.0,-65.0,-70.0,-66.0,-71.0,-65.0,-70.0,-79.0,-87.0,-79.0,-87.0,13.0,15.0,14.0,17.0,1
3080,CC:2F:71:3E:C5:1F,3225270,407331142,11389,1393206,3213881,405937936,6,48624,4072016,40184,3071942,8440,1000074,12009,34,16353,186,6,826,130000.0,39000.0,-69.0,-71.0,-68.0,-60.0,-69.0,-70.0,-67.0,-60.0,-79.0,-87.0,-79.0,-87.0,10.0,16.0,11.0,27.0,1
3081,CC:2F:71:3F:1F:24,8472783,8427888942,5258902,8021951006,3213881,405937936,80,1232731,764755308,1224201,763730928,8530,1024380,1179561,619,5263621,541935,80,5763,130000.0,43333.0,-69.0,-64.0,-72.0,-71.0,-69.0,-64.0,-71.0,-71.0,-79.0,-87.0,-79.0,-87.0,10.0,23.0,7.0,16.0,1
3082,F8:59:71:5A:E0:3D,3334602,581824408,120719,175886270,3213883,405938138,0,118743,134480302,113942,133906606,4801,573696,96462,16,123433,2517,0,522,144444.0,43333.0,-66.0,-71.0,-65.0,-71.0,-66.0,-71.0,-65.0,-70.0,-79.0,-87.0,-79.0,-87.0,13.0,16.0,14.0,16.0,1
3083,CC:2F:71:3E:C5:1F,3225274,407331546,11389,1393206,3213885,405938340,6,48624,4072016,40184,3071942,8440,1000074,12009,34,16353,186,6,826,130000.0,39000.0,-69.0,-71.0,-68.0,-60.0,-69.0,-70.0,-67.0,-60.0,-79.0,-87.0,-79.0,-87.0,10.0,16.0,11.0,27.0,1
3084,CC:2F:71:3F:1F:24,8473584,8429102466,5259697,8023163924,3213887,405938542,80,1232948,764874196,1224418,763849816,8530,1024380,1179778,619,5264416,541968,80,5763,130000.0,43333.0,-69.0,-64.0,-71.0,-70.0,-69.0,-64.0,-71.0,-69.0,-79.0,-87.0,-79.0,-87.0,10.0,23.0,8.0,17.0,1
3085,F8:59:71:5A:E0:3D,3334674,581926084,120784,175987280,3213890,405938804,0,118808,134580458,114007,134006762,4801,573696,96527,16,123498,2518,0,523,144444.0,43333.0,-67.0,-71.0,-65.0,-70.0,-66.0,-71.0,-64.0,-70.0,-79.0,-87.0,-79.0,-87.0,12.0,16.0,14.0,17.0,1
3086,CC:2F:71:3E:C5:1F,3225279,407332010,11389,1393206,3213890,405938804,6,48624,4072016,40184,3071942,8440,1000074,12009,34,16353,186,6,826,130000.0,39000.0,-69.0,-71.0,-68.0,-60.0,-69.0,-70.0,-67.0,-60.0,-79.0,-87.0,-79.0,-87.0,10.0,16.0,11.0,27.0,1
3087,CC:2F:71:3F:1F:24,8474623,8430697440,5260733,8024758636,3213890,405938804,80,1233189,764993140,1224659,763968760,8530,1024380,1180019,619,5265452,542016,80,5763,130000.0,43333.0,-69.0,-64.0,-71.0,-70.0,-68.0,-64.0,-71.0,-70.0,-79.0,-87.0,-79.0,-87.0,10.0,23.0,8.0,17.0,1
3088,F8:59:71:5A:E0:3D,3334739,582024188,120847,176085182,3213892,405939006,0,118872,134679032,114071,134105336,4801,573696,96590,16,123561,2518,0,523,144444.0,43333.0,-67.0,-72.0,-65.0,-70.0,-66.0,-71.0,-65.0,-70.0,-79.0,-87.0,-79.0,-87.0,12.0,15.0,14.0,17.0,1
3089,CC:2F:71:3E:C5:1F,3225281,407332212,11389,1393206,3213892,405939006,6,48624,4072016,40184,3071942,8440,1000074,12009,34,16353,186,6,826,130000.0,39000.0,-69.0,-71.0,-68.0,-60.0,-69.0,-70.0,-67.0,-60.0,-79.0,-87.0,-79.0,-87.0,10.0,16.0,11.0,27.0,1
3090,CC:2F:71:3F:1F:24,8475604,8432191702,5261712,8026252696,3213892,405939006,80,1233401,765110471,1224871,764086091,8530,1024380,1180230,619,5266431,542152,80,5763,130000.0,43333.0,-69.0,-64.0,-72.0,-70.0,-69.0,-64.0,-72.0,-70.0,-79.0,-87.0,-79.0,-87.0,10.0,23.0,7.0,17.0,1
3091,F8:59:71:5A:E0:3D,3334811,582124639,120912,176184754,3213899,405939885,0,118938,134779252,114137,134205556,4801,573696,96655,16,123626,2519,0,523,144444.0,43333.0,-67.0,-71.0,-65.0,-70.0,-66.0,-71.0,-65.0,-70.0,-79.0,-87.0,-79.0,-87.0,12.0,16.0,14.0,17.0,1
3092,CC:2F:71:3E:C5:1F,3225288,407333091,11389,1393206,3213899,405939885,6,48624,4072016,40184,3071942,8440,1000074,12009,34,16353,186,6,826,130000.0,39000.0,-69.0,-71.0,-68.0,-60.0,-69.0,-70.0,-67.0,-60.0,-79.0,-87.0,-79.0,-87.0,10.0,16.0,11.0,27.0,1
3093,CC:2F:71:3F:1F:24,8477088,8434481719,5263189,8028541834,3213899,405939885,80,1233650,765231773,1225120,764207393,8530,1024380,1180479,619,5267894,542245,80,5763,130000.0,43333.0,-69.0,-64.0,-72.0,-70.0,-69.0,-64.0,-71.0,-70.0,-79.0,-87.0,-79.0,-87.0,10.0,23.0,7.0,17.0,1
3094,F8:59:71:5A:E0:3D,3334875,582222601,120975,176282656,3213900,405939945,0,119002,134877812,114201,134304116,4801,573696,96719,16,123689,2519,0,523,144444.0,43333.0,-67.0,-72.0,-65.0,-71.0,-67.0,-72.0,-65.0,-70.0,-79.0,-87.0,-79.0,-87.0,12.0,15.0,14.0,16.0,1
3095,CC:2F:71:3E:C5:1F,3225291,407333353,11389,1393206,3213902,405940147,6,48624,4072016,40184,3071942,8440,1000074,12009,34,16353,186,6,826,130000.0,39000.0,-69.0,-71.0,-68.0,-60.0,-69.0,-70.0,-67.0,-60.0,-79.0,-87.0,-79.0,-87.0,10.0,16.0,11.0,27.0,1
3096,CC:2F:71:3F:1F:24,8478391,8436493261,5264489,8030553114,3213902,405940147,80,1233919,765355251,1225389,764330871,8530,1024380,1180748,619,5269194,542391,80,5763,130000.0,43333.0,-69.0,-64.0,-72.0,-70.0,-69.0,-64.0,-71.0,-70.0,-79.0,-87.0,-79.0,-87.0,10.0,23.0,7.0,17.0,1
3097,F8:59:71:5A:E0:3D,3334946,582321311,121038,176380558,3213908,405940753,0,119066,134976386,114265,134402690,4801,573696,96782,16,123752,2519,0,523,144444.0,43333.0,-67.0,-72.0,-65.0,-71.0,-66.0,-71.0,-65.0,-70.0,-79.0,-87.0,-79.0,-87.0,12.0,15.0,14.0,16.0,1
3098,CC:2F:71:3E:C5:1F,3225297,407333959,11389,1393206,3213908,405940753,6,48624,4072016,40184,3071942,8440,1000074,12009,34,16353,186,6,826,130000.0,39000.0,-69.0,-71.0,-68.0,-60.0,-69.0,-70.0,-67.0,-60.0,-79.0,-87.0,-79.0,-87.0,10.0,16.0,11.0,27.0,1
3099,CC:2F:71:3F:1F:24,8479491,8438181351,5265583,8032240598,3213908,405940753,80,1234157,765472449,1225627,764448069,8530,1024380,1180986,619,5270302,542452,80,5763,130000.0,43333.0,-69.0,-65.0,-72.0,-71.0,-69.0,-64.0,-72.0,-70.0,-79.0,-87.0,-79.0,-87.0,10.0,22.0,7.0,16.0,1
3100,F8:59:71:5A:E0:3D,3335011,582421438,121103,176480685,3213908,405940753,0,119130,135073556,114329,134499860,4801,573696,96846,16,123817,2519,0,523,144444.0,43333.0,-67.0,-72.0,-65.0,-70.0,-67.0,-71.0,-64.0,-70.0,-79.0,-87.0,-79.0,-87.0,12.0,15.0,14.0,17.0,1
3101,CC:2F:71:3E:C5:1F,3225297,407333959,11389,1393206,3213908,405940753,6,48624,4072016,40184,3071942,8440,1000074,12009,34,16353,186,6,826,130000.0,39000.0,-69.0,-71.0,-68.0,-60.0,-69.0,-70.0,-67.0,-60.0,-79.0,-87.0,-79.0,-87.0,10.0,16.0,11.0,27.0,1
3102,CC:2F:71:3F:1F:24,8480665,8439993779,5266757,8034053026,3213908,405940753,80,1234438,765598911,1225908,764574531,8530,1024380,1181267,619,5271441,542490,80,5763,130000.0,43333.0,-69.0,-64.0,-72.0,-70.0,-68.0,-64.0,-71.0,-70.0,-79.0,-87.0,-79.0,-87.0,10.0,23.0,7.0,17.0,1
3103,F8:59:71:5A:E0:3D,3335085,582523316,121168,176581695,3213917,405941621,0,119196,135175196,114395,134601500,4801,573696,96912,16,123882,2519,0,523,144444.0,43333.0,-66.0,-72.0,-65.0,-70.0,-66.0,-71.0,-64.0,-70.0,-79.0,-87.0,-79.0,-87.0,13.0,15.0,14.0,17.0,1
3104,CC:2F:71:3E:C5:1F,3225306,407334827,11389,1393206,3213917,405941621,6,48624,4072016,40184,3071942,8440,1000074,12009,34,16353,186,6,826,130000.0,39000.0,-69.0,-71.0,-68.0,-60.0,-69.0,-70.0,-67.0,-60.0,-79.0,-87.0,-79.0,-87.0,10.0,16.0,11.0,27.0,1
3105,CC:2F:71:3F:1F:24,8481705,8441569543,5267788,8035627922,3213917,405941621,80,1234678,765721112,1226148,764696732,8530,1024380,1181507,619,5272507,542590,80,5763,130000.0,43333.0,-68.0,-64.0,-70.0,-70.0,-68.0,-64.0,-71.0,-70.0,-79.0,-87.0,-79.0,-87.0,11.0,23.0,9.0,17.0,1
3106,F8:59:71:5A:E0:3D,3335154,582627802,121235,176685813,3213919,405941989,0,119262,135276836,114461,134703140,4801,573696,96978,16,123949,2519,0,523,144444.0,43333.0,-67.0,-72.0,-64.0,-70.0,-66.0,-71.0,-64.0,-70.0,-79.0,-87.0,-79.0,-87.0,12.0,15.0,15.0,17.0,1
3107,CC:2F:71:3E:C5:1F,3225308,407335195,11389,1393206,3213919,405941989,6,48624,4072016,40184,3071942,8440,1000074,12009,34,16353,186,6,826,130000.0,39000.0,-69.0,-71.0,-68.0,-60.0,-69.0,-70.0,-67.0,-60.0,-79.0,-87.0,-79.0,-87.0,10.0,16.0,11.0,27.0,1
3108,CC:2F:71:3F:1F:24,8482789,8443235333,5268870,8037293344,3213919,405941989,80,1234918,765842744,1226388,764818364,8530,1024380,1181747,619,5273589,542762,80,5764,130000.0,39000.0,-69.0,-64.0,-71.0,-70.0,-68.0,-64.0,-71.0,-70.0,-79.0,-87.0,-79.0,-87.0,10.0,23.0,8.0,17.0,1
3109,F8:59:71:5A:E0:3D,3335224,582724934,121298,176782277,3213926,405942657,0,119325,135373856,114524,134800160,4801,573696,97041,16,124012,2520,0,523,144444.0,43333.0,-66.0,-72.0,-65.0,-70.0,-66.0,-71.0,-65.0,-70.0,-79.0,-87.0,-79.0,-87.0,13.0,15.0,14.0,17.0,1
3110,CC:2F:71:3E:C5:1F,3225316,407335979,11390,1393322,3213926,405942657,6,48628,4072344,40187,3072152,8441,1000192,12010,34,16354,186,6,826,130000.0,39000.0,-70.0,-71.0,-67.0,-60.0,-69.0,-71.0,-67.0,-60.0,-79.0,-87.0,-79.0,-87.0,9.0,16.0,12.0,27.0,1
3111,CC:2F:71:3F:1F:24,8483970,8445045443,5270042,8039102584,3213928,405942859,80,1235163,765962116,1226633,764937736,8530,1024380,1181992,619,5274761,542833,80,5764,130000.0,43333.0,-70.0,-64.0,-73.0,-70.0,-68.0,-64.0,-71.0,-70.0,-79.0,-87.0,-79.0,-87.0,9.0,23.0,6.0,17.0,1
3112,F8:59:71:5A:E0:3D,3335292,582826206,121363,176883287,3213929,405942919,0,119390,135473956,114589,134900260,4801,573696,97106,16,124077,2520,0,523,144444.0,43333.0,-67.0,-72.0,-65.0,-71.0,-66.0,-72.0,-65.0,-70.0,-79.0,-87.0,-79.0,-87.0,12.0,15.0,14.0,16.0,1
3113,CC:2F:71:3E:C5:1F,3225319,407336241,11390,1393322,3213929,405942919,6,48628,4072344,40187,3072152,8441,1000192,12010,34,16354,186,6,826,130000.0,39000.0,-70.0,-71.0,-67.0,-60.0,-69.0,-71.0,-67.0,-60.0,-79.0,-87.0,-79.0,-87.0,9.0,16.0,12.0,27.0,1
3114,CC:2F:71:3F:1F:24,8485573,8447530443,5271644,8041587524,3213929,405942919,80,1235437,766089026,1226907,765064646,8530,1024380,1182266,619,5276320,543243,80,5765,130000.0,43333.0,-68.0,-64.0,-71.0,-70.0,-68.0,-64.0,-71.0,-70.0,-79.0,-87.0,-79.0,-87.0,11.0,23.0,8.0,17.0,1
3115,F8:59:71:5A:E0:3D,3335363,582927654,121428,176984129,3213935,405943525,0,119455,135574070,114654,135000374,4801,573696,97170,16,124142,2520,0,523,144444.0,43333.0,-66.0,-71.0,-65.0,-70.0,-66.0,-71.0,-65.0,-70.0,-79.0,-87.0,-79.0,-87.0,13.0,16.0,14.0,17.0,1
3116,CC:2F:71:3E:C5:1F,3225325,407336847,11390,1393322,3213935,405943525,6,48628,4072344,40187,3072152,8441,1000192,12010,34,16354,186,6,826,130000.0,39000.0,-70.0,-71.0,-67.0,-60.0,-69.0,-71.0,-67.0,-60.0,-79.0,-87.0,-79.0,-87.0,9.0,16.0,12.0,27.0,1
3117,CC:2F:71:3F:1F:24,8487012,8449742623,5273077,8043799098,3213935,405943525,80,1235712,766213901,1227182,765189521,8530,1024380,1182541,619,5277791,543569,80,5765,130000.0,43333.0,-69.0,-64.0,-72.0,-70.0,-68.0,-64.0,-71.0,-70.0,-79.0,-87.0,-79.0,-87.0,10.0,23.0,7.0,17.0,1
3118,F8:59:71:5A:E0:3D,3335429,583025818,121491,177082031,3213938,405943787,0,119518,135671090,114717,135097394,4801,573696,97233,16,124205,2521,0,523,144444.0,43333.0,-66.0,-72.0,-65.0,-70.0,-66.0,-71.0,-65.0,-70.0,-79.0,-87.0,-79.0,-87.0,13.0,15.0,14.0,17.0,1
3119,CC:2F:71:3E:C5:1F,3225328,407337109,11390,1393322,3213938,405943787,6,48628,4072344,40187,3072152,8441,1000192,12010,34,16354,186,6,826,130000.0,39000.0,-70.0,-71.0,-67.0,-60.0,-69.0,-71.0,-67.0,-60.0,-79.0,-87.0,-79.0,-87.0,9.0,16.0,12.0,27.0,1
3120,CC:2F:71:3F:1F:24,8487792,8450928919,5273854,8044985132,3213938,405943787,80,1235929,766328653,1227399,765304273,8530,1024380,1182758,619,5278573,543631,80,5765,130000.0,43333.0,-69.0,-64.0,-72.0,-70.0,-69.0,-64.0,-71.0,-70.0,-79.0,-87.0,-79.0,-87.0,10.0,23.0,7.0,17.0,1
3121,F8:59:71:5A:E0:3D,3335496,583124124,121554,177179933,3213942,405944191,0,119582,135769650,114781,135195954,4801,573696,97297,16,124268,2522,0,523,144444.0,43333.0,-66.0,-71.0,-65.0,-71.0,-66.0,-71.0,-65.0,-70.0,-79.0,-87.0,-79.0,-87.0,13.0,16.0,14.0,16.0,1
3122,CC:2F:71:3E:C5:1F,3225334,407337715,11390,1393322,3213944,405944393,6,48628,4072344,40187,3072152,8441,1000192,12010,34,16354,186,6,826,130000.0,39000.0,-70.0,-71.0,-67.0,-60.0,-69.0,-71.0,-67.0,-60.0,-79.0,-87.0,-79.0,-87.0,9.0,16.0,12.0,27.0,1
3123,CC:2F:71:3F:1F:24,8488661,8452251083,5274717,8046306690,3213944,405944393,80,1236164,766448211,1227634,765423831,8530,1024380,1182993,619,5279426,543750,80,5765,117000.0,39000.0,-69.0,-64.0,-71.0,-70.0,-68.0,-64.0,-71.0,-70.0,-79.0,-87.0,-79.0,-87.0,10.0,23.0,8.0,17.0,1
3124,F8:59:71:5A:E0:3D,3335564,583223984,121618,177279389,3213946,405944595,0,119645,135866670,114844,135292974,4801,573696,97360,16,124332,2522,0,523,144444.0,43333.0,-67.0,-71.0,-64.0,-70.0,-66.0,-71.0,-64.0,-70.0,-79.0,-87.0,-79.0,-87.0,12.0,16.0,15.0,17.0,1
3125,CC:2F:71:3E:C5:1F,3225336,407337917,11390,1393322,3213946,405944595,6,48628,4072344,40187,3072152,8441,1000192,12010,34,16354,186,6,826,130000.0,39000.0,-70.0,-71.0,-67.0,-60.0,-69.0,-71.0,-67.0,-60.0,-79.0,-87.0,-79.0,-87.0,9.0,16.0,12.0,27.0,1
3126,CC:2F:71:3F:1F:24,8490011,8454336773,5276065,8048392178,3213946,405944595,80,1236490,766577009,1227960,765552629,8530,1024380,1183319,619,5280776,543818,80,5765,130000.0,43333.0,-69.0,-64.0,-71.0,-70.0,-68.0,-64.0,-71.0,-70.0,-79.0,-87.0,-79.0,-87.0,10.0,23.0,8.0,17.0,1
3127,F8:59:71:5A:E0:3D,3335647,583336896,121687,177386615,3213960,405950281,0,119715,135974526,114914,135400830,4801,573696,97430,16,124401,2523,0,523,144444.0,43333.0,-67.0,-72.0,-65.0,-71.0,-66.0,-71.0,-65.0,-70.0,-79.0,-87.0,-79.0,-87.0,12.0,15.0,14.0,16.0,1
3128,CC:2F:71:3E:C5:1F,3225366,407349493,11390,1393322,3213976,405956171,6,48628,4072344,40187,3072152,8441,1000192,12010,34,16354,186,6,826,130000.0,39000.0,-70.0,-71.0,-67.0,-60.0,-69.0,-71.0,-67.0,-60.0,-79.0,-87.0,-79.0,-87.0,9.0,16.0,12.0,27.0,1
3129,CC:2F:71:3F:1F:24,8490748,8455414591,5276772,8049458420,3213976,405956171,80,1236716,766711955,1228186,765687575,8530,1024380,1183545,619,5281491,543850,80,5766,130000.0,43333.0,-68.0,-64.0,-70.0,-69.0,-68.0,-64.0,-71.0,-69.0,-79.0,-87.0,-79.0,-87.0,11.0,23.0,9.0,18.0,1
3130,F8:59:71:5A:E0:3D,3335733,583448660,121755,177492287,3213978,405956373,0,119785,136080918,114983,135507104,4802,573814,97499,16,124469,2524,0,523,144444.0,43333.0,-67.0,-72.0,-65.0,-70.0,-66.0,-71.0,-65.0,-70.0,-79.0,-87.0,-79.0,-87.0,12.0,15.0,14.0,17.0,1
3131,CC:2F:71:3E:C5:1F,3225368,407349695,11390,1393322,3213978,405956373,6,48628,4072344,40187,3072152,8441,1000192,12010,34,16354,186,6,826,130000.0,39000.0,-70.0,-71.0,-67.0,-60.0,-69.0,-71.0,-67.0,-60.0,-79.0,-87.0,-79.0,-87.0,9.0,16.0,12.0,27.0,1
3132,CC:2F:71:3F:1F:24,8491746,8456946041,5277768,8050989668,3213978,405956373,80,1236932,766826571,1228402,765802191,8530,1024380,1183761,619,5282487,543908,80,5766,130000.0,39000.0,-69.0,-64.0,-72.0,-70.0,-68.0,-64.0,-71.0,-70.0,-79.0,-87.0,-79.0,-87.0,10.0,23.0,7.0,17.0,1
3133,F8:59:71:5A:E0:3D,3335796,583545281,121817,177588635,3213979,405956646,0,119846,136174858,115044,135601044,4802,573814,97560,16,124531,2525,0,523,144444.0,43333.0,-67.0,-71.0,-65.0,-70.0,-66.0,-71.0,-65.0,-70.0,-79.0,-87.0,-79.0,-87.0,12.0,16.0,14.0,17.0,1
3134,CC:2F:71:3E:C5:1F,3225371,407350170,11390,1393322,3213981,405956848,6,48628,4072344,40187,3072152,8441,1000192,12010,34,16354,186,6,826,130000.0,39000.0,-70.0,-71.0,-67.0,-60.0,-69.0,-71.0,-67.0,-60.0,-79.0,-87.0,-79.0,-87.0,9.0,16.0,12.0,27.0,1
3135,CC:2F:71:3F:1F:24,8492543,8458157848,5278562,8052201000,3213981,405956848,80,1237191,766946253,1228661,765921873,8530,1024380,1184020,619,5283281,543941,80,5766,130000.0,43333.0,-68.0,-64.0,-71.0,-70.0,-68.0,-64.0,-71.0,-70.0,-79.0,-87.0,-79.0,-87.0,11.0,23.0,8.0,17.0,1
3136,F8:59:71:5A:E0:3D,3335865,583642295,121879,177684983,3213986,405957312,0,119908,136270338,115106,135696524,4802,573814,97622,16,124593,2525,0,523,144444.0,43333.0,-66.0,-72.0,-65.0,-70.0,-66.0,-71.0,-64.0,-70.0,-79.0,-87.0,-79.0,-87.0,13.0,15.0,14.0,17.0,1
3137,CC:2F:71:3E:C5:1F,3225376,407350634,11390,1393322,3213986,405957312,6,48628,4072344,40187,3072152,8441,1000192,12010,34,16354,186,6,826,130000.0,39000.0,-70.0,-71.0,-67.0,-60.0,-69.0,-71.0,-67.0,-60.0,-79.0,-87.0,-79.0,-87.0,9.0,16.0,12.0,27.0,1
3138,CC:2F:71:3F:1F:24,8493369,8459409376,5279381,8053451862,3213988,405957514,80,1237389,767058781,1228859,766034401,8530,1024380,1184218,619,5284100,544006,80,5766,130000.0,43333.0,-69.0,-64.0,-72.0,-70.0,-68.0,-64.0,-71.0,-70.0,-79.0,-87.0,-79.0,-87.0,10.0,23.0,7.0,17.0,1
3139,F8:59:71:5A:E0:3D,3335929,583738845,121941,177781331,3213988,405957514,0,119971,136367358,115169,135793544,4802,573814,97685,16,124655,2525,0,523,144444.0,43333.0,-67.0,-72.0,-66.0,-71.0,-66.0,-71.0,-65.0,-70.0,-79.0,-87.0,-79.0,-87.0,12.0,15.0,13.0,16.0,1
3140,CC:2F:71:3E:C5:1F,3225378,407350836,11390,1393322,3213988,405957514,6,48628,4072344,40187,3072152,8441,1000192,12010,34,16354,186,6,826,130000.0,39000.0,-70.0,-71.0,-67.0,-60.0,-69.0,-71.0,-67.0,-60.0,-79.0,-87.0,-79.0,-87.0,9.0,16.0,12.0,27.0,1
3141,CC:2F:71:3F:1F:24,8494199,8460678796,5280211,8054721282,3213988,405957514,80,1237602,767174447,1229072,766150067,8530,1024380,1184431,619,5284930,544036,80,5766,130000.0,43333.0,-69.0,-64.0,-71.0,-70.0,-68.0,-64.0,-71.0,-70.0,-79.0,-87.0,-79.0,-87.0,10.0,23.0,8.0,17.0,1
3142,F8:59:71:5A:E0:3D,3335999,583837469,122005,177879349,3213994,405958120,0,120035,136464484,115233,135890670,4802,573814,97749,16,124719,2526,0,523,144444.0,43333.0,-67.0,-72.0,-65.0,-70.0,-66.0,-71.0,-65.0,-70.0,-79.0,-87.0,-79.0,-87.0,12.0,15.0,14.0,17.0,1
3143,CC:2F:71:3E:C5:1F,3225384,407351442,11390,1393322,3213994,405958120,6,48628,4072344,40187,3072152,8441,1000192,12010,34,16354,186,6,826,130000.0,39000.0,-70.0,-71.0,-67.0,-60.0,-69.0,-71.0,-67.0,-60.0,-79.0,-87.0,-79.0,-87.0,9.0,16.0,12.0,27.0,1
3144,CC:2F:71:3F:1F:24,8495038,8461939331,5281044,8055981211,3213994,405958120,80,1237832,767292734,1229302,766268354,8530,1024380,1184661,619,5285763,544088,80,5766,130000.0,43333.0,-70.0,-64.0,-72.0,-69.0,-69.0,-64.0,-71.0,-69.0,-79.0,-87.0,-79.0,-87.0,9.0,23.0,7.0,18.0,1
3145,F8:59:71:5A:E0:3D,3336065,583935633,122068,177977251,3213997,405958382,0,120098,136561504,115296,135987690,4802,573814,97812,16,124782,2526,0,523,144444.0,43333.0,-67.0,-72.0,-66.0,-71.0,-66.0,-71.0,-65.0,-70.0,-79.0,-87.0,-79.0,-87.0,12.0,15.0,13.0,16.0,1
3146,CC:2F:71:3E:C5:1F,3225388,407351766,11390,1393322,3213998,405958444,6,48628,4072344,40187,3072152,8441,1000192,12010,34,16354,186,6,826,130000.0,39000.0,-70.0,-71.0,-67.0,-60.0,-69.0,-71.0,-67.0,-60.0,-79.0,-87.0,-79.0,-87.0,9.0,16.0,12.0,27.0,1
3147,CC:2F:71:3F:1F:24,8496073,8463526477,5282075,8057568033,3213998,405958444,80,1238059,767409948,1229528,766385450,8531,1024498,1184888,619,5286784,544161,80,5766,130000.0,43333.0,-69.0,-64.0,-71.0,-70.0,-68.0,-64.0,-71.0,-70.0,-79.0,-87.0,-79.0,-87.0,10.0,23.0,8.0,17.0,1
3148,F8:59:71:5A:E0:3D,3336135,584034203,122131,178075153,3214004,405959050,0,120160,136656984,115358,136083170,4802,573814,97874,16,124845,2527,0,523,144444.0,43333.0,-66.0,-71.0,-65.0,-70.0,-66.0,-71.0,-65.0,-70.0,-79.0,-87.0,-79.0,-87.0,13.0,16.0,14.0,17.0,1
3149,CC:2F:71:3E:C5:1F,3225394,407352372,11390,1393322,3214004,405959050,6,48628,4072344,40187,3072152,8441,1000192,12010,34,16354,186,6,826,130000.0,39000.0,-70.0,-71.0,-67.0,-60.0,-69.0,-71.0,-67.0,-60.0,-79.0,-87.0,-79.0,-87.0,9.0,16.0,12.0,27.0,1
3150,CC:2F:71:3F:1F:24,8497190,8465239721,5283186,8059280671,3214004,405959050,80,1238295,767526774,1229764,766502276,8531,1024498,1185124,619,5287905,544213,80,5766,130000.0,43333.0,-69.0,-64.0,-72.0,-70.0,-68.0,-64.0,-71.0,-70.0,-79.0,-87.0,-79.0,-87.0,10.0,23.0,7.0,17.0,1
3151,F8:59:71:5A:E0:3D,3336200,584132307,122194,178173055,3214006,405959252,0,120223,136754004,115421,136180190,4802,573814,97937,16,124908,2527,0,523,144444.0,43333.0,-67.0,-72.0,-65.0,-70.0,-66.0,-71.0,-64.0,-70.0,-79.0,-87.0,-79.0,-87.0,12.0,15.0,14.0,17.0,1
3152,CC:2F:71:3E:C5:1F,3225396,407352574,11390,1393322,3214006,405959252,6,48628,4072344,40187,3072152,8441,1000192,12010,34,16354,186,6,826,130000.0,39000.0,-70.0,-71.0,-67.0,-60.0,-69.0,-71.0,-67.0,-60.0,-79.0,-87.0,-79.0,-87.0,9.0,16.0,12.0,27.0,1
3153,CC:2F:71:3F:1F:24,8498385,8467080933,5284379,8061121681,3214006,405959252,80,1238537,767645798,1230006,766621300,8531,1024498,1185366,619,5289098,544253,80,5766,130000.0,43333.0,-69.0,-65.0,-71.0,-70.0,-69.0,-64.0,-72.0,-70.0,-79.0,-87.0,-79.0,-87.0,10.0,22.0,8.0,17.0,1
3154,F8:59:71:5A:E0:3D,3336266,584227565,122255,178267849,3214011,405959716,0,120285,136849484,115483,136275670,4802,573814,97999,16,124969,2528,0,523,144444.0,43333.0,-66.0,-71.0,-65.0,-70.0,-66.0,-71.0,-65.0,-70.0,-79.0,-87.0,-79.0,-87.0,13.0,16.0,14.0,17.0,1
3155,CC:2F:71:3E:C5:1F,3225403,407353240,11390,1393322,3214013,405959918,6,48628,4072344,40187,3072152,8441,1000192,12010,34,16354,186,6,826,130000.0,39000.0,-70.0,-71.0,-67.0,-60.0,-69.0,-71.0,-67.0,-60.0,-79.0,-87.0,-79.0,-87.0,9.0,16.0,12.0,27.0,1
3156,CC:2F:71:3F:1F:24,8499552,8468865883,5285539,8062905965,3214013,405959918,80,1238755,767759848,1230224,766735350,8531,1024498,1185584,619,5290220,544299,80,5768,130000.0,43333.0,-69.0,-64.0,-72.0,-70.0,-69.0,-64.0,-71.0,-70.0,-79.0,-87.0,-79.0,-87.0,10.0,23.0,7.0,17.0,1
3157,F8:59:71:5A:E0:3D,3336333,584325871,122318,178365751,3214015,405960120,0,120347,136944964,115545,136371150,4802,573814,98061,16,125032,2529,0,523,144444.0,43333.0,-66.0,-72.0,-65.0,-70.0,-66.0,-71.0,-65.0,-70.0,-79.0,-87.0,-79.0,-87.0,13.0,15.0,14.0,17.0,1
3158,CC:2F:71:3E:C5:1F,3225405,407353442,11390,1393322,3214015,405960120,6,48628,4072344,40187,3072152,8441,1000192,12010,34,16354,186,6,826,130000.0,39000.0,-70.0,-71.0,-67.0,-60.0,-69.0,-71.0,-67.0,-60.0,-79.0,-87.0,-79.0,-87.0,9.0,16.0,12.0,27.0,1
3159,CC:2F:71:3F:1F:24,8500866,8470894781,5286851,8064934661,3214015,405960120,80,1239009,767882028,1230478,766857530,8531,1024498,1185838,619,5291570,544475,80,5768,130000.0,43333.0,-69.0,-65.0,-72.0,-70.0,-69.0,-64.0,-72.0,-70.0,-79.0,-87.0,-79.0,-87.0,10.0,22.0,7.0,17.0,1
3160,F8:59:71:5A:E0:3D,3336398,584423975,122381,178463653,3214017,405960322,0,120411,137043524,115609,136469710,4802,573814,98125,16,125095,2529,0,523,144444.0,43333.0,-67.0,-72.0,-65.0,-70.0,-66.0,-71.0,-65.0,-70.0,-79.0,-87.0,-79.0,-87.0,12.0,15.0,14.0,17.0,1
3161,CC:2F:71:3E:C5:1F,3225409,407353846,11390,1393322,3214019,405960524,6,48628,4072344,40187,3072152,8441,1000192,12010,34,16354,186,6,826,130000.0,39000.0,-70.0,-71.0,-67.0,-60.0,-69.0,-71.0,-67.0,-60.0,-79.0,-87.0,-79.0,-87.0,9.0,16.0,12.0,27.0,1
3162,CC:2F:71:3F:1F:24,8502320,8473141351,5288300,8067180767,3214020,405960584,80,1239257,768006258,1230726,766981760,8531,1024498,1186086,619,5293019,544639,80,5770,130000.0,43333.0,-70.0,-65.0,-72.0,-70.0,-69.0,-64.0,-71.0,-70.0,-79.0,-87.0,-79.0,-87.0,9.0,22.0,7.0,17.0,1
3163,F8:59:71:5A:E0:3D,3336471,584527205,122447,178566217,3214024,405960988,0,120476,137143624,115674,136569810,4802,573814,98190,16,125161,2529,0,523,144444.0,43333.0,-67.0,-72.0,-65.0,-71.0,-67.0,-72.0,-65.0,-70.0,-79.0,-87.0,-79.0,-87.0,12.0,15.0,14.0,16.0,1
3164,CC:2F:71:3E:C5:1F,3225414,407354310,11390,1393322,3214024,405960988,6,48628,4072344,40187,3072152,8441,1000192,12010,34,16354,186,6,826,130000.0,39000.0,-70.0,-71.0,-67.0,-60.0,-69.0,-71.0,-67.0,-60.0,-79.0,-87.0,-79.0,-87.0,9.0,16.0,12.0,27.0,1
3165,CC:2F:71:3F:1F:24,8503537,8475014477,5289513,8069053489,3214024,405960988,80,1239523,768128352,1230992,767103854,8531,1024498,1186352,619,5294232,544672,80,5771,130000.0,43333.0,-69.0,-65.0,-72.0,-71.0,-69.0,-64.0,-71.0,-70.0,-79.0,-87.0,-79.0,-87.0,10.0,22.0,7.0,16.0,1
3166,F8:59:71:5A:E0:3D,3336536,584625309,122510,178664119,3214026,405961190,0,120540,137242198,115738,136668384,4802,573814,98253,16,125224,2529,0,523,144444.0,43333.0,-66.0,-72.0,-65.0,-70.0,-66.0,-72.0,-65.0,-70.0,-79.0,-87.0,-79.0,-87.0,13.0,15.0,14.0,17.0,1
3167,CC:2F:71:3E:C5:1F,3225416,407354512,11390,1393322,3214026,405961190,6,48628,4072344,40187,3072152,8441,1000192,12010,34,16354,186,6,826,130000.0,39000.0,-70.0,-71.0,-67.0,-60.0,-69.0,-71.0,-67.0,-60.0,-79.0,-87.0,-79.0,-87.0,9.0,16.0,12.0,27.0,1
3168,CC:2F:71:3F:1F:24,8504648,8476715341,5290622,8070754151,3214026,405961190,80,1239775,768249168,1231244,767224670,8531,1024498,1186604,619,5295341,544842,80,5774,130000.0,43333.0,-69.0,-64.0,-72.0,-70.0,-68.0,-64.0,-71.0,-69.0,-79.0,-87.0,-79.0,-87.0,10.0,23.0,7.0,17.0,1
3169,F8:59:71:5A:E0:3D,3336603,584722281,122572,178760467,3214031,405961814,0,120603,137339246,115801,136765432,4802,573814,98316,16,125286,2530,0,523,144444.0,43333.0,-66.0,-71.0,-65.0,-71.0,-66.0,-71.0,-65.0,-70.0,-79.0,-87.0,-79.0,-87.0,13.0,16.0,14.0,16.0,1
3170,CC:2F:71:3E:C5:1F,3225421,407355136,11390,1393322,3214031,405961814,6,48628,4072344,40187,3072152,8441,1000192,12010,34,16354,186,6,826,130000.0,39000.0,-70.0,-71.0,-67.0,-60.0,-69.0,-71.0,-67.0,-60.0,-79.0,-87.0,-79.0,-87.0,9.0,16.0,12.0,27.0,1
3171,CC:2F:71:3F:1F:24,8506044,8478867901,5292012,8072906027,3214032,405961874,80,1240043,768369874,1231512,767345376,8531,1024498,1186872,619,5296731,544936,80,5774,130000.0,43333.0,-68.0,-64.0,-71.0,-70.0,-68.0,-64.0,-71.0,-69.0,-79.0,-87.0,-79.0,-87.0,11.0,23.0,8.0,17.0,1
3172,F8:59:71:5A:E0:3D,3336669,584820445,122635,178858369,3214034,405962076,0,120665,137434726,115863,136860912,4802,573814,98378,16,125349,2530,0,523,144444.0,43333.0,-67.0,-71.0,-65.0,-70.0,-66.0,-71.0,-65.0,-70.0,-79.0,-87.0,-79.0,-87.0,12.0,16.0,14.0,17.0,1
3173,CC:2F:71:3E:C5:1F,3225426,407355600,11390,1393322,3214036,405962278,6,48628,4072344,40187,3072152,8441,1000192,12010,34,16354,186,6,826,130000.0,39000.0,-70.0,-71.0,-67.0,-60.0,-69.0,-71.0,-67.0,-60.0,-79.0,-87.0,-79.0,-87.0,9.0,16.0,12.0,27.0,1
3174,CC:2F:71:3F:1F:24,8506983,8480302191,5292947,8074339913,3214036,405962278,80,1240263,768486356,1231732,767461858,8531,1024498,1187092,619,5297666,544948,80,5775,130000.0,43333.0,-69.0,-65.0,-72.0,-70.0,-69.0,-64.0,-71.0,-69.0,-79.0,-87.0,-79.0,-87.0,10.0,22.0,7.0,17.0,1
3175,F8:59:71:5A:E0:3D,3336738,584918953,122698,178956271,3214040,405962682,0,120730,137534840,115928,136961026,4802,573814,98442,16,125412,2530,0,523,144444.0,43333.0,-67.0,-72.0,-65.0,-70.0,-66.0,-71.0,-64.0,-70.0,-79.0,-87.0,-79.0,-87.0,12.0,15.0,14.0,17.0,1
3176,CC:2F:71:3E:C5:1F,3225431,407356277,11390,1393322,3214041,405962955,6,48628,4072344,40187,3072152,8441,1000192,12010,34,16354,186,6,826,130000.0,39000.0,-70.0,-71.0,-67.0,-60.0,-69.0,-71.0,-67.0,-60.0,-79.0,-87.0,-79.0,-87.0,9.0,16.0,12.0,27.0,1
3177,CC:2F:71:3F:1F:24,8508081,8481985606,5294040,8076022651,3214041,405962955,80,1240502,768606324,1231971,767581826,8531,1024498,1187331,619,5298759,545138,80,5775,130000.0,43333.0,-69.0,-64.0,-71.0,-70.0,-68.0,-64.0,-71.0,-70.0,-79.0,-87.0,-79.0,-87.0,10.0,23.0,8.0,17.0,1
3178,F8:59:71:5A:E0:3D,3336806,585018944,122762,179055727,3214044,405963217,0,120794,137633400,115992,137059586,4802,573814,98506,16,125476,2530,0,523,144444.0,43333.0,-66.0,-71.0,-65.0,-70.0,-66.0,-71.0,-65.0,-70.0,-79.0,-87.0,-79.0,-87.0,13.0,16.0,14.0,17.0,1
3179,CC:2F:71:3E:C5:1F,3225434,407356539,11390,1393322,3214044,405963217,6,48628,4072344,40187,3072152,8441,1000192,12010,34,16354,186,6,826,130000.0,39000.0,-70.0,-71.0,-67.0,-60.0,-69.0,-71.0,-67.0,-60.0,-79.0,-87.0,-79.0,-87.0,9.0,16.0,12.0,27.0,1
3180,CC:2F:71:3F:1F:24,8509404,8484028732,5295360,8078065515,3214044,405963217,80,1240737,768724576,1232206,767700078,8531,1024498,1187566,619,5300056,545214,80,5775,130000.0,43333.0,-69.0,-64.0,-72.0,-69.0,-69.0,-64.0,-72.0,-69.0,-79.0,-87.0,-79.0,-87.0,10.0,23.0,7.0,18.0,1
3181,F8:59:71:5A:E0:3D,3336876,585119006,122826,179155183,3214050,405963823,0,120859,137733514,116057,137159700,4802,573814,98570,16,125540,2531,0,523,144444.0,43333.0,-67.0,-72.0,-65.0,-70.0,-66.0,-71.0,-64.0,-69.0,-79.0,-87.0,-79.0,-87.0,12.0,15.0,14.0,17.0,1
3182,CC:2F:71:3E:C5:1F,3225440,407357145,11390,1393322,3214050,405963823,6,48628,4072344,40187,3072152,8441,1000192,12010,34,16354,186,6,826,130000.0,39000.0,-70.0,-71.0,-67.0,-60.0,-69.0,-71.0,-67.0,-60.0,-79.0,-87.0,-79.0,-87.0,9.0,16.0,12.0,27.0,1
3183,CC:2F:71:3F:1F:24,8511092,8486634170,5297042,8080670347,3214050,405963823,80,1241011,768849191,1232480,767824693,8531,1024498,1187840,619,5301746,545335,80,5775,130000.0,43333.0,-69.0,-64.0,-72.0,-70.0,-68.0,-64.0,-71.0,-69.0,-79.0,-87.0,-79.0,-87.0,10.0,23.0,7.0,17.0,1
3184,F8:59:71:5A:E0:3D,3336941,585216942,122889,179252917,3214052,405964025,0,120923,137832088,116121,137258274,4802,573814,98633,16,125603,2532,0,523,144444.0,43333.0,-67.0,-72.0,-65.0,-70.0,-66.0,-71.0,-64.0,-70.0,-79.0,-87.0,-79.0,-87.0,12.0,15.0,14.0,17.0,1
3185,CC:2F:71:3E:C5:1F,3225442,407357347,11390,1393322,3214052,405964025,6,48628,4072344,40187,3072152,8441,1000192,12010,34,16354,186,6,826,130000.0,39000.0,-70.0,-71.0,-67.0,-60.0,-69.0,-71.0,-67.0,-60.0,-79.0,-87.0,-79.0,-87.0,9.0,16.0,12.0,27.0,1
3186,CC:2F:71:3F:1F:24,8512121,8488214906,5298069,8082250881,3214052,405964025,80,1241254,768968387,1232723,767943889,8531,1024498,1188083,619,5302788,545392,80,5775,130000.0,43333.0,-69.0,-64.0,-71.0,-70.0,-69.0,-64.0,-71.0,-69.0,-79.0,-87.0,-79.0,-87.0,10.0,23.0,8.0,17.0,1
3187,F8:59:71:5A:E0:3D,3337009,585315308,122952,179350819,3214057,405964489,0,120985,137927568,116183,137353754,4802,573814,98695,16,125666,2532,0,523,144444.0,43333.0,-66.0,-71.0,-65.0,-70.0,-66.0,-71.0,-65.0,-70.0,-79.0,-87.0,-79.0,-87.0,13.0,16.0,14.0,17.0,1
3188,CC:2F:71:3E:C5:1F,3225447,407357811,11390,1393322,3214057,405964489,6,48628,4072344,40187,3072152,8441,1000192,12010,34,16354,186,6,826,130000.0,39000.0,-70.0,-71.0,-67.0,-60.0,-69.0,-71.0,-67.0,-60.0,-79.0,-87.0,-79.0,-87.0,9.0,16.0,12.0,27.0,1
3189,CC:2F:71:3F:1F:24,8513041,8489618832,5298984,8083654343,3214057,405964489,80,1241462,769082059,1232931,768057561,8531,1024498,1188291,619,5303703,545451,80,5775,130000.0,39000.0,-69.0,-64.0,-72.0,-70.0,-69.0,-64.0,-72.0,-70.0,-79.0,-87.0,-79.0,-87.0,10.0,23.0,7.0,17.0,1
3190,F8:59:71:5A:E0:3D,3337075,585412060,123014,179447167,3214061,405964893,0,121048,138024588,116246,137450774,4802,573814,98758,16,125728,2532,0,523,144444.0,43333.0,-67.0,-72.0,-65.0,-70.0,-66.0,-71.0,-65.0,-70.0,-79.0,-87.0,-79.0,-87.0,12.0,15.0,14.0,17.0,1
3191,CC:2F:71:3E:C5:1F,3225451,407358215,11390,1393322,3214061,405964893,6,48628,4072344,40187,3072152,8441,1000192,12010,34,16354,186,6,826,130000.0,39000.0,-70.0,-71.0,-67.0,-60.0,-69.0,-71.0,-67.0,-60.0,-79.0,-87.0,-79.0,-87.0,9.0,16.0,12.0,27.0,1
3192,CC:2F:71:3F:1F:24,8514346,8491630534,5300285,8085665641,3214061,405964893,80,1241689,769200815,1233158,768176317,8531,1024498,1188518,619,5305004,545541,80,5776,130000.0,43333.0,-69.0,-64.0,-71.0,-70.0,-68.0,-64.0,-71.0,-69.0,-79.0,-87.0,-79.0,-87.0,10.0,23.0,8.0,17.0,1
3193,F8:59:71:5A:E0:3D,3337142,585511834,123079,179546739,3214063,405965095,0,121113,138124702,116311,137550888,4802,573814,98822,16,125793,2532,0,523,144444.0,43333.0,-67.0,-71.0,-65.0,-70.0,-66.0,-71.0,-65.0,-70.0,-79.0,-87.0,-79.0,-87.0,12.0,16.0,14.0,17.0,1
3194,CC:2F:71:3E:C5:1F,3225454,407358533,11391,1393438,3214063,405965095,6,48630,4072484,40189,3072292,8441,1000192,12010,34,16355,186,6,826,130000.0,39000.0,-69.0,-70.0,-66.0,-60.0,-69.0,-70.0,-67.0,-60.0,-79.0,-87.0,-79.0,-87.0,10.0,17.0,13.0,27.0,1
3195,CC:2F:71:3F:1F:24,8515822,8493904624,5301757,8087939327,3214065,405965297,80,1241942,769321486,1233411,768296988,8531,1024498,1188771,619,5306476,545616,80,5776,130000.0,43333.0,-69.0,-64.0,-72.0,-69.0,-69.0,-64.0,-71.0,-69.0,-79.0,-87.0,-79.0,-87.0,10.0,23.0,7.0,18.0,1
3196,F8:59:71:5A:E0:3D,3337211,585611754,123143,179646195,3214068,405965559,0,121178,138224816,116376,137651002,4802,573814,98886,16,125857,2534,0,523,144444.0,43333.0,-67.0,-71.0,-65.0,-70.0,-66.0,-71.0,-65.0,-70.0,-79.0,-87.0,-79.0,-87.0,12.0,16.0,14.0,17.0,1
3197,CC:2F:71:3E:C5:1F,3225460,407359065,11391,1393438,3214069,405965627,6,48630,4072484,40189,3072292,8441,1000192,12010,34,16355,186,6,826,130000.0,39000.0,-69.0,-70.0,-66.0,-60.0,-69.0,-70.0,-67.0,-60.0,-79.0,-87.0,-79.0,-87.0,10.0,17.0,13.0,27.0,1
3198,CC:2F:71:3F:1F:24,8517459,8496440040,5303389,8090474279,3214070,405965761,80,1242211,769445224,1233680,768420726,8531,1024498,1189040,619,5308078,545782,80,5777,130000.0,43333.0,-69.0,-64.0,-71.0,-70.0,-68.0,-64.0,-71.0,-70.0,-79.0,-87.0,-79.0,-87.0,10.0,23.0,8.0,17.0,1
3199,F8:59:71:5A:E0:3D,3337278,585710060,123206,179744097,3214072,405965963,0,121241,138321836,116439,137748022,4802,573814,98949,16,125920,2534,0,523,144444.0,43333.0,-66.0,-71.0,-65.0,-70.0,-66.0,-71.0,-64.0,-70.0,-79.0,-87.0,-79.0,-87.0,13.0,16.0,14.0,17.0,1
3200,CC:2F:71:3E:C5:1F,3225463,407359401,11391,1393438,3214072,405965963,6,48630,4072484,40189,3072292,8441,1000192,12010,34,16355,186,6,826,130000.0,39000.0,-69.0,-70.0,-66.0,-60.0,-69.0,-70.0,-67.0,-60.0,-79.0,-87.0,-79.0,-87.0,10.0,17.0,13.0,27.0,1
3201,CC:2F:71:3F:1F:24,8518912,8498688376,5304840,8092722413,3214072,405965963,80,1242493,769569098,1233962,768544600,8531,1024498,1189322,619,5309559,545799,80,5777,130000.0,43333.0,-69.0,-64.0,-71.0,-70.0,-69.0,-64.0,-71.0,-70.0,-79.0,-87.0,-79.0,-87.0,10.0,23.0,8.0,17.0,1
3202,F8:59:71:5A:E0:3D,3337346,585807261,123268,179840445,3214078,405966816,0,121303,138417316,116501,137843502,4802,573814,99011,16,125982,2534,0,523,144444.0,43333.0,-67.0,-71.0,-65.0,-71.0,-66.0,-71.0,-65.0,-70.0,-79.0,-87.0,-79.0,-87.0,12.0,16.0,14.0,16.0,1
3203,CC:2F:71:3E:C5:1F,3225469,407360254,11391,1393438,3214078,405966816,6,48630,4072484,40189,3072292,8441,1000192,12010,34,16355,186,6,826,130000.0,39000.0,-69.0,-70.0,-66.0,-60.0,-69.0,-70.0,-67.0,-60.0,-79.0,-87.0,-79.0,-87.0,10.0,17.0,13.0,27.0,1
3204,CC:2F:71:3F:1F:24,8520136,8500568173,5306057,8094601295,3214079,405966878,80,1242762,769689758,1234231,768665260,8531,1024498,1189591,619,5310776,545880,80,5777,130000.0,43333.0,-69.0,-64.0,-71.0,-69.0,-68.0,-64.0,-71.0,-69.0,-79.0,-87.0,-79.0,-87.0,10.0,23.0,8.0,18.0,1
3205,F8:59:71:5A:E0:3D,3337419,585909246,123333,179941455,3214086,405967791,0,121367,138515876,116565,137942062,4802,573814,99075,16,126047,2535,0,523,144444.0,43333.0,-67.0,-71.0,-65.0,-70.0,-66.0,-71.0,-65.0,-70.0,-79.0,-87.0,-79.0,-87.0,12.0,16.0,14.0,17.0,1
3206,CC:2F:71:3E:C5:1F,3225477,407361229,11391,1393438,3214086,405967791,6,48632,4072672,40190,3072362,8442,1000310,12011,34,16355,186,6,826,130000.0,39000.0,-70.0,-71.0,-67.0,-60.0,-69.0,-71.0,-66.0,-60.0,-79.0,-87.0,-79.0,-87.0,9.0,16.0,12.0,27.0,1
3207,CC:2F:71:3F:1F:24,8521306,8502353592,5307220,8096385801,3214086,405967791,80,1242983,769811244,1234452,768786746,8531,1024498,1189812,619,5311914,545937,80,5777,130000.0,43333.0,-70.0,-64.0,-72.0,-70.0,-69.0,-64.0,-71.0,-70.0,-79.0,-87.0,-79.0,-87.0,9.0,23.0,7.0,17.0,1
3208,F8:59:71:5A:E0:3D,3337488,586009168,123397,180040911,3214091,405968257,0,121431,138614436,116629,138040622,4802,573814,99139,16,126111,2536,0,523,144444.0,43333.0,-67.0,-71.0,-65.0,-70.0,-66.0,-71.0,-65.0,-70.0,-79.0,-87.0,-79.0,-87.0,12.0,16.0,14.0,17.0,1
3209,CC:2F:71:3E:C5:1F,3225482,407361695,11391,1393438,3214091,405968257,6,48632,4072672,40190,3072362,8442,1000310,12011,34,16355,186,6,826,130000.0,39000.0,-70.0,-71.0,-67.0,-60.0,-69.0,-71.0,-66.0,-60.0,-79.0,-87.0,-79.0,-87.0,9.0,16.0,12.0,27.0,1
3210,CC:2F:71:3F:1F:24,8522288,8503855468,5308197,8097887211,3214091,405968257,80,1243176,769923282,1234644,768898666,8532,1024616,1190005,619,5312908,546055,80,5777,130000.0,43333.0,-70.0,-65.0,-72.0,-70.0,-69.0,-64.0,-71.0,-70.0,-79.0,-87.0,-79.0,-87.0,9.0,22.0,7.0,17.0,1
3211,F8:59:71:5A:E0:3D,3337553,586104613,123458,180135705,3214095,405968908,0,121495,138713094,116693,138139280,4802,573814,99201,16,126172,2536,0,523,144444.0,43333.0,-67.0,-72.0,-66.0,-71.0,-67.0,-72.0,-65.0,-71.0,-79.0,-87.0,-79.0,-87.0,12.0,15.0,13.0,16.0,1
3212,CC:2F:71:3E:C5:1F,3225488,407362548,11391,1393438,3214097,405969110,6,48632,4072672,40190,3072362,8442,1000310,12011,34,16355,186,6,826,130000.0,39000.0,-70.0,-71.0,-67.0,-60.0,-69.0,-71.0,-66.0,-60.0,-79.0,-87.0,-79.0,-87.0,9.0,16.0,12.0,27.0,1
3213,CC:2F:71:3F:1F:24,8523385,8505536375,5309288,8099567265,3214097,405969110,80,1243391,770037716,1234859,769013100,8532,1024616,1190220,619,5314007,546072,80,5778,130000.0,43333.0,-70.0,-65.0,-72.0,-70.0,-69.0,-64.0,-71.0,-69.0,-79.0,-87.0,-79.0,-87.0,9.0,22.0,7.0,17.0,1
3214,F8:59:71:5A:E0:3D,3337625,586203630,123521,180233607,3214104,405970023,0,121558,138810114,116756,138236300,4802,573814,99264,16,126235,2538,0,523,144444.0,43333.0,-67.0,-72.0,-65.0,-71.0,-67.0,-72.0,-65.0,-71.0,-79.0,-87.0,-79.0,-87.0,12.0,15.0,14.0,16.0,1
3215,CC:2F:71:3E:C5:1F,3225495,407363461,11391,1393438,3214104,405970023,6,48632,4072672,40190,3072362,8442,1000310,12011,34,16355,186,6,826,130000.0,39000.0,-70.0,-71.0,-67.0,-60.0,-69.0,-71.0,-66.0,-60.0,-79.0,-87.0,-79.0,-87.0,9.0,16.0,12.0,27.0,1
3216,CC:2F:71:3F:1F:24,8524404,8507092704,5310300,8101122681,3214104,405970023,80,1243593,770152140,1235061,769127524,8532,1024616,1190422,619,5315005,546111,80,5778,130000.0,43333.0,-69.0,-65.0,-71.0,-70.0,-69.0,-64.0,-71.0,-70.0,-79.0,-87.0,-79.0,-87.0,10.0,22.0,8.0,17.0,1
3217,F8:59:71:5A:E0:3D,3337690,586300242,123583,180329955,3214107,405970287,0,121621,138905712,116818,138331780,4803,573932,99327,16,126297,2538,0,523,144444.0,43333.0,-67.0,-72.0,-66.0,-71.0,-67.0,-72.0,-65.0,-71.0,-79.0,-87.0,-79.0,-87.0,12.0,15.0,13.0,16.0,1
3218,CC:2F:71:3E:C5:1F,3225498,407363725,11391,1393438,3214107,405970287,6,48632,4072672,40190,3072362,8442,1000310,12011,34,16355,186,6,826,130000.0,39000.0,-70.0,-71.0,-67.0,-60.0,-69.0,-71.0,-66.0,-60.0,-79.0,-87.0,-79.0,-87.0,9.0,16.0,12.0,27.0,1
3219,CC:2F:71:3F:1F:24,8525651,8509012454,5311542,8103041965,3214109,405970489,80,1243841,770273284,1235309,769248668,8532,1024616,1190670,619,5316260,546258,80,5778,130000.0,43333.0,-69.0,-64.0,-70.0,-69.0,-69.0,-64.0,-71.0,-69.0,-79.0,-87.0,-79.0,-87.0,10.0,23.0,9.0,18.0,1
3220,F8:59:71:5A:E0:3D,3337762,586405037,123650,180434073,3214112,405970964,0,121687,139007352,116884,138433420,4803,573932,99393,16,126364,2538,0,523,144444.0,43333.0,-67.0,-72.0,-66.0,-71.0,-67.0,-72.0,-65.0,-71.0,-79.0,-87.0,-79.0,-87.0,12.0,15.0,13.0,16.0,1
3221,CC:2F:71:3E:C5:1F,3225503,407364402,11391,1393438,3214112,405970964,6,48632,4072672,40190,3072362,8442,1000310,12011,34,16355,186,6,826,130000.0,39000.0,-70.0,-71.0,-67.0,-60.0,-69.0,-71.0,-66.0,-60.0,-79.0,-87.0,-79.0,-87.0,9.0,16.0,12.0,27.0,1
3222,CC:2F:71:3F:1F:24,8526556,8510382657,5312441,8104411431,3214115,405971226,80,1244062,770400348,1235530,769375732,8532,1024616,1190891,619,5317159,546319,80,5778,130000.0,43333.0,-70.0,-64.0,-71.0,-69.0,-69.0,-64.0,-71.0,-69.0,-79.0,-87.0,-79.0,-87.0,9.0,23.0,8.0,18.0,1
3223,F8:59:71:5A:E0:3D,3337835,586511173,123718,180539745,3214117,405971428,0,121757,139115166,116954,138541234,4803,573932,99462,16,126432,2538,0,523,144444.0,43333.0,-67.0,-72.0,-66.0,-71.0,-67.0,-71.0,-65.0,-70.0,-79.0,-87.0,-79.0,-87.0,12.0,15.0,13.0,16.0,1
3224,CC:2F:71:3E:C5:1F,3225508,407364866,11391,1393438,3214117,405971428,6,48632,4072672,40190,3072362,8442,1000310,12011,34,16355,186,6,826,130000.0,39000.0,-70.0,-71.0,-67.0,-60.0,-69.0,-71.0,-66.0,-60.0,-79.0,-87.0,-79.0,-87.0,9.0,16.0,12.0,27.0,1
3225,CC:2F:71:3F:1F:24,8527687,8512124349,5313570,8106152921,3214117,405971428,80,1244287,770517352,1235755,769492736,8532,1024616,1191116,619,5318289,546395,80,5778,130000.0,43333.0,-69.0,-64.0,-71.0,-69.0,-69.0,-64.0,-71.0,-69.0,-79.0,-87.0,-79.0,-87.0,10.0,23.0,8.0,18.0,1
3226,F8:59:71:5A:E0:3D,3337900,586609277,123781,180637647,3214119,405971630,0,121820,139212186,117017,138638254,4803,573932,99525,16,126495,2539,0,523,144444.0,43333.0,-67.0,-71.0,-65.0,-71.0,-66.0,-71.0,-65.0,-70.0,-79.0,-87.0,-79.0,-87.0,12.0,16.0,14.0,16.0,1
3227,CC:2F:71:3E:C5:1F,3225510,407365068,11391,1393438,3214119,405971630,6,48632,4072672,40190,3072362,8442,1000310,12011,34,16355,186,6,826,130000.0,39000.0,-70.0,-71.0,-67.0,-60.0,-69.0,-71.0,-66.0,-60.0,-79.0,-87.0,-79.0,-87.0,9.0,16.0,12.0,27.0,1
3228,CC:2F:71:3F:1F:24,8528716,8513700211,5314595,8107728379,3214121,405971832,80,1244530,770636512,1235998,769611896,8532,1024616,1191359,619,5319314,546471,80,5780,130000.0,43333.0,-70.0,-64.0,-71.0,-69.0,-69.0,-64.0,-71.0,-69.0,-79.0,-87.0,-79.0,-87.0,9.0,23.0,8.0,18.0,1
3229,F8:59:71:5A:E0:3D,3337968,586706231,123843,180733995,3214125,405972236,0,121882,139307666,117079,138733734,4803,573932,99587,16,126557,2539,0,523,144444.0,43333.0,-66.0,-71.0,-66.0,-71.0,-66.0,-71.0,-65.0,-71.0,-79.0,-87.0,-79.0,-87.0,13.0,16.0,13.0,16.0,1
3230,CC:2F:71:3E:C5:1F,3225517,407365734,11391,1393438,3214126,405972296,6,48632,4072672,40190,3072362,8442,1000310,12011,34,16355,186,6,826,130000.0,39000.0,-70.0,-71.0,-67.0,-60.0,-69.0,-71.0,-66.0,-60.0,-79.0,-87.0,-79.0,-87.0,9.0,16.0,12.0,27.0,1
3231,CC:2F:71:3F:1F:24,8529943,8515588895,5315817,8109616599,3214126,405972296,80,1244780,770756344,1236248,769731728,8532,1024616,1191609,619,5320536,546596,80,5780,130000.0,43333.0,-69.0,-64.0,-71.0,-69.0,-69.0,-64.0,-71.0,-68.0,-79.0,-87.0,-79.0,-87.0,10.0,23.0,8.0,18.0,1
3232,F8:59:71:5A:E0:3D,3338035,586805949,123907,180833451,3214128,405972498,0,121945,139404714,117142,138830782,4803,573932,99650,16,126621,2540,0,524,144444.0,43333.0,-67.0,-71.0,-65.0,-71.0,-66.0,-71.0,-65.0,-70.0,-79.0,-87.0,-79.0,-87.0,12.0,16.0,14.0,16.0,1
3233,CC:2F:71:3E:C5:1F,3225519,407365936,11391,1393438,3214128,405972498,6,48632,4072672,40190,3072362,8442,1000310,12011,34,16355,186,6,826,130000.0,39000.0,-70.0,-71.0,-67.0,-60.0,-69.0,-71.0,-66.0,-60.0,-79.0,-87.0,-79.0,-87.0,9.0,16.0,12.0,27.0,1
3234,CC:2F:71:3F:1F:24,8531150,8517443710,5317022,8111471212,3214128,405972498,80,1245037,770876167,1236505,769851551,8532,1024616,1191866,619,5321718,546655,80,5780,130000.0,43333.0,-70.0,-64.0,-72.0,-68.0,-69.0,-64.0,-71.0,-68.0,-79.0,-87.0,-79.0,-87.0,9.0,23.0,7.0,19.0,1
3235,F8:59:71:5A:E0:3D,3338104,586904623,123970,180931353,3214134,405973270,0,122009,139503288,117206,138929356,4803,573932,99713,16,126684,2540,0,524,144444.0,43333.0,-67.0,-71.0,-65.0,-71.0,-66.0,-71.0,-65.0,-70.0,-79.0,-87.0,-79.0,-87.0,12.0,16.0,14.0,16.0,1
3236,CC:2F:71:3E:C5:1F,3225525,407366708,11391,1393438,3214134,405973270,6,48632,4072672,40190,3072362,8442,1000310,12011,34,16355,186,6,826,130000.0,39000.0,-70.0,-71.0,-67.0,-60.0,-69.0,-71.0,-66.0,-60.0,-79.0,-87.0,-79.0,-87.0,9.0,16.0,12.0,27.0,1
3237,CC:2F:71:3F:1F:24,8532240,8519111712,5318104,8113138240,3214136,405973472,80,1245246,770994121,1236714,769969505,8532,1024616,1192075,619,5322823,546780,80,5780,130000.0,43333.0,-70.0,-64.0,-71.0,-69.0,-69.0,-64.0,-71.0,-69.0,-79.0,-87.0,-79.0,-87.0,9.0,23.0,8.0,18.0,1
3238,F8:59:71:5A:E0:3D,3338174,587006097,124035,181032363,3214139,405973734,0,122075,139604928,117272,139030996,4803,573932,99779,16,126749,2540,0,524,144444.0,43333.0,-67.0,-71.0,-65.0,-71.0,-66.0,-71.0,-65.0,-70.0,-79.0,-87.0,-79.0,-87.0,12.0,16.0,14.0,16.0,1
3239,CC:2F:71:3E:C5:1F,3225530,407367172,11391,1393438,3214139,405973734,6,48632,4072672,40190,3072362,8442,1000310,12011,34,16355,186,6,826,130000.0,39000.0,-70.0,-71.0,-67.0,-60.0,-69.0,-71.0,-66.0,-60.0,-79.0,-87.0,-79.0,-87.0,9.0,16.0,12.0,27.0,1
3240,CC:2F:71:3F:1F:24,8533326,8520779404,5319187,8114805670,3214139,405973734,80,1245530,771119477,1236998,770094861,8532,1024616,1192359,619,5323906,546805,80,5780,130000.0,43333.0,-69.0,-64.0,-72.0,-69.0,-69.0,-64.0,-71.0,-69.0,-79.0,-87.0,-79.0,-87.0,10.0,23.0,7.0,18.0,1
3241,F8:59:71:5A:E0:3D,3338241,587104403,124098,181130265,3214143,405974138,0,122140,139705056,117337,139131124,4803,573932,99842,16,126812,2540,0,524,144444.0,43333.0,-67.0,-72.0,-65.0,-71.0,-66.0,-71.0,-65.0,-70.0,-79.0,-87.0,-79.0,-87.0,12.0,15.0,14.0,16.0,1
3242,CC:2F:71:3E:C5:1F,3225534,407367576,11391,1393438,3214143,405974138,6,48632,4072672,40190,3072362,8442,1000310,12011,34,16355,186,6,826,130000.0,39000.0,-70.0,-71.0,-67.0,-60.0,-69.0,-71.0,-66.0,-60.0,-79.0,-87.0,-79.0,-87.0,9.0,16.0,12.0,27.0,1
3243,CC:2F:71:3F:1F:24,8534525,8522622438,5320382,8116648300,3214143,405974138,80,1245812,771245997,1237280,770221381,8532,1024616,1192641,619,5325101,546953,80,5780,130000.0,39000.0,-70.0,-64.0,-72.0,-69.0,-69.0,-64.0,-71.0,-69.0,-79.0,-87.0,-79.0,-87.0,9.0,23.0,7.0,18.0,1
3244,F8:59:71:5A:E0:3D,3338310,587205817,124163,181231275,3214147,405974542,0,122204,139803616,117401,139229684,4803,573932,99906,16,126877,2540,0,524,144444.0,43333.0,-67.0,-72.0,-66.0,-71.0,-66.0,-71.0,-65.0,-70.0,-79.0,-87.0,-79.0,-87.0,12.0,15.0,13.0,16.0,1
3245,CC:2F:71:3E:C5:1F,3225538,407367980,11391,1393438,3214147,405974542,6,48632,4072672,40190,3072362,8442,1000310,12011,34,16355,186,6,826,130000.0,39000.0,-70.0,-71.0,-67.0,-60.0,-69.0,-71.0,-66.0,-60.0,-79.0,-87.0,-79.0,-87.0,9.0,16.0,12.0,27.0,1
3246,CC:2F:71:3F:1F:24,8535926,8524778110,5321779,8118803568,3214147,405974542,80,1246116,771372626,1237584,770348010,8532,1024616,1192945,619,5326498,547053,80,5780,130000.0,43333.0,-70.0,-64.0,-71.0,-69.0,-69.0,-64.0,-71.0,-69.0,-79.0,-87.0,-79.0,-87.0,9.0,23.0,8.0,18.0,1
3247,F8:59:71:5A:E0:3D,3338382,587306977,124228,181330847,3214154,405976130,0,122270,139903836,117467,139329904,4803,573932,99971,16,126942,2540,0,524,144444.0,43333.0,-66.0,-71.0,-65.0,-71.0,-66.0,-71.0,-65.0,-70.0,-79.0,-87.0,-79.0,-87.0,13.0,16.0,14.0,16.0,1
3248,CC:2F:71:3E:C5:1F,3225545,407369568,11391,1393438,3214154,405976130,6,48632,4072672,40190,3072362,8442,1000310,12011,34,16355,186,6,826,130000.0,39000.0,-70.0,-71.0,-67.0,-60.0,-69.0,-71.0,-66.0,-60.0,-79.0,-87.0,-79.0,-87.0,9.0,16.0,12.0,27.0,1
3249,CC:2F:71:3F:1F:24,8537126,8526619046,5322972,8120642916,3214154,405976130,80,1246345,771488684,1237813,770464068,8532,1024616,1193174,619,5327689,547211,80,5780,130000.0,43333.0,-69.0,-64.0,-71.0,-69.0,-69.0,-64.0,-71.0,-69.0,-79.0,-87.0,-79.0,-87.0,10.0,23.0,8.0,18.0,1
3250,F8:59:71:5A:E0:3D,3338448,587403673,124290,181427139,3214158,405976534,0,122332,139999316,117529,139425384,4803,573932,100033,16,127003,2541,0,524,130000.0,39000.0,-67.0,-72.0,-65.0,-70.0,-66.0,-71.0,-64.0,-70.0,-79.0,-87.0,-79.0,-87.0,12.0,15.0,14.0,17.0,1
3251,CC:2F:71:3E:C5:1F,3225549,407369972,11391,1393438,3214158,405976534,6,48632,4072672,40190,3072362,8442,1000310,12011,34,16355,186,6,826,130000.0,39000.0,-70.0,-71.0,-67.0,-60.0,-69.0,-71.0,-66.0,-60.0,-79.0,-87.0,-79.0,-87.0,9.0,16.0,12.0,27.0,1
3252,CC:2F:71:3F:1F:24,8538096,8528101814,5323938,8122125280,3214158,405976534,80,1246592,771611052,1238060,770586436,8532,1024616,1193421,619,5328657,547564,80,5780,86667.0,13000.0,-70.0,-65.0,-70.0,-69.0,-69.0,-65.0,-70.0,-69.0,-79.0,-87.0,-79.0,-87.0,9.0,22.0,9.0,18.0,1
3253,F8:59:71:5A:E0:3D,3338516,587504343,124354,181526483,3214162,405977860,0,122396,140097876,117593,139523944,4803,573932,100097,16,127067,2541,0,524,144444.0,43333.0,-67.0,-72.0,-65.0,-70.0,-66.0,-71.0,-64.0,-70.0,-79.0,-87.0,-79.0,-87.0,12.0,15.0,14.0,17.0,1
3254,CC:2F:71:3E:C5:1F,3225554,407371366,11391,1393438,3214163,405977928,6,48632,4072672,40190,3072362,8442,1000310,12011,34,16355,186,6,826,130000.0,39000.0,-70.0,-71.0,-67.0,-60.0,-69.0,-71.0,-66.0,-60.0,-79.0,-87.0,-79.0,-87.0,9.0,16.0,12.0,27.0,1
3255,CC:2F:71:3F:1F:24,8539488,8530246847,5325323,8124268658,3214165,405978189,80,1246946,771745916,1238414,770721300,8532,1024616,1193775,619,5330021,547918,80,5781,115556.0,28889.0,-70.0,-65.0,-70.0,-69.0,-70.0,-64.0,-70.0,-68.0,-79.0,-87.0,-79.0,-87.0,9.0,22.0,9.0,18.0,1
3256,F8:59:71:5A:E0:3D,3338593,587610934,124422,181632155,3214171,405978779,0,122464,140202596,117661,139628664,4803,573932,100165,16,127135,2543,0,524,144444.0,43333.0,-67.0,-72.0,-65.0,-71.0,-66.0,-71.0,-64.0,-70.0,-79.0,-87.0,-79.0,-87.0,12.0,15.0,14.0,16.0,1
3257,CC:2F:71:3E:C5:1F,3225562,407372217,11391,1393438,3214171,405978779,6,48632,4072672,40190,3072362,8442,1000310,12011,34,16355,186,6,826,130000.0,39000.0,-70.0,-71.0,-67.0,-60.0,-69.0,-71.0,-66.0,-60.0,-79.0,-87.0,-79.0,-87.0,9.0,16.0,12.0,27.0,1
3258,CC:2F:71:3F:1F:24,8541034,8532629643,5326863,8126650864,3214171,405978779,80,1247290,771880194,1238758,770855578,8532,1024616,1194119,619,5331582,548528,80,5781,115556.0,28889.0,-69.0,-64.0,-70.0,-70.0,-69.0,-64.0,-70.0,-70.0,-79.0,-87.0,-79.0,-87.0,10.0,23.0,9.0,17.0,1
3259,F8:59:71:5A:E0:3D,3338658,587709960,124485,181730057,3214173,405979903,0,122528,140301156,117725,139727224,4803,573932,100229,16,127199,2543,0,524,144444.0,43333.0,-67.0,-72.0,-65.0,-70.0,-66.0,-72.0,-65.0,-70.0,-79.0,-87.0,-79.0,-87.0,12.0,15.0,14.0,17.0,1
3260,CC:2F:71:3E:C5:1F,3225566,407373543,11391,1393438,3214175,405980105,6,48632,4072672,40190,3072362,8442,1000310,12011,34,16355,186,6,826,130000.0,39000.0,-70.0,-71.0,-67.0,-60.0,-69.0,-71.0,-66.0,-60.0,-79.0,-87.0,-79.0,-87.0,9.0,16.0,12.0,27.0,1
3261,CC:2F:71:3F:1F:24,8542974,8535645633,5328799,8129665528,3214175,405980105,80,1247565,772004344,1239033,770979728,8532,1024616,1194394,619,5333518,548642,80,5781,115556.0,28889.0,-70.0,-64.0,-71.0,-67.0,-69.0,-63.0,-70.0,-67.0,-79.0,-87.0,-79.0,-87.0,9.0,23.0,8.0,20.0,1
3262,F8:59:71:5A:E0:3D,3338728,587808741,124548,181827959,3214180,405980782,0,122593,140401284,117790,139827352,4803,573932,100292,16,127262,2543,0,524,144444.0,43333.0,-67.0,-72.0,-66.0,-70.0,-66.0,-71.0,-65.0,-70.0,-79.0,-87.0,-79.0,-87.0,12.0,15.0,13.0,17.0,1
3263,CC:2F:71:3E:C5:1F,3225573,407374422,11391,1393438,3214182,405980984,6,48632,4072672,40190,3072362,8442,1000310,12011,34,16355,186,6,826,130000.0,39000.0,-70.0,-71.0,-67.0,-60.0,-69.0,-71.0,-66.0,-60.0,-79.0,-87.0,-79.0,-87.0,9.0,16.0,12.0,27.0,1
3264,CC:2F:71:3F:1F:24,8544853,8538558824,5330671,8132577840,3214182,405980984,80,1247877,772134464,1239345,771109848,8532,1024616,1194706,619,5335390,548754,80,5781,104000.0,26000.0,-69.0,-63.0,-70.0,-68.0,-69.0,-63.0,-70.0,-68.0,-79.0,-87.0,-79.0,-87.0,10.0,24.0,9.0,19.0,1
3265,F8:59:71:5A:E0:3D,3338801,587917783,124618,181936739,3214183,405981044,0,122663,140509210,117860,139935278,4803,573932,100362,16,127332,2543,0,524,144444.0,43333.0,-67.0,-72.0,-65.0,-70.0,-66.0,-71.0,-65.0,-69.0,-79.0,-87.0,-79.0,-87.0,12.0,15.0,14.0,17.0,1
3266,CC:2F:71:3E:C5:1F,3225576,407374684,11391,1393438,3214185,405981246,6,48632,4072672,40190,3072362,8442,1000310,12011,34,16355,186,6,826,130000.0,39000.0,-70.0,-71.0,-67.0,-60.0,-69.0,-71.0,-66.0,-60.0,-79.0,-87.0,-79.0,-87.0,9.0,16.0,12.0,27.0,1
3267,CC:2F:71:3F:1F:24,8546598,8541266114,5332413,8135284868,3214185,405981246,80,1248201,772272856,1239669,771248240,8532,1024616,1195029,619,5337132,548858,80,5781,115556.0,28889.0,-69.0,-64.0,-73.0,-70.0,-68.0,-64.0,-72.0,-70.0,-79.0,-87.0,-79.0,-87.0,10.0,23.0,6.0,17.0,1
3268,F8:59:71:5A:E0:3D,3338874,588022507,124685,182040857,3214189,405981650,0,122729,140610850,117926,140036918,4803,573932,100428,16,127399,2543,0,524,144444.0,43333.0,-66.0,-72.0,-65.0,-71.0,-66.0,-72.0,-64.0,-70.0,-79.0,-87.0,-79.0,-87.0,13.0,15.0,14.0,16.0,1
3269,CC:2F:71:3E:C5:1F,3225582,407375290,11391,1393438,3214191,405981852,6,48632,4072672,40190,3072362,8442,1000310,12011,34,16355,186,6,826,130000.0,39000.0,-70.0,-71.0,-67.0,-60.0,-69.0,-71.0,-66.0,-60.0,-79.0,-87.0,-79.0,-87.0,9.0,16.0,12.0,27.0,1
3270,CC:2F:71:3F:1F:24,8547715,8542978838,5333524,8136996986,3214191,405981852,80,1248445,772395256,1239913,771370640,8532,1024616,1195273,619,5338242,549443,80,5782,117000.0,39000.0,-70.0,-65.0,-70.0,-69.0,-69.0,-64.0,-70.0,-68.0,-79.0,-87.0,-79.0,-87.0,9.0,22.0,9.0,18.0,1
3271,F8:59:71:5A:E0:3D,3338939,588120611,124748,182138759,3214191,405981852,0,122793,140709410,117990,140135478,4803,573932,100492,16,127462,2543,0,524,144444.0,43333.0,-66.0,-71.0,-65.0,-70.0,-66.0,-71.0,-64.0,-70.0,-79.0,-87.0,-79.0,-87.0,13.0,16.0,14.0,17.0,1
3272,CC:2F:71:3E:C5:1F,3225582,407375290,11391,1393438,3214191,405981852,6,48632,4072672,40190,3072362,8442,1000310,12011,34,16355,186,6,826,130000.0,39000.0,-70.0,-71.0,-67.0,-60.0,-69.0,-71.0,-66.0,-60.0,-79.0,-87.0,-79.0,-87.0,9.0,16.0,12.0,27.0,1
3273,CC:2F:71:3F:1F:24,8548890,8544770757,5334698,8138788845,3214192,405981912,80,1248682,772516241,1240150,771491625,8532,1024616,1195509,619,5339417,549502,80,5782,130000.0,43333.0,-70.0,-64.0,-71.0,-68.0,-70.0,-64.0,-70.0,-68.0,-79.0,-87.0,-79.0,-87.0,9.0,23.0,8.0,19.0,1
3274,F8:59:71:5A:E0:3D,3339007,588218977,124811,182236661,3214196,405982316,0,122856,140806430,118053,140232498,4803,573932,100555,16,127525,2543,0,524,144444.0,43333.0,-66.0,-72.0,-64.0,-70.0,-66.0,-71.0,-64.0,-70.0,-79.0,-87.0,-79.0,-87.0,13.0,15.0,15.0,17.0,1
3275,CC:2F:71:3E:C5:1F,3225589,407375956,11391,1393438,3214198,405982518,6,48632,4072672,40190,3072362,8442,1000310,12011,34,16355,186,6,826,130000.0,39000.0,-70.0,-71.0,-67.0,-60.0,-69.0,-71.0,-66.0,-60.0,-79.0,-87.0,-79.0,-87.0,9.0,16.0,12.0,27.0,1
3276,CC:2F:71:3F:1F:24,8550230,8546836319,5336032,8140853801,3214198,405982518,80,1248954,772637379,1240422,771612763,8532,1024616,1195781,619,5340738,549541,80,5782,130000.0,43333.0,-69.0,-64.0,-72.0,-67.0,-69.0,-64.0,-71.0,-67.0,-79.0,-87.0,-79.0,-87.0,10.0,23.0,7.0,20.0,1
3277,F8:59:71:5A:E0:3D,3339075,588317399,124875,182334679,3214200,405982720,0,122920,140905004,118117,140331072,4803,573932,100618,16,127589,2543,0,524,144444.0,43333.0,-67.0,-72.0,-65.0,-70.0,-66.0,-71.0,-65.0,-70.0,-79.0,-87.0,-79.0,-87.0,12.0,15.0,14.0,17.0,1
3278,CC:2F:71:3E:C5:1F,3225592,407376274,11392,1393554,3214200,405982720,6,48634,4072812,40192,3072502,8442,1000310,12011,34,16356,186,6,826,130000.0,39000.0,-68.0,-71.0,-68.0,-61.0,-69.0,-71.0,-67.0,-60.0,-79.0,-87.0,-79.0,-87.0,11.0,16.0,11.0,26.0,1
3279,CC:2F:71:3F:1F:24,8551292,8548465747,5337092,8142483027,3214200,405982720,80,1249169,772754725,1240637,771730109,8532,1024616,1195996,619,5341811,549681,80,5782,130000.0,43333.0,-70.0,-65.0,-71.0,-68.0,-69.0,-64.0,-71.0,-67.0,-79.0,-87.0,-79.0,-87.0,9.0,22.0,8.0,19.0,1
3280,F8:59:71:5A:E0:3D,3339143,588415765,124938,182432581,3214205,405983184,0,122984,141003578,118181,140429646,4803,573932,100681,16,127652,2546,0,524,144444.0,43333.0,-66.0,-71.0,-65.0,-71.0,-66.0,-71.0,-65.0,-70.0,-79.0,-87.0,-79.0,-87.0,13.0,16.0,14.0,16.0,1
3281,CC:2F:71:3E:C5:1F,3225597,407376738,11392,1393554,3214205,405983184,6,48634,4072812,40192,3072502,8442,1000310,12011,34,16356,186,6,826,130000.0,39000.0,-68.0,-71.0,-68.0,-61.0,-69.0,-71.0,-67.0,-60.0,-79.0,-87.0,-79.0,-87.0,11.0,16.0,11.0,26.0,1
3282,CC:2F:71:3F:1F:24,8552277,8549971107,5338072,8143987923,3214205,405983184,80,1249377,772869791,1240845,771845175,8532,1024616,1196204,619,5342791,549737,80,5782,130000.0,43333.0,-69.0,-64.0,-71.0,-67.0,-69.0,-64.0,-71.0,-67.0,-79.0,-87.0,-79.0,-87.0,10.0,23.0,8.0,20.0,1
3283,F8:59:71:5A:E0:3D,3339211,588514133,125001,182530483,3214210,405983650,0,123047,141100598,118244,140526666,4803,573932,100744,16,127715,2546,0,524,144444.0,43333.0,-66.0,-71.0,-65.0,-70.0,-66.0,-71.0,-64.0,-70.0,-79.0,-87.0,-79.0,-87.0,13.0,16.0,14.0,17.0,1
3284,CC:2F:71:3E:C5:1F,3225602,407377204,11392,1393554,3214210,405983650,6,48634,4072812,40192,3072502,8442,1000310,12011,34,16356,186,6,826,130000.0,39000.0,-68.0,-71.0,-68.0,-61.0,-69.0,-71.0,-67.0,-60.0,-79.0,-87.0,-79.0,-87.0,11.0,16.0,11.0,26.0,1
3285,CC:2F:71:3F:1F:24,8553253,8551454559,5339043,8145470909,3214210,405983650,80,1249617,772990500,1241084,771965766,8533,1024734,1196444,619,5343762,549806,80,5782,117000.0,39000.0,-70.0,-65.0,-72.0,-67.0,-69.0,-64.0,-71.0,-67.0,-79.0,-87.0,-79.0,-87.0,9.0,22.0,7.0,20.0,1
3286,F8:59:71:5A:E0:3D,3339277,588613791,125065,182629939,3214212,405983852,0,123111,141199172,118308,140625240,4803,573932,100807,16,127779,2547,0,524,144444.0,43333.0,-66.0,-72.0,-64.0,-71.0,-66.0,-71.0,-64.0,-70.0,-79.0,-87.0,-79.0,-87.0,13.0,15.0,15.0,16.0,1
3287,CC:2F:71:3E:C5:1F,3225606,407377608,11392,1393554,3214214,405984054,6,48634,4072812,40192,3072502,8442,1000310,12011,34,16356,186,6,826,130000.0,39000.0,-68.0,-71.0,-68.0,-61.0,-69.0,-71.0,-67.0,-60.0,-79.0,-87.0,-79.0,-87.0,11.0,16.0,11.0,26.0,1
3288,CC:2F:71:3F:1F:24,8554392,8553205561,5340178,8147221507,3214214,405984054,80,1249859,773109404,1241326,772084670,8533,1024734,1196686,619,5344897,549904,80,5782,130000.0,43333.0,-69.0,-64.0,-72.0,-67.0,-69.0,-64.0,-71.0,-67.0,-79.0,-87.0,-79.0,-87.0,10.0,23.0,7.0,20.0,1
3289,F8:59:71:5A:E0:3D,3339347,588712359,125128,182727841,3214219,405984518,0,123175,141297774,118372,140723842,4803,573932,100871,16,127842,2547,0,525,144444.0,43333.0,-66.0,-72.0,-64.0,-70.0,-65.0,-71.0,-64.0,-70.0,-79.0,-87.0,-79.0,-87.0,13.0,15.0,15.0,17.0,1
3290,CC:2F:71:3E:C5:1F,3225611,407378072,11392,1393554,3214219,405984518,6,48634,4072812,40192,3072502,8442,1000310,12011,34,16356,186,6,826,130000.0,39000.0,-68.0,-71.0,-68.0,-61.0,-69.0,-71.0,-67.0,-60.0,-79.0,-87.0,-79.0,-87.0,11.0,16.0,11.0,26.0,1
3291,CC:2F:71:3F:1F:24,8555650,8555143139,5341431,8149158621,3214219,405984518,80,1250125,773231210,1241592,772206476,8533,1024734,1196952,619,5346150,549944,80,5782,130000.0,43333.0,-69.0,-64.0,-71.0,-67.0,-69.0,-64.0,-71.0,-67.0,-79.0,-87.0,-79.0,-87.0,10.0,23.0,8.0,20.0,1
3292,F8:59:71:5A:E0:3D,3339414,588812079,125192,182827297,3214222,405984782,0,123239,141394912,118435,140820862,4804,574050,100935,16,127906,2548,0,525,144444.0,43333.0,-66.0,-71.0,-64.0,-70.0,-66.0,-71.0,-64.0,-70.0,-79.0,-87.0,-79.0,-87.0,13.0,16.0,15.0,17.0,1
3293,CC:2F:71:3E:C5:1F,3225614,407378336,11392,1393554,3214222,405984782,6,48634,4072812,40192,3072502,8442,1000310,12011,34,16356,186,6,826,130000.0,39000.0,-68.0,-71.0,-68.0,-61.0,-69.0,-71.0,-67.0,-60.0,-79.0,-87.0,-79.0,-87.0,11.0,16.0,11.0,26.0,1
3294,CC:2F:71:3F:1F:24,8557100,8557383495,5342876,8151398511,3214224,405984984,80,1250435,773359496,1241902,772334762,8533,1024734,1197262,619,5347595,549997,80,5782,130000.0,43333.0,-70.0,-65.0,-72.0,-68.0,-69.0,-65.0,-71.0,-68.0,-79.0,-87.0,-79.0,-87.0,9.0,22.0,7.0,19.0,1
3295,F8:59:71:5A:E0:3D,3339483,588910587,125255,182925199,3214228,405985388,0,123303,141493472,118499,140919422,4804,574050,100999,16,127969,2548,0,525,144444.0,43333.0,-66.0,-71.0,-65.0,-70.0,-65.0,-71.0,-64.0,-69.0,-79.0,-87.0,-79.0,-87.0,13.0,16.0,14.0,17.0,1
3296,CC:2F:71:3E:C5:1F,3225620,407378942,11392,1393554,3214228,405985388,6,48634,4072812,40192,3072502,8442,1000310,12011,34,16356,186,6,826,130000.0,39000.0,-68.0,-71.0,-68.0,-61.0,-69.0,-71.0,-67.0,-60.0,-79.0,-87.0,-79.0,-87.0,11.0,16.0,11.0,26.0,1
3297,CC:2F:71:3F:1F:24,8558538,8559599059,5344310,8153613671,3214228,405985388,80,1250729,773485261,1242196,772460527,8533,1024734,1197556,619,5349029,550033,80,5783,130000.0,43333.0,-70.0,-65.0,-72.0,-68.0,-69.0,-64.0,-71.0,-67.0,-79.0,-87.0,-79.0,-87.0,9.0,22.0,7.0,19.0,1
3298,F8:59:71:5A:E0:3D,3339550,589013211,125321,183027763,3214229,405985448,0,123368,141593572,118564,141019522,4804,574050,101064,16,128035,2548,0,525,144444.0,43333.0,-66.0,-72.0,-65.0,-71.0,-66.0,-71.0,-64.0,-70.0,-79.0,-87.0,-79.0,-87.0,13.0,15.0,14.0,16.0,1
3299,CC:2F:71:3E:C5:1F,3225623,407379204,11392,1393554,3214231,405985650,6,48634,4072812,40192,3072502,8442,1000310,12011,34,16356,186,6,826,130000.0,39000.0,-68.0,-71.0,-68.0,-61.0,-69.0,-71.0,-67.0,-60.0,-79.0,-87.0,-79.0,-87.0,11.0,16.0,11.0,26.0,1
3300,CC:2F:71:3F:1F:24,8559800,8561544127,5345569,8155558477,3214231,405985650,80,1250968,773608323,1242435,772583589,8533,1024734,1197795,619,5350288,550288,80,5784,115556.0,28889.0,-69.0,-65.0,-72.0,-68.0,-69.0,-65.0,-71.0,-68.0,-79.0,-87.0,-79.0,-87.0,10.0,22.0,7.0,19.0,1
3301,F8:59:71:5A:E0:3D,3339621,589111921,125384,183125665,3214237,405986256,0,123432,141692132,118628,141118082,4804,574050,101128,16,128098,2549,0,525,144444.0,43333.0,-66.0,-72.0,-65.0,-70.0,-66.0,-71.0,-65.0,-70.0,-79.0,-87.0,-79.0,-87.0,13.0,15.0,14.0,17.0,1
3302,CC:2F:71:3E:C5:1F,3225629,407379810,11392,1393554,3214237,405986256,6,48634,4072812,40192,3072502,8442,1000310,12011,34,16356,186,6,826,130000.0,39000.0,-68.0,-71.0,-68.0,-61.0,-69.0,-71.0,-67.0,-60.0,-79.0,-87.0,-79.0,-87.0,11.0,16.0,11.0,26.0,1
3303,CC:2F:71:3F:1F:24,8561099,8563543567,5346862,8157557311,3214237,405986256,80,1251232,773729993,1242699,772705259,8533,1024734,1198059,619,5351546,550341,80,5785,115556.0,28889.0,-70.0,-65.0,-72.0,-68.0,-69.0,-64.0,-72.0,-68.0,-79.0,-87.0,-79.0,-87.0,9.0,22.0,7.0,19.0,1
3304,F8:59:71:5A:E0:3D,3339686,589211650,125448,183225121,3214238,405986529,0,123495,141789152,118691,141215102,4804,574050,101191,16,128162,2550,0,525,144444.0,43333.0,-66.0,-72.0,-65.0,-70.0,-66.0,-71.0,-65.0,-70.0,-79.0,-87.0,-79.0,-87.0,13.0,15.0,14.0,17.0,1
3305,CC:2F:71:3E:C5:1F,3225630,407380083,11392,1393554,3214238,405986529,6,48634,4072812,40192,3072502,8442,1000310,12011,34,16356,186,6,826,130000.0,39000.0,-68.0,-71.0,-68.0,-61.0,-69.0,-71.0,-67.0,-60.0,-79.0,-87.0,-79.0,-87.0,11.0,16.0,11.0,26.0,1
3306,CC:2F:71:3F:1F:24,8562433,8565604230,5348194,8159617639,3214239,405986591,80,1251520,773854395,1242987,772829661,8533,1024734,1198347,619,5352904,550459,80,5785,115556.0,28889.0,-70.0,-64.0,-71.0,-68.0,-69.0,-64.0,-71.0,-67.0,-79.0,-87.0,-79.0,-87.0,9.0,23.0,8.0,19.0,1
3307,F8:59:71:5A:E0:3D,3339758,589308928,125510,183321469,3214248,405987459,0,123559,141887726,118755,141313676,4804,574050,101254,16,128224,2550,0,525,144444.0,43333.0,-66.0,-71.0,-65.0,-70.0,-66.0,-71.0,-65.0,-70.0,-79.0,-87.0,-79.0,-87.0,13.0,16.0,14.0,17.0,1
3308,CC:2F:71:3E:C5:1F,3225640,407381013,11392,1393554,3214248,405987459,6,48636,4073000,40193,3072572,8443,1000428,12012,34,16356,186,6,826,130000.0,39000.0,-69.0,-71.0,-68.0,-60.0,-69.0,-71.0,-67.0,-60.0,-79.0,-87.0,-79.0,-87.0,10.0,16.0,11.0,27.0,1
3309,CC:2F:71:3F:1F:24,8563428,8567119126,5349180,8161131667,3214248,405987459,80,1251745,773972795,1243212,772948061,8533,1024734,1198572,619,5353899,550531,80,5785,144444.0,43333.0,-70.0,-64.0,-71.0,-68.0,-70.0,-64.0,-71.0,-68.0,-79.0,-87.0,-79.0,-87.0,9.0,23.0,8.0,19.0,1
3310,F8:59:71:5A:E0:3D,3339821,589406830,125573,183419371,3214248,405987459,0,123622,141984746,118818,141410696,4804,574050,101317,16,128287,2551,0,525,144444.0,43333.0,-66.0,-72.0,-64.0,-71.0,-66.0,-71.0,-64.0,-70.0,-79.0,-87.0,-79.0,-87.0,13.0,15.0,15.0,16.0,1
3311,CC:2F:71:3E:C5:1F,3225640,407381013,11392,1393554,3214248,405987459,6,48636,4073000,40193,3072572,8443,1000428,12012,34,16356,186,6,826,130000.0,39000.0,-69.0,-71.0,-68.0,-60.0,-69.0,-71.0,-67.0,-60.0,-79.0,-87.0,-79.0,-87.0,10.0,16.0,11.0,27.0,1
3312,CC:2F:71:3F:1F:24,8564563,8568862512,5350315,8162875053,3214248,405987459,80,1252026,774095342,1243493,773070608,8533,1024734,1198853,619,5355019,550602,80,5785,144444.0,43333.0,-70.0,-64.0,-71.0,-67.0,-70.0,-64.0,-71.0,-67.0,-79.0,-87.0,-79.0,-87.0,9.0,23.0,8.0,20.0,1
3313,F8:59:71:5A:E0:3D,3339888,589505136,125636,183517273,3214252,405987863,0,123686,142083320,118882,141509270,4804,574050,101380,16,128350,2553,0,525,144444.0,43333.0,-66.0,-71.0,-65.0,-70.0,-66.0,-71.0,-65.0,-70.0,-79.0,-87.0,-79.0,-87.0,13.0,16.0,14.0,17.0,1
3314,CC:2F:71:3E:C5:1F,3225646,407381619,11392,1393554,3214254,405988065,6,48636,4073000,40193,3072572,8443,1000428,12012,34,16356,186,6,826,130000.0,39000.0,-69.0,-71.0,-68.0,-60.0,-69.0,-71.0,-67.0,-60.0,-79.0,-87.0,-79.0,-87.0,10.0,16.0,11.0,27.0,1
3315,CC:2F:71:3F:1F:24,8565927,8570960968,5351671,8164972701,3214256,405988267,80,1252297,774221978,1243764,773197244,8533,1024734,1199124,619,5356374,550702,80,5785,130000.0,43333.0,-70.0,-64.0,-72.0,-68.0,-70.0,-64.0,-71.0,-67.0,-79.0,-87.0,-79.0,-87.0,9.0,23.0,7.0,19.0,1
3316,F8:59:71:5A:E0:3D,3339959,589608164,125702,183619837,3214257,405988327,0,123752,142184960,118948,141610910,4804,574050,101446,16,128416,2553,0,525,144444.0,43333.0,-66.0,-72.0,-65.0,-70.0,-66.0,-71.0,-65.0,-70.0,-79.0,-87.0,-79.0,-87.0,13.0,15.0,14.0,17.0,1
3317,CC:2F:71:3E:C5:1F,3225649,407381881,11392,1393554,3214257,405988327,6,48636,4073000,40193,3072572,8443,1000428,12012,34,16356,186,6,826,130000.0,39000.0,-69.0,-71.0,-68.0,-60.0,-69.0,-71.0,-67.0,-60.0,-79.0,-87.0,-79.0,-87.0,10.0,16.0,11.0,27.0,1
3318,CC:2F:71:3F:1F:24,8567167,8572874410,5352910,8166886083,3214257,405988327,80,1252551,774345146,1244018,773320412,8533,1024734,1199378,619,5357629,550837,80,5785,130000.0,43333.0,-70.0,-64.0,-72.0,-68.0,-70.0,-64.0,-71.0,-67.0,-79.0,-87.0,-79.0,-87.0,9.0,23.0,7.0,19.0,1
3319,F8:59:71:5A:E0:3D,3340026,589709208,125767,183720679,3214259,405988529,0,123816,142283520,119012,141709470,4804,574050,101510,16,128481,2554,0,525,144444.0,43333.0,-66.0,-72.0,-66.0,-71.0,-66.0,-71.0,-65.0,-71.0,-79.0,-87.0,-79.0,-87.0,13.0,15.0,13.0,16.0,1
3320,CC:2F:71:3E:C5:1F,3225653,407382285,11392,1393554,3214261,405988731,6,48636,4073000,40193,3072572,8443,1000428,12012,34,16356,186,6,826,130000.0,39000.0,-69.0,-71.0,-68.0,-60.0,-69.0,-71.0,-67.0,-60.0,-79.0,-87.0,-79.0,-87.0,10.0,16.0,11.0,27.0,1
3321,CC:2F:71:3F:1F:24,8568251,8574537510,5353990,8168548779,3214261,405988731,80,1252764,774459262,1244231,773434528,8533,1024734,1199591,619,5358709,550848,80,5785,130000.0,43333.0,-70.0,-64.0,-72.0,-67.0,-70.0,-64.0,-71.0,-67.0,-79.0,-87.0,-79.0,-87.0,9.0,23.0,7.0,20.0,1
3322,F8:59:71:5A:E0:3D,3340096,589809158,125831,183820023,3214265,405989135,0,123881,142383634,119077,141809584,4804,574050,101574,16,128545,2554,0,525,144444.0,43333.0,-66.0,-72.0,-66.0,-70.0,-66.0,-72.0,-65.0,-70.0,-79.0,-87.0,-79.0,-87.0,13.0,15.0,13.0,17.0,1
3323,CC:2F:71:3E:C5:1F,3225657,407382689,11392,1393554,3214265,405989135,6,48636,4073000,40193,3072572,8443,1000428,12012,34,16356,186,6,826,130000.0,39000.0,-69.0,-71.0,-68.0,-60.0,-69.0,-71.0,-67.0,-60.0,-79.0,-87.0,-79.0,-87.0,10.0,16.0,11.0,27.0,1
3324,CC:2F:71:3F:1F:24,8569681,8576737284,5355415,8170748089,3214266,405989195,80,1253043,774584493,1244510,773559759,8533,1024734,1199870,619,5360134,551028,80,5785,130000.0,43333.0,-70.0,-64.0,-72.0,-67.0,-70.0,-64.0,-71.0,-67.0,-79.0,-87.0,-79.0,-87.0,9.0,23.0,7.0,20.0,1
3325,F8:59:71:5A:E0:3D,3340161,589905768,125893,183916371,3214268,405989397,0,123943,142479114,119139,141905064,4804,574050,101636,16,128607,2554,0,525,144444.0,43333.0,-66.0,-72.0,-65.0,-70.0,-66.0,-72.0,-65.0,-70.0,-79.0,-87.0,-79.0,-87.0,13.0,15.0,14.0,17.0,1
3326,CC:2F:71:3E:C5:1F,3225660,407382951,11392,1393554,3214268,405989397,6,48636,4073000,40193,3072572,8443,1000428,12012,34,16356,186,6,826,130000.0,39000.0,-69.0,-71.0,-68.0,-60.0,-69.0,-71.0,-67.0,-60.0,-79.0,-87.0,-79.0,-87.0,10.0,16.0,11.0,27.0,1
3327,CC:2F:71:3F:1F:24,8570787,8578438054,5356519,8172448657,3214268,405989397,80,1253319,774705905,1244786,773681171,8533,1024734,1200146,619,5361238,551065,80,5785,130000.0,43333.0,-70.0,-65.0,-73.0,-68.0,-70.0,-64.0,-72.0,-67.0,-79.0,-87.0,-79.0,-87.0,9.0,22.0,6.0,19.0,1
3328,F8:59:71:5A:E0:3D,3340230,590004276,125956,184014273,3214274,405990003,0,124006,142576134,119202,142002084,4804,574050,101699,16,128670,2554,0,525,144444.0,43333.0,-66.0,-72.0,-65.0,-71.0,-66.0,-72.0,-65.0,-71.0,-79.0,-87.0,-79.0,-87.0,13.0,15.0,14.0,16.0,1
3329,CC:2F:71:3E:C5:1F,3225666,407383557,11392,1393554,3214274,405990003,6,48636,4073000,40193,3072572,8443,1000428,12012,34,16356,186,6,826,130000.0,39000.0,-69.0,-71.0,-68.0,-60.0,-69.0,-71.0,-67.0,-60.0,-79.0,-87.0,-79.0,-87.0,10.0,16.0,11.0,27.0,1
3330,CC:2F:71:3F:1F:24,8571998,8580300030,5357724,8174310027,3214274,405990003,80,1253551,774826677,1245018,773801943,8533,1024734,1200378,619,5362443,551070,80,5786,130000.0,43333.0,-71.0,-65.0,-72.0,-68.0,-70.0,-65.0,-71.0,-68.0,-79.0,-87.0,-79.0,-87.0,8.0,22.0,7.0,19.0,1
3331,F8:59:71:5A:E0:3D,3340297,590103994,126020,184113729,3214277,405990265,0,124070,142674736,119266,142100686,4804,574050,101763,16,128734,2555,0,525,144444.0,43333.0,-67.0,-72.0,-65.0,-71.0,-66.0,-72.0,-65.0,-70.0,-79.0,-87.0,-79.0,-87.0,12.0,15.0,14.0,16.0,1
3332,CC:2F:71:3E:C5:1F,3225669,407383819,11392,1393554,3214277,405990265,6,48636,4073000,40193,3072572,8443,1000428,12012,34,16356,186,6,826,130000.0,39000.0,-69.0,-71.0,-68.0,-60.0,-69.0,-71.0,-67.0,-60.0,-79.0,-87.0,-79.0,-87.0,10.0,16.0,11.0,27.0,1
3333,CC:2F:71:3F:1F:24,8572969,8581786004,5358692,8175795739,3214277,405990265,80,1253786,774946353,1245253,773921619,8533,1024734,1200613,619,5363411,551157,80,5787,130000.0,43333.0,-70.0,-64.0,-71.0,-68.0,-70.0,-64.0,-71.0,-67.0,-79.0,-87.0,-79.0,-87.0,9.0,23.0,8.0,19.0,1
3334,F8:59:71:5A:E0:3D,3340366,590202502,126083,184211631,3214283,405990871,0,124134,142773296,119330,142199246,4804,574050,101827,16,128797,2555,0,525,144444.0,43333.0,-67.0,-72.0,-65.0,-71.0,-66.0,-72.0,-65.0,-70.0,-79.0,-87.0,-79.0,-87.0,12.0,15.0,14.0,16.0,1
3335,CC:2F:71:3E:C5:1F,3225675,407384425,11392,1393554,3214283,405990871,6,48636,4073000,40193,3072572,8443,1000428,12012,34,16356,186,6,826,130000.0,39000.0,-69.0,-71.0,-68.0,-60.0,-69.0,-71.0,-67.0,-60.0,-79.0,-87.0,-79.0,-87.0,10.0,16.0,11.0,27.0,1
3336,CC:2F:71:3F:1F:24,8574384,8583960808,5360101,8177969937,3214283,405990871,80,1254069,775069092,1245536,774044358,8533,1024734,1200896,619,5364801,551230,80,5787,117000.0,39000.0,-70.0,-64.0,-72.0,-67.0,-69.0,-64.0,-71.0,-67.0,-79.0,-87.0,-79.0,-87.0,9.0,23.0,7.0,20.0,1
3337,F8:59:71:5A:E0:3D,3340429,590300404,126146,184309533,3214283,405990871,0,124197,142870358,119393,142296308,4804,574050,101890,16,128860,2555,0,525,144444.0,43333.0,-66.0,-71.0,-65.0,-70.0,-66.0,-71.0,-65.0,-70.0,-79.0,-87.0,-79.0,-87.0,13.0,16.0,14.0,17.0,1
3338,CC:2F:71:3E:C5:1F,3225675,407384425,11392,1393554,3214283,405990871,6,48636,4073000,40193,3072572,8443,1000428,12012,34,16356,186,6,826,130000.0,39000.0,-69.0,-71.0,-68.0,-60.0,-69.0,-71.0,-67.0,-60.0,-79.0,-87.0,-79.0,-87.0,10.0,16.0,11.0,27.0,1
3339,CC:2F:71:3F:1F:24,8575666,8585943572,5361383,8179952701,3214283,405990871,80,1254353,775194522,1245820,774169788,8533,1024734,1201180,619,5366102,551238,80,5788,130000.0,43333.0,-70.0,-64.0,-71.0,-67.0,-70.0,-64.0,-71.0,-67.0,-79.0,-87.0,-79.0,-87.0,9.0,23.0,8.0,20.0,1
3340,F8:59:71:5A:E0:3D,3340501,590402080,126211,184410543,3214290,405991537,0,124264,142973566,119460,142399516,4804,574050,101955,16,128925,2555,0,525,144444.0,43333.0,-66.0,-71.0,-65.0,-70.0,-66.0,-71.0,-65.0,-70.0,-79.0,-87.0,-79.0,-87.0,13.0,16.0,14.0,17.0,1
3341,CC:2F:71:3E:C5:1F,3225684,407385293,11392,1393554,3214292,405991739,6,48636,4073000,40193,3072572,8443,1000428,12012,34,16356,186,6,826,130000.0,39000.0,-69.0,-71.0,-68.0,-60.0,-69.0,-71.0,-67.0,-60.0,-79.0,-87.0,-79.0,-87.0,10.0,16.0,11.0,27.0,1
3342,CC:2F:71:3F:1F:24,8577107,8588162160,5362815,8182170421,3214292,405991739,80,1254623,775321044,1246090,774296310,8533,1024734,1201450,619,5367519,551484,80,5788,117000.0,39000.0,-68.0,-65.0,-71.0,-68.0,-68.0,-65.0,-71.0,-68.0,-79.0,-87.0,-79.0,-87.0,11.0,22.0,8.0,19.0,1
3343,F8:59:71:5A:E0:3D,3340570,590506400,126278,184514661,3214292,405991739,0,124330,143075206,119526,142501156,4804,574050,102021,16,128992,2555,0,525,144444.0,43333.0,-67.0,-72.0,-65.0,-70.0,-66.0,-72.0,-65.0,-70.0,-79.0,-87.0,-79.0,-87.0,12.0,15.0,14.0,17.0,1
3344,CC:2F:71:3E:C5:1F,3225684,407385293,11392,1393554,3214292,405991739,6,48636,4073000,40193,3072572,8443,1000428,12012,34,16356,186,6,826,130000.0,39000.0,-69.0,-71.0,-68.0,-60.0,-69.0,-71.0,-67.0,-60.0,-79.0,-87.0,-79.0,-87.0,10.0,16.0,11.0,27.0,1
3345,CC:2F:71:3F:1F:24,8579039,8591168720,5364747,8185176981,3214292,405991739,80,1254933,775457972,1246400,774433238,8533,1024734,1201760,619,5369418,551655,80,5788,115556.0,28889.0,-69.0,-65.0,-71.0,-69.0,-68.0,-64.0,-71.0,-68.0,-79.0,-87.0,-79.0,-87.0,10.0,22.0,8.0,18.0,1
3346,F8:59:71:5A:E0:3D,3340645,590612951,126346,184620333,3214299,405992618,0,124399,143181466,119595,142607416,4804,574050,102090,16,129060,2556,0,525,144444.0,43333.0,-66.0,-72.0,-65.0,-70.0,-66.0,-72.0,-65.0,-70.0,-79.0,-87.0,-79.0,-87.0,13.0,15.0,14.0,17.0,1
3347,CC:2F:71:3E:C5:1F,3225691,407386172,11392,1393554,3214299,405992618,6,48636,4073000,40193,3072572,8443,1000428,12012,34,16356,186,6,826,130000.0,39000.0,-69.0,-71.0,-68.0,-60.0,-69.0,-71.0,-67.0,-60.0,-79.0,-87.0,-79.0,-87.0,10.0,16.0,11.0,27.0,1
3348,CC:2F:71:3F:1F:24,8580486,8593392833,5366186,8187400081,3214300,405992752,80,1255206,775581417,1246673,774556683,8533,1024734,1202033,619,5370881,551735,80,5788,115556.0,28889.0,-69.0,-64.0,-71.0,-68.0,-69.0,-64.0,-70.0,-68.0,-79.0,-87.0,-79.0,-87.0,10.0,23.0,8.0,19.0,1
3349,F8:59:71:5A:E0:3D,3340714,590714339,126412,184721459,3214302,405992880,0,124464,143280132,119660,142706082,4804,574050,102155,16,129126,2556,0,525,144444.0,43333.0,-66.0,-72.0,-66.0,-71.0,-66.0,-72.0,-65.0,-70.0,-79.0,-87.0,-79.0,-87.0,13.0,15.0,13.0,16.0,1
3350,CC:2F:71:3E:C5:1F,3225694,407386434,11392,1393554,3214302,405992880,6,48636,4073000,40193,3072572,8443,1000428,12012,34,16356,186,6,826,130000.0,39000.0,-69.0,-71.0,-68.0,-60.0,-69.0,-71.0,-67.0,-60.0,-79.0,-87.0,-79.0,-87.0,10.0,16.0,11.0,27.0,1
3351,CC:2F:71:3F:1F:24,8581921,8595610621,5367619,8189617741,3214302,405992880,80,1255502,775708259,1246969,774683525,8533,1024734,1202329,619,5372338,551788,80,5789,130000.0,43333.0,-69.0,-64.0,-71.0,-68.0,-69.0,-64.0,-71.0,-68.0,-79.0,-87.0,-79.0,-87.0,10.0,23.0,8.0,19.0,1
3352,F8:59:71:5A:E0:3D,3340782,590811293,126474,184817807,3214308,405993486,0,124527,143377166,119723,142803116,4804,574050,102217,16,129188,2556,0,525,144444.0,43333.0,-67.0,-73.0,-65.0,-71.0,-66.0,-72.0,-65.0,-70.0,-79.0,-87.0,-79.0,-87.0,12.0,14.0,14.0,16.0,1
3353,CC:2F:71:3E:C5:1F,3225700,407387040,11392,1393554,3214308,405993486,6,48636,4073000,40193,3072572,8443,1000428,12012,34,16356,186,6,826,130000.0,39000.0,-69.0,-71.0,-68.0,-60.0,-69.0,-71.0,-67.0,-60.0,-79.0,-87.0,-79.0,-87.0,10.0,16.0,11.0,27.0,1
3354,CC:2F:71:3F:1F:24,8583109,8597434879,5368801,8191441393,3214308,405993486,80,1255713,775822167,1247180,774797433,8533,1024734,1202540,619,5373489,551861,80,5789,130000.0,43333.0,-69.0,-64.0,-71.0,-68.0,-69.0,-64.0,-71.0,-68.0,-79.0,-87.0,-79.0,-87.0,10.0,23.0,8.0,19.0,1
3355,F8:59:71:5A:E0:3D,3340846,590907843,126536,184914155,3214310,405993688,0,124590,143474186,119786,142900136,4804,574050,102280,16,129250,2556,0,525,144444.0,43333.0,-67.0,-72.0,-65.0,-71.0,-66.0,-72.0,-65.0,-71.0,-79.0,-87.0,-79.0,-87.0,12.0,15.0,14.0,16.0,1
3356,CC:2F:71:3E:C5:1F,3225702,407387242,11392,1393554,3214310,405993688,6,48636,4073000,40193,3072572,8443,1000428,12012,34,16356,186,6,826,130000.0,39000.0,-69.0,-71.0,-68.0,-60.0,-69.0,-71.0,-67.0,-60.0,-79.0,-87.0,-79.0,-87.0,10.0,16.0,11.0,27.0,1
3357,CC:2F:71:3F:1F:24,8584390,8599411823,5370080,8193418135,3214310,405993688,80,1255951,775940619,1247418,774915885,8533,1024734,1202778,619,5374799,551940,80,5789,130000.0,43333.0,-69.0,-65.0,-71.0,-69.0,-69.0,-65.0,-71.0,-69.0,-79.0,-87.0,-79.0,-87.0,10.0,22.0,8.0,18.0,1
3358,F8:59:71:5A:E0:3D,3340914,591006209,126599,185012057,3214315,405994152,0,124653,143571220,119849,142997170,4804,574050,102342,16,129313,2557,0,525,144444.0,43333.0,-67.0,-73.0,-65.0,-71.0,-66.0,-72.0,-65.0,-70.0,-79.0,-87.0,-79.0,-87.0,12.0,14.0,14.0,16.0,1
3359,CC:2F:71:3E:C5:1F,3225707,407387706,11392,1393554,3214315,405994152,6,48636,4073000,40193,3072572,8443,1000428,12012,34,16356,186,6,826,130000.0,39000.0,-69.0,-71.0,-68.0,-60.0,-69.0,-71.0,-67.0,-60.0,-79.0,-87.0,-79.0,-87.0,10.0,16.0,11.0,27.0,1
3360,CC:2F:71:3F:1F:24,8585587,8601248445,5371270,8195254091,3214317,405994354,80,1256197,776065921,1247664,775041187,8533,1024734,1203024,619,5375989,551988,80,5790,130000.0,43333.0,-69.0,-64.0,-71.0,-68.0,-69.0,-64.0,-71.0,-67.0,-79.0,-87.0,-79.0,-87.0,10.0,23.0,8.0,19.0,1
3361,F8:59:71:5A:E0:3D,3340985,591110731,126666,185116175,3214319,405994556,0,124719,143672916,119915,143098866,4804,574050,102408,16,129380,2558,0,525,144444.0,43333.0,-66.0,-72.0,-65.0,-71.0,-66.0,-72.0,-64.0,-70.0,-79.0,-87.0,-79.0,-87.0,13.0,15.0,14.0,16.0,1
3362,CC:2F:71:3E:C5:1F,3225711,407388110,11392,1393554,3214319,405994556,6,48636,4073000,40193,3072572,8443,1000428,12012,34,16356,186,6,826,130000.0,39000.0,-69.0,-71.0,-68.0,-60.0,-69.0,-71.0,-67.0,-60.0,-79.0,-87.0,-79.0,-87.0,10.0,16.0,11.0,27.0,1
3363,CC:2F:71:3F:1F:24,8586638,8602847793,5372317,8196852869,3214321,405994924,80,1256412,776180976,1247879,775156242,8533,1024734,1203239,619,5377036,552025,80,5790,130000.0,43333.0,-70.0,-64.0,-71.0,-68.0,-69.0,-64.0,-70.0,-68.0,-79.0,-87.0,-79.0,-87.0,9.0,23.0,8.0,19.0,1
3364,F8:59:71:5A:E0:3D,3341052,591207765,126729,185212639,3214323,405995126,0,124782,143769936,119978,143195886,4804,574050,102471,16,129443,2558,0,525,144444.0,43333.0,-67.0,-72.0,-64.0,-70.0,-66.0,-72.0,-64.0,-70.0,-79.0,-87.0,-79.0,-87.0,12.0,15.0,15.0,17.0,1
3365,CC:2F:71:3E:C5:1F,3225716,407388796,11393,1393670,3214323,405995126,6,48638,4073140,40195,3072712,8443,1000428,12012,34,16357,186,6,826,130000.0,39000.0,-70.0,-71.0,-67.0,-60.0,-69.0,-71.0,-67.0,-60.0,-79.0,-87.0,-79.0,-87.0,9.0,16.0,12.0,27.0,1
3366,CC:2F:71:3F:1F:24,8587757,8604566035,5373432,8198570707,3214325,405995328,80,1256628,776295518,1248095,775270784,8533,1024734,1203455,619,5378151,552074,80,5790,117000.0,39000.0,-69.0,-64.0,-70.0,-68.0,-69.0,-64.0,-70.0,-68.0,-79.0,-87.0,-79.0,-87.0,10.0,23.0,9.0,19.0,1
3367,F8:59:71:5A:E0:3D,3341121,591304779,126791,185308987,3214330,405995792,0,124845,143866956,120041,143292906,4804,574050,102534,16,129505,2558,0,525,144444.0,43333.0,-66.0,-72.0,-65.0,-70.0,-66.0,-72.0,-64.0,-70.0,-79.0,-87.0,-79.0,-87.0,13.0,15.0,14.0,17.0,1
3368,CC:2F:71:3E:C5:1F,3225723,407389462,11393,1393670,3214330,405995792,6,48638,4073140,40195,3072712,8443,1000428,12012,34,16357,186,6,826,130000.0,39000.0,-70.0,-71.0,-67.0,-60.0,-69.0,-71.0,-67.0,-60.0,-79.0,-87.0,-79.0,-87.0,9.0,16.0,12.0,27.0,1
3369,CC:2F:71:3F:1F:24,8588900,8606320607,5374570,8200324815,3214330,405995792,80,1256866,776414148,1248333,775389414,8533,1024734,1203693,619,5379280,552109,80,5790,130000.0,43333.0,-69.0,-64.0,-71.0,-68.0,-69.0,-64.0,-71.0,-68.0,-79.0,-87.0,-79.0,-87.0,10.0,23.0,8.0,19.0,1
3370,F8:59:71:5A:E0:3D,3341184,591402681,126854,185406889,3214330,405995792,0,124908,143963976,120104,143389926,4804,574050,102597,16,129568,2559,0,525,144444.0,43333.0,-66.0,-71.0,-65.0,-70.0,-66.0,-71.0,-65.0,-70.0,-79.0,-87.0,-79.0,-87.0,13.0,16.0,14.0,17.0,1
3371,CC:2F:71:3E:C5:1F,3225723,407389462,11393,1393670,3214330,405995792,6,48638,4073140,40195,3072712,8443,1000428,12012,34,16357,186,6,826,130000.0,39000.0,-70.0,-71.0,-67.0,-60.0,-69.0,-71.0,-67.0,-60.0,-79.0,-87.0,-79.0,-87.0,9.0,16.0,12.0,27.0,1
3372,CC:2F:71:3F:1F:24,8589920,8607888599,5375590,8201892807,3214330,405995792,80,1257078,776531166,1248545,775506432,8533,1024734,1203903,619,5380275,552187,80,5791,130000.0,43333.0,-70.0,-64.0,-71.0,-68.0,-70.0,-64.0,-71.0,-68.0,-79.0,-87.0,-79.0,-87.0,9.0,23.0,8.0,19.0,1
3373,F8:59:71:5A:E0:3D,3341254,591502743,126918,185506345,3214336,405996398,0,124974,144065644,120170,143491594,4804,574050,102661,16,129632,2559,0,525,144444.0,43333.0,-67.0,-72.0,-66.0,-71.0,-66.0,-72.0,-65.0,-70.0,-79.0,-87.0,-79.0,-87.0,12.0,15.0,13.0,16.0,1
3374,CC:2F:71:3E:C5:1F,3225730,407390130,11393,1393670,3214337,405996460,6,48638,4073140,40195,3072712,8443,1000428,12012,34,16357,186,6,826,130000.0,39000.0,-70.0,-71.0,-67.0,-60.0,-69.0,-71.0,-67.0,-60.0,-79.0,-87.0,-79.0,-87.0,9.0,16.0,12.0,27.0,1
3375,CC:2F:71:3F:1F:24,8591356,8610090487,5377017,8204093825,3214339,405996662,80,1257359,776656757,1248825,775631905,8534,1024852,1204184,619,5381716,552270,80,5792,130000.0,43333.0,-69.0,-64.0,-71.0,-68.0,-69.0,-64.0,-70.0,-68.0,-79.0,-87.0,-79.0,-87.0,10.0,23.0,8.0,19.0,1
3376,F8:59:71:5A:E0:3D,3341322,591602523,126982,185605801,3214340,405996722,0,125038,144164204,120234,143590154,4804,574050,102725,16,129696,2560,0,525,144444.0,43333.0,-66.0,-72.0,-65.0,-70.0,-66.0,-71.0,-64.0,-70.0,-79.0,-87.0,-79.0,-87.0,13.0,15.0,14.0,17.0,1
3377,CC:2F:71:3E:C5:1F,3225733,407390392,11393,1393670,3214340,405996722,6,48638,4073140,40195,3072712,8443,1000428,12012,34,16357,186,6,826,130000.0,39000.0,-70.0,-71.0,-67.0,-60.0,-69.0,-71.0,-67.0,-60.0,-79.0,-87.0,-79.0,-87.0,9.0,16.0,12.0,27.0,1
3378,CC:2F:71:3F:1F:24,8592741,8612234155,5378401,8206237433,3214340,405996722,80,1257640,776781769,1249106,775756917,8534,1024852,1204465,619,5383120,552373,80,5793,130000.0,43333.0,-69.0,-64.0,-70.0,-68.0,-69.0,-64.0,-70.0,-68.0,-79.0,-87.0,-79.0,-87.0,10.0,23.0,9.0,19.0,1
3379,F8:59:71:5A:E0:3D,3341391,591701031,127045,185703703,3214346,405997328,0,125101,144261224,120297,143687174,4804,574050,102788,16,129759,2561,0,525,144444.0,43333.0,-66.0,-71.0,-65.0,-70.0,-66.0,-71.0,-64.0,-70.0,-79.0,-87.0,-79.0,-87.0,13.0,16.0,14.0,17.0,1
3380,CC:2F:71:3E:C5:1F,3225739,407390998,11393,1393670,3214346,405997328,6,48638,4073140,40195,3072712,8443,1000428,12012,34,16357,186,6,826,130000.0,39000.0,-70.0,-71.0,-67.0,-60.0,-69.0,-71.0,-67.0,-60.0,-79.0,-87.0,-79.0,-87.0,9.0,16.0,12.0,27.0,1
3381,CC:2F:71:3F:1F:24,8594218,8614514455,5379872,8208517127,3214346,405997328,80,1257928,776906191,1249394,775881339,8534,1024852,1204753,619,5384591,552441,80,5793,130000.0,43333.0,-69.0,-64.0,-71.0,-68.0,-69.0,-64.0,-71.0,-68.0,-79.0,-87.0,-79.0,-87.0,10.0,23.0,8.0,19.0,1
3382,F8:59:71:5A:E0:3D,3341468,591806113,127109,185803159,3214359,406002954,0,125166,144361352,120362,143787302,4804,574050,102851,16,129823,2561,0,525,144444.0,43333.0,-66.0,-72.0,-65.0,-70.0,-66.0,-72.0,-64.0,-70.0,-79.0,-87.0,-79.0,-87.0,13.0,15.0,14.0,17.0,1
3383,CC:2F:71:3E:C5:1F,3225753,407396684,11393,1393670,3214360,406003014,6,48638,4073140,40195,3072712,8443,1000428,12012,34,16357,186,6,826,130000.0,39000.0,-70.0,-71.0,-67.0,-60.0,-69.0,-71.0,-67.0,-60.0,-79.0,-87.0,-79.0,-87.0,9.0,16.0,12.0,27.0,1
3384,CC:2F:71:3F:1F:24,8595607,8616649211,5381247,8210646197,3214360,406003014,80,1258209,777041183,1249675,776016331,8534,1024852,1205034,619,5385966,552504,80,5793,130000.0,39000.0,-70.0,-65.0,-72.0,-69.0,-69.0,-65.0,-71.0,-68.0,-79.0,-87.0,-79.0,-87.0,9.0,22.0,7.0,18.0,1
3385,F8:59:71:5A:E0:3D,3341556,591920983,127179,185911939,3214377,406009044,0,125236,144469152,120432,143895102,4804,574050,102921,16,129893,2561,0,525,144444.0,43333.0,-66.0,-73.0,-65.0,-71.0,-66.0,-72.0,-65.0,-71.0,-79.0,-87.0,-79.0,-87.0,13.0,14.0,14.0,16.0,1
3386,CC:2F:71:3E:C5:1F,3225770,407402714,11393,1393670,3214377,406009044,6,48638,4073140,40195,3072712,8443,1000428,12012,34,16357,186,6,826,130000.0,39000.0,-70.0,-71.0,-67.0,-60.0,-69.0,-71.0,-67.0,-60.0,-79.0,-87.0,-79.0,-87.0,9.0,16.0,12.0,27.0,1
3387,CC:2F:71:3F:1F:24,8596547,8618062563,5382170,8212053519,3214377,406009044,80,1258439,777159366,1249905,776134514,8534,1024852,1205264,619,5386859,552525,80,5793,130000.0,43333.0,-69.0,-65.0,-72.0,-68.0,-69.0,-64.0,-71.0,-68.0,-79.0,-87.0,-79.0,-87.0,10.0,22.0,7.0,19.0,1
3388,F8:59:71:5A:E0:3D,3341622,592019192,127242,186009673,3214380,406009519,0,125300,144567712,120496,143993662,4804,574050,102985,16,129956,2561,0,525,144444.0,43333.0,-67.0,-73.0,-65.0,-71.0,-66.0,-72.0,-65.0,-70.0,-79.0,-87.0,-79.0,-87.0,12.0,14.0,14.0,16.0,1
3389,CC:2F:71:3E:C5:1F,3225773,407403189,11393,1393670,3214380,406009519,6,48638,4073140,40195,3072712,8443,1000428,12012,34,16357,186,6,826,130000.0,39000.0,-70.0,-71.0,-67.0,-60.0,-69.0,-71.0,-67.0,-60.0,-79.0,-87.0,-79.0,-87.0,9.0,16.0,12.0,27.0,1
3390,CC:2F:71:3F:1F:24,8597647,8619752312,5383267,8213742793,3214380,406009519,80,1258647,777276180,1250113,776251328,8534,1024852,1205471,619,5387986,552618,80,5793,130000.0,43333.0,-68.0,-64.0,-72.0,-69.0,-68.0,-64.0,-71.0,-69.0,-79.0,-87.0,-79.0,-87.0,11.0,23.0,7.0,18.0,1
3391,F8:59:71:5A:E0:3D,3341694,592120868,127307,186110683,3214387,406010185,0,125365,144667812,120561,144093762,4804,574050,103050,16,130021,2563,0,525,144444.0,43333.0,-67.0,-72.0,-65.0,-71.0,-66.0,-72.0,-64.0,-70.0,-79.0,-87.0,-79.0,-87.0,12.0,15.0,14.0,16.0,1
3392,CC:2F:71:3E:C5:1F,3225780,407403855,11393,1393670,3214387,406010185,6,48638,4073140,40195,3072712,8443,1000428,12012,34,16357,186,6,826,130000.0,39000.0,-70.0,-71.0,-67.0,-60.0,-69.0,-71.0,-67.0,-60.0,-79.0,-87.0,-79.0,-87.0,9.0,16.0,12.0,27.0,1
3393,CC:2F:71:3F:1F:24,8598820,8621550574,5384433,8215540389,3214387,406010185,80,1258865,777395360,1250331,776370508,8534,1024852,1205689,619,5389130,553158,80,5795,115556.0,28889.0,-69.0,-65.0,-72.0,-69.0,-69.0,-64.0,-71.0,-68.0,-79.0,-87.0,-79.0,-87.0,10.0,22.0,7.0,18.0,1
3394,F8:59:71:5A:E0:3D,3341759,592218972,127370,186208585,3214389,406010387,0,125428,144764846,120624,144190796,4804,574050,103112,16,130083,2563,0,525,144444.0,43333.0,-66.0,-71.0,-64.0,-70.0,-66.0,-71.0,-64.0,-70.0,-79.0,-87.0,-79.0,-87.0,13.0,16.0,15.0,17.0,1
3395,CC:2F:71:3E:C5:1F,3225782,407404057,11393,1393670,3214389,406010387,6,48638,4073140,40195,3072712,8443,1000428,12012,34,16357,186,6,826,130000.0,39000.0,-70.0,-71.0,-67.0,-60.0,-69.0,-71.0,-67.0,-60.0,-79.0,-87.0,-79.0,-87.0,9.0,16.0,12.0,27.0,1
3396,CC:2F:71:3F:1F:24,8600150,8623604648,5385761,8217594261,3214389,406010387,80,1259154,777519900,1250620,776495048,8534,1024852,1205978,619,5390470,553293,80,5795,115556.0,28889.0,-69.0,-63.0,-71.0,-70.0,-69.0,-63.0,-71.0,-69.0,-79.0,-87.0,-79.0,-87.0,10.0,24.0,8.0,17.0,1
3397,F8:59:71:5A:E0:3D,3341827,592317340,127433,186306487,3214394,406010853,0,125493,144863524,120688,144289356,4805,574168,103177,16,130147,2564,0,525,144444.0,43333.0,-67.0,-72.0,-65.0,-71.0,-66.0,-72.0,-65.0,-70.0,-79.0,-87.0,-79.0,-87.0,12.0,15.0,14.0,16.0,1
3398,CC:2F:71:3E:C5:1F,3225789,407404725,11393,1393670,3214396,406011055,6,48638,4073140,40195,3072712,8443,1000428,12012,34,16357,186,6,826,130000.0,39000.0,-70.0,-71.0,-67.0,-60.0,-69.0,-71.0,-67.0,-60.0,-79.0,-87.0,-79.0,-87.0,9.0,16.0,12.0,27.0,1
3399,CC:2F:71:3F:1F:24,8601244,8625272864,5386848,8219261809,3214396,406011055,80,1259439,777647231,1250905,776622379,8534,1024852,1206263,619,5391567,553295,80,5795,115556.0,28889.0,-69.0,-64.0,-71.0,-70.0,-69.0,-63.0,-71.0,-69.0,-79.0,-87.0,-79.0,-87.0,10.0,23.0,8.0,17.0,1
3400,F8:59:71:5A:E0:3D,3341897,592418814,127498,186407497,3214399,406011317,0,125558,144963680,120753,144389512,4805,574168,103241,16,130212,2565,0,526,144444.0,43333.0,-67.0,-72.0,-65.0,-71.0,-66.0,-72.0,-65.0,-70.0,-79.0,-87.0,-79.0,-87.0,12.0,15.0,14.0,16.0,1
3401,CC:2F:71:3E:C5:1F,3225792,407404987,11393,1393670,3214399,406011317,6,48638,4073140,40195,3072712,8443,1000428,12012,34,16357,186,6,826,130000.0,39000.0,-70.0,-71.0,-67.0,-60.0,-69.0,-71.0,-67.0,-60.0,-79.0,-87.0,-79.0,-87.0,9.0,16.0,12.0,27.0,1
3402,CC:2F:71:3F:1F:24,8602129,8626623010,5387730,8220611693,3214399,406011317,80,1259643,777762059,1251109,776737207,8534,1024852,1206465,619,5392449,553352,80,5796,130000.0,43333.0,-71.0,-64.0,-72.0,-69.0,-70.0,-64.0,-71.0,-69.0,-79.0,-87.0,-79.0,-87.0,8.0,23.0,7.0,18.0,1
3403,F8:59:71:5A:E0:3D,3341964,592517096,127562,186505515,3214402,406011581,0,125622,145060806,120817,144486638,4805,574168,103305,16,130276,2565,0,526,144444.0,43333.0,-67.0,-72.0,-65.0,-71.0,-66.0,-71.0,-65.0,-71.0,-79.0,-87.0,-79.0,-87.0,12.0,15.0,14.0,16.0,1
3404,CC:2F:71:3E:C5:1F,3225795,407405251,11393,1393670,3214402,406011581,6,48640,4073328,40196,3072782,8444,1000546,12013,34,16357,186,6,826,130000.0,39000.0,-69.0,-72.0,-69.0,-60.0,-68.0,-70.0,-67.0,-60.0,-79.0,-87.0,-79.0,-87.0,10.0,15.0,10.0,27.0,1
3405,CC:2F:71:3F:1F:24,8603077,8628069996,5388673,8222058213,3214404,406011783,80,1259849,777877075,1251315,776852223,8534,1024852,1206671,619,5393388,553369,80,5797,130000.0,43333.0,-70.0,-65.0,-72.0,-69.0,-70.0,-64.0,-71.0,-68.0,-79.0,-87.0,-79.0,-87.0,9.0,22.0,7.0,18.0,1
3406,F8:59:71:5A:E0:3D,3342032,592614050,127624,186601863,3214408,406012187,0,125685,145157826,120880,144583658,4805,574168,103368,16,130338,2565,0,526,144444.0,43333.0,-67.0,-72.0,-65.0,-71.0,-66.0,-71.0,-65.0,-70.0,-79.0,-87.0,-79.0,-87.0,12.0,15.0,14.0,16.0,1
3407,CC:2F:71:3E:C5:1F,3225801,407405857,11393,1393670,3214408,406012187,6,48640,4073328,40196,3072782,8444,1000546,12013,34,16357,186,6,826,130000.0,39000.0,-69.0,-72.0,-69.0,-60.0,-68.0,-70.0,-67.0,-60.0,-79.0,-87.0,-79.0,-87.0,10.0,15.0,10.0,27.0,1
3408,CC:2F:71:3F:1F:24,8603906,8629332106,5389498,8223319919,3214408,406012187,80,1260055,777993529,1251521,776968677,8534,1024852,1206877,619,5394189,553400,80,5798,130000.0,43333.0,-70.0,-65.0,-71.0,-69.0,-70.0,-65.0,-71.0,-68.0,-79.0,-87.0,-79.0,-87.0,9.0,22.0,8.0,18.0,1
3409,F8:59:71:5A:E0:3D,3342097,592713566,127688,186701319,3214409,406012247,0,125749,145256414,120944,144682246,4805,574168,103432,16,130402,2567,0,526,144444.0,43333.0,-66.0,-72.0,-65.0,-71.0,-66.0,-72.0,-65.0,-71.0,-79.0,-87.0,-79.0,-87.0,13.0,15.0,14.0,16.0,1
3410,CC:2F:71:3E:C5:1F,3225804,407406119,11393,1393670,3214411,406012449,6,48640,4073328,40196,3072782,8444,1000546,12013,34,16357,186,6,826,130000.0,39000.0,-69.0,-72.0,-69.0,-60.0,-68.0,-70.0,-67.0,-60.0,-79.0,-87.0,-79.0,-87.0,10.0,15.0,10.0,27.0,1
3411,CC:2F:71:3F:1F:24,8605209,8631343472,5390798,8225331023,3214411,406012449,80,1260280,778110413,1251746,777085561,8534,1024852,1207102,619,5395517,553549,80,5798,130000.0,43333.0,-69.0,-65.0,-71.0,-68.0,-69.0,-65.0,-71.0,-68.0,-79.0,-87.0,-79.0,-87.0,10.0,22.0,8.0,19.0,1
3412,F8:59:71:5A:E0:3D,3342166,592812074,127751,186799221,3214415,406012853,0,125813,145354988,121008,144780820,4805,574168,103495,16,130465,2567,0,526,144444.0,43333.0,-67.0,-72.0,-65.0,-71.0,-67.0,-72.0,-65.0,-71.0,-79.0,-87.0,-79.0,-87.0,12.0,15.0,14.0,16.0,1
3413,CC:2F:71:3E:C5:1F,3225808,407406523,11393,1393670,3214415,406012853,6,48640,4073328,40196,3072782,8444,1000546,12013,34,16357,186,6,826,130000.0,39000.0,-69.0,-72.0,-69.0,-60.0,-68.0,-70.0,-67.0,-60.0,-79.0,-87.0,-79.0,-87.0,10.0,15.0,10.0,27.0,1
3414,CC:2F:71:3F:1F:24,8606500,8633324116,5392083,8227311061,3214417,406013055,80,1260542,778232454,1252008,777207602,8534,1024852,1207364,619,5396802,553623,80,5798,130000.0,43333.0,-69.0,-65.0,-71.0,-67.0,-69.0,-64.0,-71.0,-67.0,-79.0,-87.0,-79.0,-87.0,10.0,22.0,8.0,20.0,1
3415,F8:59:71:5A:E0:3D,3342231,592910178,127814,186897123,3214417,406013055,0,125877,145453562,121072,144879394,4805,574168,103558,16,130528,2568,0,526,144444.0,43333.0,-67.0,-72.0,-66.0,-71.0,-66.0,-72.0,-65.0,-71.0,-79.0,-87.0,-79.0,-87.0,12.0,15.0,13.0,16.0,1
3416,CC:2F:71:3E:C5:1F,3225810,407406725,11393,1393670,3214417,406013055,6,48640,4073328,40196,3072782,8444,1000546,12013,34,16357,186,6,826,130000.0,39000.0,-69.0,-72.0,-69.0,-60.0,-68.0,-70.0,-67.0,-60.0,-79.0,-87.0,-79.0,-87.0,10.0,15.0,10.0,27.0,1
3417,CC:2F:71:3F:1F:24,8607682,8635147568,5393265,8229134513,3214417,406013055,80,1260811,778354532,1252277,777329680,8534,1024852,1207633,619,5397971,553757,80,5798,130000.0,43333.0,-69.0,-65.0,-72.0,-68.0,-69.0,-65.0,-71.0,-67.0,-79.0,-87.0,-79.0,-87.0,10.0,22.0,7.0,19.0,1
3418,F8:59:71:5A:E0:3D,3342302,593010300,127878,186996579,3214424,406013721,0,125941,145552122,121136,144977954,4805,574168,103622,16,130592,2569,0,526,144444.0,43333.0,-67.0,-72.0,-65.0,-71.0,-66.0,-72.0,-65.0,-70.0,-79.0,-87.0,-79.0,-87.0,12.0,15.0,14.0,16.0,1
3419,CC:2F:71:3E:C5:1F,3225817,407407391,11393,1393670,3214424,406013721,6,48640,4073328,40196,3072782,8444,1000546,12013,34,16357,186,6,826,130000.0,39000.0,-69.0,-72.0,-69.0,-60.0,-68.0,-70.0,-67.0,-60.0,-79.0,-87.0,-79.0,-87.0,10.0,15.0,10.0,27.0,1
3420,CC:2F:71:3F:1F:24,8609341,8637714746,5394917,8231701025,3214424,406013721,80,1261107,778481370,1252573,777456518,8534,1024852,1207929,619,5399636,554009,80,5798,130000.0,43333.0,-68.0,-65.0,-71.0,-68.0,-68.0,-64.0,-71.0,-67.0,-79.0,-87.0,-79.0,-87.0,11.0,22.0,8.0,19.0,1
3421,F8:59:71:5A:E0:3D,3342367,593108404,127941,187094481,3214426,406013923,0,126004,145649156,121199,145074988,4805,574168,103684,16,130655,2570,0,526,144444.0,43333.0,-67.0,-72.0,-65.0,-71.0,-66.0,-72.0,-65.0,-71.0,-79.0,-87.0,-79.0,-87.0,12.0,15.0,14.0,16.0,1
3422,CC:2F:71:3E:C5:1F,3225819,407407593,11393,1393670,3214426,406013923,6,48640,4073328,40196,3072782,8444,1000546,12013,34,16357,186,6,826,130000.0,39000.0,-69.0,-72.0,-69.0,-60.0,-68.0,-70.0,-67.0,-60.0,-79.0,-87.0,-79.0,-87.0,10.0,15.0,10.0,27.0,1
3423,CC:2F:71:3F:1F:24,8610540,8639562270,5396114,8233548347,3214426,406013923,80,1261358,778601588,1252824,777576736,8534,1024852,1208180,619,5400825,554060,80,5798,130000.0,43333.0,-70.0,-64.0,-71.0,-67.0,-69.0,-64.0,-71.0,-67.0,-79.0,-87.0,-79.0,-87.0,9.0,23.0,8.0,20.0,1
3424,F8:59:71:5A:E0:3D,3342436,593206912,128004,187192383,3214432,406014529,0,126068,145747730,121263,145173562,4805,574168,103747,16,130718,2571,0,526,144444.0,43333.0,-67.0,-72.0,-65.0,-71.0,-66.0,-71.0,-65.0,-70.0,-79.0,-87.0,-79.0,-87.0,12.0,15.0,14.0,16.0,1
3425,CC:2F:71:3E:C5:1F,3225825,407408199,11393,1393670,3214432,406014529,6,48640,4073328,40196,3072782,8444,1000546,12013,34,16357,186,6,826,130000.0,39000.0,-69.0,-72.0,-69.0,-60.0,-68.0,-70.0,-67.0,-60.0,-79.0,-87.0,-79.0,-87.0,10.0,15.0,10.0,27.0,1
3426,CC:2F:71:3F:1F:24,8611373,8640817080,5396940,8234802491,3214433,406014589,80,1261569,778717539,1253035,777692687,8534,1024852,1208391,619,5401659,554082,80,5798,130000.0,39000.0,-69.0,-64.0,-71.0,-68.0,-69.0,-64.0,-70.0,-67.0,-79.0,-87.0,-79.0,-87.0,10.0,23.0,8.0,19.0,1
3427,F8:59:71:5A:E0:3D,3342502,593305076,128067,187290285,3214435,406014791,0,126132,145846290,121327,145272122,4805,574168,103811,16,130781,2571,0,526,144444.0,43333.0,-67.0,-72.0,-66.0,-71.0,-66.0,-72.0,-65.0,-71.0,-79.0,-87.0,-79.0,-87.0,12.0,15.0,13.0,16.0,1
3428,CC:2F:71:3E:C5:1F,3225828,407408461,11393,1393670,3214435,406014791,6,48640,4073328,40196,3072782,8444,1000546,12013,34,16357,186,6,826,130000.0,39000.0,-69.0,-72.0,-69.0,-60.0,-68.0,-70.0,-67.0,-60.0,-79.0,-87.0,-79.0,-87.0,10.0,15.0,10.0,27.0,1
3429,CC:2F:71:3F:1F:24,8612287,8642216242,5397852,8236201451,3214435,406014791,80,1261799,778835045,1253265,777810193,8534,1024852,1208621,619,5402571,554096,80,5798,130000.0,43333.0,-69.0,-64.0,-71.0,-68.0,-69.0,-64.0,-70.0,-68.0,-79.0,-87.0,-79.0,-87.0,10.0,23.0,8.0,19.0,1
3430,F8:59:71:5A:E0:3D,3342569,593403382,128130,187388187,3214439,406015195,0,126196,145944864,121391,145370696,4805,574168,103874,16,130844,2571,0,526,144444.0,43333.0,-67.0,-72.0,-65.0,-71.0,-67.0,-72.0,-65.0,-70.0,-79.0,-87.0,-79.0,-87.0,12.0,15.0,14.0,16.0,1
3431,CC:2F:71:3E:C5:1F,3225832,407408865,11393,1393670,3214439,406015195,6,48640,4073328,40196,3072782,8444,1000546,12013,34,16357,186,6,826,130000.0,39000.0,-69.0,-72.0,-69.0,-60.0,-68.0,-70.0,-67.0,-60.0,-79.0,-87.0,-79.0,-87.0,10.0,15.0,10.0,27.0,1
3432,CC:2F:71:3F:1F:24,8613422,8643956761,5398980,8237941091,3214442,406015670,80,1262065,778958253,1253531,777933401,8534,1024852,1208887,619,5403699,554146,80,5798,130000.0,43333.0,-68.0,-64.0,-70.0,-70.0,-68.0,-64.0,-70.0,-69.0,-79.0,-87.0,-79.0,-87.0,11.0,23.0,9.0,17.0,1
3433,F8:59:71:5A:E0:3D,3342640,593505129,128195,187489197,3214445,406015932,0,126260,146043424,121455,145469256,4805,574168,103938,16,130909,2571,0,526,144444.0,43333.0,-68.0,-73.0,-65.0,-71.0,-67.0,-72.0,-65.0,-70.0,-79.0,-87.0,-79.0,-87.0,11.0,14.0,14.0,16.0,1
3434,CC:2F:71:3E:C5:1F,3225838,407409602,11393,1393670,3214445,406015932,6,48640,4073328,40196,3072782,8444,1000546,12013,34,16357,186,6,826,130000.0,39000.0,-69.0,-72.0,-69.0,-60.0,-68.0,-70.0,-67.0,-60.0,-79.0,-87.0,-79.0,-87.0,10.0,15.0,10.0,27.0,1
3435,CC:2F:71:3F:1F:24,8614455,8645541851,5400010,8239525919,3214445,406015932,80,1262295,779078649,1253761,778053797,8534,1024852,1209117,619,5404729,554356,80,5798,130000.0,39000.0,-68.0,-64.0,-71.0,-69.0,-67.0,-64.0,-71.0,-69.0,-79.0,-87.0,-79.0,-87.0,11.0,23.0,8.0,18.0,1
3436,F8:59:71:5A:E0:3D,3342706,593604787,128259,187588653,3214447,406016134,0,126325,146143524,121520,145569356,4805,574168,104003,16,130973,2571,0,526,144444.0,43333.0,-67.0,-72.0,-65.0,-71.0,-67.0,-72.0,-65.0,-70.0,-79.0,-87.0,-79.0,-87.0,12.0,15.0,14.0,16.0,1
3437,CC:2F:71:3E:C5:1F,3225840,407409804,11393,1393670,3214447,406016134,6,48640,4073328,40196,3072782,8444,1000546,12013,34,16357,186,6,826,130000.0,39000.0,-69.0,-72.0,-69.0,-60.0,-68.0,-70.0,-67.0,-60.0,-79.0,-87.0,-79.0,-87.0,10.0,15.0,10.0,27.0,1
3438,CC:2F:71:3F:1F:24,8615601,8647291985,5401152,8241275649,3214449,406016336,80,1262516,779194250,1253982,778169398,8534,1024852,1209338,619,5405849,554444,80,5798,115556.0,28889.0,-68.0,-64.0,-71.0,-69.0,-68.0,-64.0,-70.0,-69.0,-79.0,-87.0,-79.0,-87.0,11.0,23.0,8.0,18.0,1
3439,F8:59:71:5A:E0:3D,3342775,593703295,128322,187686555,3214453,406016740,0,126387,146239004,121582,145664836,4805,574168,104065,16,131036,2572,0,526,144444.0,43333.0,-67.0,-72.0,-65.0,-70.0,-67.0,-72.0,-65.0,-70.0,-79.0,-87.0,-79.0,-87.0,12.0,15.0,14.0,17.0,1
3440,CC:2F:71:3E:C5:1F,3225846,407410410,11393,1393670,3214453,406016740,6,48640,4073328,40196,3072782,8444,1000546,12013,34,16357,186,6,826,130000.0,39000.0,-69.0,-72.0,-69.0,-60.0,-68.0,-70.0,-67.0,-60.0,-79.0,-87.0,-79.0,-87.0,10.0,15.0,10.0,27.0,1
3441,CC:2F:71:3F:1F:24,8616595,8648813065,5402142,8242796325,3214453,406016740,80,1262747,779313470,1254213,778288618,8534,1024852,1209569,619,5406861,554473,80,5798,115556.0,28889.0,-68.0,-64.0,-72.0,-70.0,-68.0,-64.0,-71.0,-69.0,-79.0,-87.0,-79.0,-87.0,11.0,23.0,7.0,17.0,1
3442,F8:59:71:5A:E0:3D,3342841,593801459,128385,187784457,3214456,406017002,0,126452,146339118,121647,145764950,4805,574168,104129,16,131099,2573,0,526,144444.0,43333.0,-67.0,-72.0,-65.0,-71.0,-66.0,-72.0,-65.0,-70.0,-79.0,-87.0,-79.0,-87.0,12.0,15.0,14.0,16.0,1
3443,CC:2F:71:3E:C5:1F,3225849,407410672,11393,1393670,3214456,406017002,6,48640,4073328,40196,3072782,8444,1000546,12013,34,16357,186,6,826,130000.0,39000.0,-69.0,-72.0,-69.0,-60.0,-68.0,-70.0,-67.0,-60.0,-79.0,-87.0,-79.0,-87.0,10.0,15.0,10.0,27.0,1
3444,CC:2F:71:3F:1F:24,8617689,8650492989,5403233,8244475987,3214456,406017002,80,1263007,779434462,1254473,778409610,8534,1024852,1209829,619,5407952,554543,80,5798,130000.0,43333.0,-69.0,-64.0,-71.0,-70.0,-69.0,-64.0,-70.0,-69.0,-79.0,-87.0,-79.0,-87.0,10.0,23.0,8.0,17.0,1
3445,F8:59:71:5A:E0:3D,3342908,593899765,128448,187882359,3214460,406017406,0,126516,146437692,121711,145863524,4805,574168,104192,16,131162,2574,0,526,144444.0,43333.0,-67.0,-72.0,-66.0,-71.0,-66.0,-71.0,-65.0,-71.0,-79.0,-87.0,-79.0,-87.0,12.0,15.0,13.0,16.0,1
3446,CC:2F:71:3E:C5:1F,3225853,407411076,11393,1393670,3214460,406017406,6,48640,4073328,40196,3072782,8444,1000546,12013,34,16357,186,6,826,130000.0,39000.0,-69.0,-72.0,-69.0,-60.0,-68.0,-70.0,-67.0,-60.0,-79.0,-87.0,-79.0,-87.0,10.0,15.0,10.0,27.0,1
3447,CC:2F:71:3F:1F:24,8619029,8652557103,5404567,8246539495,3214462,406017608,80,1263260,779556120,1254726,778531268,8534,1024852,1210081,619,5409286,554579,80,5798,130000.0,43333.0,-70.0,-64.0,-71.0,-69.0,-69.0,-64.0,-70.0,-68.0,-79.0,-87.0,-79.0,-87.0,9.0,23.0,8.0,18.0,1
3448,F8:59:71:5A:E0:3D,3342978,594001295,128514,187983485,3214464,406017810,0,126581,146537806,121776,145963638,4805,574168,104256,16,131228,2574,0,526,144444.0,43333.0,-67.0,-72.0,-65.0,-71.0,-67.0,-72.0,-65.0,-71.0,-79.0,-87.0,-79.0,-87.0,12.0,15.0,14.0,16.0,1
3449,CC:2F:71:3E:C5:1F,3225858,407411596,11394,1393786,3214464,406017810,6,48642,4073468,40198,3072922,8444,1000546,12013,34,16358,186,6,826,130000.0,39000.0,-69.0,-71.0,-68.0,-60.0,-69.0,-70.0,-67.0,-60.0,-79.0,-87.0,-79.0,-87.0,10.0,16.0,11.0,27.0,1
3450,CC:2F:71:3F:1F:24,8620810,8655322961,5406346,8249305151,3214464,406017810,80,1263575,779686480,1255041,778661628,8534,1024852,1210396,619,5411065,554630,80,5798,130000.0,43333.0,-70.0,-64.0,-70.0,-69.0,-70.0,-64.0,-70.0,-68.0,-79.0,-87.0,-79.0,-87.0,9.0,23.0,9.0,18.0,1
3451,F8:59:71:5A:E0:3D,3343046,594099661,128577,188081387,3214469,406018274,0,126644,146634826,121839,146060658,4805,574168,104319,16,131291,2576,0,526,144444.0,43333.0,-66.0,-72.0,-65.0,-71.0,-66.0,-71.0,-65.0,-70.0,-79.0,-87.0,-79.0,-87.0,13.0,15.0,14.0,16.0,1
3452,CC:2F:71:3E:C5:1F,3225863,407412060,11394,1393786,3214469,406018274,6,48642,4073468,40198,3072922,8444,1000546,12013,34,16358,186,6,826,130000.0,39000.0,-69.0,-71.0,-68.0,-60.0,-69.0,-70.0,-67.0,-60.0,-79.0,-87.0,-79.0,-87.0,10.0,16.0,11.0,27.0,1
3453,CC:2F:71:3F:1F:24,8622091,8657287365,5407622,8251269091,3214469,406018274,80,1263808,779804973,1255274,778780121,8534,1024852,1210629,619,5412310,554739,80,5798,130000.0,43333.0,-71.0,-64.0,-71.0,-68.0,-70.0,-64.0,-70.0,-68.0,-79.0,-87.0,-79.0,-87.0,8.0,23.0,8.0,19.0,1
3454,F8:59:71:5A:E0:3D,3343112,594199319,128641,188180843,3214471,406018476,0,126712,146739588,121907,146165420,4805,574168,104384,16,131355,2576,0,526,130000.0,39000.0,-66.0,-73.0,-66.0,-71.0,-66.0,-72.0,-65.0,-70.0,-79.0,-87.0,-79.0,-87.0,13.0,14.0,13.0,16.0,1
3455,CC:2F:71:3E:C5:1F,3225867,407412464,11394,1393786,3214473,406018678,6,48642,4073468,40198,3072922,8444,1000546,12013,34,16358,186,6,826,130000.0,39000.0,-69.0,-71.0,-68.0,-60.0,-69.0,-70.0,-67.0,-60.0,-79.0,-87.0,-79.0,-87.0,10.0,16.0,11.0,27.0,1
3456,CC:2F:71:3F:1F:24,8623572,8659577835,5409099,8253559157,3214473,406018678,80,1264096,779936423,1255562,778911571,8534,1024852,1210917,619,5413818,555298,80,5798,104000.0,26000.0,-68.0,-64.0,-72.0,-69.0,-68.0,-64.0,-71.0,-69.0,-79.0,-87.0,-79.0,-87.0,11.0,23.0,7.0,18.0,1
3457,F8:59:71:5A:E0:3D,3343185,594303875,128708,188284793,3214477,406019082,0,126779,146842796,121974,146268628,4805,574168,104451,16,131422,2576,0,526,144444.0,43333.0,-67.0,-73.0,-66.0,-71.0,-67.0,-73.0,-66.0,-70.0,-79.0,-87.0,-79.0,-87.0,12.0,14.0,13.0,16.0,1
3458,CC:2F:71:3E:C5:1F,3225871,407412868,11394,1393786,3214477,406019082,6,48642,4073468,40198,3072922,8444,1000546,12013,34,16358,186,6,826,130000.0,39000.0,-69.0,-71.0,-68.0,-60.0,-69.0,-70.0,-67.0,-60.0,-79.0,-87.0,-79.0,-87.0,10.0,16.0,11.0,27.0,1
3459,CC:2F:71:3F:1F:24,8624950,8661706315,5410473,8255687233,3214477,406019082,80,1264371,780059293,1255837,779034441,8534,1024852,1211192,619,5415189,555419,80,5798,104000.0,26000.0,-69.0,-64.0,-72.0,-69.0,-69.0,-64.0,-72.0,-68.0,-79.0,-87.0,-79.0,-87.0,10.0,23.0,7.0,18.0,1
3460,F8:59:71:5A:E0:3D,3343251,594402039,128771,188382695,3214480,406019344,0,126842,146939830,122037,146365662,4805,574168,104513,16,131485,2576,0,526,144444.0,43333.0,-66.0,-72.0,-65.0,-70.0,-66.0,-72.0,-65.0,-70.0,-79.0,-87.0,-79.0,-87.0,13.0,15.0,14.0,17.0,1
3461,CC:2F:71:3E:C5:1F,3225874,407413130,11394,1393786,3214480,406019344,6,48642,4073468,40198,3072922,8444,1000546,12013,34,16358,186,6,826,130000.0,39000.0,-69.0,-71.0,-68.0,-60.0,-69.0,-70.0,-67.0,-60.0,-79.0,-87.0,-79.0,-87.0,10.0,16.0,11.0,27.0,1
3462,CC:2F:71:3F:1F:24,8626354,8663872553,5411872,8257853007,3214482,406019546,80,1264657,780183495,1256123,779158643,8534,1024852,1211478,619,5416591,555439,80,5798,115556.0,28889.0,-69.0,-63.0,-70.0,-68.0,-68.0,-63.0,-72.0,-68.0,-79.0,-87.0,-79.0,-87.0,10.0,24.0,9.0,19.0,1
3463,F8:59:71:5A:E0:3D,3343318,594500345,128834,188480597,3214484,406019748,0,126906,147038404,122101,146464236,4805,574168,104576,16,131548,2577,0,526,144444.0,43333.0,-66.0,-72.0,-65.0,-70.0,-66.0,-72.0,-65.0,-70.0,-79.0,-87.0,-79.0,-87.0,13.0,15.0,14.0,17.0,1
3464,CC:2F:71:3E:C5:1F,3225880,407413736,11394,1393786,3214486,406019950,6,48642,4073468,40198,3072922,8444,1000546,12013,34,16358,186,6,826,130000.0,39000.0,-69.0,-71.0,-68.0,-60.0,-69.0,-70.0,-67.0,-60.0,-79.0,-87.0,-79.0,-87.0,10.0,16.0,11.0,27.0,1
3465,CC:2F:71:3F:1F:24,8627456,8665554615,5412970,8259534665,3214486,406019950,80,1264904,780303655,1256370,779278803,8534,1024852,1211725,619,5417689,555515,80,5798,117000.0,39000.0,-68.0,-64.0,-72.0,-68.0,-68.0,-64.0,-72.0,-68.0,-79.0,-87.0,-79.0,-87.0,11.0,23.0,7.0,19.0,1
3466,F8:59:71:5A:E0:3D,3343388,594600329,128898,188580053,3214490,406020276,0,126971,147137082,122165,146562796,4806,574286,104641,16,131612,2578,0,526,144444.0,43333.0,-67.0,-72.0,-65.0,-70.0,-66.0,-71.0,-65.0,-70.0,-79.0,-87.0,-79.0,-87.0,12.0,15.0,14.0,17.0,1
3467,CC:2F:71:3E:C5:1F,3225884,407414062,11394,1393786,3214490,406020276,6,48644,4073656,40199,3072992,8445,1000664,12014,34,16358,186,6,826,130000.0,39000.0,-69.0,-71.0,-68.0,-60.0,-69.0,-70.0,-67.0,-60.0,-79.0,-87.0,-79.0,-87.0,10.0,16.0,11.0,27.0,1
3468,CC:2F:71:3F:1F:24,8628427,8667041355,5413937,8261021079,3214490,406020276,80,1265143,780423755,1256609,779398903,8534,1024852,1211964,619,5418656,555725,80,5798,115556.0,28889.0,-69.0,-64.0,-72.0,-69.0,-68.0,-64.0,-72.0,-68.0,-79.0,-87.0,-79.0,-87.0,10.0,23.0,7.0,18.0,1
3469,F8:59:71:5A:E0:3D,3343453,594696939,128960,188676401,3214493,406020538,0,127034,147234102,122228,146659816,4806,574286,104704,16,131674,2581,0,526,144444.0,43333.0,-66.0,-72.0,-65.0,-71.0,-66.0,-72.0,-65.0,-70.0,-79.0,-87.0,-79.0,-87.0,13.0,15.0,14.0,16.0,1
3470,CC:2F:71:3E:C5:1F,3225887,407414324,11394,1393786,3214493,406020538,6,48644,4073656,40199,3072992,8445,1000664,12014,34,16358,186,6,826,130000.0,39000.0,-69.0,-71.0,-68.0,-60.0,-69.0,-70.0,-67.0,-60.0,-79.0,-87.0,-79.0,-87.0,10.0,16.0,11.0,27.0,1
3471,CC:2F:71:3F:1F:24,8629516,8668709321,5415019,8262688379,3214497,406020942,80,1265405,780545027,1256871,779520175,8534,1024852,1212226,619,5419738,555791,80,5798,115556.0,28889.0,-68.0,-64.0,-72.0,-68.0,-68.0,-64.0,-71.0,-68.0,-79.0,-87.0,-79.0,-87.0,11.0,23.0,7.0,19.0,1
3472,F8:59:71:5A:E0:3D,3343524,594797117,129025,188775973,3214499,406021144,0,127100,147334322,122294,146760036,4806,574286,104769,16,131739,2582,0,526,144444.0,43333.0,-67.0,-72.0,-64.0,-70.0,-66.0,-71.0,-64.0,-70.0,-79.0,-87.0,-79.0,-87.0,12.0,15.0,15.0,17.0,1
3473,CC:2F:71:3E:C5:1F,3225893,407414930,11394,1393786,3214499,406021144,6,48644,4073656,40199,3072992,8445,1000664,12014,34,16358,186,6,826,130000.0,39000.0,-69.0,-71.0,-68.0,-60.0,-69.0,-70.0,-67.0,-60.0,-79.0,-87.0,-79.0,-87.0,10.0,16.0,11.0,27.0,1
3474,CC:2F:71:3F:1F:24,8630940,8670911441,5416441,8264890297,3214499,406021144,80,1265695,780670865,1257161,779646013,8534,1024852,1212516,619,5421160,555898,80,5798,130000.0,43333.0,-68.0,-64.0,-71.0,-68.0,-68.0,-64.0,-71.0,-68.0,-79.0,-87.0,-79.0,-87.0,11.0,23.0,8.0,19.0,1
3475,F8:59:71:5A:E0:3D,3343592,594898602,129090,188876983,3214502,406021619,0,127166,147435976,122360,146861690,4806,574286,104834,16,131804,2582,0,526,144444.0,43333.0,-66.0,-72.0,-65.0,-71.0,-66.0,-71.0,-64.0,-70.0,-79.0,-87.0,-79.0,-87.0,13.0,15.0,14.0,16.0,1
3476,CC:2F:71:3E:C5:1F,3225896,407415405,11394,1393786,3214502,406021619,6,48644,4073656,40199,3072992,8445,1000664,12014,34,16358,186,6,826,130000.0,39000.0,-69.0,-71.0,-68.0,-60.0,-69.0,-70.0,-67.0,-60.0,-79.0,-87.0,-79.0,-87.0,10.0,16.0,11.0,27.0,1
3477,CC:2F:71:3F:1F:24,8632699,8673636314,5418197,8267614695,3214502,406021619,80,1265987,780800516,1257453,779775664,8534,1024852,1212808,619,5422916,556156,80,5798,115556.0,28889.0,-70.0,-64.0,-71.0,-69.0,-69.0,-63.0,-71.0,-69.0,-79.0,-87.0,-79.0,-87.0,9.0,23.0,8.0,18.0,1
3478,F8:59:71:5A:E0:3D,3343665,595004738,129158,188982655,3214507,406022083,0,127235,147542250,122429,146967964,4806,574286,104902,16,131872,2583,0,526,144444.0,43333.0,-66.0,-71.0,-65.0,-70.0,-66.0,-71.0,-64.0,-70.0,-79.0,-87.0,-79.0,-87.0,13.0,16.0,14.0,17.0,1
3479,CC:2F:71:3E:C5:1F,3225903,407416071,11394,1393786,3214509,406022285,6,48644,4073656,40199,3072992,8445,1000664,12014,34,16358,186,6,826,130000.0,39000.0,-69.0,-71.0,-68.0,-60.0,-69.0,-70.0,-67.0,-60.0,-79.0,-87.0,-79.0,-87.0,10.0,16.0,11.0,27.0,1
3480,CC:2F:71:3F:1F:24,8634404,8676274832,5419895,8270252547,3214509,406022285,80,1266295,780931448,1257761,779906596,8534,1024852,1213116,619,5424614,556234,80,5798,115556.0,28889.0,-70.0,-63.0,-71.0,-69.0,-69.0,-63.0,-71.0,-69.0,-79.0,-87.0,-79.0,-87.0,9.0,24.0,8.0,18.0,1
3481,F8:59:71:5A:E0:3D,3343732,595103044,129221,189080557,3214511,406022487,0,127298,147639270,122492,147064984,4806,574286,104965,16,131935,2583,0,526,144444.0,43333.0,-67.0,-72.0,-64.0,-70.0,-66.0,-71.0,-64.0,-70.0,-79.0,-87.0,-79.0,-87.0,12.0,15.0,15.0,17.0,1
3482,CC:2F:71:3E:C5:1F,3225905,407416273,11394,1393786,3214511,406022487,6,48644,4073656,40199,3072992,8445,1000664,12014,34,16358,186,6,826,130000.0,39000.0,-69.0,-71.0,-68.0,-60.0,-69.0,-70.0,-67.0,-60.0,-79.0,-87.0,-79.0,-87.0,10.0,16.0,11.0,27.0,1
3483,CC:2F:71:3F:1F:24,8635874,8678549658,5421363,8272527171,3214511,406022487,80,1266523,781048728,1257989,780023876,8534,1024852,1213344,619,5426067,556371,80,5798,144444.0,43333.0,-70.0,-63.0,-72.0,-69.0,-69.0,-63.0,-71.0,-69.0,-79.0,-87.0,-79.0,-87.0,9.0,24.0,7.0,18.0,1
3484,F8:59:71:5A:E0:3D,3343801,595202966,129285,189180013,3214516,406022953,0,127361,147736290,122555,147162004,4806,574286,105028,16,131999,2585,0,526,144444.0,43333.0,-66.0,-71.0,-65.0,-71.0,-65.0,-71.0,-64.0,-70.0,-79.0,-87.0,-79.0,-87.0,13.0,16.0,14.0,16.0,1
3485,CC:2F:71:3E:C5:1F,3225911,407416799,11394,1393786,3214517,406023013,6,48644,4073656,40199,3072992,8445,1000664,12014,34,16358,186,6,826,130000.0,39000.0,-69.0,-71.0,-68.0,-60.0,-69.0,-70.0,-67.0,-60.0,-79.0,-87.0,-79.0,-87.0,10.0,16.0,11.0,27.0,1
3486,CC:2F:71:3F:1F:24,8637353,8680833010,5422836,8274809997,3214517,406023013,80,1266805,781172310,1258270,780147340,8535,1024970,1213626,619,5427555,556466,80,5798,144444.0,43333.0,-70.0,-64.0,-71.0,-69.0,-69.0,-63.0,-71.0,-68.0,-79.0,-87.0,-79.0,-87.0,9.0,23.0,8.0,18.0,1
3487,F8:59:71:5A:E0:3D,3343869,595301332,129348,189277915,3214521,406023417,0,127425,147834976,122619,147260690,4806,574286,105092,16,132062,2586,0,528,144444.0,43333.0,-66.0,-72.0,-65.0,-71.0,-66.0,-71.0,-65.0,-70.0,-79.0,-87.0,-79.0,-87.0,13.0,15.0,14.0,16.0,1
3488,CC:2F:71:3E:C5:1F,3225915,407417203,11394,1393786,3214521,406023417,6,48644,4073656,40199,3072992,8445,1000664,12014,34,16358,186,6,826,130000.0,39000.0,-69.0,-71.0,-68.0,-60.0,-69.0,-70.0,-67.0,-60.0,-79.0,-87.0,-79.0,-87.0,10.0,16.0,11.0,27.0,1
3489,CC:2F:71:3F:1F:24,8638528,8682631832,5424007,8276608415,3214521,406023417,80,1267046,781293102,1258511,780268132,8535,1024970,1213867,619,5428726,556558,80,5799,130000.0,43333.0,-69.0,-64.0,-72.0,-68.0,-69.0,-64.0,-71.0,-68.0,-79.0,-87.0,-79.0,-87.0,10.0,23.0,7.0,19.0,1
3490,F8:59:71:5A:E0:3D,3343938,595400006,129411,189375817,3214527,406024189,0,127488,147931996,122682,147357710,4806,574286,105155,16,132125,2586,0,528,144444.0,43333.0,-66.0,-72.0,-65.0,-70.0,-66.0,-72.0,-64.0,-70.0,-79.0,-87.0,-79.0,-87.0,13.0,15.0,14.0,17.0,1
3491,CC:2F:71:3E:C5:1F,3225921,407417975,11394,1393786,3214527,406024189,6,48644,4073656,40199,3072992,8445,1000664,12014,34,16358,186,6,826,130000.0,39000.0,-69.0,-71.0,-68.0,-60.0,-69.0,-70.0,-67.0,-60.0,-79.0,-87.0,-79.0,-87.0,10.0,16.0,11.0,27.0,1
3492,CC:2F:71:3F:1F:24,8639913,8684766674,5425386,8278742485,3214527,406024189,80,1267298,781414748,1258763,780389778,8535,1024970,1214119,619,5430105,556861,80,5799,130000.0,43333.0,-69.0,-65.0,-72.0,-68.0,-68.0,-65.0,-71.0,-68.0,-79.0,-87.0,-79.0,-87.0,10.0,22.0,7.0,19.0,1
3493,F8:59:71:5A:E0:3D,3344007,595499926,129475,189475273,3214532,406024653,0,127554,148033664,122748,147459378,4806,574286,105219,16,132189,2586,0,528,144444.0,43333.0,-66.0,-71.0,-65.0,-71.0,-66.0,-71.0,-64.0,-70.0,-79.0,-87.0,-79.0,-87.0,13.0,16.0,14.0,16.0,1
3494,CC:2F:71:3E:C5:1F,3225926,407418439,11394,1393786,3214532,406024653,6,48644,4073656,40199,3072992,8445,1000664,12014,34,16358,186,6,826,130000.0,39000.0,-69.0,-71.0,-68.0,-60.0,-69.0,-70.0,-67.0,-60.0,-79.0,-87.0,-79.0,-87.0,10.0,16.0,11.0,27.0,1
3495,CC:2F:71:3F:1F:24,8641073,8686547680,5426541,8280523027,3214532,406024653,80,1267516,781530952,1258981,780505982,8535,1024970,1214337,619,5431228,557078,80,5799,115556.0,28889.0,-71.0,-64.0,-71.0,-68.0,-70.0,-64.0,-71.0,-68.0,-79.0,-87.0,-79.0,-87.0,8.0,23.0,8.0,19.0,1
3496,F8:59:71:5A:E0:3D,3344077,595602894,129541,189577837,3214536,406025057,0,127619,148133764,122813,147559478,4806,574286,105284,16,132255,2587,0,528,144444.0,43333.0,-67.0,-72.0,-64.0,-70.0,-66.0,-71.0,-64.0,-70.0,-79.0,-87.0,-79.0,-87.0,12.0,15.0,15.0,17.0,1
3497,CC:2F:71:3E:C5:1F,3225930,407418843,11394,1393786,3214536,406025057,6,48644,4073656,40199,3072992,8445,1000664,12014,34,16358,186,6,826,130000.0,39000.0,-69.0,-71.0,-68.0,-60.0,-69.0,-70.0,-67.0,-60.0,-79.0,-87.0,-79.0,-87.0,10.0,16.0,11.0,27.0,1
3498,CC:2F:71:3F:1F:24,8642511,8688770688,5427975,8282745631,3214536,406025057,80,1267773,781656082,1259238,780631112,8535,1024970,1214594,619,5432658,557183,80,5799,117000.0,39000.0,-69.0,-63.0,-72.0,-70.0,-69.0,-63.0,-71.0,-70.0,-79.0,-87.0,-79.0,-87.0,10.0,24.0,7.0,17.0,1
3499,F8:59:71:5A:E0:3D,3344145,595702754,129605,189677293,3214540,406025461,0,127684,148233864,122878,147659578,4806,574286,105349,16,132319,2587,0,528,144444.0,43333.0,-66.0,-72.0,-65.0,-71.0,-66.0,-71.0,-64.0,-70.0,-79.0,-87.0,-79.0,-87.0,13.0,15.0,14.0,16.0,1
3500,CC:2F:71:3E:C5:1F,3225934,407419247,11394,1393786,3214540,406025461,6,48644,4073656,40199,3072992,8445,1000664,12014,34,16358,186,6,826,130000.0,39000.0,-69.0,-71.0,-68.0,-60.0,-69.0,-70.0,-67.0,-60.0,-79.0,-87.0,-79.0,-87.0,10.0,16.0,11.0,27.0,1
3501,CC:2F:71:3F:1F:24,8644264,8691490358,5429724,8285464897,3214540,406025461,80,1268101,781786496,1259566,780761526,8535,1024970,1214919,619,5434443,557250,80,5799,130000.0,43333.0,-70.0,-64.0,-72.0,-69.0,-70.0,-64.0,-72.0,-69.0,-79.0,-87.0,-79.0,-87.0,9.0,23.0,7.0,18.0,1
3502,F8:59:71:5A:E0:3D,3344214,595802674,129669,189776749,3214545,406025925,0,127749,148333992,122943,147759706,4806,574286,105412,16,132383,2587,0,528,144444.0,43333.0,-66.0,-72.0,-65.0,-71.0,-66.0,-72.0,-65.0,-70.0,-79.0,-87.0,-79.0,-87.0,13.0,15.0,14.0,16.0,1
3503,CC:2F:71:3E:C5:1F,3225939,407419711,11394,1393786,3214545,406025925,6,48644,4073656,40199,3072992,8445,1000664,12014,34,16358,186,6,826,130000.0,39000.0,-69.0,-71.0,-68.0,-60.0,-69.0,-70.0,-67.0,-60.0,-79.0,-87.0,-79.0,-87.0,10.0,16.0,11.0,27.0,1
3504,CC:2F:71:3F:1F:24,8645563,8693485062,5431018,8287459137,3214545,406025925,80,1268341,781907361,1259806,780882391,8535,1024970,1215159,619,5435737,557319,80,5799,130000.0,43333.0,-70.0,-64.0,-72.0,-70.0,-70.0,-64.0,-72.0,-70.0,-79.0,-87.0,-79.0,-87.0,9.0,23.0,7.0,17.0,1
3505,F8:59:71:5A:E0:3D,3344281,595903886,129734,189877759,3214547,406026127,0,127815,148435632,123009,147861346,4806,574286,105478,16,132448,2587,0,528,144444.0,43333.0,-66.0,-72.0,-65.0,-71.0,-66.0,-71.0,-65.0,-70.0,-79.0,-87.0,-79.0,-87.0,13.0,15.0,14.0,16.0,1
3506,CC:2F:71:3E:C5:1F,3225943,407420115,11394,1393786,3214549,406026329,6,48644,4073656,40199,3072992,8445,1000664,12014,34,16358,186,6,826,130000.0,39000.0,-69.0,-71.0,-68.0,-60.0,-69.0,-70.0,-67.0,-60.0,-79.0,-87.0,-79.0,-87.0,10.0,16.0,11.0,27.0,1
3507,CC:2F:71:3F:1F:24,8647001,8695707766,5432452,8289681437,3214549,406026329,80,1268600,782029919,1260065,781004949,8535,1024970,1215418,619,5437162,557507,80,5800,130000.0,43333.0,-70.0,-63.0,-72.0,-69.0,-70.0,-63.0,-72.0,-69.0,-79.0,-87.0,-79.0,-87.0,9.0,24.0,7.0,18.0,1
3508,F8:59:71:5A:E0:3D,3344347,596000638,129796,189974107,3214551,406026531,0,127877,148531112,123071,147956826,4806,574286,105540,16,132510,2588,0,528,144444.0,43333.0,-66.0,-71.0,-65.0,-70.0,-66.0,-71.0,-65.0,-70.0,-79.0,-87.0,-79.0,-87.0,13.0,16.0,14.0,17.0,1
3509,CC:2F:71:3E:C5:1F,3225945,407420317,11394,1393786,3214551,406026531,6,48644,4073656,40199,3072992,8445,1000664,12014,34,16358,186,6,826,130000.0,39000.0,-69.0,-71.0,-68.0,-60.0,-69.0,-70.0,-67.0,-60.0,-79.0,-87.0,-79.0,-87.0,10.0,16.0,11.0,27.0,1
3510,CC:2F:71:3F:1F:24,8648992,8698804994,5434441,8292778463,3214551,406026531,80,1268911,782161379,1260376,781136409,8535,1024970,1215729,619,5439160,557561,80,5800,130000.0,43333.0,-70.0,-64.0,-72.0,-70.0,-70.0,-64.0,-72.0,-69.0,-79.0,-87.0,-79.0,-87.0,9.0,23.0,7.0,17.0,1
3511,F8:59:71:5A:E0:3D,3344419,596103792,129862,190076671,3214557,406027121,0,127943,148632752,123137,148058466,4806,574286,105606,16,132576,2588,0,528,144444.0,43333.0,-66.0,-72.0,-65.0,-70.0,-66.0,-71.0,-64.0,-70.0,-79.0,-87.0,-79.0,-87.0,13.0,15.0,14.0,17.0,1
3512,CC:2F:71:3E:C5:1F,3225951,407420907,11394,1393786,3214557,406027121,6,48644,4073656,40199,3072992,8445,1000664,12014,34,16358,186,6,826,130000.0,39000.0,-69.0,-71.0,-68.0,-60.0,-69.0,-70.0,-67.0,-60.0,-79.0,-87.0,-79.0,-87.0,10.0,16.0,11.0,27.0,1
3513,CC:2F:71:3F:1F:24,8651330,8702440934,5436771,8296413611,3214559,406027323,80,1269246,782292863,1260711,781267893,8535,1024970,1216064,619,5441490,557683,80,5800,130000.0,43333.0,-70.0,-64.0,-73.0,-70.0,-70.0,-64.0,-72.0,-70.0,-79.0,-87.0,-79.0,-87.0,9.0,23.0,6.0,17.0,1
3514,F8:59:71:5A:E0:3D,3344485,596203450,129926,190176127,3214559,406027323,0,128008,148732866,123202,148158580,4806,574286,105670,16,132640,2588,0,528,144444.0,43333.0,-67.0,-72.0,-66.0,-71.0,-66.0,-72.0,-65.0,-71.0,-79.0,-87.0,-79.0,-87.0,12.0,15.0,13.0,16.0,1
3515,CC:2F:71:3E:C5:1F,3225955,407421311,11394,1393786,3214561,406027525,6,48644,4073656,40199,3072992,8445,1000664,12014,34,16358,186,6,826,130000.0,39000.0,-69.0,-71.0,-68.0,-60.0,-69.0,-70.0,-67.0,-60.0,-79.0,-87.0,-79.0,-87.0,10.0,16.0,11.0,27.0,1
3516,CC:2F:71:3F:1F:24,8652786,8704684760,5438225,8298657235,3214561,406027525,80,1269521,782417833,1260986,781392863,8535,1024970,1216339,619,5442914,557761,80,5801,130000.0,43333.0,-70.0,-64.0,-73.0,-70.0,-70.0,-64.0,-73.0,-69.0,-79.0,-87.0,-79.0,-87.0,9.0,23.0,6.0,17.0,1
3517,F8:59:71:5A:E0:3D,3344557,596303845,129990,190275583,3214567,406028262,0,128073,148832980,123267,148258694,4806,574286,105734,16,132704,2588,0,528,144444.0,43333.0,-66.0,-72.0,-65.0,-70.0,-65.0,-71.0,-64.0,-70.0,-79.0,-87.0,-79.0,-87.0,13.0,15.0,14.0,17.0,1
3518,CC:2F:71:3E:C5:1F,3225961,407422048,11394,1393786,3214567,406028262,6,48644,4073656,40199,3072992,8445,1000664,12014,34,16358,186,6,826,130000.0,39000.0,-69.0,-71.0,-68.0,-60.0,-69.0,-70.0,-67.0,-60.0,-79.0,-87.0,-79.0,-87.0,10.0,16.0,11.0,27.0,1
3519,CC:2F:71:3F:1F:24,8654199,8706863951,5439632,8300835689,3214567,406028262,80,1269772,782539513,1261237,781514543,8535,1024970,1216590,619,5444351,557799,80,5801,130000.0,43333.0,-70.0,-64.0,-72.0,-70.0,-70.0,-64.0,-72.0,-70.0,-79.0,-87.0,-79.0,-87.0,9.0,23.0,7.0,17.0,1
3520,F8:59:71:5A:E0:3D,3344626,596405177,130055,190376593,3214571,406028584,0,128138,148933094,123332,148358808,4806,574286,105798,16,132769,2588,0,528,144444.0,43333.0,-66.0,-72.0,-65.0,-70.0,-66.0,-71.0,-64.0,-70.0,-79.0,-87.0,-79.0,-87.0,13.0,15.0,14.0,17.0,1
3521,CC:2F:71:3E:C5:1F,3225965,407422370,11394,1393786,3214571,406028584,6,48644,4073656,40199,3072992,8445,1000664,12014,34,16358,186,6,826,130000.0,39000.0,-69.0,-71.0,-68.0,-60.0,-69.0,-70.0,-67.0,-60.0,-79.0,-87.0,-79.0,-87.0,10.0,16.0,11.0,27.0,1
3522,CC:2F:71:3F:1F:24,8655738,8709246191,5441167,8303217607,3214571,406028584,80,1270039,782664373,1261504,781639403,8535,1024970,1216857,619,5445850,557962,80,5801,130000.0,43333.0,-69.0,-63.0,-72.0,-70.0,-69.0,-63.0,-71.0,-69.0,-79.0,-87.0,-79.0,-87.0,10.0,24.0,7.0,17.0,1
3523,F8:59:71:5A:E0:3D,3344695,596504985,130119,190475937,3214576,406029048,0,128204,149034748,123398,148460462,4806,574286,105863,16,132833,2589,0,528,144444.0,43333.0,-66.0,-72.0,-66.0,-71.0,-66.0,-72.0,-65.0,-70.0,-79.0,-87.0,-79.0,-87.0,13.0,15.0,13.0,16.0,1
3524,CC:2F:71:3E:C5:1F,3225970,407422834,11394,1393786,3214576,406029048,6,48644,4073656,40199,3072992,8445,1000664,12014,34,16358,186,6,826,130000.0,39000.0,-69.0,-71.0,-68.0,-60.0,-69.0,-70.0,-67.0,-60.0,-79.0,-87.0,-79.0,-87.0,10.0,16.0,11.0,27.0,1
3525,CC:2F:71:3F:1F:24,8657225,8711538242,5442647,8305508992,3214578,406029250,80,1270284,782785316,1261749,781760346,8535,1024970,1217101,619,5447366,558025,80,5801,130000.0,43333.0,-70.0,-63.0,-72.0,-69.0,-69.0,-63.0,-71.0,-69.0,-79.0,-87.0,-79.0,-87.0,9.0,24.0,7.0,18.0,1
3526,F8:59:71:5A:E0:3D,3344763,596604789,130183,190575337,3214580,406029452,0,128269,149134862,123463,148560576,4806,574286,105927,16,132897,2589,0,528,144444.0,43333.0,-66.0,-72.0,-64.0,-70.0,-66.0,-71.0,-64.0,-70.0,-79.0,-87.0,-79.0,-87.0,13.0,15.0,15.0,17.0,1
3527,CC:2F:71:3E:C5:1F,3225975,407423298,11394,1393786,3214581,406029512,6,48644,4073656,40199,3072992,8445,1000664,12014,34,16358,186,6,826,130000.0,39000.0,-69.0,-71.0,-68.0,-60.0,-69.0,-70.0,-67.0,-60.0,-79.0,-87.0,-79.0,-87.0,10.0,16.0,11.0,27.0,1
3528,CC:2F:71:3F:1F:24,8658878,8714092896,5444297,8308063384,3214581,406029512,80,1270575,782911967,1262040,781886997,8535,1024970,1217392,619,5449016,558152,80,5801,130000.0,43333.0,-70.0,-64.0,-72.0,-70.0,-69.0,-64.0,-71.0,-69.0,-79.0,-87.0,-79.0,-87.0,9.0,23.0,7.0,17.0,1
3529,F8:59:71:5A:E0:3D,3344832,596704709,130247,190674793,3214585,406029916,0,128333,149233422,123527,148659136,4806,574286,105991,16,132961,2590,0,528,144444.0,43333.0,-66.0,-72.0,-65.0,-70.0,-66.0,-72.0,-64.0,-70.0,-79.0,-87.0,-79.0,-87.0,13.0,15.0,14.0,17.0,1
3530,CC:2F:71:3E:C5:1F,3225979,407423702,11394,1393786,3214585,406029916,6,48644,4073656,40199,3072992,8445,1000664,12014,34,16358,186,6,826,130000.0,39000.0,-69.0,-71.0,-68.0,-60.0,-69.0,-70.0,-67.0,-60.0,-79.0,-87.0,-79.0,-87.0,10.0,16.0,11.0,27.0,1
3531,CC:2F:71:3F:1F:24,8660453,8716530714,5445868,8310500798,3214585,406029916,80,1270842,783034257,1262307,782009287,8535,1024970,1217659,619,5450563,558213,80,5801,130000.0,43333.0,-70.0,-64.0,-72.0,-70.0,-69.0,-64.0,-72.0,-70.0,-79.0,-87.0,-79.0,-87.0,9.0,23.0,7.0,17.0,1
3532,F8:59:71:5A:E0:3D,3344900,596803131,130311,190772811,3214589,406030320,0,128396,149330442,123590,148756156,4806,574286,106054,16,133025,2591,0,528,144444.0,43333.0,-66.0,-72.0,-64.0,-70.0,-66.0,-71.0,-64.0,-70.0,-79.0,-87.0,-79.0,-87.0,13.0,15.0,15.0,17.0,1
3533,CC:2F:71:3E:C5:1F,3225984,407424222,11395,1393902,3214589,406030320,6,48646,4073796,40201,3073132,8445,1000664,12014,34,16359,186,6,826,130000.0,39000.0,-69.0,-71.0,-67.0,-60.0,-68.0,-70.0,-67.0,-60.0,-79.0,-87.0,-79.0,-87.0,10.0,16.0,12.0,27.0,1
3534,CC:2F:71:3F:1F:24,8661641,8718356464,5447052,8312326144,3214589,406030320,80,1271125,783158161,1262590,782133191,8535,1024970,1217942,619,5451771,558216,80,5802,130000.0,43333.0,-70.0,-64.0,-72.0,-69.0,-70.0,-63.0,-71.0,-69.0,-79.0,-87.0,-79.0,-87.0,9.0,23.0,7.0,18.0,1
3535,F8:59:71:5A:E0:3D,3344970,596904605,130376,190873821,3214594,406030784,0,128461,149430556,123655,148856270,4806,574286,106118,16,133090,2591,0,528,144444.0,43333.0,-66.0,-71.0,-65.0,-71.0,-66.0,-71.0,-64.0,-70.0,-79.0,-87.0,-79.0,-87.0,13.0,16.0,14.0,16.0,1
3536,CC:2F:71:3E:C5:1F,3225989,407424686,11395,1393902,3214594,406030784,6,48646,4073796,40201,3073132,8445,1000664,12014,34,16359,186,6,826,130000.0,39000.0,-69.0,-71.0,-67.0,-60.0,-68.0,-70.0,-67.0,-60.0,-79.0,-87.0,-79.0,-87.0,10.0,16.0,12.0,27.0,1
3537,CC:2F:71:3F:1F:24,8662977,8720415430,5448383,8314384646,3214594,406030784,80,1271387,783283773,1262852,782258803,8535,1024970,1218204,619,5453102,558376,80,5803,130000.0,43333.0,-69.0,-64.0,-71.0,-69.0,-69.0,-64.0,-71.0,-69.0,-79.0,-87.0,-79.0,-87.0,10.0,23.0,8.0,18.0,1
3538,F8:59:71:5A:E0:3D,3345038,597004465,130440,190973277,3214598,406031188,0,128526,149530656,123720,148956370,4806,574286,106183,16,133154,2591,0,528,144444.0,43333.0,-66.0,-71.0,-65.0,-71.0,-66.0,-71.0,-64.0,-70.0,-79.0,-87.0,-79.0,-87.0,13.0,16.0,14.0,16.0,1
3539,CC:2F:71:3E:C5:1F,3225993,407425090,11395,1393902,3214598,406031188,6,48646,4073796,40201,3073132,8445,1000664,12014,34,16359,186,6,826,130000.0,39000.0,-69.0,-71.0,-67.0,-60.0,-68.0,-70.0,-67.0,-60.0,-79.0,-87.0,-79.0,-87.0,10.0,16.0,12.0,27.0,1
3540,CC:2F:71:3F:1F:24,8664275,8722399806,5449677,8316368618,3214598,406031188,80,1271655,783406875,1263120,782381905,8535,1024970,1218472,619,5454390,558418,80,5803,130000.0,43333.0,-69.0,-64.0,-72.0,-70.0,-69.0,-64.0,-71.0,-69.0,-79.0,-87.0,-79.0,-87.0,10.0,23.0,7.0,17.0,1
3541,F8:59:71:5A:E0:3D,3345102,597103921,130504,191072733,3214598,406031188,0,128589,149627676,123783,149053390,4806,574286,106246,16,133218,2591,0,528,144444.0,43333.0,-66.0,-71.0,-65.0,-70.0,-66.0,-71.0,-64.0,-70.0,-79.0,-87.0,-79.0,-87.0,13.0,16.0,14.0,17.0,1
3542,CC:2F:71:3E:C5:1F,3225995,407425292,11395,1393902,3214600,406031390,6,48646,4073796,40201,3073132,8445,1000664,12014,34,16359,186,6,826,130000.0,39000.0,-69.0,-71.0,-67.0,-60.0,-68.0,-70.0,-67.0,-60.0,-79.0,-87.0,-79.0,-87.0,10.0,16.0,12.0,27.0,1
3543,CC:2F:71:3F:1F:24,8665399,8724122251,5450797,8318090659,3214602,406031592,80,1271934,783531758,1263399,782506788,8535,1024970,1218751,619,5455516,558428,80,5803,130000.0,43333.0,-70.0,-64.0,-72.0,-70.0,-69.0,-63.0,-72.0,-69.0,-79.0,-87.0,-79.0,-87.0,9.0,23.0,7.0,17.0,1
3544,F8:59:71:5A:E0:3D,3345175,597204245,130568,191172189,3214607,406032056,0,128654,149727776,123848,149153490,4806,574286,106311,16,133282,2591,0,528,144444.0,43333.0,-66.0,-72.0,-65.0,-70.0,-66.0,-71.0,-65.0,-70.0,-79.0,-87.0,-79.0,-87.0,13.0,15.0,14.0,17.0,1
3545,CC:2F:71:3E:C5:1F,3226002,407425958,11395,1393902,3214607,406032056,6,48646,4073796,40201,3073132,8445,1000664,12014,34,16359,186,6,826,130000.0,39000.0,-69.0,-71.0,-67.0,-60.0,-68.0,-70.0,-67.0,-60.0,-79.0,-87.0,-79.0,-87.0,10.0,16.0,12.0,27.0,1
3546,CC:2F:71:3F:1F:24,8666500,8725810411,5451893,8319778355,3214607,406032056,80,1272191,783653950,1263656,782628980,8535,1024970,1219008,619,5456612,558446,80,5804,130000.0,43333.0,-70.0,-64.0,-73.0,-70.0,-69.0,-64.0,-71.0,-69.0,-79.0,-87.0,-79.0,-87.0,9.0,23.0,6.0,17.0,1
3547,F8:59:71:5A:E0:3D,3345240,597302271,130631,191270091,3214609,406032180,0,128717,149823374,123910,149248970,4807,574404,106374,16,133345,2591,0,528,144444.0,43333.0,-66.0,-72.0,-64.0,-70.0,-66.0,-71.0,-64.0,-70.0,-79.0,-87.0,-79.0,-87.0,13.0,15.0,15.0,17.0,1
3548,CC:2F:71:3E:C5:1F,3226004,407426082,11395,1393902,3214609,406032180,6,48647,4073914,40201,3073132,8446,1000782,12015,34,16359,186,6,826,130000.0,39000.0,-70.0,-72.0,-67.0,-60.0,-69.0,-71.0,-67.0,-60.0,-79.0,-87.0,-79.0,-87.0,9.0,15.0,12.0,27.0,1
3549,CC:2F:71:3F:1F:24,8667693,8727646631,5453083,8321614383,3214610,406032248,80,1272429,783773886,1263894,782748916,8535,1024970,1219246,619,5457802,558543,80,5804,130000.0,43333.0,-69.0,-64.0,-71.0,-69.0,-69.0,-64.0,-71.0,-69.0,-79.0,-87.0,-78.0,-87.0,10.0,23.0,7.0,18.0,1
3550,F8:59:71:5A:E0:3D,3345312,597402535,130695,191369547,3214617,406032988,0,128784,149926596,123977,149352192,4807,574404,106438,16,133409,2591,0,528,144444.0,43333.0,-66.0,-71.0,-64.0,-70.0,-66.0,-71.0,-64.0,-70.0,-79.0,-87.0,-78.0,-87.0,13.0,16.0,14.0,17.0,1
3551,CC:2F:71:3E:C5:1F,3226012,407426890,11395,1393902,3214617,406032988,6,48648,4073984,40202,3073202,8446,1000782,12015,34,16359,186,6,826,130000.0,39000.0,-69.0,-72.0,-67.0,-60.0,-69.0,-71.0,-67.0,-60.0,-79.0,-87.0,-78.0,-87.0,10.0,15.0,11.0,27.0,1
3552,CC:2F:71:3F:1F:24,8668727,8729227881,5454110,8323194893,3214617,406032988,80,1272656,783889710,1264121,782864740,8535,1024970,1219473,619,5458815,558549,80,5804,130000.0,43333.0,-70.0,-64.0,-73.0,-69.0,-69.0,-64.0,-72.0,-69.0,-79.0,-87.0,-78.0,-87.0,9.0,23.0,5.0,18.0,1
3553,F8:59:71:5A:E0:3D,3345375,597498943,130757,191465895,3214618,406033048,0,128847,150023616,124040,149449212,4807,574404,106501,16,133471,2591,0,528,144444.0,43333.0,-67.0,-72.0,-65.0,-71.0,-66.0,-72.0,-65.0,-71.0,-79.0,-87.0,-78.0,-87.0,12.0,15.0,13.0,16.0,1
3554,CC:2F:71:3E:C5:1F,3226013,407426950,11395,1393902,3214618,406033048,6,48648,4073984,40202,3073202,8446,1000782,12015,34,16359,186,6,826,130000.0,39000.0,-69.0,-72.0,-67.0,-60.0,-69.0,-71.0,-67.0,-60.0,-79.0,-87.0,-78.0,-87.0,10.0,15.0,11.0,27.0,1
3555,CC:2F:71:3F:1F:24,8669591,8730540437,5454973,8324507389,3214618,406033048,80,1272883,784007354,1264348,782982384,8535,1024970,1219700,619,5459692,558599,80,5804,130000.0,43333.0,-70.0,-64.0,-72.0,-69.0,-69.0,-64.0,-71.0,-69.0,-79.0,-87.0,-78.0,-87.0,9.0,23.0,6.0,18.0,1
3556,F8:59:71:5A:E0:3D,3345443,597595897,130819,191562243,3214624,406033654,0,128909,150119096,124102,149544692,4807,574404,106563,16,133533,2591,0,528,144444.0,43333.0,-67.0,-72.0,-65.0,-71.0,-66.0,-71.0,-65.0,-70.0,-79.0,-87.0,-78.0,-87.0,12.0,15.0,13.0,16.0,1
3557,CC:2F:71:3E:C5:1F,3226019,407427556,11395,1393902,3214624,406033654,6,48648,4073984,40202,3073202,8446,1000782,12015,34,16359,186,6,826,130000.0,39000.0,-69.0,-72.0,-67.0,-60.0,-69.0,-71.0,-67.0,-60.0,-79.0,-87.0,-78.0,-87.0,10.0,15.0,11.0,27.0,1
3558,CC:2F:71:3F:1F:24,8670439,8731826669,5455813,8325792813,3214626,406033856,80,1273071,784120126,1264536,783095156,8535,1024970,1219888,619,5460532,558632,80,5804,130000.0,43333.0,-69.0,-64.0,-71.0,-70.0,-69.0,-64.0,-71.0,-69.0,-79.0,-87.0,-78.0,-87.0,10.0,23.0,7.0,17.0,1
3559,F8:59:71:5A:E0:3D,3345511,597695944,130884,191661815,3214627,406034129,0,128973,150216222,124166,149641818,4807,574404,106627,16,133598,2592,0,528,144444.0,43333.0,-66.0,-71.0,-65.0,-70.0,-66.0,-71.0,-65.0,-70.0,-79.0,-87.0,-78.0,-87.0,13.0,16.0,13.0,17.0,1
3560,CC:2F:71:3E:C5:1F,3226022,407428031,11395,1393902,3214627,406034129,6,48648,4073984,40202,3073202,8446,1000782,12015,34,16359,186,6,826,130000.0,39000.0,-69.0,-72.0,-67.0,-60.0,-69.0,-71.0,-67.0,-60.0,-79.0,-87.0,-78.0,-87.0,10.0,15.0,11.0,27.0,1
3561,CC:2F:71:3F:1F:24,8671453,8733382578,5456826,8327348449,3214627,406034129,80,1273312,784238952,1264777,783213982,8535,1024970,1220129,619,5461545,558681,80,5804,130000.0,43333.0,-70.0,-63.0,-72.0,-69.0,-69.0,-63.0,-71.0,-69.0,-79.0,-87.0,-78.0,-87.0,9.0,24.0,6.0,18.0,1
3562,F8:59:71:5A:E0:3D,3345580,597794372,130947,191759717,3214633,406034655,0,129036,150313242,124229,149738838,4807,574404,106690,16,133660,2593,0,528,144444.0,43333.0,-66.0,-72.0,-65.0,-70.0,-66.0,-72.0,-65.0,-70.0,-79.0,-87.0,-78.0,-87.0,13.0,15.0,13.0,17.0,1
3563,CC:2F:71:3E:C5:1F,3226028,407428557,11395,1393902,3214633,406034655,6,48648,4073984,40202,3073202,8446,1000782,12015,34,16359,186,6,826,130000.0,39000.0,-69.0,-72.0,-67.0,-60.0,-69.0,-71.0,-67.0,-60.0,-79.0,-87.0,-78.0,-87.0,10.0,15.0,11.0,27.0,1
3564,CC:2F:71:3F:1F:24,8672549,8735059714,5457914,8329024857,3214635,406034857,80,1273574,784361604,1265038,783336516,8536,1025088,1220390,619,5462633,558721,80,5804,117000.0,39000.0,-71.0,-64.0,-71.0,-68.0,-70.0,-64.0,-71.0,-68.0,-79.0,-87.0,-78.0,-87.0,8.0,23.0,7.0,19.0,1
3565,F8:59:71:5A:E0:3D,3345647,597892678,131010,191857619,3214637,406035059,0,129100,150411830,124293,149837426,4807,574404,106754,16,133724,2594,0,528,144444.0,43333.0,-66.0,-73.0,-65.0,-71.0,-66.0,-72.0,-65.0,-71.0,-79.0,-87.0,-78.0,-87.0,13.0,14.0,13.0,16.0,1
3566,CC:2F:71:3E:C5:1F,3226032,407428961,11395,1393902,3214637,406035059,6,48648,4073984,40202,3073202,8446,1000782,12015,34,16359,186,6,826,130000.0,39000.0,-69.0,-72.0,-67.0,-60.0,-69.0,-71.0,-67.0,-60.0,-79.0,-87.0,-78.0,-87.0,10.0,15.0,11.0,27.0,1
3567,CC:2F:71:3F:1F:24,8673702,8736823956,5459065,8330788897,3214637,406035059,80,1273850,784490749,1265314,783465661,8536,1025088,1220665,619,5463784,558894,80,5804,104000.0,26000.0,-68.0,-64.0,-71.0,-69.0,-68.0,-64.0,-71.0,-68.0,-79.0,-87.0,-78.0,-87.0,11.0,23.0,7.0,18.0,1
3568,F8:59:71:5A:E0:3D,3345719,597998754,131078,191963291,3214641,406035463,0,129171,150521212,124364,149946808,4807,574404,106822,16,133792,2595,0,528,144444.0,43333.0,-66.0,-72.0,-64.0,-70.0,-66.0,-72.0,-64.0,-70.0,-79.0,-87.0,-78.0,-87.0,13.0,15.0,14.0,17.0,1
3569,CC:2F:71:3E:C5:1F,3226036,407429365,11395,1393902,3214641,406035463,6,48648,4073984,40202,3073202,8446,1000782,12015,34,16359,186,6,826,130000.0,39000.0,-69.0,-72.0,-67.0,-60.0,-69.0,-71.0,-67.0,-60.0,-79.0,-87.0,-78.0,-87.0,10.0,15.0,11.0,27.0,1
3570,CC:2F:71:3F:1F:24,8675003,8738829594,5460362,8332794131,3214641,406035463,80,1274133,784615957,1265597,783590869,8536,1025088,1220948,619,5465064,559433,80,5805,65000.0,14444.0,-69.0,-64.0,-72.0,-69.0,-68.0,-64.0,-71.0,-69.0,-79.0,-87.0,-78.0,-87.0,10.0,23.0,6.0,18.0,1
3571,F8:59:71:5A:E0:3D,3345788,598098674,131142,192062747,3214646,406035927,0,129235,150619772,124428,150045368,4807,574404,106886,16,133856,2596,0,528,144444.0,43333.0,-66.0,-72.0,-65.0,-70.0,-66.0,-72.0,-65.0,-70.0,-79.0,-87.0,-78.0,-87.0,13.0,15.0,13.0,17.0,1
3572,CC:2F:71:3E:C5:1F,3226041,407429829,11395,1393902,3214646,406035927,6,48648,4073984,40202,3073202,8446,1000782,12015,34,16359,186,6,826,130000.0,39000.0,-69.0,-72.0,-67.0,-60.0,-69.0,-71.0,-67.0,-60.0,-79.0,-87.0,-78.0,-87.0,10.0,15.0,11.0,27.0,1
3573,CC:2F:71:3F:1F:24,8676326,8740870798,5461680,8334834871,3214646,406035927,80,1274428,784743905,1265892,783718817,8536,1025088,1221243,619,5466399,559690,80,5805,115556.0,28889.0,-69.0,-64.0,-72.0,-69.0,-68.0,-64.0,-71.0,-69.0,-79.0,-87.0,-78.0,-87.0,10.0,23.0,6.0,18.0,1
3574,F8:59:71:5A:E0:3D,3345856,598198534,131206,192162203,3214650,406036331,0,129300,150719886,124493,150145482,4807,574404,106950,16,133920,2597,0,528,144444.0,43333.0,-66.0,-73.0,-65.0,-70.0,-66.0,-72.0,-64.0,-70.0,-79.0,-87.0,-78.0,-87.0,13.0,14.0,13.0,17.0,1
3575,CC:2F:71:3E:C5:1F,3226045,407430233,11395,1393902,3214650,406036331,6,48648,4073984,40202,3073202,8446,1000782,12015,34,16359,186,6,826,130000.0,39000.0,-69.0,-72.0,-67.0,-60.0,-69.0,-71.0,-67.0,-60.0,-79.0,-87.0,-78.0,-87.0,10.0,15.0,11.0,27.0,1
3576,CC:2F:71:3F:1F:24,8678070,8743574986,5463420,8337538655,3214650,406036331,80,1274778,784885685,1266242,783860597,8536,1025088,1221593,619,5468139,560273,80,5806,104000.0,26000.0,-68.0,-64.0,-71.0,-69.0,-68.0,-64.0,-70.0,-69.0,-79.0,-87.0,-78.0,-87.0,11.0,23.0,7.0,18.0,1
3577,F8:59:71:5A:E0:3D,3345930,598307718,131276,192270983,3214654,406036735,0,129370,150827686,124563,150253282,4807,574404,107020,16,133990,2600,0,528,144444.0,43333.0,-66.0,-72.0,-65.0,-70.0,-66.0,-72.0,-64.0,-70.0,-79.0,-87.0,-78.0,-87.0,13.0,15.0,13.0,17.0,1
3578,CC:2F:71:3E:C5:1F,3226050,407430697,11395,1393902,3214655,406036795,6,48648,4073984,40202,3073202,8446,1000782,12015,34,16359,186,6,826,130000.0,39000.0,-69.0,-72.0,-67.0,-60.0,-69.0,-71.0,-67.0,-60.0,-79.0,-87.0,-78.0,-87.0,10.0,15.0,11.0,27.0,1
3579,CC:2F:71:3F:1F:24,8679362,8745558558,5464707,8339521763,3214655,406036795,80,1275035,785005469,1266499,783980381,8536,1025088,1221850,619,5469426,560495,80,5806,115556.0,28889.0,-68.0,-64.0,-71.0,-69.0,-68.0,-64.0,-71.0,-69.0,-79.0,-87.0,-78.0,-87.0,11.0,23.0,7.0,18.0,1
3580,F8:59:71:5A:E0:3D,3345999,598407638,131340,192370439,3214659,406037199,0,129434,150926260,124627,150351856,4807,574404,107083,16,134053,2602,0,528,144444.0,43333.0,-67.0,-72.0,-65.0,-70.0,-66.0,-71.0,-65.0,-70.0,-79.0,-87.0,-78.0,-87.0,12.0,15.0,13.0,17.0,1
3581,CC:2F:71:3E:C5:1F,3226054,407431101,11395,1393902,3214659,406037199,6,48648,4073984,40202,3073202,8446,1000782,12015,34,16359,186,6,826,130000.0,39000.0,-69.0,-72.0,-67.0,-60.0,-69.0,-71.0,-67.0,-60.0,-79.0,-87.0,-78.0,-87.0,10.0,15.0,11.0,27.0,1
3582,CC:2F:71:3F:1F:24,8680714,8747644538,5466055,8341607339,3214659,406037199,80,1275321,785131069,1266785,784105981,8536,1025088,1222136,619,5470773,560614,80,5806,115556.0,28889.0,-70.0,-65.0,-71.0,-68.0,-69.0,-65.0,-71.0,-68.0,-79.0,-87.0,-78.0,-87.0,9.0,22.0,7.0,19.0,1
3583,F8:59:71:5A:E0:3D,3346065,598504390,131402,192466787,3214663,406037603,0,129497,151023294,124690,150448890,4807,574404,107145,16,134116,2602,0,528,144444.0,43333.0,-67.0,-73.0,-65.0,-71.0,-66.0,-72.0,-65.0,-70.0,-79.0,-87.0,-78.0,-87.0,12.0,14.0,13.0,16.0,1
3584,CC:2F:71:3E:C5:1F,3226058,407431505,11395,1393902,3214663,406037603,6,48648,4073984,40202,3073202,8446,1000782,12015,34,16359,186,6,826,130000.0,39000.0,-69.0,-72.0,-67.0,-60.0,-69.0,-71.0,-67.0,-60.0,-79.0,-87.0,-78.0,-87.0,10.0,15.0,11.0,27.0,1
3585,CC:2F:71:3F:1F:24,8681588,8748975890,5466925,8342938287,3214663,406037603,80,1275548,785248233,1267012,784223145,8536,1025088,1222363,619,5471644,560667,80,5806,130000.0,43333.0,-69.0,-64.0,-71.0,-68.0,-69.0,-64.0,-71.0,-68.0,-79.0,-87.0,-78.0,-87.0,10.0,23.0,7.0,19.0,1
3586,F8:59:71:5A:E0:3D,3346129,598602352,131465,192564689,3214664,406037663,0,129562,151123408,124755,150549004,4807,574404,107209,16,134179,2602,0,528,144444.0,43333.0,-66.0,-72.0,-65.0,-70.0,-66.0,-71.0,-65.0,-70.0,-79.0,-87.0,-78.0,-87.0,13.0,15.0,13.0,17.0,1
3587,CC:2F:71:3E:C5:1F,3226061,407431767,11395,1393902,3214666,406037865,6,48648,4073984,40202,3073202,8446,1000782,12015,34,16359,186,6,826,130000.0,39000.0,-69.0,-72.0,-67.0,-60.0,-69.0,-71.0,-67.0,-60.0,-79.0,-87.0,-78.0,-87.0,10.0,15.0,11.0,27.0,1
3588,CC:2F:71:3F:1F:24,8682546,8750439366,5467880,8344401501,3214666,406037865,80,1275807,785372217,1267271,784347129,8536,1025088,1222620,619,5472599,560940,80,5807,130000.0,43333.0,-69.0,-65.0,-72.0,-68.0,-69.0,-65.0,-71.0,-68.0,-79.0,-87.0,-78.0,-87.0,10.0,22.0,6.0,19.0,1
3589,F8:59:71:5A:E0:3D,3346203,598705724,131531,192667253,3214672,406038471,0,129628,151225062,124821,150650658,4807,574404,107274,16,134244,2603,0,528,144444.0,43333.0,-66.0,-72.0,-65.0,-71.0,-66.0,-71.0,-64.0,-70.0,-79.0,-87.0,-78.0,-87.0,13.0,15.0,13.0,16.0,1
3590,CC:2F:71:3E:C5:1F,3226067,407432373,11395,1393902,3214672,406038471,6,48648,4073984,40202,3073202,8446,1000782,12015,34,16359,186,6,826,130000.0,39000.0,-69.0,-72.0,-67.0,-60.0,-69.0,-71.0,-67.0,-60.0,-79.0,-87.0,-78.0,-87.0,10.0,15.0,11.0,27.0,1
3591,CC:2F:71:3F:1F:24,8683311,8751596154,5468639,8345557683,3214672,406038471,80,1276032,785489281,1267496,784464193,8536,1025088,1222845,619,5473358,560990,80,5807,130000.0,43333.0,-69.0,-65.0,-71.0,-68.0,-69.0,-64.0,-71.0,-68.0,-79.0,-87.0,-78.0,-87.0,10.0,22.0,7.0,19.0,1
3592,F8:59:71:5A:E0:3D,3346266,598803458,131594,192764987,3214672,406038471,0,129692,151323622,124885,150749218,4807,574404,107338,16,134308,2603,0,528,144444.0,43333.0,-66.0,-72.0,-65.0,-70.0,-66.0,-72.0,-64.0,-70.0,-79.0,-87.0,-78.0,-87.0,13.0,15.0,13.0,17.0,1
3593,CC:2F:71:3E:C5:1F,3226067,407432373,11395,1393902,3214672,406038471,6,48648,4073984,40202,3073202,8446,1000782,12015,34,16359,186,6,826,130000.0,39000.0,-69.0,-72.0,-67.0,-60.0,-69.0,-71.0,-67.0,-60.0,-79.0,-87.0,-78.0,-87.0,10.0,15.0,11.0,27.0,1
3594,CC:2F:71:3F:1F:24,8684220,8752982784,5469548,8346944313,3214672,406038471,80,1276259,785609961,1267723,784584873,8536,1025088,1223070,619,5474267,561202,80,5807,115556.0,28889.0,-68.0,-65.0,-72.0,-69.0,-68.0,-65.0,-71.0,-69.0,-79.0,-87.0,-78.0,-87.0,11.0,22.0,6.0,18.0,1
3595,F8:59:71:5A:E0:3D,3346337,598902142,131658,192863005,3214679,406039137,0,129757,151422302,124950,150847898,4807,574404,107402,16,134372,2605,0,528,144444.0,43333.0,-66.0,-72.0,-65.0,-71.0,-66.0,-71.0,-64.0,-70.0,-79.0,-87.0,-78.0,-87.0,13.0,15.0,13.0,16.0,1
3596,CC:2F:71:3E:C5:1F,3226074,407433039,11395,1393902,3214679,406039137,6,48648,4073984,40202,3073202,8446,1000782,12015,34,16359,186,6,826,130000.0,39000.0,-69.0,-72.0,-67.0,-60.0,-69.0,-71.0,-67.0,-60.0,-79.0,-87.0,-78.0,-87.0,10.0,15.0,11.0,27.0,1
3597,CC:2F:71:3F:1F:24,8685666,8755208232,5470985,8349168893,3214681,406039339,80,1276576,785738979,1268040,784713891,8536,1025088,1223387,619,5475704,561363,80,5807,115556.0,28889.0,-69.0,-64.0,-72.0,-69.0,-69.0,-64.0,-71.0,-69.0,-79.0,-87.0,-78.0,-87.0,10.0,23.0,6.0,18.0,1
3598,F8:59:71:5A:E0:3D,3346403,599001800,131722,192962461,3214681,406039339,0,129822,151522430,125015,150948026,4807,574404,107465,16,134436,2605,0,528,144444.0,43333.0,-66.0,-72.0,-65.0,-70.0,-66.0,-72.0,-64.0,-70.0,-79.0,-87.0,-78.0,-87.0,13.0,15.0,13.0,17.0,1
3599,CC:2F:71:3E:C5:1F,3226076,407433241,11395,1393902,3214681,406039339,6,48648,4073984,40202,3073202,8446,1000782,12015,34,16359,186,6,826,130000.0,39000.0,-69.0,-72.0,-67.0,-60.0,-69.0,-71.0,-67.0,-60.0,-79.0,-87.0,-78.0,-87.0,10.0,15.0,11.0,27.0,1
3600,CC:2F:71:3F:1F:24,8686974,8757232128,5472293,8351192789,3214681,406039339,80,1276851,785860571,1268315,784835483,8536,1025088,1223662,619,5477012,561380,80,5807,117000.0,39000.0,-69.0,-65.0,-72.0,-68.0,-69.0,-65.0,-71.0,-68.0,-79.0,-87.0,-78.0,-87.0,10.0,22.0,6.0,19.0,1
3601,F8:59:71:5A:E0:3D,3346473,599100581,131785,193060363,3214688,406040218,0,129886,151620990,125079,151046586,4807,574404,107529,16,134499,2606,0,528,144444.0,43333.0,-67.0,-72.0,-65.0,-71.0,-66.0,-72.0,-65.0,-71.0,-79.0,-87.0,-78.0,-87.0,12.0,15.0,13.0,16.0,1
3602,CC:2F:71:3E:C5:1F,3226083,407434120,11395,1393902,3214688,406040218,6,48648,4073984,40202,3073202,8446,1000782,12015,34,16359,186,6,826,130000.0,39000.0,-69.0,-72.0,-67.0,-60.0,-69.0,-71.0,-67.0,-60.0,-79.0,-87.0,-78.0,-87.0,10.0,15.0,11.0,27.0,1
3603,CC:2F:71:3F:1F:24,8688237,8759172735,5473549,8353132517,3214688,406040218,80,1277076,785978907,1268540,784953819,8536,1025088,1223887,619,5478268,561929,80,5807,117000.0,39000.0,-69.0,-65.0,-71.0,-68.0,-69.0,-64.0,-71.0,-68.0,-79.0,-87.0,-78.0,-87.0,10.0,22.0,7.0,19.0,1
3604,F8:59:71:5A:E0:3D,3346539,599198745,131848,193158265,3214691,406040480,0,129950,151719564,125143,151145160,4807,574404,107592,16,134562,2607,0,528,144444.0,43333.0,-66.0,-72.0,-65.0,-71.0,-66.0,-72.0,-65.0,-71.0,-79.0,-87.0,-78.0,-87.0,13.0,15.0,13.0,16.0,1
3605,CC:2F:71:3E:C5:1F,3226086,407434382,11395,1393902,3214691,406040480,6,48648,4073984,40202,3073202,8446,1000782,12015,34,16359,186,6,826,130000.0,39000.0,-69.0,-72.0,-67.0,-60.0,-69.0,-71.0,-67.0,-60.0,-79.0,-87.0,-78.0,-87.0,10.0,15.0,11.0,27.0,1
3606,CC:2F:71:3F:1F:24,8689509,8761126083,5474818,8355085603,3214691,406040480,80,1277333,786100340,1268797,785075252,8536,1025088,1224141,619,5479526,561961,80,5807,130000.0,43333.0,-69.0,-64.0,-71.0,-68.0,-69.0,-64.0,-71.0,-68.0,-79.0,-87.0,-78.0,-87.0,10.0,23.0,7.0,19.0,1
3607,F8:59:71:5A:E0:3D,3346605,599295497,131910,193254613,3214695,406040884,0,130012,151815044,125205,151240640,4807,574404,107654,16,134624,2607,0,528,144444.0,43333.0,-66.0,-72.0,-65.0,-71.0,-66.0,-71.0,-65.0,-70.0,-79.0,-87.0,-78.0,-87.0,13.0,15.0,13.0,16.0,1
3608,CC:2F:71:3E:C5:1F,3226090,407434786,11395,1393902,3214695,406040884,6,48648,4073984,40202,3073202,8446,1000782,12015,34,16359,186,6,826,130000.0,39000.0,-69.0,-72.0,-67.0,-60.0,-69.0,-71.0,-67.0,-60.0,-79.0,-87.0,-78.0,-87.0,10.0,15.0,11.0,27.0,1
3609,CC:2F:71:3F:1F:24,8690576,8762759203,5475879,8356718117,3214697,406041086,80,1277548,786214776,1269012,785189688,8536,1025088,1224356,619,5480565,561995,80,5807,130000.0,39000.0,-70.0,-64.0,-71.0,-68.0,-69.0,-64.0,-71.0,-67.0,-79.0,-87.0,-78.0,-87.0,9.0,23.0,7.0,19.0,1
3610,F8:59:71:5A:E0:3D,3346672,599393803,131973,193352515,3214699,406041288,0,130074,151910524,125267,151336120,4807,574404,107716,16,134687,2610,0,528,144444.0,43333.0,-67.0,-73.0,-66.0,-71.0,-66.0,-72.0,-65.0,-71.0,-79.0,-87.0,-78.0,-87.0,12.0,14.0,12.0,16.0,1
3611,CC:2F:71:3E:C5:1F,3226094,407435190,11395,1393902,3214699,406041288,6,48648,4073984,40202,3073202,8446,1000782,12015,34,16359,186,6,826,130000.0,39000.0,-69.0,-72.0,-67.0,-60.0,-69.0,-71.0,-67.0,-60.0,-79.0,-87.0,-78.0,-87.0,10.0,15.0,11.0,27.0,1
3612,CC:2F:71:3F:1F:24,8691811,8764664791,5477112,8358623503,3214699,406041288,80,1277781,786332748,1269245,785307660,8536,1025088,1224589,619,5481831,562135,80,5807,130000.0,43333.0,-70.0,-64.0,-72.0,-67.0,-69.0,-64.0,-71.0,-67.0,-79.0,-87.0,-78.0,-87.0,9.0,23.0,6.0,20.0,1
3613,F8:59:71:5A:E0:3D,3346740,599492169,132036,193450417,3214704,406041752,0,130138,152009084,125331,151434680,4807,574404,107780,16,134750,2610,0,528,144444.0,43333.0,-67.0,-72.0,-65.0,-71.0,-66.0,-72.0,-65.0,-71.0,-79.0,-87.0,-78.0,-87.0,12.0,15.0,13.0,16.0,1
3614,CC:2F:71:3E:C5:1F,3226099,407435654,11395,1393902,3214704,406041752,6,48648,4073984,40202,3073202,8446,1000782,12015,34,16359,186,6,826,130000.0,39000.0,-69.0,-72.0,-67.0,-60.0,-69.0,-71.0,-67.0,-60.0,-79.0,-87.0,-78.0,-87.0,10.0,15.0,11.0,27.0,1
3615,CC:2F:71:3F:1F:24,8693190,8766791907,5478486,8360750155,3214704,406041752,80,1278032,786451408,1269496,785426320,8536,1025088,1224840,619,5483205,562158,80,5808,130000.0,43333.0,-69.0,-64.0,-72.0,-67.0,-69.0,-64.0,-71.0,-67.0,-79.0,-87.0,-78.0,-87.0,10.0,23.0,6.0,20.0,1
3616,F8:59:71:5A:E0:3D,3346806,599588921,132098,193546765,3214708,406042156,0,130199,152103024,125392,151528620,4807,574404,107841,16,134812,2610,0,528,144444.0,43333.0,-67.0,-73.0,-65.0,-71.0,-66.0,-72.0,-65.0,-71.0,-79.0,-87.0,-78.0,-87.0,12.0,14.0,13.0,16.0,1
3617,CC:2F:71:3E:C5:1F,3226103,407436058,11395,1393902,3214708,406042156,6,48648,4073984,40202,3073202,8446,1000782,12015,34,16359,186,6,826,130000.0,39000.0,-69.0,-72.0,-67.0,-60.0,-69.0,-71.0,-67.0,-60.0,-79.0,-87.0,-78.0,-87.0,10.0,15.0,11.0,27.0,1
3618,CC:2F:71:3F:1F:24,8694203,8768333811,5479495,8362291655,3214708,406042156,80,1278248,786568045,1269712,785542957,8536,1025088,1225056,619,5484214,562302,80,5808,130000.0,43333.0,-69.0,-65.0,-72.0,-67.0,-69.0,-64.0,-72.0,-67.0,-79.0,-87.0,-78.0,-87.0,10.0,22.0,6.0,20.0,1
3619,F8:59:71:5A:E0:3D,3346871,599685753,132161,193643229,3214710,406042524,0,130263,152201598,125456,151627194,4807,574404,107904,16,134875,2610,0,528,144444.0,43333.0,-66.0,-72.0,-65.0,-71.0,-66.0,-72.0,-65.0,-71.0,-79.0,-87.0,-78.0,-87.0,13.0,15.0,13.0,16.0,1
3620,CC:2F:71:3E:C5:1F,3226106,407436542,11396,1394018,3214710,406042524,6,48650,4074124,40204,3073342,8446,1000782,12015,34,16360,186,6,826,130000.0,39000.0,-69.0,-71.0,-68.0,-60.0,-69.0,-71.0,-67.0,-60.0,-79.0,-87.0,-78.0,-87.0,10.0,16.0,10.0,27.0,1
3621,CC:2F:71:3F:1F:24,8695349,8770097877,5480639,8364055353,3214710,406042524,80,1278461,786682347,1269925,785657259,8536,1025088,1225269,619,5485358,562429,80,5808,130000.0,43333.0,-69.0,-64.0,-71.0,-68.0,-69.0,-64.0,-71.0,-67.0,-79.0,-87.0,-78.0,-87.0,10.0,23.0,7.0,19.0,1
3622,F8:59:71:5A:E0:3D,3346940,599782767,132223,193739577,3214717,406043190,0,130327,152300186,125520,151725782,4807,574404,107966,16,134937,2611,0,528,144444.0,43333.0,-67.0,-72.0,-66.0,-71.0,-66.0,-72.0,-65.0,-71.0,-79.0,-87.0,-78.0,-87.0,12.0,15.0,12.0,16.0,1
3623,CC:2F:71:3E:C5:1F,3226114,407437342,11396,1394018,3214718,406043324,6,48650,4074124,40204,3073342,8446,1000782,12015,34,16360,186,6,826,130000.0,39000.0,-69.0,-71.0,-68.0,-60.0,-69.0,-71.0,-67.0,-60.0,-79.0,-87.0,-78.0,-87.0,10.0,16.0,10.0,27.0,1
3624,CC:2F:71:3F:1F:24,8696435,8771759241,5481717,8365715917,3214718,406043324,80,1278713,786799651,1270177,785774563,8536,1025088,1225521,619,5486436,562549,80,5808,130000.0,43333.0,-70.0,-65.0,-71.0,-67.0,-69.0,-64.0,-71.0,-67.0,-79.0,-87.0,-78.0,-87.0,9.0,22.0,7.0,20.0,1
3625,F8:59:71:5A:E0:3D,3347005,599880871,132286,193837479,3214719,406043392,0,130389,152395666,125582,151821262,4807,574404,108028,16,134999,2611,0,528,144444.0,43333.0,-66.0,-72.0,-65.0,-70.0,-66.0,-71.0,-64.0,-70.0,-79.0,-87.0,-78.0,-87.0,13.0,15.0,13.0,17.0,1
3626,CC:2F:71:3E:C5:1F,3226115,407437410,11396,1394018,3214719,406043392,6,48650,4074124,40204,3073342,8446,1000782,12015,34,16360,186,6,826,130000.0,39000.0,-69.0,-71.0,-68.0,-60.0,-69.0,-71.0,-67.0,-60.0,-79.0,-87.0,-78.0,-87.0,10.0,16.0,10.0,27.0,1
3627,CC:2F:71:3F:1F:24,8697855,8773956947,5483136,8367913555,3214719,406043392,80,1278969,786921663,1270433,785896575,8536,1025088,1225777,619,5487855,562671,80,5808,130000.0,43333.0,-69.0,-65.0,-71.0,-68.0,-69.0,-64.0,-71.0,-67.0,-79.0,-87.0,-78.0,-87.0,10.0,22.0,7.0,19.0,1
3628,F8:59:71:5A:E0:3D,3347075,599979441,132349,193935381,3214726,406044060,0,130453,152494240,125646,151919836,4807,574404,108091,16,135063,2611,0,528,144444.0,43333.0,-66.0,-72.0,-65.0,-71.0,-66.0,-71.0,-65.0,-70.0,-79.0,-87.0,-78.0,-87.0,13.0,15.0,13.0,16.0,1
3629,CC:2F:71:3E:C5:1F,3226122,407438078,11396,1394018,3214726,406044060,6,48650,4074124,40204,3073342,8446,1000782,12015,34,16360,186,6,826,130000.0,39000.0,-69.0,-71.0,-68.0,-60.0,-69.0,-71.0,-67.0,-60.0,-79.0,-87.0,-78.0,-87.0,10.0,16.0,10.0,27.0,1
3630,CC:2F:71:3F:1F:24,8699214,8776049527,5484488,8370005467,3214726,406044060,80,1279215,787041151,1270678,786015945,8537,1025206,1226023,619,5489194,562746,80,5808,130000.0,43333.0,-69.0,-64.0,-72.0,-68.0,-69.0,-64.0,-71.0,-67.0,-79.0,-87.0,-78.0,-87.0,10.0,23.0,6.0,19.0,1
3631,F8:59:71:5A:E0:3D,3347141,600077493,132412,194033171,3214729,406044322,0,130516,152591260,125709,152016856,4807,574404,108154,16,135126,2612,0,528,144444.0,43333.0,-66.0,-72.0,-65.0,-71.0,-66.0,-72.0,-65.0,-71.0,-79.0,-87.0,-78.0,-87.0,13.0,15.0,13.0,16.0,1
3632,CC:2F:71:3E:C5:1F,3226125,407438340,11396,1394018,3214729,406044322,6,48650,4074124,40204,3073342,8446,1000782,12015,34,16360,186,6,826,130000.0,39000.0,-69.0,-71.0,-68.0,-60.0,-69.0,-71.0,-67.0,-60.0,-79.0,-87.0,-78.0,-87.0,10.0,16.0,10.0,27.0,1
3633,CC:2F:71:3F:1F:24,8700429,8777911561,5485700,8371867239,3214729,406044322,80,1279508,787165313,1270971,786140107,8537,1025206,1226316,619,5490419,562850,80,5808,130000.0,43333.0,-70.0,-65.0,-71.0,-68.0,-69.0,-65.0,-71.0,-68.0,-79.0,-87.0,-78.0,-87.0,9.0,22.0,7.0,19.0,1
3634,F8:59:71:5A:E0:3D,3347209,600174447,132474,194129519,3214735,406044928,0,130578,152686740,125771,152112336,4807,574404,108216,16,135187,2614,0,528,144444.0,43333.0,-66.0,-72.0,-65.0,-70.0,-66.0,-71.0,-65.0,-70.0,-79.0,-87.0,-78.0,-87.0,13.0,15.0,13.0,17.0,1
3635,CC:2F:71:3E:C5:1F,3226131,407438946,11396,1394018,3214735,406044928,6,48650,4074124,40204,3073342,8446,1000782,12015,34,16360,186,6,826,130000.0,39000.0,-69.0,-71.0,-68.0,-60.0,-69.0,-71.0,-67.0,-60.0,-79.0,-87.0,-78.0,-87.0,10.0,16.0,10.0,27.0,1
3636,CC:2F:71:3F:1F:24,8701411,8779410775,5486676,8373365847,3214735,406044928,80,1279722,787279561,1271185,786254355,8537,1025206,1226530,619,5491374,562870,80,5808,130000.0,43333.0,-70.0,-65.0,-72.0,-68.0,-70.0,-64.0,-71.0,-68.0,-79.0,-87.0,-78.0,-87.0,9.0,22.0,6.0,19.0,1
3637,F8:59:71:5A:E0:3D,3347275,600274105,132538,194228975,3214737,406045130,0,130643,152786840,125836,152212436,4807,574404,108281,16,135252,2615,0,528,144444.0,43333.0,-67.0,-72.0,-65.0,-71.0,-66.0,-72.0,-65.0,-70.0,-79.0,-87.0,-78.0,-87.0,12.0,15.0,13.0,16.0,1
3638,CC:2F:71:3E:C5:1F,3226133,407439148,11396,1394018,3214737,406045130,6,48650,4074124,40204,3073342,8446,1000782,12015,34,16360,186,6,826,130000.0,39000.0,-69.0,-71.0,-68.0,-60.0,-69.0,-71.0,-67.0,-60.0,-79.0,-87.0,-78.0,-87.0,10.0,16.0,10.0,27.0,1
3639,CC:2F:71:3F:1F:24,8702634,8781295557,5487896,8375250367,3214738,406045190,80,1279961,787400037,1271424,786374831,8537,1025206,1226769,619,5492610,563180,80,5808,130000.0,43333.0,-69.0,-64.0,-72.0,-70.0,-68.0,-64.0,-71.0,-69.0,-79.0,-87.0,-78.0,-87.0,10.0,23.0,6.0,17.0,1
3640,F8:59:71:5A:E0:3D,3347366,600384873,132602,194328431,3214764,406056442,0,130707,152885400,125900,152310996,4807,574404,108345,16,135316,2615,0,528,144444.0,43333.0,-66.0,-72.0,-65.0,-70.0,-66.0,-72.0,-64.0,-70.0,-79.0,-87.0,-78.0,-87.0,13.0,15.0,13.0,17.0,1
3641,CC:2F:71:3E:C5:1F,3226162,407450662,11396,1394018,3214766,406056644,6,48650,4074124,40204,3073342,8446,1000782,12015,34,16360,186,6,826,130000.0,39000.0,-69.0,-71.0,-68.0,-60.0,-69.0,-71.0,-67.0,-60.0,-79.0,-87.0,-78.0,-87.0,10.0,16.0,10.0,27.0,1
3642,CC:2F:71:3F:1F:24,8703553,8782671457,5488787,8376614813,3214766,406056644,80,1280168,787517891,1271631,786492685,8537,1025206,1226976,619,5493506,563255,80,5808,130000.0,43333.0,-68.0,-64.0,-73.0,-70.0,-68.0,-63.0,-72.0,-69.0,-79.0,-87.0,-78.0,-87.0,11.0,23.0,5.0,17.0,1
3643,F8:59:71:5A:E0:3D,3347435,600484795,132666,194427887,3214769,406056908,0,130770,152982420,125963,152408016,4807,574404,108408,16,135379,2615,0,528,144444.0,43333.0,-66.0,-71.0,-65.0,-70.0,-66.0,-71.0,-64.0,-70.0,-79.0,-87.0,-78.0,-87.0,13.0,16.0,13.0,17.0,1
3644,CC:2F:71:3E:C5:1F,3226165,407450926,11396,1394018,3214769,406056908,6,48652,4074312,40205,3073412,8447,1000900,12016,34,16360,186,6,826,130000.0,39000.0,-68.0,-71.0,-68.0,-60.0,-69.0,-71.0,-67.0,-60.0,-79.0,-87.0,-78.0,-87.0,11.0,16.0,10.0,27.0,1
3645,CC:2F:71:3F:1F:24,8705112,8785076338,5490342,8379019157,3214770,406057181,80,1280433,787642999,1271896,786617793,8537,1025206,1227241,619,5495037,563552,80,5809,115556.0,28889.0,-70.0,-64.0,-71.0,-68.0,-70.0,-64.0,-71.0,-68.0,-79.0,-87.0,-78.0,-87.0,9.0,23.0,7.0,19.0,1
3646,F8:59:71:5A:E0:3D,3347499,600582970,132729,194525789,3214770,406057181,0,130834,153080980,126027,152506576,4807,574404,108472,16,135443,2615,0,528,144444.0,43333.0,-66.0,-71.0,-65.0,-70.0,-65.0,-71.0,-65.0,-70.0,-79.0,-87.0,-78.0,-87.0,13.0,16.0,13.0,17.0,1
3647,CC:2F:71:3E:C5:1F,3226169,407451461,11396,1394018,3214773,406057443,6,48652,4074312,40205,3073412,8447,1000900,12016,34,16360,186,6,826,130000.0,39000.0,-68.0,-71.0,-68.0,-60.0,-69.0,-71.0,-67.0,-60.0,-79.0,-87.0,-78.0,-87.0,11.0,16.0,10.0,27.0,1
3648,CC:2F:71:3F:1F:24,8706768,8787641704,5491993,8381584059,3214775,406057645,80,1280736,787769225,1272199,786744019,8537,1025206,1227544,619,5496712,563679,80,5809,117000.0,39000.0,-70.0,-64.0,-71.0,-68.0,-69.0,-64.0,-71.0,-68.0,-79.0,-87.0,-78.0,-87.0,9.0,23.0,7.0,19.0,1
3649,F8:59:71:5A:E0:3D,3347572,600683294,132793,194625245,3214779,406058049,0,130897,153178000,126090,152603596,4807,574404,108535,16,135507,2616,0,528,144444.0,43333.0,-65.0,-72.0,-65.0,-69.0,-66.0,-71.0,-65.0,-70.0,-79.0,-87.0,-78.0,-87.0,14.0,15.0,13.0,18.0,1
3650,CC:2F:71:3E:C5:1F,3226175,407452067,11396,1394018,3214779,406058049,6,48652,4074312,40205,3073412,8447,1000900,12016,34,16360,186,6,826,130000.0,39000.0,-68.0,-71.0,-68.0,-60.0,-69.0,-71.0,-67.0,-60.0,-79.0,-87.0,-78.0,-87.0,11.0,16.0,10.0,27.0,1
3651,CC:2F:71:3F:1F:24,8708065,8789640806,5493286,8383582757,3214779,406058049,80,1281023,787892023,1272486,786866817,8537,1025206,1227831,619,5498005,563731,80,5811,130000.0,43333.0,-70.0,-64.0,-72.0,-68.0,-69.0,-64.0,-72.0,-68.0,-79.0,-87.0,-78.0,-87.0,9.0,23.0,6.0,19.0,1
3652,F8:59:71:5A:E0:3D,3347634,600778150,132854,194720039,3214780,406058111,0,130961,153275152,126153,152700630,4808,574522,108598,16,135568,2618,0,528,144444.0,43333.0,-66.0,-72.0,-66.0,-71.0,-66.0,-71.0,-65.0,-70.0,-79.0,-87.0,-78.0,-87.0,13.0,15.0,12.0,16.0,1
3653,CC:2F:71:3E:C5:1F,3226176,407452129,11396,1394018,3214780,406058111,6,48652,4074312,40205,3073412,8447,1000900,12016,34,16360,186,6,826,130000.0,39000.0,-68.0,-71.0,-68.0,-60.0,-69.0,-71.0,-67.0,-60.0,-79.0,-87.0,-78.0,-87.0,11.0,16.0,10.0,27.0,1
3654,CC:2F:71:3F:1F:24,8709648,8792095744,5494868,8386037633,3214780,406058111,80,1281291,788012653,1272754,786987447,8537,1025206,1228099,619,5499587,563811,80,5811,130000.0,43333.0,-69.0,-64.0,-71.0,-68.0,-69.0,-64.0,-71.0,-68.0,-79.0,-87.0,-78.0,-87.0,10.0,23.0,7.0,19.0,1
3655,F8:59:71:5A:E0:3D,3347704,600876718,132917,194817941,3214787,406058777,0,131024,153372242,126216,152797720,4808,574522,108661,16,135631,2618,0,528,144444.0,43333.0,-67.0,-71.0,-65.0,-71.0,-66.0,-71.0,-65.0,-70.0,-79.0,-87.0,-78.0,-87.0,12.0,16.0,13.0,16.0,1
3656,CC:2F:71:3E:C5:1F,3226183,407452795,11396,1394018,3214787,406058777,6,48652,4074312,40205,3073412,8447,1000900,12016,34,16360,186,6,826,130000.0,39000.0,-68.0,-71.0,-68.0,-60.0,-69.0,-71.0,-67.0,-60.0,-79.0,-87.0,-78.0,-87.0,11.0,16.0,10.0,27.0,1
3657,CC:2F:71:3F:1F:24,8710611,8793554154,5495822,8387495175,3214789,406058979,80,1281485,788128156,1272948,787102950,8537,1025206,1228292,619,5500541,563878,80,5812,130000.0,43333.0,-70.0,-64.0,-72.0,-69.0,-70.0,-64.0,-72.0,-68.0,-79.0,-87.0,-78.0,-87.0,9.0,23.0,6.0,18.0,1
3658,F8:59:71:5A:E0:3D,3347770,600976376,132981,194917397,3214789,406058979,0,131087,153469262,126279,152894740,4808,574522,108724,16,135695,2620,0,528,144444.0,43333.0,-66.0,-71.0,-66.0,-70.0,-66.0,-70.0,-65.0,-70.0,-79.0,-87.0,-78.0,-87.0,13.0,16.0,12.0,17.0,1
3659,CC:2F:71:3E:C5:1F,3226185,407452997,11396,1394018,3214789,406058979,6,48652,4074312,40205,3073412,8447,1000900,12016,34,16360,186,6,826,130000.0,39000.0,-68.0,-71.0,-68.0,-60.0,-69.0,-71.0,-67.0,-60.0,-79.0,-87.0,-78.0,-87.0,11.0,16.0,10.0,27.0,1
3660,CC:2F:71:3F:1F:24,8711491,8794902474,5496702,8388843495,3214789,406058979,80,1281713,788245630,1273176,787220424,8537,1025206,1228520,619,5501421,563909,80,5814,130000.0,43333.0,-70.0,-64.0,-72.0,-68.0,-69.0,-64.0,-71.0,-67.0,-79.0,-87.0,-78.0,-87.0,9.0,23.0,6.0,19.0,1
3661,F8:59:71:5A:E0:3D,3347838,601073162,133043,195013577,3214795,406059585,0,131149,153564742,126341,152990220,4808,574522,108786,16,135757,2620,0,528,144444.0,43333.0,-66.0,-71.0,-65.0,-70.0,-66.0,-71.0,-65.0,-70.0,-79.0,-87.0,-78.0,-87.0,13.0,16.0,13.0,17.0,1
3662,CC:2F:71:3E:C5:1F,3226191,407453603,11396,1394018,3214795,406059585,6,48652,4074312,40205,3073412,8447,1000900,12016,34,16360,186,6,826,130000.0,39000.0,-68.0,-71.0,-68.0,-60.0,-69.0,-71.0,-67.0,-60.0,-79.0,-87.0,-78.0,-87.0,11.0,16.0,10.0,27.0,1
3663,CC:2F:71:3F:1F:24,8712276,8796090774,5497481,8390031189,3214795,406059585,80,1281943,788364730,1273406,787339524,8537,1025206,1228750,619,5502200,563928,80,5814,130000.0,43333.0,-69.0,-64.0,-71.0,-68.0,-70.0,-64.0,-71.0,-68.0,-79.0,-87.0,-78.0,-87.0,10.0,23.0,7.0,19.0,1
3664,F8:59:71:5A:E0:3D,3347905,601172880,133107,195113033,3214798,406059847,0,131213,153663302,126405,153088780,4808,574522,108850,16,135821,2622,0,528,144444.0,43333.0,-67.0,-70.0,-65.0,-70.0,-66.0,-70.0,-65.0,-70.0,-79.0,-87.0,-78.0,-87.0,12.0,17.0,13.0,17.0,1
3665,CC:2F:71:3E:C5:1F,3226194,407453865,11396,1394018,3214798,406059847,6,48652,4074312,40205,3073412,8447,1000900,12016,34,16360,186,6,826,130000.0,39000.0,-68.0,-71.0,-68.0,-60.0,-69.0,-71.0,-67.0,-60.0,-79.0,-87.0,-78.0,-87.0,11.0,16.0,10.0,27.0,1
3666,CC:2F:71:3F:1F:24,8713202,8797507234,5498404,8391447387,3214798,406059847,80,1282167,788480134,1273630,787454928,8537,1025206,1228974,619,5503123,563958,80,5814,130000.0,43333.0,-70.0,-64.0,-72.0,-68.0,-69.0,-64.0,-71.0,-68.0,-79.0,-87.0,-78.0,-87.0,9.0,23.0,6.0,19.0,1
3667,F8:59:71:5A:E0:3D,3347973,601269834,133169,195209381,3214804,406060453,0,131275,153758782,126467,153184260,4808,574522,108912,16,135883,2622,0,528,144444.0,43333.0,-66.0,-71.0,-65.0,-71.0,-66.0,-71.0,-65.0,-70.0,-79.0,-87.0,-78.0,-87.0,13.0,16.0,13.0,16.0,1
3668,CC:2F:71:3E:C5:1F,3226200,407454471,11396,1394018,3214804,406060453,6,48652,4074312,40205,3073412,8447,1000900,12016,34,16360,186,6,826,130000.0,39000.0,-68.0,-71.0,-68.0,-60.0,-69.0,-71.0,-67.0,-60.0,-79.0,-87.0,-78.0,-87.0,11.0,16.0,10.0,27.0,1
3669,CC:2F:71:3F:1F:24,8714496,8799501656,5499692,8393441203,3214804,406060453,80,1282420,788598890,1273883,787573684,8537,1025206,1229227,619,5504411,563965,80,5814,130000.0,43333.0,-70.0,-64.0,-72.0,-68.0,-69.0,-64.0,-71.0,-68.0,-79.0,-87.0,-78.0,-87.0,9.0,23.0,6.0,19.0,1
3670,F8:59:71:5A:E0:3D,3348038,601367938,133232,195307283,3214806,406060655,0,131339,153857342,126531,153282820,4808,574522,108976,16,135946,2622,0,528,144444.0,43333.0,-66.0,-71.0,-65.0,-71.0,-66.0,-71.0,-65.0,-70.0,-79.0,-87.0,-78.0,-87.0,13.0,16.0,13.0,16.0,1
3671,CC:2F:71:3E:C5:1F,3226202,407454673,11396,1394018,3214806,406060655,6,48652,4074312,40205,3073412,8447,1000900,12016,34,16360,186,6,826,130000.0,39000.0,-68.0,-71.0,-68.0,-60.0,-69.0,-71.0,-67.0,-60.0,-79.0,-87.0,-78.0,-87.0,11.0,16.0,10.0,27.0,1
3672,CC:2F:71:3F:1F:24,8716250,8802218902,5501444,8396158247,3214806,406060655,80,1282710,788729573,1274173,787704367,8537,1025206,1229517,619,5506148,564039,80,5814,130000.0,43333.0,-69.0,-64.0,-72.0,-69.0,-69.0,-63.0,-71.0,-68.0,-79.0,-87.0,-78.0,-87.0,10.0,23.0,6.0,18.0,1
3673,F8:59:71:5A:E0:3D,3348110,601472520,133299,195411401,3214811,406061119,0,131405,153958982,126597,153384460,4808,574522,109042,16,136013,2622,0,528,144444.0,43333.0,-66.0,-72.0,-65.0,-71.0,-66.0,-71.0,-65.0,-71.0,-79.0,-87.0,-78.0,-87.0,13.0,15.0,13.0,16.0,1
3674,CC:2F:71:3E:C5:1F,3226209,407455339,11396,1394018,3214813,406061321,6,48652,4074312,40205,3073412,8447,1000900,12016,34,16360,186,6,826,130000.0,39000.0,-68.0,-71.0,-68.0,-60.0,-69.0,-71.0,-67.0,-60.0,-79.0,-87.0,-78.0,-87.0,11.0,16.0,10.0,27.0,1
3675,CC:2F:71:3F:1F:24,8717680,8804423246,5502867,8398361925,3214813,406061321,80,1282968,788851921,1274431,787826715,8537,1025206,1229775,619,5507580,564113,80,5814,130000.0,43333.0,-68.0,-64.0,-72.0,-68.0,-68.0,-64.0,-71.0,-68.0,-79.0,-87.0,-78.0,-87.0,11.0,23.0,6.0,19.0,1
3676,F8:59:71:5A:E0:3D,3348178,601572380,133363,195510857,3214815,406061523,0,131469,154057542,126661,153483020,4808,574522,109106,16,136077,2622,0,528,144444.0,43333.0,-67.0,-72.0,-65.0,-71.0,-66.0,-72.0,-64.0,-70.0,-79.0,-87.0,-78.0,-87.0,12.0,15.0,13.0,16.0,1
3677,CC:2F:71:3E:C5:1F,3226211,407455541,11396,1394018,3214815,406061523,6,48652,4074312,40205,3073412,8447,1000900,12016,34,16360,186,6,826,130000.0,39000.0,-68.0,-71.0,-68.0,-60.0,-69.0,-71.0,-67.0,-60.0,-79.0,-87.0,-78.0,-87.0,11.0,16.0,10.0,27.0,1
3678,CC:2F:71:3F:1F:24,8718819,8806175810,5504004,8400114287,3214815,406061523,80,1283212,788971183,1274675,787945977,8537,1025206,1230019,619,5508723,564422,80,5814,115556.0,28889.0,-69.0,-64.0,-71.0,-69.0,-68.0,-64.0,-71.0,-69.0,-79.0,-87.0,-78.0,-87.0,10.0,23.0,7.0,18.0,1
3679,F8:59:71:5A:E0:3D,3348245,601670686,133426,195608759,3214819,406061927,0,131532,154154562,126724,153580040,4808,574522,109169,16,136140,2623,0,528,144444.0,43333.0,-66.0,-72.0,-65.0,-70.0,-66.0,-72.0,-64.0,-70.0,-79.0,-87.0,-78.0,-87.0,13.0,15.0,13.0,17.0,1
3680,CC:2F:71:3E:C5:1F,3226216,407456165,11396,1394018,3214820,406062147,6,48652,4074312,40205,3073412,8447,1000900,12016,34,16360,186,6,826,130000.0,39000.0,-68.0,-71.0,-68.0,-60.0,-69.0,-71.0,-67.0,-60.0,-79.0,-87.0,-78.0,-87.0,11.0,16.0,10.0,27.0,1
3681,CC:2F:71:3F:1F:24,8719901,8807835820,5505081,8401773673,3214820,406062147,80,1283441,789089991,1274904,788064785,8537,1025206,1230248,619,5509799,564535,80,5814,115556.0,28889.0,-69.0,-65.0,-73.0,-70.0,-69.0,-64.0,-72.0,-70.0,-79.0,-87.0,-78.0,-87.0,10.0,22.0,5.0,17.0,1
3682,F8:59:71:5A:E0:3D,3348316,601772380,133491,195709769,3214825,406062611,0,131597,154254662,126789,153680140,4808,574522,109234,16,136205,2624,0,528,144444.0,43333.0,-66.0,-72.0,-65.0,-70.0,-66.0,-71.0,-65.0,-70.0,-79.0,-87.0,-78.0,-87.0,13.0,15.0,13.0,17.0,1
3683,CC:2F:71:3E:C5:1F,3226221,407456629,11396,1394018,3214825,406062611,6,48652,4074312,40205,3073412,8447,1000900,12016,34,16360,186,6,826,130000.0,39000.0,-68.0,-71.0,-68.0,-60.0,-69.0,-71.0,-67.0,-60.0,-79.0,-87.0,-78.0,-87.0,11.0,16.0,10.0,27.0,1
3684,CC:2F:71:3F:1F:24,8721254,8809915488,5506429,8403852877,3214825,406062611,80,1283721,789217084,1275184,788191878,8537,1025206,1230528,619,5511148,564731,80,5816,115556.0,28889.0,-68.0,-65.0,-72.0,-70.0,-68.0,-64.0,-72.0,-70.0,-79.0,-87.0,-78.0,-87.0,11.0,22.0,6.0,17.0,1
3685,F8:59:71:5A:E0:3D,3348381,601873390,133556,195810779,3214825,406062611,0,131663,154356316,126855,153781794,4808,574522,109299,16,136270,2627,0,528,144444.0,43333.0,-66.0,-72.0,-65.0,-70.0,-66.0,-72.0,-65.0,-70.0,-79.0,-87.0,-79.0,-87.0,13.0,15.0,14.0,17.0,1
3686,CC:2F:71:3E:C5:1F,3226225,407457033,11396,1394018,3214829,406063015,6,48652,4074312,40205,3073412,8447,1000900,12016,34,16360,186,6,826,130000.0,39000.0,-68.0,-71.0,-68.0,-60.0,-69.0,-71.0,-67.0,-60.0,-79.0,-87.0,-79.0,-87.0,11.0,16.0,11.0,27.0,1
3687,CC:2F:71:3F:1F:24,8722656,8812080120,5507827,8406017105,3214829,406063015,80,1284013,789346326,1275476,788321120,8537,1025206,1230820,619,5512546,564934,80,5817,115556.0,28889.0,-69.0,-64.0,-72.0,-70.0,-68.0,-64.0,-71.0,-69.0,-79.0,-87.0,-79.0,-87.0,10.0,23.0,7.0,17.0,1
3688,F8:59:71:5A:E0:3D,3348455,601975481,133621,195911789,3214834,406063692,0,131729,154457984,126921,153883462,4808,574522,109365,16,136335,2627,0,528,144444.0,43333.0,-66.0,-72.0,-66.0,-70.0,-66.0,-71.0,-65.0,-70.0,-79.0,-87.0,-79.0,-87.0,13.0,15.0,13.0,17.0,1
3689,CC:2F:71:3E:C5:1F,3226230,407457710,11396,1394018,3214834,406063692,6,48652,4074312,40205,3073412,8447,1000900,12016,34,16360,186,6,826,130000.0,39000.0,-68.0,-71.0,-68.0,-60.0,-69.0,-71.0,-67.0,-60.0,-79.0,-87.0,-79.0,-87.0,11.0,16.0,11.0,27.0,1
3690,CC:2F:71:3F:1F:24,8724084,8814284723,5509250,8408221031,3214834,406063692,80,1284286,789470422,1275749,788445216,8537,1025206,1231093,619,5513935,565131,80,5817,115556.0,28889.0,-69.0,-64.0,-73.0,-70.0,-68.0,-64.0,-72.0,-69.0,-79.0,-87.0,-79.0,-87.0,10.0,23.0,6.0,17.0,1
3691,F8:59:71:5A:E0:3D,3348520,602074997,133685,196011245,3214835,406063752,0,131794,154558098,126986,153983576,4808,574522,109429,16,136399,2628,0,528,144444.0,43333.0,-67.0,-72.0,-65.0,-70.0,-66.0,-72.0,-65.0,-70.0,-79.0,-87.0,-79.0,-87.0,12.0,15.0,14.0,17.0,1
3692,CC:2F:71:3E:C5:1F,3226231,407457770,11396,1394018,3214835,406063752,6,48652,4074312,40205,3073412,8447,1000900,12016,34,16360,186,6,826,130000.0,39000.0,-68.0,-71.0,-68.0,-60.0,-69.0,-71.0,-67.0,-60.0,-79.0,-87.0,-79.0,-87.0,11.0,16.0,11.0,27.0,1
3693,CC:2F:71:3F:1F:24,8725435,8816369945,5510598,8410305991,3214837,406063954,80,1284530,789591042,1275993,788565836,8537,1025206,1231337,619,5515317,565287,80,5817,130000.0,43333.0,-68.0,-64.0,-72.0,-69.0,-68.0,-64.0,-72.0,-69.0,-79.0,-87.0,-79.0,-87.0,11.0,23.0,7.0,18.0,1
3694,F8:59:71:5A:E0:3D,3348589,602173505,133748,196109147,3214841,406064358,0,131857,154655132,127049,154080610,4808,574522,109491,16,136462,2630,0,528,144444.0,43333.0,-66.0,-72.0,-65.0,-71.0,-66.0,-72.0,-65.0,-70.0,-79.0,-87.0,-79.0,-87.0,13.0,15.0,14.0,16.0,1
3695,CC:2F:71:3E:C5:1F,3226237,407458376,11396,1394018,3214841,406064358,6,48652,4074312,40205,3073412,8447,1000900,12016,34,16360,186,6,826,130000.0,39000.0,-68.0,-71.0,-68.0,-60.0,-69.0,-71.0,-67.0,-60.0,-79.0,-87.0,-79.0,-87.0,11.0,16.0,11.0,27.0,1
3696,CC:2F:71:3F:1F:24,8726368,8817784873,5511525,8411720313,3214843,406064560,80,1284754,789707100,1276217,788681894,8537,1025206,1231561,619,5516244,565560,80,5817,115556.0,28889.0,-69.0,-64.0,-72.0,-68.0,-68.0,-64.0,-71.0,-68.0,-79.0,-87.0,-79.0,-87.0,10.0,23.0,7.0,19.0,1
3697,F8:59:71:5A:E0:3D,3348652,602268501,133809,196203941,3214843,406064560,0,131919,154750612,127111,154176090,4808,574522,109553,16,136523,2630,0,528,144444.0,43333.0,-67.0,-72.0,-65.0,-70.0,-66.0,-72.0,-65.0,-70.0,-79.0,-87.0,-79.0,-87.0,12.0,15.0,14.0,17.0,1
3698,CC:2F:71:3E:C5:1F,3226240,407458638,11396,1394018,3214844,406064620,6,48652,4074312,40205,3073412,8447,1000900,12016,34,16360,186,6,826,130000.0,39000.0,-68.0,-71.0,-68.0,-60.0,-69.0,-71.0,-67.0,-60.0,-79.0,-87.0,-79.0,-87.0,11.0,16.0,11.0,27.0,1
3699,CC:2F:71:3F:1F:24,8727267,8819160433,5512423,8413095813,3214844,406064620,80,1284959,789821772,1276422,788796566,8537,1025206,1231766,619,5517142,565642,80,5817,115556.0,28889.0,-69.0,-64.0,-72.0,-69.0,-68.0,-64.0,-72.0,-69.0,-79.0,-87.0,-79.0,-87.0,10.0,23.0,7.0,18.0,1
3700,F8:59:71:5A:E0:3D,3348723,602368623,133873,196303397,3214850,406065226,0,131983,154849172,127175,154274650,4808,574522,109617,16,136587,2631,0,528,144444.0,43333.0,-67.0,-72.0,-65.0,-70.0,-66.0,-72.0,-65.0,-70.0,-79.0,-87.0,-79.0,-87.0,12.0,15.0,14.0,17.0,1
3701,CC:2F:71:3E:C5:1F,3226246,407459244,11396,1394018,3214850,406065226,6,48652,4074312,40205,3073412,8447,1000900,12016,34,16360,186,6,826,130000.0,39000.0,-68.0,-71.0,-68.0,-60.0,-69.0,-71.0,-67.0,-60.0,-79.0,-87.0,-79.0,-87.0,11.0,16.0,11.0,27.0,1
3702,CC:2F:71:3F:1F:24,8728316,8820765349,5513466,8414700123,3214850,406065226,80,1285184,789938704,1276647,788913498,8537,1025206,1231991,619,5518166,565672,80,5817,115556.0,28889.0,-69.0,-64.0,-71.0,-69.0,-68.0,-64.0,-71.0,-69.0,-79.0,-87.0,-79.0,-87.0,10.0,23.0,8.0,18.0,1
3703,F8:59:71:5A:E0:3D,3348790,602468397,133938,196402969,3214852,406065428,0,132046,154946192,127238,154371670,4808,574522,109680,16,136652,2631,0,528,144444.0,43333.0,-66.0,-72.0,-65.0,-70.0,-66.0,-72.0,-65.0,-70.0,-79.0,-87.0,-79.0,-87.0,13.0,15.0,14.0,17.0,1
3704,CC:2F:71:3E:C5:1F,3226249,407459562,11397,1394134,3214852,406065428,6,48654,4074452,40207,3073552,8447,1000900,12016,34,16361,186,6,826,130000.0,39000.0,-69.0,-71.0,-68.0,-60.0,-68.0,-71.0,-67.0,-60.0,-79.0,-87.0,-79.0,-87.0,10.0,16.0,11.0,27.0,1
3705,CC:2F:71:3F:1F:24,8729494,8822578049,5514642,8416512621,3214852,406065428,80,1285440,790059338,1276903,789034132,8537,1025206,1232247,619,5519361,565794,80,5818,115556.0,28889.0,-69.0,-64.0,-72.0,-68.0,-68.0,-64.0,-71.0,-68.0,-79.0,-87.0,-79.0,-87.0,10.0,23.0,7.0,19.0,1
3706,F8:59:71:5A:E0:3D,3348859,602565411,134000,196499317,3214859,406066094,0,132109,155043212,127301,154468690,4808,574522,109743,16,136714,2631,0,528,144444.0,43333.0,-67.0,-72.0,-65.0,-70.0,-66.0,-72.0,-65.0,-70.0,-79.0,-87.0,-79.0,-87.0,12.0,15.0,14.0,17.0,1
3707,CC:2F:71:3E:C5:1F,3226256,407460228,11397,1394134,3214859,406066094,6,48654,4074452,40207,3073552,8447,1000900,12016,34,16361,186,6,826,130000.0,39000.0,-69.0,-71.0,-68.0,-60.0,-68.0,-71.0,-67.0,-60.0,-79.0,-87.0,-79.0,-87.0,10.0,16.0,11.0,27.0,1
3708,CC:2F:71:3F:1F:24,8730450,8824025675,5515591,8417959581,3214859,406066094,80,1285661,790175111,1277124,789149905,8537,1025206,1232468,619,5520294,565853,80,5818,115556.0,28889.0,-68.0,-64.0,-72.0,-69.0,-68.0,-64.0,-72.0,-69.0,-79.0,-87.0,-79.0,-87.0,11.0,23.0,7.0,18.0,1
3709,F8:59:71:5A:E0:3D,3348924,602663515,134063,196597219,3214861,406066296,0,132171,155138692,127363,154564170,4808,574522,109805,16,136777,2631,0,528,144444.0,43333.0,-66.0,-72.0,-65.0,-70.0,-66.0,-72.0,-65.0,-70.0,-79.0,-87.0,-79.0,-87.0,13.0,15.0,14.0,17.0,1
3710,CC:2F:71:3E:C5:1F,3226258,407460430,11397,1394134,3214861,406066296,6,48654,4074452,40207,3073552,8447,1000900,12016,34,16361,186,6,826,130000.0,39000.0,-69.0,-71.0,-68.0,-60.0,-68.0,-71.0,-67.0,-60.0,-79.0,-87.0,-79.0,-87.0,10.0,16.0,11.0,27.0,1
3711,CC:2F:71:3F:1F:24,8731384,8825455053,5516523,8419388757,3214861,406066296,80,1285894,790291653,1277357,789266447,8537,1025206,1232701,619,5521241,565886,80,5818,115556.0,28889.0,-69.0,-64.0,-72.0,-70.0,-69.0,-63.0,-72.0,-69.0,-79.0,-87.0,-79.0,-87.0,10.0,23.0,7.0,17.0,1
3712,F8:59:71:5A:E0:3D,3348992,602760716,134125,196693567,3214867,406067149,0,132233,155234172,127425,154659650,4808,574522,109867,16,136839,2632,0,528,144444.0,43333.0,-66.0,-72.0,-65.0,-70.0,-66.0,-72.0,-65.0,-70.0,-79.0,-87.0,-79.0,-87.0,13.0,15.0,14.0,17.0,1
3713,CC:2F:71:3E:C5:1F,3226264,407461283,11397,1394134,3214867,406067149,6,48654,4074452,40207,3073552,8447,1000900,12016,34,16361,186,6,826,130000.0,39000.0,-69.0,-71.0,-68.0,-60.0,-68.0,-71.0,-67.0,-60.0,-79.0,-87.0,-79.0,-87.0,10.0,16.0,11.0,27.0,1
3714,CC:2F:71:3F:1F:24,8732356,8826935300,5517487,8420867949,3214869,406067351,80,1286064,790405193,1277527,789379987,8537,1025206,1232871,619,5522206,566044,80,5818,130000.0,39000.0,-68.0,-64.0,-72.0,-70.0,-68.0,-63.0,-72.0,-70.0,-79.0,-87.0,-79.0,-87.0,11.0,23.0,7.0,17.0,1
3715,F8:59:71:5A:E0:3D,3349064,602862396,134190,196794577,3214874,406067819,0,132300,155337366,127492,154762844,4808,574522,109933,16,136904,2632,0,528,144444.0,43333.0,-67.0,-72.0,-65.0,-70.0,-66.0,-72.0,-65.0,-70.0,-79.0,-87.0,-79.0,-87.0,12.0,15.0,14.0,17.0,1
3716,CC:2F:71:3E:C5:1F,3226271,407461953,11397,1394134,3214874,406067819,6,48654,4074452,40207,3073552,8447,1000900,12016,34,16361,186,6,826,130000.0,39000.0,-69.0,-71.0,-68.0,-60.0,-68.0,-71.0,-67.0,-60.0,-79.0,-87.0,-79.0,-87.0,10.0,16.0,11.0,27.0,1
3717,CC:2F:71:3F:1F:24,8733661,8828943565,5518785,8422875297,3214876,406068268,80,1286319,790528565,1277782,789503359,8537,1025206,1233126,619,5523504,566514,80,5818,130000.0,39000.0,-69.0,-64.0,-72.0,-70.0,-69.0,-63.0,-72.0,-70.0,-79.0,-87.0,-79.0,-87.0,10.0,23.0,7.0,17.0,1
3718,F8:59:71:5A:E0:3D,3349140,602964759,134257,196895819,3214883,406068940,0,132366,155436138,127558,154861616,4808,574522,109999,16,136971,2632,0,528,144444.0,43333.0,-67.0,-72.0,-65.0,-70.0,-66.0,-72.0,-65.0,-70.0,-79.0,-87.0,-79.0,-87.0,12.0,15.0,14.0,17.0,1
3719,CC:2F:71:3E:C5:1F,3226280,407463074,11397,1394134,3214883,406068940,6,48654,4074452,40207,3073552,8447,1000900,12016,34,16361,186,6,826,130000.0,39000.0,-69.0,-71.0,-68.0,-60.0,-68.0,-71.0,-67.0,-60.0,-79.0,-87.0,-79.0,-87.0,10.0,16.0,11.0,27.0,1
3720,CC:2F:71:3F:1F:24,8735131,8831208159,5520248,8425139219,3214883,406068940,80,1286569,790654135,1278031,789628811,8538,1025324,1233376,619,5524950,567079,80,5818,130000.0,43333.0,-69.0,-63.0,-73.0,-69.0,-68.0,-63.0,-72.0,-69.0,-79.0,-87.0,-79.0,-87.0,10.0,24.0,6.0,18.0,1
3721,F8:59:71:5A:E0:3D,3349213,603069730,134324,196999937,3214889,406069793,0,132434,155540858,127626,154966336,4808,574522,110067,16,137038,2633,0,528,144444.0,43333.0,-66.0,-73.0,-65.0,-70.0,-66.0,-72.0,-65.0,-70.0,-79.0,-87.0,-79.0,-87.0,13.0,14.0,14.0,17.0,1
3722,CC:2F:71:3E:C5:1F,3226286,407463927,11397,1394134,3214889,406069793,6,48654,4074452,40207,3073552,8447,1000900,12016,34,16361,186,6,826,130000.0,39000.0,-69.0,-71.0,-68.0,-60.0,-68.0,-71.0,-67.0,-60.0,-79.0,-87.0,-79.0,-87.0,10.0,16.0,11.0,27.0,1
3723,CC:2F:71:3F:1F:24,8736732,8833674990,5521843,8427605197,3214889,406069793,80,1286878,790790054,1278340,789764730,8538,1025324,1233685,619,5526562,567197,80,5819,115556.0,28889.0,-68.0,-63.0,-72.0,-69.0,-68.0,-63.0,-71.0,-68.0,-79.0,-87.0,-79.0,-87.0,11.0,24.0,7.0,18.0,1
3724,F8:59:71:5A:E0:3D,3349289,603177869,134393,197107163,3214896,406070706,0,132503,155647118,127695,155072596,4808,574522,110136,16,137107,2633,0,528,144444.0,43333.0,-66.0,-72.0,-65.0,-70.0,-66.0,-72.0,-65.0,-70.0,-79.0,-87.0,-79.0,-87.0,13.0,15.0,14.0,17.0,1
3725,CC:2F:71:3E:C5:1F,3226293,407464840,11397,1394134,3214896,406070706,6,48654,4074452,40207,3073552,8447,1000900,12016,34,16361,186,6,826,130000.0,39000.0,-69.0,-71.0,-68.0,-60.0,-68.0,-71.0,-67.0,-60.0,-79.0,-87.0,-79.0,-87.0,10.0,16.0,11.0,27.0,1
3726,CC:2F:71:3F:1F:24,8738318,8836127397,5523422,8430056691,3214896,406070706,80,1287166,790917230,1278628,789891906,8538,1025324,1233973,619,5528141,567259,80,5820,115556.0,28889.0,-68.0,-64.0,-72.0,-69.0,-68.0,-63.0,-72.0,-69.0,-79.0,-87.0,-79.0,-87.0,11.0,23.0,7.0,18.0,1
3727,F8:59:71:5A:E0:3D,3349357,603277673,134457,197206563,3214900,406071110,0,132567,155745678,127759,155171156,4808,574522,110200,16,137171,2634,0,528,130000.0,39000.0,-66.0,-72.0,-65.0,-70.0,-66.0,-72.0,-65.0,-70.0,-79.0,-87.0,-79.0,-87.0,13.0,15.0,14.0,17.0,1
3728,CC:2F:71:3E:C5:1F,3226297,407465244,11397,1394134,3214900,406071110,6,48654,4074452,40207,3073552,8447,1000900,12016,34,16361,186,6,826,130000.0,39000.0,-69.0,-71.0,-68.0,-60.0,-68.0,-71.0,-67.0,-60.0,-79.0,-87.0,-79.0,-87.0,10.0,16.0,11.0,27.0,1
3729,CC:2F:71:3F:1F:24,8739504,8837952653,5524604,8431881543,3214900,406071110,80,1287388,791036662,1278850,790011338,8538,1025324,1234195,619,5529323,567476,80,5820,117000.0,39000.0,-69.0,-63.0,-72.0,-69.0,-68.0,-63.0,-71.0,-68.0,-79.0,-87.0,-79.0,-87.0,10.0,24.0,7.0,18.0,1
3730,F8:59:71:5A:E0:3D,3349425,603379046,134522,197307461,3214903,406071585,0,132631,155844238,127823,155269716,4808,574522,110264,16,137236,2635,0,528,144444.0,43333.0,-66.0,-72.0,-65.0,-71.0,-66.0,-72.0,-64.0,-70.0,-79.0,-87.0,-79.0,-87.0,13.0,15.0,14.0,16.0,1
3731,CC:2F:71:3E:C5:1F,3226300,407465719,11397,1394134,3214903,406071585,6,48654,4074452,40207,3073552,8447,1000900,12016,34,16361,186,6,826,130000.0,39000.0,-69.0,-71.0,-68.0,-60.0,-68.0,-71.0,-67.0,-60.0,-79.0,-87.0,-79.0,-87.0,10.0,16.0,11.0,27.0,1
3732,CC:2F:71:3F:1F:24,8740846,8840023692,5525941,8433951905,3214905,406071787,80,1287653,791159794,1279115,790134470,8538,1025324,1234460,619,5530660,567571,80,5821,130000.0,39000.0,-69.0,-64.0,-72.0,-69.0,-68.0,-63.0,-71.0,-68.0,-79.0,-87.0,-79.0,-87.0,10.0,23.0,7.0,18.0,1
3733,F8:59:71:5A:E0:3D,3349495,603480520,134587,197408471,3214908,406072049,0,132697,155945878,127889,155371356,4808,574522,110330,16,137301,2635,0,528,144444.0,43333.0,-66.0,-72.0,-65.0,-71.0,-66.0,-72.0,-65.0,-70.0,-79.0,-87.0,-79.0,-87.0,13.0,15.0,14.0,16.0,1
3734,CC:2F:71:3E:C5:1F,3226307,407466385,11397,1394134,3214910,406072251,6,48654,4074452,40207,3073552,8447,1000900,12016,34,16361,186,6,826,130000.0,39000.0,-69.0,-71.0,-68.0,-60.0,-68.0,-71.0,-67.0,-60.0,-79.0,-87.0,-79.0,-87.0,10.0,16.0,11.0,27.0,1
3735,CC:2F:71:3F:1F:24,8741897,8841624122,5526987,8435551871,3214910,406072251,80,1287881,791279062,1279343,790253738,8538,1025324,1234688,619,5531706,567600,80,5821,130000.0,43333.0,-68.0,-64.0,-72.0,-68.0,-68.0,-64.0,-72.0,-68.0,-79.0,-87.0,-79.0,-87.0,11.0,23.0,7.0,19.0,1
3736,F8:59:71:5A:E0:3D,3349560,603578624,134650,197506373,3214910,406072251,0,132761,156044452,127953,155469930,4808,574522,110393,16,137364,2636,0,528,144444.0,43333.0,-66.0,-72.0,-65.0,-70.0,-66.0,-72.0,-64.0,-70.0,-79.0,-87.0,-79.0,-87.0,13.0,15.0,14.0,17.0,1
3737,CC:2F:71:3E:C5:1F,3226309,407466587,11397,1394134,3214912,406072453,6,48654,4074452,40207,3073552,8447,1000900,12016,34,16361,186,6,826,130000.0,39000.0,-69.0,-71.0,-68.0,-60.0,-68.0,-71.0,-67.0,-60.0,-79.0,-87.0,-79.0,-87.0,10.0,16.0,11.0,27.0,1
3738,CC:2F:71:3F:1F:24,8742999,8843319604,5528087,8437247151,3214912,406072453,80,1288116,791395804,1279578,790370480,8538,1025324,1234922,619,5532806,567705,80,5821,130000.0,43333.0,-69.0,-64.0,-72.0,-69.0,-68.0,-63.0,-71.0,-69.0,-79.0,-87.0,-79.0,-87.0,10.0,23.0,7.0,18.0,1
3739,F8:59:71:5A:E0:3D,3349627,603674024,134711,197601167,3214916,406072857,0,132822,156138392,128014,155563870,4808,574522,110454,16,137425,2636,0,528,144444.0,43333.0,-66.0,-72.0,-65.0,-70.0,-66.0,-72.0,-64.0,-70.0,-79.0,-87.0,-79.0,-87.0,13.0,15.0,14.0,17.0,1
3740,CC:2F:71:3E:C5:1F,3226313,407466991,11397,1394134,3214916,406072857,6,48654,4074452,40207,3073552,8447,1000900,12016,34,16361,186,6,826,130000.0,39000.0,-69.0,-71.0,-68.0,-60.0,-68.0,-71.0,-67.0,-60.0,-79.0,-87.0,-79.0,-87.0,10.0,16.0,11.0,27.0,1
3741,CC:2F:71:3F:1F:24,8744121,8845041166,5529204,8438968249,3214917,406072917,80,1288346,791513352,1279808,790488028,8538,1025324,1235152,619,5533923,567787,80,5821,130000.0,43333.0,-69.0,-63.0,-72.0,-69.0,-68.0,-63.0,-72.0,-68.0,-79.0,-87.0,-79.0,-87.0,10.0,24.0,7.0,18.0,1
3742,F8:59:71:5A:E0:3D,3349693,603772188,134774,197699069,3214919,406073119,0,132885,156235412,128077,155660890,4808,574522,110517,16,137488,2636,0,528,144444.0,43333.0,-66.0,-73.0,-66.0,-71.0,-66.0,-72.0,-65.0,-70.0,-79.0,-87.0,-79.0,-87.0,13.0,14.0,13.0,16.0,1
3743,CC:2F:71:3E:C5:1F,3226317,407467315,11397,1394134,3214920,406073181,6,48654,4074452,40207,3073552,8447,1000900,12016,34,16361,186,6,826,130000.0,39000.0,-69.0,-71.0,-68.0,-60.0,-68.0,-71.0,-67.0,-60.0,-79.0,-87.0,-79.0,-87.0,10.0,16.0,11.0,27.0,1
3744,CC:2F:71:3F:1F:24,8745181,8846669280,5530261,8440596099,3214920,406073181,80,1288532,791624392,1279994,790599068,8538,1025324,1235338,619,5534980,567899,80,5822,130000.0,43333.0,-68.0,-64.0,-72.0,-69.0,-68.0,-64.0,-72.0,-69.0,-79.0,-87.0,-79.0,-87.0,11.0,23.0,7.0,18.0,1
3745,F8:59:71:5A:E0:3D,3349767,603872742,134838,197798525,3214929,406074217,0,132949,156332550,128140,155757910,4809,574640,110581,16,137552,2636,0,528,144444.0,43333.0,-67.0,-72.0,-66.0,-71.0,-66.0,-72.0,-65.0,-70.0,-79.0,-87.0,-79.0,-87.0,12.0,15.0,13.0,16.0,1
3746,CC:2F:71:3E:C5:1F,3226326,407468351,11397,1394134,3214929,406074217,6,48656,4074640,40208,3073622,8448,1001018,12017,34,16361,186,6,826,130000.0,39000.0,-69.0,-70.0,-67.0,-60.0,-68.0,-70.0,-67.0,-60.0,-79.0,-87.0,-79.0,-87.0,10.0,17.0,12.0,27.0,1
3747,CC:2F:71:3F:1F:24,8746442,8848599528,5531513,8442525311,3214929,406074217,80,1288803,791747305,1280265,790721981,8538,1025324,1235609,619,5536232,568008,80,5822,130000.0,43333.0,-70.0,-64.0,-71.0,-68.0,-69.0,-64.0,-71.0,-67.0,-79.0,-87.0,-79.0,-87.0,9.0,23.0,8.0,19.0,1
3748,F8:59:71:5A:E0:3D,3349831,603969292,134900,197894873,3214931,406074419,0,133011,156428030,128202,155853390,4809,574640,110643,16,137614,2637,0,528,144444.0,43333.0,-67.0,-72.0,-65.0,-71.0,-66.0,-72.0,-65.0,-71.0,-79.0,-87.0,-79.0,-87.0,12.0,15.0,14.0,16.0,1
3749,CC:2F:71:3E:C5:1F,3226328,407468553,11397,1394134,3214931,406074419,6,48656,4074640,40208,3073622,8448,1001018,12017,34,16361,186,6,826,130000.0,39000.0,-69.0,-70.0,-67.0,-60.0,-68.0,-70.0,-67.0,-60.0,-79.0,-87.0,-79.0,-87.0,10.0,17.0,12.0,27.0,1
3750,CC:2F:71:3F:1F:24,8747560,8850319188,5532628,8444244709,3214932,406074479,80,1289044,791864773,1280506,790839449,8538,1025324,1235850,619,5537347,568055,80,5822,130000.0,43333.0,-70.0,-64.0,-72.0,-68.0,-70.0,-64.0,-71.0,-68.0,-79.0,-87.0,-79.0,-87.0,9.0,23.0,7.0,19.0,1
3751,F8:59:71:5A:E0:3D,3349899,604067658,134963,197992775,3214936,406074883,0,133076,156528144,128267,155953504,4809,574640,110707,16,137677,2638,0,528,144444.0,43333.0,-67.0,-72.0,-64.0,-71.0,-66.0,-72.0,-64.0,-70.0,-79.0,-87.0,-79.0,-87.0,12.0,15.0,15.0,16.0,1
3752,CC:2F:71:3E:C5:1F,3226335,407469219,11397,1394134,3214938,406075085,6,48656,4074640,40208,3073622,8448,1001018,12017,34,16361,186,6,826,130000.0,39000.0,-69.0,-70.0,-67.0,-60.0,-68.0,-70.0,-67.0,-60.0,-79.0,-87.0,-79.0,-87.0,10.0,17.0,12.0,27.0,1
3753,CC:2F:71:3F:1F:24,8748577,8851873440,5533639,8445798355,3214938,406075085,80,1289234,791979169,1280696,790953845,8538,1025324,1236040,619,5538358,568151,80,5822,144444.0,43333.0,-70.0,-64.0,-71.0,-68.0,-70.0,-64.0,-71.0,-68.0,-79.0,-87.0,-79.0,-87.0,9.0,23.0,8.0,19.0,1
3754,F8:59:71:5A:E0:3D,3349965,604164410,135025,198089123,3214940,406075287,0,133139,156625178,128330,156050538,4809,574640,110769,16,137739,2638,0,528,144444.0,43333.0,-67.0,-73.0,-65.0,-71.0,-66.0,-72.0,-65.0,-71.0,-79.0,-87.0,-79.0,-87.0,12.0,14.0,14.0,16.0,1
3755,CC:2F:71:3E:C5:1F,3226337,407469421,11397,1394134,3214940,406075287,6,48656,4074640,40208,3073622,8448,1001018,12017,34,16361,186,6,826,130000.0,39000.0,-69.0,-70.0,-67.0,-60.0,-68.0,-70.0,-67.0,-60.0,-79.0,-87.0,-79.0,-87.0,10.0,17.0,12.0,27.0,1
3756,CC:2F:71:3F:1F:24,8749959,8854011130,5535019,8447935843,3214940,406075287,80,1289496,792099151,1280958,791073827,8538,1025324,1236302,619,5539737,568254,80,5822,130000.0,43333.0,-69.0,-64.0,-72.0,-68.0,-69.0,-64.0,-71.0,-68.0,-79.0,-87.0,-79.0,-87.0,10.0,23.0,7.0,19.0,1
3757,F8:59:71:5A:E0:3D,3350035,604265884,135090,198190133,3214945,406075751,0,133204,156725278,128395,156150638,4809,574640,110834,16,137804,2638,0,528,144444.0,43333.0,-67.0,-73.0,-65.0,-71.0,-66.0,-72.0,-65.0,-70.0,-79.0,-87.0,-79.0,-87.0,12.0,14.0,14.0,16.0,1
3758,CC:2F:71:3E:C5:1F,3226342,407469885,11397,1394134,3214945,406075751,6,48656,4074640,40208,3073622,8448,1001018,12017,34,16361,186,6,826,130000.0,39000.0,-69.0,-70.0,-67.0,-60.0,-68.0,-70.0,-67.0,-60.0,-79.0,-87.0,-79.0,-87.0,10.0,17.0,12.0,27.0,1
3759,CC:2F:71:3F:1F:24,8752135,8857392862,5537188,8451316909,3214947,406075953,80,1289815,792232779,1281277,791207455,8538,1025324,1236621,619,5541907,568284,80,5822,130000.0,43333.0,-70.0,-64.0,-71.0,-68.0,-69.0,-64.0,-71.0,-68.0,-79.0,-87.0,-79.0,-87.0,9.0,23.0,8.0,19.0,1
3760,F8:59:71:5A:E0:3D,3350104,604367298,135155,198291143,3214949,406076155,0,133269,156825378,128460,156250738,4809,574640,110899,16,137869,2640,0,528,144444.0,43333.0,-67.0,-72.0,-65.0,-71.0,-66.0,-72.0,-65.0,-70.0,-79.0,-87.0,-79.0,-87.0,12.0,15.0,14.0,16.0,1
3761,CC:2F:71:3E:C5:1F,3226346,407470289,11397,1394134,3214949,406076155,6,48656,4074640,40208,3073622,8448,1001018,12017,34,16361,186,6,826,130000.0,39000.0,-69.0,-70.0,-67.0,-60.0,-68.0,-70.0,-67.0,-60.0,-79.0,-87.0,-79.0,-87.0,10.0,17.0,12.0,27.0,1
3762,CC:2F:71:3F:1F:24,8753880,8860092906,5538931,8454016751,3214949,406076155,80,1290157,792365392,1281619,791340068,8538,1025324,1236963,619,5543650,568317,80,5822,130000.0,43333.0,-71.0,-64.0,-71.0,-68.0,-70.0,-64.0,-71.0,-68.0,-79.0,-87.0,-79.0,-87.0,8.0,23.0,8.0,19.0,1
3763,F8:59:71:5A:E0:3D,3350174,604470266,135221,198393707,3214953,406076559,0,133334,156925478,128525,156350838,4809,574640,110964,16,137935,2640,0,528,144444.0,43333.0,-66.0,-72.0,-65.0,-70.0,-66.0,-71.0,-65.0,-70.0,-79.0,-87.0,-79.0,-87.0,13.0,15.0,14.0,17.0,1
3764,CC:2F:71:3E:C5:1F,3226350,407470693,11397,1394134,3214953,406076559,6,48656,4074640,40208,3073622,8448,1001018,12017,34,16361,186,6,826,130000.0,39000.0,-69.0,-70.0,-67.0,-60.0,-68.0,-70.0,-67.0,-60.0,-79.0,-87.0,-79.0,-87.0,10.0,17.0,12.0,27.0,1
3765,CC:2F:71:3F:1F:24,8755333,8862338064,5540380,8456261505,3214953,406076559,80,1290412,792487452,1281874,791462128,8538,1025324,1237218,619,5545099,568456,80,5822,130000.0,43333.0,-70.0,-64.0,-71.0,-68.0,-70.0,-64.0,-71.0,-68.0,-79.0,-87.0,-79.0,-87.0,9.0,23.0,8.0,19.0,1
3766,F8:59:71:5A:E0:3D,3350239,604566876,135283,198490055,3214956,406076821,0,133397,157022498,128588,156447858,4809,574640,111027,16,137997,2641,0,528,144444.0,43333.0,-66.0,-72.0,-65.0,-70.0,-66.0,-72.0,-65.0,-70.0,-79.0,-87.0,-79.0,-87.0,13.0,15.0,14.0,17.0,1
3767,CC:2F:71:3E:C5:1F,3226355,407471157,11397,1394134,3214958,406077023,6,48656,4074640,40208,3073622,8448,1001018,12017,34,16361,186,6,826,130000.0,39000.0,-69.0,-70.0,-67.0,-60.0,-68.0,-70.0,-67.0,-60.0,-79.0,-87.0,-79.0,-87.0,10.0,17.0,12.0,27.0,1
3768,CC:2F:71:3F:1F:24,8756505,8864136810,5541546,8458059661,3214959,406077149,80,1290663,792608996,1282125,791583672,8538,1025324,1237469,619,5546265,568495,80,5822,130000.0,43333.0,-68.0,-64.0,-70.0,-69.0,-68.0,-64.0,-69.0,-69.0,-79.0,-87.0,-79.0,-87.0,11.0,23.0,9.0,18.0,1
3769,F8:59:71:5A:E0:3D,3350308,604666862,135347,198589511,3214961,406077351,0,133460,157119518,128651,156544878,4809,574640,111090,16,138061,2641,0,528,144444.0,43333.0,-66.0,-72.0,-65.0,-70.0,-66.0,-72.0,-64.0,-70.0,-79.0,-87.0,-79.0,-87.0,13.0,15.0,14.0,17.0,1
3770,CC:2F:71:3E:C5:1F,3226358,407471485,11397,1394134,3214961,406077351,6,48656,4074640,40208,3073622,8448,1001018,12017,34,16361,186,6,826,130000.0,39000.0,-69.0,-70.0,-67.0,-60.0,-68.0,-70.0,-67.0,-60.0,-79.0,-87.0,-79.0,-87.0,10.0,17.0,12.0,27.0,1
3771,CC:2F:71:3F:1F:24,8757583,8865794844,5542622,8459717493,3214961,406077351,80,1290866,792722110,1282328,791696786,8538,1025324,1237672,619,5547341,568573,80,5822,130000.0,43333.0,-68.0,-64.0,-71.0,-69.0,-68.0,-64.0,-71.0,-69.0,-79.0,-87.0,-79.0,-87.0,11.0,23.0,8.0,18.0,1
3772,F8:59:71:5A:E0:3D,3350376,604765441,135410,198687413,3214966,406078028,0,133524,157218078,128715,156643438,4809,574640,111154,16,138124,2642,0,528,144444.0,43333.0,-66.0,-72.0,-65.0,-70.0,-66.0,-72.0,-64.0,-70.0,-79.0,-87.0,-79.0,-87.0,13.0,15.0,14.0,17.0,1
3773,CC:2F:71:3E:C5:1F,3226363,407472162,11397,1394134,3214966,406078028,6,48656,4074640,40208,3073622,8448,1001018,12017,34,16361,186,6,826,130000.0,39000.0,-69.0,-70.0,-67.0,-60.0,-68.0,-70.0,-67.0,-60.0,-79.0,-87.0,-79.0,-87.0,10.0,17.0,12.0,27.0,1
3774,CC:2F:71:3F:1F:24,8758600,8867338691,5543632,8461260461,3214968,406078230,80,1291113,792843618,1282575,791818294,8538,1025324,1237919,619,5548351,568654,80,5822,130000.0,43333.0,-69.0,-64.0,-72.0,-69.0,-68.0,-64.0,-72.0,-68.0,-79.0,-87.0,-79.0,-87.0,10.0,23.0,7.0,18.0,1
3775,F8:59:71:5A:E0:3D,3350445,604865361,135474,198786869,3214971,406078492,0,133587,157315098,128778,156740458,4809,574640,111217,16,138188,2643,0,528,144444.0,43333.0,-66.0,-72.0,-64.0,-70.0,-66.0,-72.0,-64.0,-70.0,-79.0,-87.0,-79.0,-87.0,13.0,15.0,15.0,17.0,1
3776,CC:2F:71:3E:C5:1F,3226368,407472626,11397,1394134,3214971,406078492,6,48656,4074640,40208,3073622,8448,1001018,12017,34,16361,186,6,826,130000.0,39000.0,-69.0,-70.0,-67.0,-60.0,-68.0,-70.0,-67.0,-60.0,-79.0,-87.0,-79.0,-87.0,10.0,17.0,12.0,27.0,1
3777,CC:2F:71:3F:1F:24,8759570,8868823215,5544599,8462744723,3214971,406078492,80,1291339,792969240,1282801,791943916,8538,1025324,1238145,619,5549318,568671,80,5822,130000.0,43333.0,-70.0,-64.0,-72.0,-68.0,-69.0,-64.0,-71.0,-68.0,-79.0,-87.0,-79.0,-87.0,9.0,23.0,7.0,19.0,1
3778,F8:59:71:5A:E0:3D,3350517,604971325,135542,198892429,3214975,406078896,0,133656,157421358,128847,156846718,4809,574640,111286,16,138256,2647,0,528,144444.0,43333.0,-66.0,-72.0,-65.0,-70.0,-66.0,-72.0,-65.0,-70.0,-79.0,-87.0,-79.0,-87.0,13.0,15.0,14.0,17.0,1
3779,CC:2F:71:3E:C5:1F,3226372,407473030,11397,1394134,3214975,406078896,6,48656,4074640,40208,3073622,8448,1001018,12017,34,16361,186,6,826,130000.0,39000.0,-69.0,-70.0,-67.0,-60.0,-68.0,-70.0,-67.0,-60.0,-79.0,-87.0,-79.0,-87.0,10.0,17.0,12.0,27.0,1
3780,CC:2F:71:3F:1F:24,8760694,8870549339,5545719,8464470443,3214975,406078896,80,1291582,793088332,1283044,792063008,8538,1025324,1238388,619,5550437,568838,80,5822,130000.0,43333.0,-69.0,-64.0,-71.0,-68.0,-69.0,-64.0,-70.0,-68.0,-79.0,-87.0,-79.0,-87.0,10.0,23.0,8.0,19.0,1
3781,F8:59:71:5A:E0:3D,3350584,605069631,135605,198990331,3214979,406079300,0,133718,157516838,128909,156942198,4809,574640,111348,16,138319,2648,0,528,144444.0,43333.0,-66.0,-72.0,-64.0,-71.0,-66.0,-72.0,-64.0,-70.0,-79.0,-87.0,-79.0,-87.0,13.0,15.0,15.0,16.0,1
3782,CC:2F:71:3E:C5:1F,3226376,407473434,11397,1394134,3214979,406079300,6,48656,4074640,40208,3073622,8448,1001018,12017,34,16361,186,6,826,130000.0,39000.0,-69.0,-70.0,-67.0,-60.0,-68.0,-70.0,-67.0,-60.0,-79.0,-87.0,-79.0,-87.0,10.0,17.0,12.0,27.0,1
3783,CC:2F:71:3F:1F:24,8761584,8871907555,5546605,8465828255,3214979,406079300,80,1291811,793204352,1283273,792179028,8538,1025324,1238617,619,5551297,568860,80,5822,130000.0,43333.0,-69.0,-64.0,-71.0,-68.0,-68.0,-64.0,-71.0,-68.0,-79.0,-87.0,-79.0,-87.0,10.0,23.0,8.0,19.0,1
3784,F8:59:71:5A:E0:3D,3350650,605164889,135666,199085125,3214984,406079764,0,133781,157613872,128972,157039232,4809,574640,111410,16,138380,2648,0,528,144444.0,43333.0,-66.0,-72.0,-65.0,-70.0,-66.0,-72.0,-64.0,-70.0,-79.0,-87.0,-79.0,-87.0,13.0,15.0,14.0,17.0,1
3785,CC:2F:71:3E:C5:1F,3226381,407473898,11397,1394134,3214984,406079764,6,48656,4074640,40208,3073622,8448,1001018,12017,34,16361,186,6,826,130000.0,39000.0,-69.0,-70.0,-67.0,-60.0,-68.0,-70.0,-67.0,-60.0,-79.0,-87.0,-79.0,-87.0,10.0,17.0,12.0,27.0,1
3786,CC:2F:71:3F:1F:24,8762964,8874028653,5547980,8467948889,3214984,406079764,80,1292071,793325883,1283533,792300559,8538,1025324,1238877,619,5552699,568919,80,5822,130000.0,43333.0,-69.0,-64.0,-71.0,-68.0,-68.0,-64.0,-71.0,-68.0,-79.0,-87.0,-79.0,-87.0,10.0,23.0,8.0,19.0,1
3787,F8:59:71:5A:E0:3D,3350716,605264547,135730,199184581,3214986,406079966,0,133845,157712432,129036,157137792,4809,574640,111474,16,138444,2648,0,528,144444.0,43333.0,-66.0,-72.0,-65.0,-70.0,-66.0,-72.0,-65.0,-70.0,-79.0,-87.0,-79.0,-87.0,13.0,15.0,14.0,17.0,1
3788,CC:2F:71:3E:C5:1F,3226383,407474100,11397,1394134,3214986,406079966,6,48656,4074640,40208,3073622,8448,1001018,12017,34,16361,186,6,826,130000.0,39000.0,-69.0,-70.0,-67.0,-60.0,-68.0,-70.0,-67.0,-60.0,-79.0,-87.0,-79.0,-87.0,10.0,17.0,12.0,27.0,1
3789,CC:2F:71:3F:1F:24,8764411,8876265835,5549425,8470185869,3214986,406079966,80,1292323,793444575,1283785,792419251,8538,1025324,1239129,619,5554112,568988,80,5822,130000.0,43333.0,-69.0,-64.0,-71.0,-68.0,-69.0,-64.0,-71.0,-68.0,-79.0,-87.0,-79.0,-87.0,10.0,23.0,8.0,19.0,1
3790,F8:59:71:5A:E0:3D,3350789,605364935,135795,199284153,3214994,406080782,0,133908,157809480,129099,157234840,4809,574640,111537,16,138509,2648,0,528,144444.0,43333.0,-67.0,-73.0,-65.0,-71.0,-66.0,-72.0,-65.0,-71.0,-79.0,-87.0,-79.0,-87.0,12.0,14.0,14.0,16.0,1
3791,CC:2F:71:3E:C5:1F,3226392,407475032,11398,1394250,3214994,406080782,6,48658,4074780,40210,3073762,8448,1001018,12017,34,16362,186,6,826,130000.0,39000.0,-69.0,-71.0,-67.0,-60.0,-68.0,-70.0,-67.0,-60.0,-79.0,-87.0,-79.0,-87.0,10.0,16.0,12.0,27.0,1
3792,CC:2F:71:3F:1F:24,8765237,8877513158,5550243,8471432376,3214994,406080782,80,1292541,793562326,1284003,792537002,8538,1025324,1239347,619,5554962,569058,80,5822,130000.0,43333.0,-70.0,-64.0,-72.0,-68.0,-69.0,-64.0,-71.0,-68.0,-79.0,-87.0,-79.0,-87.0,9.0,23.0,7.0,19.0,1
3793,F8:59:71:5A:E0:3D,3350854,605461545,135857,199380501,3214997,406081044,0,133971,157906500,129162,157331860,4809,574640,111600,16,138571,2649,0,528,144444.0,43333.0,-67.0,-72.0,-65.0,-71.0,-66.0,-72.0,-65.0,-70.0,-79.0,-87.0,-79.0,-87.0,12.0,15.0,14.0,16.0,1
3794,CC:2F:71:3E:C5:1F,3226395,407475294,11398,1394250,3214997,406081044,6,48658,4074780,40210,3073762,8448,1001018,12017,34,16362,186,6,826,130000.0,39000.0,-69.0,-71.0,-67.0,-60.0,-68.0,-70.0,-67.0,-60.0,-79.0,-87.0,-79.0,-87.0,10.0,16.0,12.0,27.0,1
3795,CC:2F:71:3F:1F:24,8766357,8879234454,5551360,8473153410,3214997,406081044,80,1292803,793687922,1284265,792662598,8538,1025324,1239607,619,5556079,569092,80,5822,130000.0,43333.0,-69.0,-64.0,-71.0,-68.0,-69.0,-64.0,-71.0,-68.0,-79.0,-87.0,-79.0,-87.0,10.0,23.0,8.0,19.0,1
3796,F8:59:71:5A:E0:3D,3350924,605564401,135923,199482953,3215001,406081448,0,134036,158006600,129227,157431960,4809,574640,111665,16,138637,2649,0,528,144444.0,39000.0,-66.0,-72.0,-66.0,-71.0,-66.0,-72.0,-65.0,-71.0,-79.0,-87.0,-79.0,-87.0,13.0,15.0,13.0,16.0,1
3797,CC:2F:71:3E:C5:1F,3226399,407475698,11398,1394250,3215001,406081448,6,48658,4074780,40210,3073762,8448,1001018,12017,34,16362,186,6,826,130000.0,39000.0,-69.0,-71.0,-67.0,-60.0,-68.0,-70.0,-67.0,-60.0,-79.0,-87.0,-79.0,-87.0,10.0,16.0,12.0,27.0,1
3798,CC:2F:71:3F:1F:24,8767458,8880903522,5552455,8474821872,3215003,406081650,80,1293029,793807632,1284491,792782308,8538,1025324,1239833,619,5557174,569188,80,5822,130000.0,43333.0,-71.0,-65.0,-71.0,-68.0,-70.0,-64.0,-71.0,-68.0,-79.0,-87.0,-79.0,-87.0,8.0,22.0,8.0,19.0,1
3799,F8:59:71:5A:E0:3D,3350992,605664205,135987,199582353,3215005,406081852,0,134101,158106728,129292,157532088,4809,574640,111730,16,138701,2649,0,529,144444.0,43333.0,-66.0,-72.0,-65.0,-71.0,-66.0,-71.0,-65.0,-70.0,-79.0,-87.0,-79.0,-87.0,13.0,15.0,14.0,16.0,1
3800,CC:2F:71:3E:C5:1F,3226404,407476162,11398,1394250,3215006,406081912,6,48658,4074780,40210,3073762,8448,1001018,12017,34,16362,186,6,826,130000.0,39000.0,-69.0,-71.0,-67.0,-60.0,-68.0,-70.0,-67.0,-60.0,-79.0,-87.0,-79.0,-87.0,10.0,16.0,12.0,27.0,1
3801,CC:2F:71:3F:1F:24,8768216,8882053606,5553210,8475971694,3215006,406081912,80,1293257,793926604,1284719,792901280,8538,1025324,1240061,619,5557929,569215,80,5822,130000.0,43333.0,-70.0,-64.0,-70.0,-67.0,-70.0,-64.0,-71.0,-67.0,-79.0,-87.0,-79.0,-87.0,9.0,23.0,9.0,20.0,1
3802,F8:59:71:5A:E0:3D,3351059,605763923,136051,199681809,3215008,406082114,0,134164,158203748,129355,157629108,4809,574640,111793,16,138765,2652,0,529,144444.0,43333.0,-66.0,-72.0,-65.0,-71.0,-66.0,-72.0,-65.0,-70.0,-79.0,-87.0,-79.0,-87.0,13.0,15.0,14.0,16.0,1
3803,CC:2F:71:3E:C5:1F,3226406,407476364,11398,1394250,3215008,406082114,6,48658,4074780,40210,3073762,8448,1001018,12017,34,16362,186,6,826,130000.0,39000.0,-69.0,-71.0,-67.0,-60.0,-68.0,-70.0,-67.0,-60.0,-79.0,-87.0,-79.0,-87.0,10.0,16.0,12.0,27.0,1
3804,CC:2F:71:3F:1F:24,8769029,8883290540,5554019,8477208224,3215010,406082316,80,1293520,794046792,1284982,793021468,8538,1025324,1240324,619,5558738,569250,80,5822,130000.0,43333.0,-70.0,-64.0,-71.0,-68.0,-70.0,-64.0,-71.0,-68.0,-79.0,-87.0,-79.0,-87.0,9.0,23.0,8.0,19.0,1
3805,F8:59:71:5A:E0:3D,3351127,605862291,136114,199779711,3215013,406082580,0,134228,158302322,129419,157727682,4809,574640,111856,16,138828,2652,0,529,144444.0,43333.0,-66.0,-72.0,-65.0,-70.0,-66.0,-71.0,-65.0,-70.0,-79.0,-87.0,-79.0,-87.0,13.0,15.0,14.0,17.0,1
3806,CC:2F:71:3E:C5:1F,3226413,407477032,11398,1394250,3215015,406082782,6,48660,4074968,40211,3073832,8449,1001136,12018,34,16362,186,6,826,130000.0,39000.0,-69.0,-71.0,-68.0,-60.0,-68.0,-70.0,-67.0,-60.0,-79.0,-87.0,-79.0,-87.0,10.0,16.0,11.0,27.0,1
3807,CC:2F:71:3F:1F:24,8770067,8884879288,5555052,8478796506,3215015,406082782,80,1293766,794166202,1285228,793140878,8538,1025324,1240570,619,5559766,569297,80,5823,130000.0,43333.0,-70.0,-64.0,-71.0,-68.0,-70.0,-64.0,-72.0,-68.0,-79.0,-87.0,-79.0,-87.0,9.0,23.0,8.0,19.0,1
3808,F8:59:71:5A:E0:3D,3351195,605960657,136177,199877613,3215018,406083044,0,134293,158402436,129484,157827796,4809,574640,111920,16,138891,2652,0,529,144444.0,43333.0,-66.0,-73.0,-66.0,-71.0,-66.0,-72.0,-65.0,-71.0,-79.0,-87.0,-79.0,-87.0,13.0,14.0,13.0,16.0,1
3809,CC:2F:71:3E:C5:1F,3226416,407477294,11398,1394250,3215018,406083044,6,48660,4074968,40211,3073832,8449,1001136,12018,34,16362,186,6,826,130000.0,39000.0,-69.0,-71.0,-68.0,-60.0,-68.0,-70.0,-67.0,-60.0,-79.0,-87.0,-79.0,-87.0,10.0,16.0,11.0,27.0,1
3810,CC:2F:71:3F:1F:24,8771160,8886559474,5556142,8480476430,3215018,406083044,80,1294006,794286420,1285468,793261096,8538,1025324,1240810,619,5560861,569331,80,5825,130000.0,43333.0,-70.0,-64.0,-72.0,-68.0,-70.0,-64.0,-71.0,-67.0,-79.0,-87.0,-79.0,-87.0,9.0,23.0,7.0,19.0,1
3811,F8:59:71:5A:E0:3D,3351262,606058963,136240,199975515,3215022,406083448,0,134356,158499470,129547,157924830,4809,574640,111982,16,138954,2653,0,529,144444.0,43333.0,-66.0,-73.0,-65.0,-71.0,-66.0,-72.0,-65.0,-71.0,-79.0,-87.0,-79.0,-87.0,13.0,14.0,14.0,16.0,1
3812,CC:2F:71:3E:C5:1F,3226420,407477698,11398,1394250,3215022,406083448,6,48660,4074968,40211,3073832,8449,1001136,12018,34,16362,186,6,826,130000.0,39000.0,-69.0,-71.0,-68.0,-60.0,-68.0,-70.0,-67.0,-60.0,-79.0,-87.0,-79.0,-87.0,10.0,16.0,11.0,27.0,1
3813,CC:2F:71:3F:1F:24,8772421,8888494084,5557399,8482410636,3215022,406083448,80,1294246,794405583,1285708,793380259,8538,1025324,1241050,619,5562118,569393,80,5825,130000.0,43333.0,-70.0,-64.0,-71.0,-68.0,-70.0,-64.0,-71.0,-67.0,-79.0,-87.0,-79.0,-87.0,9.0,23.0,8.0,19.0,1
3814,F8:59:71:5A:E0:3D,3351329,606157269,136303,200073417,3215026,406083852,0,134419,158596532,129610,158021892,4809,574640,112045,16,139017,2653,0,529,144444.0,43333.0,-67.0,-73.0,-65.0,-71.0,-66.0,-72.0,-65.0,-70.0,-79.0,-87.0,-79.0,-87.0,12.0,14.0,14.0,16.0,1
3815,CC:2F:71:3E:C5:1F,3226425,407478375,11398,1394250,3215027,406084125,6,48660,4074968,40211,3073832,8449,1001136,12018,34,16362,186,6,826,130000.0,39000.0,-69.0,-71.0,-68.0,-60.0,-68.0,-70.0,-67.0,-60.0,-79.0,-87.0,-79.0,-87.0,10.0,16.0,11.0,27.0,1
3816,CC:2F:71:3F:1F:24,8773918,8890807353,5558891,8484723228,3215027,406084125,80,1294510,794530151,1285972,793504827,8538,1025324,1241314,619,5563584,569719,80,5825,104000.0,26000.0,-68.0,-64.0,-71.0,-69.0,-68.0,-64.0,-71.0,-69.0,-79.0,-87.0,-79.0,-87.0,11.0,23.0,8.0,18.0,1
3817,F8:59:71:5A:E0:3D,3351401,606260570,136369,200175981,3215032,406084589,0,134486,158699712,129677,158125072,4809,574640,112112,16,139083,2655,0,529,144444.0,43333.0,-67.0,-73.0,-65.0,-71.0,-66.0,-72.0,-65.0,-70.0,-79.0,-87.0,-79.0,-87.0,12.0,14.0,14.0,16.0,1
3818,CC:2F:71:3E:C5:1F,3226430,407478839,11398,1394250,3215032,406084589,6,48660,4074968,40211,3073832,8449,1001136,12018,34,16362,186,6,826,130000.0,39000.0,-69.0,-71.0,-68.0,-60.0,-68.0,-70.0,-67.0,-60.0,-79.0,-87.0,-79.0,-87.0,10.0,16.0,11.0,27.0,1
3819,CC:2F:71:3F:1F:24,8775206,8892789219,5560173,8486704568,3215033,406084651,80,1294772,794653211,1286234,793627887,8538,1025324,1241572,619,5564892,569775,80,5825,115556.0,28889.0,-69.0,-64.0,-72.0,-68.0,-69.0,-64.0,-71.0,-68.0,-79.0,-87.0,-79.0,-87.0,10.0,23.0,7.0,19.0,1
3820,F8:59:71:5A:E0:3D,3351471,606360554,136433,200275437,3215038,406085117,0,134552,158799944,129742,158225186,4810,574758,112177,16,139147,2655,0,529,144444.0,43333.0,-67.0,-73.0,-65.0,-71.0,-67.0,-73.0,-65.0,-71.0,-79.0,-87.0,-79.0,-87.0,12.0,14.0,14.0,16.0,1
3821,CC:2F:71:3E:C5:1F,3226436,407479367,11398,1394250,3215038,406085117,6,48660,4074968,40211,3073832,8449,1001136,12018,34,16362,186,6,826,130000.0,39000.0,-69.0,-71.0,-68.0,-60.0,-68.0,-70.0,-67.0,-60.0,-79.0,-87.0,-79.0,-87.0,10.0,16.0,11.0,27.0,1
3822,CC:2F:71:3F:1F:24,8776413,8894645001,5561375,8488559884,3215038,406085117,80,1295038,794776415,1286499,793750973,8539,1025442,1241838,619,5566084,569820,80,5825,115556.0,28889.0,-69.0,-64.0,-72.0,-68.0,-69.0,-64.0,-71.0,-68.0,-79.0,-87.0,-79.0,-87.0,10.0,23.0,7.0,19.0,1
3823,F8:59:71:5A:E0:3D,3351536,606458658,136496,200373339,3215040,406085319,0,134616,158898518,129806,158323760,4810,574758,112240,16,139210,2655,0,529,144444.0,43333.0,-66.0,-72.0,-65.0,-70.0,-66.0,-72.0,-64.0,-70.0,-79.0,-87.0,-79.0,-87.0,13.0,15.0,14.0,17.0,1
3824,CC:2F:71:3E:C5:1F,3226438,407479569,11398,1394250,3215040,406085319,6,48660,4074968,40211,3073832,8449,1001136,12018,34,16362,186,6,826,130000.0,39000.0,-69.0,-71.0,-68.0,-60.0,-68.0,-70.0,-67.0,-60.0,-79.0,-87.0,-79.0,-87.0,10.0,16.0,11.0,27.0,1
3825,CC:2F:71:3F:1F:24,8777546,8896376011,5562504,8490290490,3215042,406085521,80,1295278,794895628,1286739,793870186,8539,1025442,1242078,619,5567223,569956,80,5825,130000.0,43333.0,-69.0,-64.0,-72.0,-68.0,-69.0,-64.0,-71.0,-68.0,-79.0,-87.0,-79.0,-87.0,10.0,23.0,7.0,19.0,1
3826,F8:59:71:5A:E0:3D,3351604,606557024,136559,200471241,3215045,406085783,0,134679,158995538,129869,158420780,4810,574758,112303,16,139273,2656,0,529,144444.0,43333.0,-66.0,-72.0,-65.0,-71.0,-66.0,-72.0,-64.0,-70.0,-79.0,-87.0,-79.0,-87.0,13.0,15.0,14.0,16.0,1
3827,CC:2F:71:3E:C5:1F,3226445,407480235,11398,1394250,3215047,406085985,6,48660,4074968,40211,3073832,8449,1001136,12018,34,16362,186,6,826,130000.0,39000.0,-69.0,-71.0,-68.0,-60.0,-68.0,-70.0,-67.0,-60.0,-79.0,-87.0,-79.0,-87.0,10.0,16.0,11.0,27.0,1
3828,CC:2F:71:3F:1F:24,8778881,8898433671,5563834,8492347686,3215047,406085985,80,1295570,795020440,1287031,793994998,8539,1025442,1242370,619,5568553,569963,80,5825,130000.0,43333.0,-69.0,-64.0,-71.0,-68.0,-68.0,-64.0,-71.0,-68.0,-79.0,-87.0,-79.0,-87.0,10.0,23.0,8.0,19.0,1
3829,F8:59:71:5A:E0:3D,3351671,606655330,136622,200569143,3215049,406086187,0,134741,159091046,129931,158516288,4810,574758,112365,16,139335,2660,0,529,144444.0,43333.0,-67.0,-72.0,-65.0,-71.0,-66.0,-72.0,-64.0,-70.0,-79.0,-87.0,-79.0,-87.0,12.0,15.0,14.0,16.0,1
3830,CC:2F:71:3E:C5:1F,3226447,407480437,11398,1394250,3215049,406086187,6,48660,4074968,40211,3073832,8449,1001136,12018,34,16362,186,6,826,130000.0,39000.0,-69.0,-71.0,-68.0,-60.0,-68.0,-70.0,-67.0,-60.0,-79.0,-87.0,-79.0,-87.0,10.0,16.0,11.0,27.0,1
3831,CC:2F:71:3F:1F:24,8779714,8899704807,5564665,8493618620,3215049,406086187,80,1295802,795138280,1287263,794112838,8539,1025442,1242602,619,5569383,570168,80,5825,115556.0,26000.0,-68.0,-64.0,-71.0,-69.0,-68.0,-64.0,-72.0,-69.0,-79.0,-87.0,-79.0,-87.0,11.0,23.0,8.0,18.0,1
3832,F8:59:71:5A:E0:3D,3351739,606755190,136686,200668599,3215053,406086591,0,134804,159188066,129994,158613308,4810,574758,112428,16,139400,2661,0,529,144444.0,43333.0,-67.0,-73.0,-65.0,-71.0,-67.0,-73.0,-65.0,-71.0,-79.0,-87.0,-79.0,-87.0,12.0,14.0,14.0,16.0,1
3833,CC:2F:71:3E:C5:1F,3226451,407480841,11398,1394250,3215053,406086591,6,48660,4074968,40211,3073832,8449,1001136,12018,34,16362,186,6,826,130000.0,39000.0,-69.0,-71.0,-68.0,-60.0,-68.0,-70.0,-67.0,-60.0,-79.0,-87.0,-79.0,-87.0,10.0,16.0,11.0,27.0,1
3834,CC:2F:71:3F:1F:24,8780642,8901123155,5565589,8495036564,3215053,406086591,80,1296020,795254550,1287481,794229108,8539,1025442,1242820,619,5570308,570281,80,5825,115556.0,28889.0,-68.0,-64.0,-72.0,-69.0,-68.0,-63.0,-72.0,-68.0,-79.0,-87.0,-79.0,-87.0,11.0,23.0,7.0,18.0,1
3835,F8:59:71:5A:E0:3D,3351804,606851800,136748,200764947,3215056,406086853,0,134868,159286626,130058,158711868,4810,574758,112492,16,139462,2661,0,529,144444.0,43333.0,-66.0,-72.0,-65.0,-70.0,-66.0,-72.0,-64.0,-70.0,-79.0,-87.0,-79.0,-87.0,13.0,15.0,14.0,17.0,1
3836,CC:2F:71:3E:C5:1F,3226456,407481305,11398,1394250,3215058,406087055,6,48660,4074968,40211,3073832,8449,1001136,12018,34,16362,186,6,826,130000.0,39000.0,-69.0,-71.0,-68.0,-60.0,-68.0,-70.0,-67.0,-60.0,-79.0,-87.0,-79.0,-87.0,10.0,16.0,11.0,27.0,1
3837,CC:2F:71:3F:1F:24,8781598,8902573151,5566540,8496486096,3215058,406087055,80,1296259,795373859,1287720,794348417,8539,1025442,1243059,619,5571259,570341,80,5826,130000.0,43333.0,-69.0,-64.0,-72.0,-68.0,-69.0,-63.0,-71.0,-68.0,-79.0,-87.0,-79.0,-87.0,10.0,23.0,7.0,19.0,1
3838,F8:59:71:5A:E0:3D,3351872,606950222,136812,200862965,3215060,406087257,0,134932,159383752,130122,158808994,4810,574758,112556,16,139526,2663,0,529,144444.0,43333.0,-67.0,-72.0,-65.0,-71.0,-66.0,-72.0,-65.0,-71.0,-79.0,-87.0,-79.0,-87.0,12.0,15.0,14.0,16.0,1
3839,CC:2F:71:3E:C5:1F,3226460,407481709,11398,1394250,3215062,406087459,6,48660,4074968,40211,3073832,8449,1001136,12018,34,16362,186,6,826,130000.0,39000.0,-69.0,-71.0,-68.0,-60.0,-68.0,-70.0,-67.0,-60.0,-79.0,-87.0,-79.0,-87.0,10.0,16.0,11.0,27.0,1
3840,CC:2F:71:3F:1F:24,8782379,8903759575,5567317,8497672116,3215062,406087459,80,1296487,795491165,1287948,794465723,8539,1025442,1243287,619,5572036,570351,80,5826,130000.0,43333.0,-69.0,-64.0,-72.0,-68.0,-69.0,-64.0,-71.0,-68.0,-79.0,-87.0,-79.0,-87.0,10.0,23.0,7.0,19.0,1
3841,F8:59:71:5A:E0:3D,3351939,607048528,136875,200960867,3215064,406087661,0,134995,159480772,130185,158906014,4810,574758,112619,16,139589,2663,0,529,144444.0,43333.0,-67.0,-73.0,-65.0,-71.0,-66.0,-72.0,-65.0,-70.0,-79.0,-87.0,-79.0,-87.0,12.0,14.0,14.0,16.0,1
3842,CC:2F:71:3E:C5:1F,3226462,407481911,11398,1394250,3215064,406087661,6,48660,4074968,40211,3073832,8449,1001136,12018,34,16362,186,6,826,130000.0,39000.0,-69.0,-71.0,-68.0,-60.0,-68.0,-70.0,-67.0,-60.0,-79.0,-87.0,-79.0,-87.0,10.0,16.0,11.0,27.0,1
3843,CC:2F:71:3F:1F:24,8783109,8904868465,5568045,8498780804,3215064,406087661,80,1296707,795607541,1288168,794582099,8539,1025442,1243507,619,5572764,570363,80,5826,130000.0,43333.0,-69.0,-64.0,-72.0,-68.0,-69.0,-64.0,-71.0,-68.0,-79.0,-87.0,-79.0,-87.0,10.0,23.0,7.0,19.0,1
3844,F8:59:71:5A:E0:3D,3352006,607145340,136937,201057215,3215069,406088125,0,135058,159577806,130248,159003048,4810,574758,112681,16,139651,2663,0,529,144444.0,43333.0,-66.0,-72.0,-65.0,-70.0,-66.0,-72.0,-64.0,-70.0,-79.0,-87.0,-79.0,-87.0,13.0,15.0,14.0,17.0,1
3845,CC:2F:71:3E:C5:1F,3226467,407482375,11398,1394250,3215069,406088125,6,48660,4074968,40211,3073832,8449,1001136,12018,34,16362,186,6,826,130000.0,39000.0,-69.0,-71.0,-68.0,-60.0,-68.0,-70.0,-67.0,-60.0,-79.0,-87.0,-79.0,-87.0,10.0,16.0,11.0,27.0,1
3846,CC:2F:71:3F:1F:24,8784296,8906692133,5569227,8500604008,3215069,406088125,80,1296943,795725861,1288404,794700419,8539,1025442,1243742,619,5573941,570473,80,5827,130000.0,43333.0,-69.0,-64.0,-72.0,-68.0,-68.0,-64.0,-71.0,-68.0,-79.0,-87.0,-79.0,-87.0,10.0,23.0,7.0,19.0,1
3847,F8:59:71:5A:E0:3D,3352075,607246754,137002,201158225,3215073,406088529,0,135122,159676366,130312,159101608,4810,574758,112745,16,139716,2664,0,529,144444.0,43333.0,-67.0,-72.0,-65.0,-70.0,-66.0,-71.0,-64.0,-70.0,-79.0,-87.0,-79.0,-87.0,12.0,15.0,14.0,17.0,1
3848,CC:2F:71:3E:C5:1F,3226471,407482779,11398,1394250,3215073,406088529,6,48660,4074968,40211,3073832,8449,1001136,12018,34,16362,186,6,826,130000.0,39000.0,-69.0,-71.0,-68.0,-60.0,-68.0,-70.0,-67.0,-60.0,-79.0,-87.0,-79.0,-87.0,10.0,16.0,11.0,27.0,1
3849,CC:2F:71:3F:1F:24,8785844,8909087425,5570771,8502998896,3215073,406088529,80,1297202,795848349,1288663,794822907,8539,1025442,1244001,619,5575481,570595,80,5827,130000.0,43333.0,-69.0,-64.0,-72.0,-69.0,-69.0,-64.0,-71.0,-68.0,-79.0,-87.0,-79.0,-87.0,10.0,23.0,7.0,18.0,1
3850,F8:59:71:5A:E0:3D,3352144,607348168,137067,201259235,3215077,406088933,0,135189,159779574,130379,159204816,4810,574758,112810,16,139781,2664,0,529,144444.0,43333.0,-66.0,-72.0,-65.0,-71.0,-66.0,-71.0,-64.0,-70.0,-79.0,-87.0,-79.0,-87.0,13.0,15.0,14.0,16.0,1
3851,CC:2F:71:3E:C5:1F,3226475,407483183,11398,1394250,3215077,406088933,6,48660,4074968,40211,3073832,8449,1001136,12018,34,16362,186,6,826,130000.0,39000.0,-69.0,-71.0,-68.0,-60.0,-68.0,-70.0,-67.0,-60.0,-79.0,-87.0,-79.0,-87.0,10.0,16.0,11.0,27.0,1
3852,CC:2F:71:3F:1F:24,8787058,8910948045,5571981,8504859112,3215077,406088933,80,1297471,795973748,1288932,794948306,8539,1025442,1244270,619,5576700,570605,80,5827,130000.0,43333.0,-70.0,-64.0,-72.0,-68.0,-70.0,-64.0,-71.0,-68.0,-79.0,-87.0,-79.0,-87.0,9.0,23.0,7.0,19.0,1
3853,F8:59:71:5A:E0:3D,3352214,607449642,137132,201360245,3215082,406089397,0,135254,159879674,130444,159304916,4810,574758,112875,16,139846,2665,0,529,144444.0,43333.0,-66.0,-72.0,-65.0,-70.0,-66.0,-72.0,-64.0,-70.0,-79.0,-87.0,-79.0,-87.0,13.0,15.0,14.0,17.0,1
3854,CC:2F:71:3E:C5:1F,3226480,407483647,11398,1394250,3215082,406089397,6,48660,4074968,40211,3073832,8449,1001136,12018,34,16362,186,6,826,130000.0,39000.0,-69.0,-71.0,-68.0,-60.0,-68.0,-70.0,-67.0,-60.0,-79.0,-87.0,-79.0,-87.0,10.0,16.0,11.0,27.0,1
3855,CC:2F:71:3F:1F:24,8788579,8913300165,5573497,8507210768,3215082,406089397,80,1297734,796098104,1289195,795072662,8539,1025442,1244533,619,5578180,570712,80,5827,130000.0,43333.0,-70.0,-65.0,-73.0,-68.0,-69.0,-64.0,-71.0,-68.0,-79.0,-87.0,-79.0,-87.0,9.0,22.0,6.0,19.0,1
3856,F8:59:71:5A:E0:3D,3352281,607547948,137195,201458147,3215086,406089801,0,135318,159978262,130508,159403504,4810,574758,112939,16,139909,2665,0,529,144444.0,43333.0,-66.0,-72.0,-66.0,-71.0,-66.0,-72.0,-65.0,-70.0,-79.0,-87.0,-79.0,-87.0,13.0,15.0,13.0,16.0,1
3857,CC:2F:71:3E:C5:1F,3226484,407484051,11398,1394250,3215086,406089801,6,48660,4074968,40211,3073832,8449,1001136,12018,34,16362,186,6,826,130000.0,39000.0,-69.0,-71.0,-68.0,-60.0,-68.0,-70.0,-67.0,-60.0,-79.0,-87.0,-79.0,-87.0,10.0,16.0,11.0,27.0,1
3858,CC:2F:71:3F:1F:24,8789929,8915384245,5574843,8509294444,3215086,406089801,80,1297977,796220304,1289438,795194862,8539,1025442,1244775,619,5579562,570889,80,5827,130000.0,39000.0,-69.0,-64.0,-71.0,-68.0,-69.0,-64.0,-71.0,-68.0,-79.0,-87.0,-79.0,-87.0,10.0,23.0,8.0,19.0,1
3859,F8:59:71:5A:E0:3D,3352351,607649635,137260,201559157,3215091,406090478,0,135383,160078362,130573,159503604,4810,574758,113004,16,139974,2667,0,529,144444.0,43333.0,-66.0,-72.0,-65.0,-71.0,-66.0,-71.0,-65.0,-70.0,-79.0,-87.0,-79.0,-87.0,13.0,15.0,14.0,16.0,1
3860,CC:2F:71:3E:C5:1F,3226490,407484788,11398,1394250,3215092,406090538,6,48660,4074968,40211,3073832,8449,1001136,12018,34,16362,186,6,826,130000.0,39000.0,-69.0,-71.0,-68.0,-60.0,-68.0,-70.0,-67.0,-60.0,-79.0,-87.0,-79.0,-87.0,10.0,16.0,11.0,27.0,1
3861,CC:2F:71:3F:1F:24,8790917,8916895850,5575825,8510805312,3215092,406090538,80,1298244,796343712,1289705,795318270,8539,1025442,1245042,619,5580544,570915,80,5827,130000.0,43333.0,-69.0,-64.0,-72.0,-68.0,-69.0,-64.0,-71.0,-68.0,-79.0,-87.0,-79.0,-87.0,10.0,23.0,7.0,19.0,1
3862,F8:59:71:5A:E0:3D,3352417,607747799,137323,201657059,3215094,406090740,0,135445,160173842,130635,159599084,4810,574758,113066,16,140037,2667,0,529,144444.0,43333.0,-66.0,-72.0,-65.0,-71.0,-66.0,-72.0,-65.0,-71.0,-79.0,-87.0,-79.0,-87.0,13.0,15.0,14.0,16.0,1
3863,CC:2F:71:3E:C5:1F,3226492,407484990,11398,1394250,3215094,406090740,6,48660,4074968,40211,3073832,8449,1001136,12018,34,16362,186,6,826,130000.0,39000.0,-69.0,-71.0,-68.0,-60.0,-68.0,-70.0,-67.0,-60.0,-79.0,-87.0,-79.0,-87.0,10.0,16.0,11.0,27.0,1
3864,CC:2F:71:3F:1F:24,8791944,8918461408,5576848,8512370466,3215096,406090942,80,1298511,796466037,1289972,795440595,8539,1025442,1245308,619,5581567,570940,80,5827,130000.0,43333.0,-69.0,-64.0,-71.0,-67.0,-69.0,-64.0,-71.0,-67.0,-79.0,-87.0,-79.0,-87.0,10.0,23.0,8.0,20.0,1
3865,F8:59:71:5A:E0:3D,3352486,607846139,137386,201754793,3215100,406091346,0,135510,160273956,130700,159699198,4810,574758,113130,16,140100,2668,0,529,144444.0,43333.0,-66.0,-72.0,-65.0,-71.0,-66.0,-71.0,-64.0,-70.0,-79.0,-87.0,-79.0,-87.0,13.0,15.0,14.0,16.0,1
3866,CC:2F:71:3E:C5:1F,3226498,407485596,11398,1394250,3215100,406091346,6,48660,4074968,40211,3073832,8449,1001136,12018,34,16362,186,6,826,130000.0,39000.0,-69.0,-71.0,-68.0,-60.0,-68.0,-70.0,-67.0,-60.0,-79.0,-87.0,-79.0,-87.0,10.0,16.0,11.0,27.0,1
3867,CC:2F:71:3F:1F:24,8793215,8920420842,5578115,8514329496,3215100,406091346,80,1298776,796587677,1290237,795562235,8539,1025442,1245573,619,5582834,571019,80,5827,130000.0,43333.0,-69.0,-64.0,-71.0,-68.0,-69.0,-64.0,-71.0,-68.0,-79.0,-87.0,-79.0,-87.0,10.0,23.0,8.0,19.0,1
3868,F8:59:71:5A:E0:3D,3352551,607942749,137448,201851141,3215103,406091608,0,135574,160372544,130764,159797786,4810,574758,113192,16,140162,2669,0,529,144444.0,43333.0,-66.0,-72.0,-65.0,-71.0,-66.0,-72.0,-64.0,-70.0,-79.0,-87.0,-79.0,-87.0,13.0,15.0,14.0,16.0,1
3869,CC:2F:71:3E:C5:1F,3226501,407485858,11398,1394250,3215103,406091608,6,48660,4074968,40211,3073832,8449,1001136,12018,34,16362,186,6,826,130000.0,39000.0,-69.0,-71.0,-68.0,-60.0,-68.0,-70.0,-67.0,-60.0,-79.0,-87.0,-79.0,-87.0,10.0,16.0,11.0,27.0,1
3870,CC:2F:71:3F:1F:24,8794957,8923123702,5579854,8517032094,3215103,406091608,80,1299075,796713193,1290536,795687751,8539,1025442,1245872,619,5584573,571059,80,5827,130000.0,43333.0,-69.0,-64.0,-71.0,-68.0,-69.0,-64.0,-71.0,-67.0,-79.0,-87.0,-79.0,-87.0,10.0,23.0,8.0,19.0,1
3871,F8:59:71:5A:E0:3D,3352619,608042609,137512,201950597,3215107,406092012,0,135638,160471104,130828,159896346,4810,574758,113256,16,140226,2669,0,529,144444.0,43333.0,-66.0,-72.0,-64.0,-71.0,-65.0,-71.0,-64.0,-70.0,-79.0,-87.0,-79.0,-87.0,13.0,15.0,15.0,16.0,1
3872,CC:2F:71:3E:C5:1F,3226507,407486464,11398,1394250,3215109,406092214,6,48660,4074968,40211,3073832,8449,1001136,12018,34,16362,186,6,826,130000.0,39000.0,-69.0,-71.0,-68.0,-60.0,-68.0,-70.0,-67.0,-60.0,-79.0,-87.0,-79.0,-87.0,10.0,16.0,11.0,27.0,1
3873,CC:2F:71:3F:1F:24,8796377,8925313560,5581268,8519221346,3215109,406092214,80,1299330,796835437,1290791,795809995,8539,1025442,1246127,619,5585987,571482,80,5827,130000.0,43333.0,-70.0,-64.0,-72.0,-68.0,-69.0,-64.0,-71.0,-68.0,-79.0,-87.0,-79.0,-87.0,9.0,23.0,7.0,19.0,1
3874,F8:59:71:5A:E0:3D,3352687,608141197,137576,202048615,3215111,406092582,0,135701,160568124,130891,159993366,4810,574758,113319,16,140290,2672,0,529,144444.0,43333.0,-66.0,-72.0,-65.0,-70.0,-66.0,-71.0,-64.0,-70.0,-79.0,-87.0,-79.0,-87.0,13.0,15.0,14.0,17.0,1
3875,CC:2F:71:3E:C5:1F,3226510,407486948,11399,1394366,3215111,406092582,6,48662,4075108,40213,3073972,8449,1001136,12018,34,16363,186,6,826,130000.0,39000.0,-68.0,-71.0,-67.0,-60.0,-68.0,-70.0,-67.0,-60.0,-79.0,-87.0,-79.0,-87.0,11.0,16.0,12.0,27.0,1
3876,CC:2F:71:3F:1F:24,8797794,8927491856,5582681,8521399072,3215113,406092784,80,1299576,796958428,1291037,795932986,8539,1025442,1246373,619,5587359,571535,80,5827,130000.0,43333.0,-70.0,-64.0,-72.0,-70.0,-69.0,-63.0,-71.0,-69.0,-79.0,-87.0,-79.0,-87.0,9.0,23.0,7.0,17.0,1
3877,F8:59:71:5A:E0:3D,3352760,608244427,137642,202151179,3215118,406093248,0,135766,160668224,130956,160093466,4810,574758,113384,16,140356,2672,0,529,144444.0,43333.0,-66.0,-72.0,-65.0,-71.0,-66.0,-71.0,-64.0,-70.0,-79.0,-87.0,-79.0,-87.0,13.0,15.0,14.0,16.0,1
3878,CC:2F:71:3E:C5:1F,3226517,407487614,11399,1394366,3215118,406093248,6,48662,4075108,40213,3073972,8449,1001136,12018,34,16363,186,6,826,130000.0,39000.0,-68.0,-71.0,-67.0,-60.0,-68.0,-70.0,-67.0,-60.0,-79.0,-87.0,-79.0,-87.0,11.0,16.0,12.0,27.0,1
3879,CC:2F:71:3F:1F:24,8799411,8929992838,5584291,8523899388,3215120,406093450,80,1299850,797079820,1291311,796054378,8539,1025442,1246646,619,5589010,571598,80,5827,144444.0,43333.0,-69.0,-63.0,-71.0,-70.0,-68.0,-63.0,-71.0,-69.0,-79.0,-87.0,-79.0,-87.0,10.0,24.0,8.0,17.0,1
3880,F8:59:71:5A:E0:3D,3352825,608342531,137705,202249081,3215120,406093450,0,135829,160765244,131019,160190486,4810,574758,113447,16,140419,2672,0,529,144444.0,43333.0,-66.0,-72.0,-65.0,-71.0,-66.0,-72.0,-65.0,-71.0,-79.0,-87.0,-79.0,-87.0,13.0,15.0,14.0,16.0,1
3881,CC:2F:71:3E:C5:1F,3226519,407487816,11399,1394366,3215120,406093450,6,48662,4075108,40213,3073972,8449,1001136,12018,34,16363,186,6,826,130000.0,39000.0,-68.0,-71.0,-67.0,-60.0,-68.0,-70.0,-67.0,-60.0,-79.0,-87.0,-79.0,-87.0,11.0,16.0,12.0,27.0,1
3882,CC:2F:71:3F:1F:24,8800667,8931932982,5585547,8525839532,3215120,406093450,80,1300111,797201106,1291572,796175664,8539,1025442,1246907,619,5590257,571772,80,5828,130000.0,43333.0,-69.0,-63.0,-72.0,-70.0,-69.0,-63.0,-71.0,-70.0,-79.0,-87.0,-79.0,-87.0,10.0,24.0,7.0,17.0,1
3883,F8:59:71:5A:E0:3D,3352892,608440837,137768,202346983,3215124,406093854,0,135892,160862264,131082,160287506,4810,574758,113510,16,140482,2672,0,529,144444.0,43333.0,-66.0,-72.0,-65.0,-70.0,-66.0,-72.0,-65.0,-70.0,-79.0,-87.0,-79.0,-87.0,13.0,15.0,14.0,17.0,1
3884,CC:2F:71:3E:C5:1F,3226523,407488220,11399,1394366,3215124,406093854,6,48662,4075108,40213,3073972,8449,1001136,12018,34,16363,186,6,826,130000.0,39000.0,-68.0,-71.0,-67.0,-60.0,-68.0,-70.0,-67.0,-60.0,-79.0,-87.0,-79.0,-87.0,11.0,16.0,12.0,27.0,1
3885,CC:2F:71:3F:1F:24,8801948,8933905442,5586822,8527811386,3215126,406094056,80,1300381,797324670,1291842,796299228,8539,1025442,1247177,619,5591541,571815,80,5828,130000.0,43333.0,-70.0,-63.0,-72.0,-69.0,-69.0,-63.0,-72.0,-69.0,-79.0,-87.0,-79.0,-87.0,9.0,24.0,7.0,18.0,1
3886,F8:59:71:5A:E0:3D,3352961,608539265,137831,202444885,3215130,406094380,0,135956,160959402,131145,160384526,4811,574876,113574,16,140545,2672,0,529,144444.0,43333.0,-66.0,-71.0,-65.0,-70.0,-66.0,-71.0,-65.0,-70.0,-79.0,-87.0,-79.0,-87.0,13.0,16.0,14.0,17.0,1
3887,CC:2F:71:3E:C5:1F,3226529,407488746,11399,1394366,3215130,406094380,6,48662,4075108,40213,3073972,8449,1001136,12018,34,16363,186,6,826,130000.0,39000.0,-68.0,-71.0,-67.0,-60.0,-68.0,-70.0,-67.0,-60.0,-79.0,-87.0,-79.0,-87.0,11.0,16.0,12.0,27.0,1
3888,CC:2F:71:3F:1F:24,8803399,8936142139,5588269,8530047759,3215130,406094380,80,1300645,797446666,1292106,796421224,8539,1025442,1247441,619,5592988,571978,80,5828,130000.0,43333.0,-69.0,-64.0,-72.0,-69.0,-69.0,-63.0,-72.0,-69.0,-79.0,-87.0,-79.0,-87.0,10.0,23.0,7.0,18.0,1
3889,F8:59:71:5A:E0:3D,3353028,608637571,137894,202542787,3215134,406094784,0,136019,161056422,131208,160481546,4811,574876,113637,16,140608,2673,0,529,144444.0,43333.0,-66.0,-71.0,-65.0,-70.0,-66.0,-71.0,-64.0,-70.0,-79.0,-87.0,-79.0,-87.0,13.0,16.0,14.0,17.0,1
3890,CC:2F:71:3E:C5:1F,3226533,407489150,11399,1394366,3215134,406094784,6,48662,4075108,40213,3073972,8449,1001136,12018,34,16363,186,6,826,130000.0,39000.0,-68.0,-71.0,-67.0,-60.0,-68.0,-70.0,-67.0,-60.0,-79.0,-87.0,-79.0,-87.0,11.0,16.0,12.0,27.0,1
3891,CC:2F:71:3F:1F:24,8804831,8938351564,5589697,8532256780,3215134,406094784,80,1300924,797569862,1292385,796544420,8539,1025442,1247720,619,5594388,572087,80,5828,130000.0,43333.0,-70.0,-64.0,-71.0,-67.0,-70.0,-64.0,-72.0,-68.0,-79.0,-87.0,-79.0,-87.0,9.0,23.0,8.0,20.0,1
3892,F8:59:71:5A:E0:3D,3353095,608735877,137957,202640689,3215138,406095188,0,136084,161156564,131273,160581688,4811,574876,113701,16,140671,2673,0,530,144444.0,43333.0,-66.0,-71.0,-65.0,-71.0,-66.0,-71.0,-65.0,-70.0,-79.0,-87.0,-79.0,-87.0,13.0,16.0,14.0,16.0,1
3893,CC:2F:71:3E:C5:1F,3226537,407489554,11399,1394366,3215138,406095188,6,48662,4075108,40213,3073972,8449,1001136,12018,34,16363,186,6,826,130000.0,39000.0,-68.0,-71.0,-67.0,-60.0,-68.0,-70.0,-67.0,-60.0,-79.0,-87.0,-79.0,-87.0,11.0,16.0,12.0,27.0,1
3894,CC:2F:71:3F:1F:24,8806520,8940970826,5591382,8534875638,3215138,406095188,80,1301187,797691202,1292648,796665760,8539,1025442,1247983,619,5596096,572177,80,5828,130000.0,43333.0,-70.0,-64.0,-71.0,-68.0,-70.0,-64.0,-72.0,-67.0,-79.0,-87.0,-79.0,-87.0,9.0,23.0,8.0,19.0,1
3895,F8:59:71:5A:E0:3D,3353191,608854415,138026,202747915,3215165,406106500,0,136153,161262838,131342,160687962,4811,574876,113769,16,140739,2673,0,530,144444.0,43333.0,-66.0,-71.0,-65.0,-70.0,-65.0,-71.0,-65.0,-70.0,-78.0,-87.0,-78.0,-87.0,12.0,16.0,13.0,17.0,1
3896,CC:2F:71:3E:C5:1F,3226564,407500866,11399,1394366,3215165,406106500,6,48662,4075108,40213,3073972,8449,1001136,12018,34,16363,186,6,826,130000.0,39000.0,-68.0,-71.0,-67.0,-60.0,-68.0,-70.0,-67.0,-60.0,-78.0,-87.0,-78.0,-87.0,10.0,16.0,11.0,27.0,1
3897,CC:2F:71:3F:1F:24,8807438,8942346000,5592273,8536239500,3215165,406106500,80,1301390,797813038,1292851,796787596,8539,1025442,1248186,619,5596992,572254,80,5828,130000.0,43333.0,-70.0,-64.0,-72.0,-68.0,-70.0,-64.0,-71.0,-68.0,-78.0,-87.0,-78.0,-87.0,8.0,23.0,6.0,19.0,1
3898,F8:59:71:5A:E0:3D,3353257,608951167,138088,202844263,3215169,406106904,0,136216,161359858,131405,160784982,4811,574876,113832,16,140802,2674,0,530,144444.0,43333.0,-66.0,-71.0,-65.0,-71.0,-66.0,-71.0,-64.0,-70.0,-78.0,-87.0,-78.0,-87.0,12.0,16.0,13.0,16.0,1
3899,CC:2F:71:3E:C5:1F,3226568,407501270,11399,1394366,3215169,406106904,6,48662,4075108,40213,3073972,8449,1001136,12018,34,16363,186,6,826,130000.0,39000.0,-68.0,-71.0,-67.0,-60.0,-68.0,-70.0,-67.0,-60.0,-78.0,-87.0,-78.0,-87.0,10.0,16.0,11.0,27.0,1
3900,CC:2F:71:3F:1F:24,8808176,8943463112,5593007,8537356208,3215169,406106904,80,1301585,797928004,1293046,796902562,8539,1025442,1248381,619,5597726,572280,80,5828,130000.0,43333.0,-71.0,-64.0,-71.0,-68.0,-70.0,-64.0,-72.0,-68.0,-78.0,-87.0,-78.0,-87.0,7.0,23.0,7.0,19.0,1
3901,F8:59:71:5A:E0:3D,3353324,609051098,138152,202943719,3215172,406107379,0,136279,161456878,131468,160882002,4811,574876,113895,16,140866,2674,0,530,144444.0,43333.0,-66.0,-71.0,-65.0,-70.0,-65.0,-71.0,-65.0,-70.0,-78.0,-87.0,-78.0,-87.0,12.0,16.0,13.0,17.0,1
3902,CC:2F:71:3E:C5:1F,3226571,407501745,11399,1394366,3215172,406107379,6,48662,4075108,40213,3073972,8449,1001136,12018,34,16363,186,6,826,130000.0,39000.0,-68.0,-71.0,-67.0,-60.0,-68.0,-70.0,-67.0,-60.0,-78.0,-87.0,-78.0,-87.0,10.0,16.0,11.0,27.0,1
3903,CC:2F:71:3F:1F:24,8809283,8945156583,5594111,8539049204,3215172,406107379,80,1301864,798050267,1293325,797024825,8539,1025442,1248660,619,5598811,572298,80,5828,130000.0,43333.0,-71.0,-64.0,-74.0,-68.0,-70.0,-64.0,-72.0,-68.0,-78.0,-87.0,-78.0,-87.0,7.0,23.0,4.0,19.0,1
3904,F8:59:71:5A:E0:3D,3353394,609149666,138215,203041621,3215179,406108045,0,136342,161553898,131531,160979022,4811,574876,113958,16,140929,2675,0,530,144444.0,43333.0,-67.0,-72.0,-66.0,-71.0,-66.0,-72.0,-65.0,-70.0,-78.0,-87.0,-78.0,-87.0,11.0,15.0,12.0,16.0,1
3905,CC:2F:71:3E:C5:1F,3226578,407502411,11399,1394366,3215179,406108045,6,48662,4075108,40213,3073972,8449,1001136,12018,34,16363,186,6,826,130000.0,39000.0,-68.0,-71.0,-67.0,-60.0,-68.0,-70.0,-67.0,-60.0,-78.0,-87.0,-78.0,-87.0,10.0,16.0,11.0,27.0,1
3906,CC:2F:71:3F:1F:24,8810429,8946912711,5595250,8540804666,3215179,406108045,80,1302082,798167971,1293543,797142529,8539,1025442,1248878,619,5599968,572435,80,5828,117000.0,39000.0,-70.0,-64.0,-72.0,-68.0,-70.0,-64.0,-72.0,-68.0,-78.0,-87.0,-78.0,-87.0,8.0,23.0,6.0,19.0,1
3907,F8:59:71:5A:E0:3D,3353460,609248441,138279,203140194,3215181,406108247,0,136407,161652608,131596,161077732,4811,574876,114023,16,140993,2676,0,530,144444.0,43333.0,-67.0,-72.0,-65.0,-71.0,-66.0,-72.0,-65.0,-71.0,-78.0,-87.0,-78.0,-87.0,11.0,15.0,13.0,16.0,1
3908,CC:2F:71:3E:C5:1F,3226580,407502613,11399,1394366,3215181,406108247,6,48662,4075108,40213,3073972,8449,1001136,12018,34,16363,186,6,826,130000.0,39000.0,-68.0,-71.0,-67.0,-60.0,-68.0,-70.0,-67.0,-60.0,-78.0,-87.0,-78.0,-87.0,10.0,16.0,11.0,27.0,1
3909,CC:2F:71:3F:1F:24,8811827,8949068919,5596646,8542960672,3215181,406108247,80,1302376,798294658,1293837,797269216,8539,1025442,1249172,619,5601365,572532,80,5829,130000.0,43333.0,-70.0,-64.0,-72.0,-69.0,-70.0,-64.0,-72.0,-68.0,-78.0,-87.0,-78.0,-87.0,8.0,23.0,6.0,18.0,1
3910,F8:59:71:5A:E0:3D,3353530,609348503,138343,203239650,3215187,406108853,0,136471,161751168,131660,161176292,4811,574876,114087,16,141057,2676,0,530,144444.0,43333.0,-66.0,-72.0,-65.0,-71.0,-66.0,-71.0,-65.0,-70.0,-78.0,-87.0,-78.0,-87.0,12.0,15.0,13.0,16.0,1
3911,CC:2F:71:3E:C5:1F,3226587,407503279,11399,1394366,3215188,406108913,6,48662,4075108,40213,3073972,8449,1001136,12018,34,16363,186,6,826,130000.0,39000.0,-68.0,-71.0,-67.0,-60.0,-68.0,-70.0,-67.0,-60.0,-78.0,-87.0,-78.0,-87.0,10.0,16.0,11.0,27.0,1
3912,CC:2F:71:3F:1F:24,8813035,8950923195,5597847,8544814282,3215188,406108913,80,1302605,798413566,1294066,797388124,8539,1025442,1249401,619,5602566,572645,80,5829,130000.0,43333.0,-70.0,-64.0,-73.0,-69.0,-70.0,-64.0,-72.0,-68.0,-78.0,-87.0,-78.0,-87.0,8.0,23.0,5.0,18.0,1
3913,F8:59:71:5A:E0:3D,3353596,609448081,138407,203339106,3215189,406108975,0,136535,161849728,131724,161274852,4811,574876,114151,16,141121,2676,0,530,144444.0,43333.0,-67.0,-72.0,-65.0,-71.0,-66.0,-72.0,-65.0,-70.0,-78.0,-87.0,-78.0,-87.0,11.0,15.0,13.0,16.0,1
3914,CC:2F:71:3E:C5:1F,3226588,407503341,11399,1394366,3215189,406108975,6,48664,4075296,40214,3074042,8450,1001254,12019,34,16363,186,6,826,130000.0,39000.0,-69.0,-71.0,-68.0,-60.0,-68.0,-70.0,-67.0,-60.0,-78.0,-87.0,-78.0,-87.0,9.0,16.0,10.0,27.0,1
3915,CC:2F:71:3F:1F:24,8814212,8952729645,5599023,8546620670,3215189,406108975,80,1302853,798533805,1294314,797508363,8539,1025442,1249649,619,5603742,572739,80,5829,130000.0,43333.0,-70.0,-64.0,-72.0,-69.0,-70.0,-64.0,-72.0,-68.0,-78.0,-87.0,-78.0,-87.0,8.0,23.0,6.0,18.0,1
3916,F8:59:71:5A:E0:3D,3353664,609545011,138470,203435570,3215194,406109441,0,136598,161945314,131787,161370438,4811,574876,114214,16,141184,2677,0,530,144444.0,43333.0,-66.0,-72.0,-65.0,-71.0,-66.0,-72.0,-65.0,-71.0,-78.0,-87.0,-78.0,-87.0,12.0,15.0,13.0,16.0,1
3917,CC:2F:71:3E:C5:1F,3226595,407504009,11399,1394366,3215196,406109643,6,48664,4075296,40214,3074042,8450,1001254,12019,34,16363,186,6,826,130000.0,39000.0,-69.0,-71.0,-68.0,-60.0,-68.0,-70.0,-67.0,-60.0,-78.0,-87.0,-78.0,-87.0,9.0,16.0,10.0,27.0,1
3918,CC:2F:71:3F:1F:24,8815422,8954582663,5600224,8548472818,3215198,406109845,80,1303085,798653121,1294545,797627561,8540,1025560,1249881,619,5604943,572774,80,5830,130000.0,43333.0,-71.0,-64.0,-73.0,-69.0,-70.0,-64.0,-72.0,-68.0,-78.0,-87.0,-78.0,-87.0,7.0,23.0,5.0,18.0,1
3919,F8:59:71:5A:E0:3D,3353734,609646485,138535,203536580,3215199,406109905,0,136664,162046982,131853,161472106,4811,574876,114278,16,141249,2677,0,530,144444.0,43333.0,-66.0,-71.0,-65.0,-70.0,-65.0,-71.0,-65.0,-70.0,-78.0,-87.0,-78.0,-87.0,12.0,16.0,13.0,17.0,1
3920,CC:2F:71:3E:C5:1F,3226598,407504271,11399,1394366,3215199,406109905,6,48664,4075296,40214,3074042,8450,1001254,12019,34,16363,186,6,826,130000.0,39000.0,-69.0,-71.0,-68.0,-60.0,-68.0,-70.0,-67.0,-60.0,-78.0,-87.0,-78.0,-87.0,9.0,16.0,10.0,27.0,1
3921,CC:2F:71:3F:1F:24,8816863,8956814811,5601664,8550704906,3215199,406109905,80,1303328,798773761,1294788,797748201,8540,1025560,1250124,619,5606383,572911,80,5832,117000.0,39000.0,-71.0,-64.0,-73.0,-68.0,-70.0,-64.0,-72.0,-68.0,-78.0,-87.0,-78.0,-87.0,7.0,23.0,5.0,19.0,1
3922,F8:59:71:5A:E0:3D,3353802,609746345,138599,203636036,3215203,406110309,0,136730,162148636,131919,161573760,4811,574876,114343,16,141313,2679,0,530,144444.0,43333.0,-66.0,-72.0,-66.0,-71.0,-66.0,-72.0,-65.0,-71.0,-78.0,-87.0,-78.0,-87.0,12.0,15.0,12.0,16.0,1
3923,CC:2F:71:3E:C5:1F,3226602,407504675,11399,1394366,3215203,406110309,6,48664,4075296,40214,3074042,8450,1001254,12019,34,16363,186,6,826,130000.0,39000.0,-69.0,-71.0,-68.0,-60.0,-68.0,-70.0,-67.0,-60.0,-78.0,-87.0,-78.0,-87.0,9.0,16.0,10.0,27.0,1
3924,CC:2F:71:3F:1F:24,8818217,8958902353,5603012,8552791842,3215205,406110511,80,1303598,798894705,1295058,797869145,8540,1025560,1250394,619,5607717,572938,80,5832,130000.0,43333.0,-69.0,-64.0,-72.0,-68.0,-70.0,-64.0,-72.0,-68.0,-78.0,-87.0,-78.0,-87.0,9.0,23.0,6.0,19.0,1
3925,F8:59:71:5A:E0:3D,3353870,609846205,138663,203735492,3215207,406110713,0,136793,162245656,131982,161670780,4811,574876,114406,16,141377,2679,0,530,144444.0,43333.0,-67.0,-72.0,-66.0,-71.0,-66.0,-71.0,-65.0,-70.0,-78.0,-87.0,-78.0,-87.0,11.0,15.0,12.0,16.0,1
3926,CC:2F:71:3E:C5:1F,3226606,407505079,11399,1394366,3215207,406110713,6,48664,4075296,40214,3074042,8450,1001254,12019,34,16363,186,6,826,130000.0,39000.0,-69.0,-71.0,-68.0,-60.0,-68.0,-70.0,-67.0,-60.0,-78.0,-87.0,-78.0,-87.0,9.0,16.0,10.0,27.0,1
3927,CC:2F:71:3F:1F:24,8819665,8961136675,5604458,8555025962,3215207,406110713,80,1303916,799028684,1295376,798003124,8540,1025560,1250712,619,5609144,573015,80,5832,130000.0,43333.0,-70.0,-64.0,-72.0,-68.0,-69.0,-63.0,-71.0,-67.0,-78.0,-87.0,-78.0,-87.0,8.0,23.0,6.0,19.0,1
3928,F8:59:71:5A:E0:3D,3353940,609950585,138730,203839610,3215210,406110975,0,136860,162348836,132049,161773960,4811,574876,114473,16,141444,2681,0,530,144444.0,43333.0,-66.0,-72.0,-66.0,-71.0,-66.0,-72.0,-65.0,-70.0,-78.0,-87.0,-78.0,-87.0,12.0,15.0,12.0,16.0,1
3929,CC:2F:71:3E:C5:1F,3226609,407505341,11399,1394366,3215210,406110975,6,48664,4075296,40214,3074042,8450,1001254,12019,34,16363,186,6,826,130000.0,39000.0,-69.0,-71.0,-68.0,-60.0,-68.0,-70.0,-67.0,-60.0,-78.0,-87.0,-78.0,-87.0,9.0,16.0,10.0,27.0,1
3930,CC:2F:71:3F:1F:24,8821226,8963552123,5606014,8557440946,3215212,406111177,80,1304178,799155824,1295638,798130264,8540,1025560,1250974,619,5610733,573111,80,5834,130000.0,43333.0,-70.0,-64.0,-72.0,-69.0,-70.0,-64.0,-72.0,-68.0,-78.0,-87.0,-78.0,-87.0,8.0,23.0,6.0,18.0,1
3931,F8:59:71:5A:E0:3D,3354013,610052433,138797,203940852,3215216,406111581,0,136928,162450702,132117,161875826,4811,574876,114540,16,141511,2681,0,530,144444.0,43333.0,-66.0,-72.0,-65.0,-71.0,-66.0,-72.0,-65.0,-70.0,-78.0,-87.0,-78.0,-87.0,12.0,15.0,13.0,16.0,1
3932,CC:2F:71:3E:C5:1F,3226615,407505947,11399,1394366,3215216,406111581,6,48664,4075296,40214,3074042,8450,1001254,12019,34,16363,186,6,826,130000.0,39000.0,-69.0,-71.0,-68.0,-60.0,-68.0,-70.0,-67.0,-60.0,-78.0,-87.0,-78.0,-87.0,9.0,16.0,10.0,27.0,1
3933,CC:2F:71:3F:1F:24,8822392,8965345843,5607176,8559234262,3215216,406111581,80,1304389,799272890,1295849,798247330,8540,1025560,1251185,619,5611895,573184,80,5834,130000.0,43333.0,-70.0,-64.0,-72.0,-69.0,-70.0,-64.0,-72.0,-69.0,-78.0,-87.0,-78.0,-87.0,8.0,23.0,6.0,18.0,1
3934,F8:59:71:5A:E0:3D,3354079,610151923,138861,204040140,3215218,406111783,0,136993,162550802,132182,161975926,4811,574876,114605,16,141575,2682,0,530,144444.0,43333.0,-67.0,-72.0,-65.0,-71.0,-66.0,-71.0,-65.0,-70.0,-78.0,-87.0,-78.0,-87.0,11.0,15.0,13.0,16.0,1
3935,CC:2F:71:3E:C5:1F,3226617,407506149,11399,1394366,3215218,406111783,6,48664,4075296,40214,3074042,8450,1001254,12019,34,16363,186,6,826,130000.0,39000.0,-69.0,-71.0,-68.0,-60.0,-68.0,-70.0,-67.0,-60.0,-78.0,-87.0,-78.0,-87.0,9.0,16.0,10.0,27.0,1
3936,CC:2F:71:3F:1F:24,8823589,8967190187,5608371,8561078404,3215218,406111783,80,1304615,799391362,1296075,798365802,8540,1025560,1251411,619,5613090,573222,80,5834,130000.0,43333.0,-70.0,-64.0,-71.0,-68.0,-69.0,-64.0,-72.0,-68.0,-78.0,-87.0,-78.0,-87.0,8.0,23.0,7.0,19.0,1
3937,F8:59:71:5A:E0:3D,3354152,610255153,138927,204142704,3215225,406112449,0,137059,162652484,132248,162077608,4811,574876,114671,16,141641,2682,0,530,144444.0,43333.0,-66.0,-72.0,-66.0,-71.0,-66.0,-71.0,-65.0,-70.0,-78.0,-87.0,-78.0,-87.0,12.0,15.0,12.0,16.0,1
3938,CC:2F:71:3E:C5:1F,3226624,407506815,11399,1394366,3215225,406112449,6,48664,4075296,40214,3074042,8450,1001254,12019,34,16363,186,6,826,130000.0,39000.0,-69.0,-71.0,-68.0,-60.0,-68.0,-70.0,-67.0,-60.0,-78.0,-87.0,-78.0,-87.0,9.0,16.0,10.0,27.0,1
3939,CC:2F:71:3F:1F:24,8825056,8969453021,5609831,8563340572,3215225,406112449,80,1304865,799514108,1296325,798488548,8540,1025560,1251661,619,5614550,573332,80,5834,130000.0,43333.0,-70.0,-64.0,-73.0,-68.0,-69.0,-63.0,-72.0,-68.0,-78.0,-87.0,-78.0,-87.0,8.0,23.0,5.0,19.0,1
3940,F8:59:71:5A:E0:3D,3354218,610354811,138991,204242160,3215227,406112651,0,137123,162751058,132312,162176182,4811,574876,114734,16,141705,2682,0,530,144444.0,43333.0,-66.0,-72.0,-65.0,-71.0,-66.0,-72.0,-65.0,-71.0,-78.0,-87.0,-78.0,-87.0,12.0,15.0,13.0,16.0,1
3941,CC:2F:71:3E:C5:1F,3226626,407507017,11399,1394366,3215227,406112651,6,48664,4075296,40214,3074042,8450,1001254,12019,34,16363,186,6,826,130000.0,39000.0,-69.0,-71.0,-68.0,-60.0,-68.0,-70.0,-67.0,-60.0,-78.0,-87.0,-78.0,-87.0,9.0,16.0,10.0,27.0,1
3942,CC:2F:71:3F:1F:24,8826019,8970920541,5610792,8564807890,3215227,406112651,80,1305050,799629894,1296510,798604334,8540,1025560,1251846,619,5615511,573448,80,5834,130000.0,43333.0,-69.0,-65.0,-72.0,-67.0,-69.0,-65.0,-71.0,-67.0,-78.0,-87.0,-78.0,-87.0,9.0,22.0,6.0,20.0,1
3943,F8:59:71:5A:E0:3D,3354290,610456700,139056,204343170,3215234,406113530,0,137189,162852712,132378,162277836,4811,574876,114799,16,141770,2683,0,530,144444.0,43333.0,-67.0,-73.0,-66.0,-71.0,-67.0,-72.0,-65.0,-70.0,-78.0,-87.0,-78.0,-87.0,11.0,14.0,12.0,16.0,1
3944,CC:2F:71:3E:C5:1F,3226633,407507896,11399,1394366,3215234,406113530,6,48664,4075296,40214,3074042,8450,1001254,12019,34,16363,186,6,826,130000.0,39000.0,-69.0,-71.0,-68.0,-60.0,-68.0,-70.0,-67.0,-60.0,-78.0,-87.0,-78.0,-87.0,9.0,16.0,10.0,27.0,1
3945,CC:2F:71:3F:1F:24,8827045,8972488802,5611811,8566375272,3215234,406113530,80,1305261,799745290,1296721,798719730,8540,1025560,1252057,619,5616530,573876,80,5834,104000.0,26000.0,-69.0,-64.0,-71.0,-69.0,-69.0,-64.0,-72.0,-69.0,-78.0,-87.0,-78.0,-87.0,9.0,23.0,7.0,18.0,1
3946,F8:59:71:5A:E0:3D,3354354,610554662,139119,204441072,3215235,406113590,0,137252,162949732,132441,162374856,4811,574876,114862,16,141833,2683,0,530,144444.0,43333.0,-67.0,-72.0,-65.0,-71.0,-67.0,-72.0,-65.0,-71.0,-78.0,-87.0,-78.0,-87.0,11.0,15.0,13.0,16.0,1
3947,CC:2F:71:3E:C5:1F,3226634,407507956,11399,1394366,3215235,406113590,6,48664,4075296,40214,3074042,8450,1001254,12019,34,16363,186,6,826,130000.0,39000.0,-69.0,-71.0,-68.0,-60.0,-68.0,-70.0,-67.0,-60.0,-78.0,-87.0,-78.0,-87.0,9.0,16.0,10.0,27.0,1
3948,CC:2F:71:3F:1F:24,8828039,8974012462,5612802,8567898670,3215237,406113792,80,1305530,799868826,1296990,798843266,8540,1025560,1252326,619,5617521,573930,80,5835,115556.0,28889.0,-68.0,-65.0,-72.0,-69.0,-68.0,-65.0,-72.0,-69.0,-78.0,-87.0,-78.0,-87.0,10.0,22.0,6.0,18.0,1
3949,F8:59:71:5A:E0:3D,3354425,610653372,139182,204538974,3215243,406114398,0,137315,163046752,132504,162471876,4811,574876,114925,16,141896,2684,0,530,144444.0,43333.0,-66.0,-71.0,-65.0,-70.0,-66.0,-71.0,-65.0,-70.0,-78.0,-87.0,-78.0,-87.0,12.0,16.0,13.0,17.0,1
3950,CC:2F:71:3E:C5:1F,3226642,407508764,11399,1394366,3215243,406114398,6,48664,4075296,40214,3074042,8450,1001254,12019,34,16363,186,6,826,130000.0,39000.0,-69.0,-71.0,-68.0,-60.0,-68.0,-70.0,-67.0,-60.0,-78.0,-87.0,-78.0,-87.0,9.0,16.0,10.0,27.0,1
3951,CC:2F:71:3F:1F:24,8829293,8975940564,5614050,8569826166,3215243,406114398,80,1305787,799989664,1297247,798964104,8540,1025560,1252583,619,5618769,574029,80,5835,130000.0,39000.0,-70.0,-64.0,-72.0,-67.0,-69.0,-64.0,-71.0,-67.0,-78.0,-87.0,-78.0,-87.0,8.0,23.0,6.0,20.0,1
3952,F8:59:71:5A:E0:3D,3354489,610752828,139246,204638430,3215243,406114398,0,137380,163146866,132569,162571990,4811,574876,114989,16,141960,2685,0,530,144444.0,43333.0,-66.0,-72.0,-66.0,-71.0,-66.0,-72.0,-65.0,-71.0,-78.0,-87.0,-78.0,-87.0,12.0,15.0,12.0,16.0,1
3953,CC:2F:71:3E:C5:1F,3226642,407508764,11399,1394366,3215243,406114398,6,48664,4075296,40214,3074042,8450,1001254,12019,34,16363,186,6,826,130000.0,39000.0,-69.0,-71.0,-68.0,-60.0,-68.0,-70.0,-67.0,-60.0,-78.0,-87.0,-78.0,-87.0,9.0,16.0,10.0,27.0,1
3954,CC:2F:71:3F:1F:24,8830360,8977576342,5615117,8571461944,3215243,406114398,80,1306028,800109069,1297488,799083509,8540,1025560,1252824,619,5619836,574106,80,5836,130000.0,43333.0,-70.0,-64.0,-72.0,-68.0,-70.0,-64.0,-72.0,-68.0,-78.0,-87.0,-78.0,-87.0,8.0,23.0,6.0,19.0,1
3955,F8:59:71:5A:E0:3D,3354558,610849842,139308,204734778,3215250,406115064,0,137443,163243942,132632,162669066,4811,574876,115052,16,142022,2685,0,530,144444.0,43333.0,-66.0,-72.0,-66.0,-71.0,-66.0,-72.0,-65.0,-71.0,-78.0,-87.0,-78.0,-87.0,12.0,15.0,12.0,16.0,1
3956,CC:2F:71:3E:C5:1F,3226649,407509430,11399,1394366,3215250,406115064,6,48664,4075296,40214,3074042,8450,1001254,12019,34,16363,186,6,826,130000.0,39000.0,-69.0,-71.0,-68.0,-60.0,-68.0,-70.0,-67.0,-60.0,-78.0,-87.0,-78.0,-87.0,9.0,16.0,10.0,27.0,1
3957,CC:2F:71:3F:1F:24,8831489,8979305946,5616237,8573190680,3215252,406115266,80,1306267,800227889,1297727,799202329,8540,1025560,1253063,619,5620956,574173,80,5837,130000.0,43333.0,-70.0,-64.0,-72.0,-68.0,-70.0,-64.0,-71.0,-68.0,-78.0,-87.0,-78.0,-87.0,8.0,23.0,6.0,19.0,1
3958,F8:59:71:5A:E0:3D,3354624,610948062,139372,204832796,3215252,406115266,0,137506,163340962,132695,162766086,4811,574876,115115,16,142086,2685,0,530,144444.0,43333.0,-67.0,-72.0,-65.0,-71.0,-66.0,-71.0,-65.0,-70.0,-78.0,-87.0,-78.0,-87.0,11.0,15.0,13.0,16.0,1
3959,CC:2F:71:3E:C5:1F,3226652,407509748,11400,1394482,3215252,406115266,6,48665,4075366,40215,3074112,8450,1001254,12019,34,16364,186,6,826,130000.0,39000.0,-69.0,-71.0,-68.0,-60.0,-68.0,-70.0,-67.0,-60.0,-78.0,-87.0,-78.0,-87.0,9.0,16.0,10.0,27.0,1
3960,CC:2F:71:3F:1F:24,8832443,8980768104,5617191,8574652838,3215252,406115266,80,1306485,800345457,1297945,799319897,8540,1025560,1253281,619,5621910,574272,80,5837,130000.0,43333.0,-70.0,-64.0,-72.0,-68.0,-69.0,-64.0,-71.0,-68.0,-78.0,-87.0,-78.0,-87.0,8.0,23.0,6.0,19.0,1
3961,F8:59:71:5A:E0:3D,3354693,611048038,139437,204932368,3215256,406115670,0,137572,163441224,132761,162866348,4811,574876,115180,16,142151,2685,0,531,144444.0,43333.0,-66.0,-71.0,-65.0,-70.0,-66.0,-71.0,-64.0,-70.0,-78.0,-87.0,-78.0,-87.0,12.0,16.0,13.0,17.0,1
3962,CC:2F:71:3E:C5:1F,3226659,407510414,11400,1394482,3215259,406115932,6,48666,4075436,40216,3074182,8450,1001254,12019,34,16364,186,6,826,130000.0,39000.0,-69.0,-71.0,-68.0,-60.0,-68.0,-70.0,-67.0,-60.0,-78.0,-87.0,-78.0,-87.0,9.0,16.0,10.0,27.0,1
3963,CC:2F:71:3F:1F:24,8833390,8982208980,5618131,8576093048,3215259,406115932,80,1306701,800462771,1298161,799437211,8540,1025560,1253497,619,5622850,574315,80,5837,117000.0,39000.0,-70.0,-64.0,-71.0,-68.0,-70.0,-64.0,-71.0,-67.0,-78.0,-87.0,-78.0,-87.0,8.0,23.0,7.0,19.0,1
3964,F8:59:71:5A:E0:3D,3354762,611147958,139501,205031824,3215261,406116134,0,137636,163539784,132825,162964908,4811,574876,115244,16,142215,2685,0,531,144444.0,43333.0,-66.0,-71.0,-65.0,-71.0,-66.0,-71.0,-64.0,-70.0,-78.0,-87.0,-78.0,-87.0,12.0,16.0,13.0,16.0,1
3965,CC:2F:71:3E:C5:1F,3226661,407510616,11400,1394482,3215261,406116134,6,48666,4075436,40216,3074182,8450,1001254,12019,34,16364,186,6,826,130000.0,39000.0,-69.0,-71.0,-68.0,-60.0,-68.0,-70.0,-67.0,-60.0,-78.0,-87.0,-78.0,-87.0,9.0,16.0,10.0,27.0,1
3966,CC:2F:71:3F:1F:24,8834372,8983707586,5619111,8577591452,3215261,406116134,80,1306979,800588008,1298439,799562448,8540,1025560,1253774,619,5623830,574345,80,5838,130000.0,43333.0,-70.0,-64.0,-72.0,-68.0,-70.0,-64.0,-71.0,-68.0,-78.0,-87.0,-78.0,-87.0,8.0,23.0,6.0,19.0,1
3967,F8:59:71:5A:E0:3D,3354828,611246124,139564,205129726,3215264,406116398,0,137700,163638358,132889,163063482,4811,574876,115307,16,142278,2686,0,531,144444.0,43333.0,-66.0,-72.0,-65.0,-71.0,-66.0,-71.0,-64.0,-70.0,-78.0,-87.0,-78.0,-87.0,12.0,15.0,13.0,16.0,1
3968,CC:2F:71:3E:C5:1F,3226666,407511082,11400,1394482,3215266,406116600,6,48668,4075624,40217,3074252,8451,1001372,12020,34,16364,186,6,826,130000.0,39000.0,-69.0,-70.0,-67.0,-60.0,-68.0,-70.0,-66.0,-60.0,-78.0,-87.0,-78.0,-87.0,9.0,17.0,11.0,27.0,1
3969,CC:2F:71:3F:1F:24,8835431,8985329696,5620165,8579213096,3215266,406116600,80,1307248,800711686,1298708,799686126,8540,1025560,1254043,619,5624884,574404,80,5838,130000.0,43333.0,-70.0,-64.0,-72.0,-68.0,-70.0,-64.0,-71.0,-67.0,-78.0,-87.0,-78.0,-87.0,8.0,23.0,6.0,19.0,1
3970,F8:59:71:5A:E0:3D,3354899,611346246,139628,205229182,3215271,406117064,0,137763,163735378,132952,163160502,4811,574876,115370,16,142342,2686,0,531,144444.0,43333.0,-66.0,-72.0,-65.0,-70.0,-66.0,-71.0,-64.0,-70.0,-78.0,-87.0,-78.0,-87.0,12.0,15.0,13.0,17.0,1
3971,CC:2F:71:3E:C5:1F,3226671,407511546,11400,1394482,3215271,406117064,6,48668,4075624,40217,3074252,8451,1001372,12020,34,16364,186,6,826,130000.0,39000.0,-69.0,-70.0,-67.0,-60.0,-68.0,-70.0,-66.0,-60.0,-78.0,-87.0,-78.0,-87.0,9.0,17.0,11.0,27.0,1
3972,CC:2F:71:3F:1F:24,8836560,8987063568,5621289,8580946504,3215271,406117064,80,1307511,800833172,1298971,799807612,8540,1025560,1254306,619,5626008,574443,80,5838,130000.0,39000.0,-70.0,-64.0,-72.0,-68.0,-69.0,-64.0,-72.0,-67.0,-78.0,-87.0,-78.0,-87.0,8.0,23.0,6.0,19.0,1
3973,F8:59:71:5A:E0:3D,3354964,611444350,139691,205327084,3215273,406117266,0,137827,163833938,133016,163259062,4811,574876,115434,16,142405,2686,0,531,144444.0,43333.0,-67.0,-72.0,-65.0,-71.0,-66.0,-72.0,-65.0,-71.0,-78.0,-87.0,-78.0,-87.0,11.0,15.0,13.0,16.0,1
3974,CC:2F:71:3E:C5:1F,3226677,407512405,11404,1395139,3215273,406117266,6,48674,4076439,40223,3075067,8451,1001372,12025,34,16368,186,6,827,144444.0,39000.0,-69.0,-71.0,-67.0,-60.0,-68.0,-71.0,-67.0,-61.0,-78.0,-87.0,-78.0,-87.0,9.0,16.0,11.0,27.0,1
3975,CC:2F:71:3F:1F:24,8837522,8988538498,5622249,8582421232,3215273,406117266,80,1307731,800949726,1299191,799924166,8540,1025560,1254526,619,5626968,574450,80,5840,130000.0,43333.0,-70.0,-64.0,-72.0,-68.0,-70.0,-64.0,-72.0,-68.0,-78.0,-87.0,-78.0,-87.0,8.0,23.0,6.0,19.0,1
3976,F8:59:71:5A:E0:3D,3355032,611541304,139753,205423432,3215279,406117872,0,137889,163929418,133078,163354542,4811,574876,115496,16,142467,2686,0,531,144444.0,43333.0,-66.0,-72.0,-65.0,-71.0,-66.0,-72.0,-65.0,-71.0,-78.0,-87.0,-78.0,-87.0,12.0,15.0,13.0,16.0,1
3977,CC:2F:71:3E:C5:1F,3226683,407513011,11404,1395139,3215279,406117872,6,48674,4076439,40223,3075067,8451,1001372,12025,34,16368,186,6,827,144444.0,39000.0,-69.0,-71.0,-67.0,-60.0,-68.0,-71.0,-67.0,-61.0,-78.0,-87.0,-78.0,-87.0,9.0,16.0,11.0,27.0,1
3978,CC:2F:71:3F:1F:24,8838755,8990427394,5623476,8584309522,3215279,406117872,80,1307975,801069540,1299435,800043980,8540,1025560,1254770,619,5628193,574515,80,5840,130000.0,43333.0,-71.0,-65.0,-72.0,-68.0,-70.0,-64.0,-72.0,-68.0,-78.0,-87.0,-78.0,-87.0,7.0,22.0,6.0,19.0,1
3979,F8:59:71:5A:E0:3D,3355099,611642436,139818,205524442,3215281,406117994,0,137955,164029636,133143,163454642,4812,574994,115562,16,142532,2686,0,531,144444.0,43333.0,-66.0,-72.0,-65.0,-71.0,-66.0,-71.0,-65.0,-70.0,-78.0,-87.0,-78.0,-87.0,12.0,15.0,13.0,16.0,1
3980,CC:2F:71:3E:C5:1F,3226685,407513133,11404,1395139,3215281,406117994,6,48674,4076439,40223,3075067,8451,1001372,12025,34,16368,186,6,827,144444.0,39000.0,-69.0,-71.0,-67.0,-60.0,-68.0,-71.0,-67.0,-61.0,-78.0,-87.0,-78.0,-87.0,9.0,16.0,11.0,27.0,1
3981,CC:2F:71:3F:1F:24,8840249,8992737418,5624966,8586619222,3215283,406118196,80,1308241,801191534,1299701,800165974,8540,1025560,1255036,619,5629667,574589,80,5841,130000.0,43333.0,-71.0,-64.0,-72.0,-68.0,-70.0,-64.0,-72.0,-68.0,-78.0,-87.0,-78.0,-87.0,7.0,23.0,6.0,19.0,1
3982,F8:59:71:5A:E0:3D,3355171,611742700,139882,205623898,3215289,406118802,0,138018,164126656,133206,163551662,4812,574994,115625,16,142596,2686,0,531,144444.0,43333.0,-66.0,-71.0,-65.0,-70.0,-66.0,-71.0,-65.0,-70.0,-78.0,-87.0,-78.0,-87.0,12.0,16.0,13.0,17.0,1
3983,CC:2F:71:3E:C5:1F,3226693,407513941,11404,1395139,3215289,406118802,6,48674,4076439,40223,3075067,8451,1001372,12025,34,16368,186,6,827,144444.0,39000.0,-69.0,-71.0,-67.0,-60.0,-68.0,-71.0,-67.0,-61.0,-78.0,-87.0,-78.0,-87.0,9.0,16.0,11.0,27.0,1
3984,CC:2F:71:3F:1F:24,8841718,8995005046,5626429,8588886244,3215289,406118802,80,1308508,801315000,1299968,800289440,8540,1025560,1255303,619,5631133,574636,80,5842,130000.0,43333.0,-70.0,-64.0,-72.0,-70.0,-70.0,-64.0,-72.0,-69.0,-78.0,-87.0,-78.0,-87.0,8.0,23.0,6.0,17.0,1
3985,F8:59:71:5A:E0:3D,3355237,611842491,139946,205723354,3215291,406119137,0,138082,164225216,133270,163650222,4812,574994,115689,16,142660,2686,0,531,144444.0,43333.0,-66.0,-72.0,-65.0,-70.0,-66.0,-72.0,-64.0,-70.0,-78.0,-87.0,-78.0,-87.0,12.0,15.0,13.0,17.0,1
3986,CC:2F:71:3E:C5:1F,3226695,407514276,11404,1395139,3215291,406119137,6,48674,4076439,40223,3075067,8451,1001372,12025,34,16368,186,6,827,144444.0,39000.0,-69.0,-71.0,-67.0,-60.0,-68.0,-71.0,-67.0,-61.0,-78.0,-87.0,-78.0,-87.0,9.0,16.0,11.0,27.0,1
3987,CC:2F:71:3F:1F:24,8842895,8996817715,5627604,8590698578,3215291,406119137,80,1308735,801435036,1300194,800409358,8541,1025678,1255530,619,5632323,574753,80,5842,130000.0,43333.0,-69.0,-63.0,-72.0,-69.0,-68.0,-63.0,-71.0,-69.0,-78.0,-87.0,-78.0,-87.0,9.0,24.0,6.0,18.0,1
3988,F8:59:71:5A:E0:3D,3355309,611944167,140011,205824364,3215298,406119803,0,138148,164326856,133336,163751862,4812,574994,115755,16,142725,2686,0,531,144444.0,43333.0,-66.0,-72.0,-65.0,-70.0,-66.0,-72.0,-64.0,-70.0,-78.0,-86.0,-78.0,-87.0,12.0,14.0,13.0,17.0,1
3989,CC:2F:71:3E:C5:1F,3226704,407515144,11404,1395139,3215300,406120005,6,48674,4076439,40223,3075067,8451,1001372,12025,34,16368,186,6,827,144444.0,39000.0,-69.0,-71.0,-67.0,-60.0,-68.0,-71.0,-67.0,-61.0,-78.0,-86.0,-78.0,-87.0,9.0,15.0,11.0,27.0,1
3990,CC:2F:71:3F:1F:24,8844056,8998593407,5628756,8592473402,3215300,406120005,80,1308976,801561122,1300435,800535444,8541,1025678,1255771,619,5633475,574872,80,5842,130000.0,43333.0,-69.0,-64.0,-72.0,-69.0,-69.0,-63.0,-72.0,-69.0,-78.0,-86.0,-78.0,-87.0,9.0,22.0,6.0,18.0,1
3991,F8:59:71:5A:E0:3D,3355378,612048487,140078,205928482,3215300,406120005,0,138215,164430050,133403,163855056,4812,574994,115821,16,142792,2687,0,531,144444.0,43333.0,-67.0,-73.0,-65.0,-71.0,-66.0,-72.0,-64.0,-70.0,-78.0,-86.0,-78.0,-87.0,11.0,13.0,13.0,16.0,1
3992,CC:2F:71:3E:C5:1F,3226704,407515144,11404,1395139,3215300,406120005,6,48674,4076439,40223,3075067,8451,1001372,12025,34,16368,186,6,827,144444.0,39000.0,-69.0,-71.0,-67.0,-60.0,-68.0,-71.0,-67.0,-61.0,-78.0,-86.0,-78.0,-87.0,9.0,15.0,11.0,27.0,1
3993,CC:2F:71:3F:1F:24,8845465,9000769069,5630165,8594649064,3215300,406120005,80,1309239,801685927,1300698,800660249,8541,1025678,1256034,619,5634884,574925,80,5842,130000.0,43333.0,-68.0,-63.0,-72.0,-70.0,-68.0,-63.0,-72.0,-69.0,-78.0,-86.0,-78.0,-87.0,10.0,23.0,6.0,17.0,1
3994,F8:59:71:5A:E0:3D,3355445,612146793,140141,206026384,3215304,406120409,0,138279,164528610,133467,163953616,4812,574994,115885,16,142855,2688,0,531,144444.0,43333.0,-67.0,-72.0,-65.0,-70.0,-66.0,-72.0,-65.0,-70.0,-78.0,-86.0,-78.0,-87.0,11.0,14.0,13.0,17.0,1
3995,CC:2F:71:3E:C5:1F,3226710,407515750,11404,1395139,3215306,406120611,6,48674,4076439,40223,3075067,8451,1001372,12025,34,16368,186,6,827,144444.0,39000.0,-69.0,-71.0,-67.0,-60.0,-68.0,-71.0,-67.0,-61.0,-78.0,-86.0,-78.0,-87.0,9.0,15.0,11.0,27.0,1
3996,CC:2F:71:3F:1F:24,8847074,9003260561,5631768,8597139950,3215306,406120611,80,1309510,801806865,1300969,800781187,8541,1025678,1256305,619,5636487,574995,80,5842,130000.0,43333.0,-68.0,-63.0,-72.0,-70.0,-68.0,-63.0,-72.0,-70.0,-78.0,-86.0,-78.0,-87.0,10.0,23.0,6.0,17.0,1
3997,F8:59:71:5A:E0:3D,3355515,612248267,140206,206127394,3215309,406120873,0,138344,164628710,133532,164053716,4812,574994,115950,16,142920,2688,0,531,144444.0,43333.0,-66.0,-72.0,-65.0,-70.0,-66.0,-71.0,-64.0,-70.0,-78.0,-86.0,-78.0,-87.0,12.0,14.0,13.0,17.0,1
3998,CC:2F:71:3E:C5:1F,3226714,407516128,11405,1395255,3215309,406120873,6,48677,4076685,40226,3075313,8451,1001372,12026,34,16369,186,6,827,144444.0,39000.0,-69.0,-71.0,-67.0,-60.0,-69.0,-72.0,-68.0,-61.0,-78.0,-86.0,-78.0,-87.0,9.0,15.0,11.0,27.0,1
3999,CC:2F:71:3F:1F:24,8848553,9005549583,5633244,8599428710,3215309,406120873,80,1309772,801931135,1301231,800905457,8541,1025678,1256567,619,5637930,575123,80,5842,130000.0,43333.0,-68.0,-63.0,-72.0,-70.0,-68.0,-63.0,-72.0,-69.0,-78.0,-86.0,-78.0,-87.0,10.0,23.0,6.0,17.0,1
4000,F8:59:71:5A:E0:3D,3355584,612349625,140271,206228348,3215313,406121277,0,138409,164728810,133597,164153816,4812,574994,116015,16,142985,2688,0,531,130000.0,39000.0,-66.0,-72.0,-64.0,-70.0,-66.0,-72.0,-64.0,-70.0,-78.0,-86.0,-78.0,-87.0,12.0,14.0,14.0,17.0,1
4001,CC:2F:71:3E:C5:1F,3226720,407516900,11405,1395255,3215315,406121645,6,48677,4076685,40226,3075313,8451,1001372,12026,34,16369,186,6,827,144444.0,39000.0,-69.0,-71.0,-67.0,-60.0,-69.0,-72.0,-68.0,-61.0,-78.0,-86.0,-78.0,-87.0,9.0,15.0,11.0,27.0,1
4002,CC:2F:71:3F:1F:24,8850149,9008017559,5634834,8601895914,3215315,406121645,80,1310065,802058857,1301524,801033179,8541,1025678,1256860,619,5639539,575240,80,5843,130000.0,43333.0,-69.0,-63.0,-71.0,-70.0,-69.0,-63.0,-71.0,-70.0,-78.0,-86.0,-78.0,-87.0,9.0,23.0,7.0,17.0,1
4003,F8:59:71:5A:E0:3D,3355654,612449741,140335,206327692,3215319,406122049,0,138473,164827384,133661,164252390,4812,574994,116078,16,143049,2689,0,531,144444.0,43333.0,-66.0,-72.0,-65.0,-70.0,-66.0,-72.0,-64.0,-70.0,-78.0,-86.0,-78.0,-87.0,12.0,14.0,13.0,17.0,1
4004,CC:2F:71:3E:C5:1F,3226724,407517304,11405,1395255,3215319,406122049,6,48677,4076685,40226,3075313,8451,1001372,12026,34,16369,186,6,827,144444.0,39000.0,-69.0,-71.0,-67.0,-60.0,-69.0,-72.0,-68.0,-61.0,-78.0,-86.0,-78.0,-87.0,9.0,15.0,11.0,27.0,1
4005,CC:2F:71:3F:1F:24,8851440,9009996687,5636120,8603874578,3215320,406122109,80,1310319,802184141,1301778,801158463,8541,1025678,1257113,619,5640839,575351,80,5843,130000.0,39000.0,-69.0,-63.0,-72.0,-70.0,-69.0,-63.0,-72.0,-70.0,-78.0,-86.0,-78.0,-87.0,9.0,23.0,6.0,17.0,1
4006,F8:59:71:5A:E0:3D,3355725,612552769,140401,206430256,3215324,406122513,0,138539,164929024,133727,164354030,4812,574994,116144,16,143115,2690,0,531,144444.0,43333.0,-66.0,-72.0,-64.0,-70.0,-66.0,-72.0,-64.0,-70.0,-78.0,-86.0,-78.0,-87.0,12.0,14.0,14.0,17.0,1
4007,CC:2F:71:3E:C5:1F,3226729,407517768,11405,1395255,3215324,406122513,6,48677,4076685,40226,3075313,8451,1001372,12026,34,16369,186,6,827,144444.0,39000.0,-69.0,-71.0,-67.0,-60.0,-69.0,-72.0,-68.0,-61.0,-78.0,-86.0,-78.0,-87.0,9.0,15.0,11.0,27.0,1
4008,CC:2F:71:3F:1F:24,8853208,9012740371,5637884,8606617858,3215324,406122513,80,1310612,802311991,1302071,801286313,8541,1025678,1257406,619,5642583,575503,80,5843,130000.0,43333.0,-69.0,-63.0,-72.0,-70.0,-69.0,-63.0,-71.0,-70.0,-78.0,-86.0,-78.0,-87.0,9.0,23.0,6.0,17.0,1
4009,F8:59:71:5A:E0:3D,3355792,612651075,140464,206528158,3215328,406122917,0,138603,165027584,133791,164452590,4812,574994,116208,16,143178,2690,0,531,144444.0,43333.0,-66.0,-71.0,-64.0,-70.0,-66.0,-71.0,-64.0,-70.0,-78.0,-86.0,-78.0,-87.0,12.0,15.0,14.0,17.0,1
4010,CC:2F:71:3E:C5:1F,3226733,407518172,11405,1395255,3215328,406122917,6,48677,4076685,40226,3075313,8451,1001372,12026,34,16369,186,6,827,144444.0,39000.0,-69.0,-71.0,-67.0,-60.0,-69.0,-72.0,-68.0,-61.0,-78.0,-86.0,-78.0,-87.0,9.0,15.0,11.0,27.0,1
4011,CC:2F:71:3F:1F:24,8854139,9014161925,5638811,8608039008,3215328,406122917,80,1310851,802429243,1302310,801403565,8541,1025678,1257645,619,5643530,575565,80,5843,130000.0,43333.0,-70.0,-63.0,-72.0,-69.0,-70.0,-63.0,-71.0,-69.0,-78.0,-86.0,-78.0,-87.0,8.0,23.0,6.0,18.0,1
4012,F8:59:71:5A:E0:3D,3355860,612749441,140527,206626060,3215333,406123381,0,138666,165124604,133854,164549610,4812,574994,116271,16,143241,2691,0,531,144444.0,43333.0,-66.0,-72.0,-64.0,-70.0,-66.0,-71.0,-64.0,-70.0,-78.0,-86.0,-78.0,-87.0,12.0,14.0,14.0,17.0,1
4013,CC:2F:71:3E:C5:1F,3226738,407518636,11405,1395255,3215333,406123381,6,48677,4076685,40226,3075313,8451,1001372,12026,34,16369,186,6,827,144444.0,39000.0,-69.0,-71.0,-67.0,-60.0,-69.0,-72.0,-68.0,-61.0,-78.0,-86.0,-78.0,-87.0,9.0,15.0,11.0,27.0,1
4014,CC:2F:71:3F:1F:24,8855526,9016301561,5640193,8610178180,3215333,406123381,80,1311143,802555411,1302602,801529733,8541,1025678,1257937,619,5644912,575588,80,5843,130000.0,39000.0,-69.0,-64.0,-71.0,-69.0,-69.0,-63.0,-71.0,-69.0,-78.0,-86.0,-78.0,-87.0,9.0,22.0,7.0,18.0,1
4015,F8:59:71:5A:E0:3D,3355927,612847747,140590,206723962,3215337,406123785,0,138729,165221624,133917,164646630,4812,574994,116334,16,143304,2693,0,531,144444.0,43333.0,-66.0,-71.0,-64.0,-71.0,-66.0,-71.0,-64.0,-70.0,-78.0,-86.0,-78.0,-87.0,12.0,15.0,14.0,16.0,1
4016,CC:2F:71:3E:C5:1F,3226742,407519040,11405,1395255,3215337,406123785,6,48677,4076685,40226,3075313,8451,1001372,12026,34,16369,186,6,827,144444.0,39000.0,-69.0,-71.0,-67.0,-60.0,-69.0,-72.0,-68.0,-61.0,-78.0,-86.0,-78.0,-87.0,9.0,15.0,11.0,27.0,1
4017,CC:2F:71:3F:1F:24,8856845,9018327807,5641508,8612204022,3215337,406123785,80,1311384,802674690,1302843,801649012,8541,1025678,1258178,619,5646202,575636,80,5843,144444.0,43333.0,-70.0,-64.0,-71.0,-68.0,-70.0,-64.0,-71.0,-68.0,-78.0,-86.0,-78.0,-87.0,8.0,22.0,7.0,19.0,1
4018,F8:59:71:5A:E0:3D,3355992,612945851,140653,206821864,3215339,406123987,0,138792,165318644,133980,164743650,4812,574994,116397,16,143367,2693,0,531,144444.0,43333.0,-66.0,-71.0,-65.0,-71.0,-66.0,-71.0,-64.0,-70.0,-78.0,-86.0,-78.0,-87.0,12.0,15.0,13.0,16.0,1
4019,CC:2F:71:3E:C5:1F,3226746,407519444,11405,1395255,3215341,406124189,6,48677,4076685,40226,3075313,8451,1001372,12026,34,16369,186,6,827,144444.0,39000.0,-69.0,-71.0,-67.0,-60.0,-69.0,-72.0,-68.0,-61.0,-78.0,-86.0,-78.0,-87.0,9.0,15.0,11.0,27.0,1
4020,CC:2F:71:3F:1F:24,8858601,9021052243,5643260,8614928054,3215341,406124189,80,1311708,802804590,1303167,801778912,8541,1025678,1258502,619,5647979,575850,80,5843,130000.0,43333.0,-69.0,-65.0,-71.0,-68.0,-68.0,-65.0,-70.0,-68.0,-78.0,-86.0,-78.0,-87.0,9.0,21.0,7.0,19.0,1
4021,F8:59:71:5A:E0:3D,3356061,613045771,140717,206921320,3215344,406124451,0,138856,165417204,134044,164842210,4812,574994,116461,16,143431,2693,0,531,144444.0,43333.0,-66.0,-71.0,-65.0,-70.0,-66.0,-71.0,-64.0,-70.0,-78.0,-86.0,-78.0,-87.0,12.0,15.0,13.0,17.0,1
4022,CC:2F:71:3E:C5:1F,3226751,407519908,11405,1395255,3215346,406124653,6,48677,4076685,40226,3075313,8451,1001372,12026,34,16369,186,6,827,144444.0,39000.0,-69.0,-71.0,-67.0,-60.0,-69.0,-72.0,-68.0,-61.0,-78.0,-86.0,-78.0,-87.0,9.0,15.0,11.0,27.0,1
4023,CC:2F:71:3F:1F:24,8860079,9023335469,5644733,8617210816,3215346,406124653,80,1311995,802927422,1303454,801901744,8541,1025678,1258789,619,5649452,575947,80,5843,130000.0,43333.0,-69.0,-65.0,-71.0,-68.0,-69.0,-65.0,-70.0,-67.0,-78.0,-86.0,-78.0,-87.0,9.0,21.0,7.0,19.0,1
4024,F8:59:71:5A:E0:3D,3356126,613142447,140779,207017668,3215347,406124779,0,138918,165512684,134106,164937690,4812,574994,116523,16,143493,2693,0,531,144444.0,43333.0,-66.0,-72.0,-64.0,-71.0,-66.0,-71.0,-64.0,-70.0,-78.0,-86.0,-78.0,-87.0,12.0,14.0,14.0,16.0,1
4025,CC:2F:71:3E:C5:1F,3226752,407520034,11405,1395255,3215347,406124779,6,48677,4076685,40226,3075313,8451,1001372,12026,34,16369,186,6,827,144444.0,39000.0,-69.0,-71.0,-67.0,-60.0,-69.0,-72.0,-68.0,-61.0,-78.0,-86.0,-78.0,-87.0,9.0,15.0,11.0,27.0,1
4026,CC:2F:71:3F:1F:24,8861029,9024791597,5645682,8618666818,3215347,406124779,80,1312217,803042654,1303676,802016976,8541,1025678,1259011,619,5650401,575970,80,5843,130000.0,43333.0,-69.0,-65.0,-71.0,-68.0,-69.0,-65.0,-71.0,-68.0,-78.0,-86.0,-78.0,-87.0,9.0,21.0,7.0,19.0,1
4027,F8:59:71:5A:E0:3D,3356195,613239674,140841,207114016,3215354,406125658,0,138980,165608164,134168,165033170,4812,574994,116585,16,143555,2693,0,531,144444.0,43333.0,-66.0,-72.0,-65.0,-71.0,-66.0,-71.0,-64.0,-70.0,-78.0,-86.0,-78.0,-87.0,12.0,14.0,13.0,16.0,1
4028,CC:2F:71:3E:C5:1F,3226759,407520913,11405,1395255,3215354,406125658,6,48677,4076685,40226,3075313,8451,1001372,12026,34,16369,186,6,827,144444.0,39000.0,-69.0,-71.0,-67.0,-60.0,-69.0,-72.0,-68.0,-61.0,-78.0,-86.0,-78.0,-87.0,9.0,15.0,11.0,27.0,1
4029,CC:2F:71:3F:1F:24,8862203,9026592258,5646849,8620466600,3215354,406125658,80,1312463,803161998,1303922,802136320,8541,1025678,1259257,619,5651546,576035,80,5843,130000.0,43333.0,-69.0,-65.0,-71.0,-68.0,-69.0,-65.0,-71.0,-67.0,-78.0,-86.0,-78.0,-87.0,9.0,21.0,7.0,19.0,1
4030,F8:59:71:5A:E0:3D,3356261,613337838,140904,207211918,3215357,406125920,0,139043,165705184,134231,165130190,4812,574994,116648,16,143618,2694,0,531,144444.0,43333.0,-66.0,-72.0,-65.0,-70.0,-66.0,-71.0,-64.0,-70.0,-78.0,-86.0,-78.0,-87.0,12.0,14.0,13.0,17.0,1
4031,CC:2F:71:3E:C5:1F,3226762,407521175,11405,1395255,3215357,406125920,6,48677,4076685,40226,3075313,8451,1001372,12026,34,16369,186,6,827,144444.0,39000.0,-69.0,-71.0,-67.0,-60.0,-69.0,-72.0,-68.0,-61.0,-78.0,-86.0,-78.0,-87.0,9.0,15.0,11.0,27.0,1
4032,CC:2F:71:3F:1F:24,8863243,9028179790,5647886,8622053870,3215357,406125920,80,1312704,803281402,1304163,802255724,8541,1025678,1259498,619,5652605,576096,80,5843,130000.0,43333.0,-70.0,-65.0,-71.0,-68.0,-70.0,-65.0,-71.0,-67.0,-78.0,-86.0,-78.0,-87.0,8.0,21.0,7.0,19.0,1
4033,F8:59:71:5A:E0:3D,3356329,613436204,140967,207309820,3215362,406126384,0,139105,165800664,134293,165225670,4812,574994,116710,16,143681,2694,0,531,144444.0,43333.0,-66.0,-71.0,-64.0,-71.0,-66.0,-71.0,-64.0,-70.0,-78.0,-86.0,-78.0,-87.0,12.0,15.0,14.0,16.0,1
4034,CC:2F:71:3E:C5:1F,3226767,407521639,11405,1395255,3215362,406126384,6,48677,4076685,40226,3075313,8451,1001372,12026,34,16369,186,6,827,144444.0,39000.0,-69.0,-71.0,-67.0,-60.0,-69.0,-72.0,-68.0,-61.0,-78.0,-86.0,-78.0,-87.0,9.0,15.0,11.0,27.0,1
4035,CC:2F:71:3F:1F:24,8864157,9029574560,5648795,8623448176,3215362,406126384,80,1312915,803396860,1304374,802371182,8541,1025678,1259708,619,5653508,576097,80,5844,130000.0,43333.0,-70.0,-64.0,-72.0,-69.0,-70.0,-64.0,-71.0,-68.0,-78.0,-86.0,-78.0,-87.0,8.0,22.0,6.0,18.0,1
4036,F8:59:71:5A:E0:3D,3356397,613534570,141030,207407722,3215367,406126848,0,139169,165899224,134357,165324230,4812,574994,116774,16,143744,2694,0,531,144444.0,43333.0,-66.0,-71.0,-65.0,-70.0,-66.0,-71.0,-64.0,-70.0,-78.0,-86.0,-78.0,-87.0,12.0,15.0,13.0,17.0,1
4037,CC:2F:71:3E:C5:1F,3226772,407522103,11405,1395255,3215367,406126848,6,48677,4076685,40226,3075313,8451,1001372,12026,34,16369,186,6,827,144444.0,39000.0,-69.0,-71.0,-67.0,-60.0,-69.0,-72.0,-68.0,-61.0,-78.0,-86.0,-78.0,-87.0,9.0,15.0,11.0,27.0,1
4038,CC:2F:71:3F:1F:24,8865330,9031377488,5649963,8625250640,3215367,406126848,80,1313152,803520880,1304611,802495202,8541,1025678,1259945,619,5654682,576216,80,5844,130000.0,43333.0,-70.0,-64.0,-71.0,-69.0,-70.0,-64.0,-71.0,-68.0,-78.0,-86.0,-78.0,-87.0,8.0,22.0,7.0,18.0,1
4039,F8:59:71:5A:E0:3D,3356469,613637658,141096,207510286,3215373,406127372,0,139234,165999324,134422,165424330,4812,574994,116839,16,143810,2695,0,531,144444.0,43333.0,-66.0,-71.0,-65.0,-71.0,-66.0,-71.0,-64.0,-70.0,-78.0,-86.0,-78.0,-87.0,12.0,15.0,13.0,16.0,1
4040,CC:2F:71:3E:C5:1F,3226778,407522627,11405,1395255,3215373,406127372,6,48677,4076685,40226,3075313,8451,1001372,12026,34,16369,186,6,827,144444.0,39000.0,-69.0,-71.0,-67.0,-60.0,-69.0,-72.0,-68.0,-61.0,-78.0,-86.0,-78.0,-87.0,9.0,15.0,11.0,27.0,1
4041,CC:2F:71:3F:1F:24,8866508,9033185908,5651135,8627058536,3215373,406127372,80,1313403,803639524,1304862,802613846,8541,1025678,1260196,619,5655854,576219,80,5844,130000.0,43333.0,-70.0,-65.0,-71.0,-69.0,-70.0,-65.0,-71.0,-68.0,-78.0,-86.0,-78.0,-87.0,8.0,21.0,7.0,18.0,1
4042,F8:59:71:5A:E0:3D,3356534,613732856,141157,207605080,3215377,406127776,0,139298,166097898,134486,165522904,4812,574994,116902,16,143871,2695,0,531,144444.0,43333.0,-66.0,-72.0,-65.0,-71.0,-66.0,-72.0,-65.0,-70.0,-78.0,-86.0,-78.0,-87.0,12.0,14.0,13.0,16.0,1
4043,CC:2F:71:3E:C5:1F,3226782,407523031,11405,1395255,3215377,406127776,6,48677,4076685,40226,3075313,8451,1001372,12026,34,16369,186,6,827,144444.0,39000.0,-69.0,-71.0,-67.0,-60.0,-69.0,-72.0,-68.0,-61.0,-78.0,-86.0,-78.0,-87.0,9.0,15.0,11.0,27.0,1
4044,CC:2F:71:3F:1F:24,8867786,9035147144,5652409,8629019368,3215377,406127776,80,1313642,803758922,1305101,802733244,8541,1025678,1260435,619,5657098,576442,80,5844,130000.0,43333.0,-69.0,-65.0,-71.0,-68.0,-69.0,-65.0,-71.0,-68.0,-78.0,-86.0,-78.0,-87.0,9.0,21.0,7.0,19.0,1
4045,F8:59:71:5A:E0:3D,3356601,613832630,141222,207704652,3215379,406127978,0,139361,166194918,134549,165619924,4812,574994,116965,16,143936,2696,0,531,144444.0,43333.0,-67.0,-72.0,-65.0,-71.0,-66.0,-72.0,-65.0,-71.0,-78.0,-86.0,-78.0,-87.0,11.0,14.0,13.0,16.0,1
4046,CC:2F:71:3E:C5:1F,3226787,407523551,11406,1395371,3215381,406128180,6,48679,4076825,40228,3075453,8451,1001372,12026,34,16370,186,6,827,144444.0,39000.0,-69.0,-71.0,-68.0,-60.0,-69.0,-72.0,-67.0,-61.0,-78.0,-86.0,-78.0,-87.0,9.0,15.0,10.0,27.0,1
4047,CC:2F:71:3F:1F:24,8869227,9037370695,5653846,8631242515,3215381,406128180,80,1313891,803879021,1305350,802853343,8541,1025678,1260684,619,5658565,576465,80,5845,130000.0,43333.0,-70.0,-65.0,-72.0,-68.0,-69.0,-65.0,-72.0,-67.0,-78.0,-86.0,-78.0,-87.0,8.0,21.0,6.0,19.0,1
4048,F8:59:71:5A:E0:3D,3356671,613931198,141285,207802554,3215386,406128644,0,139424,166291938,134612,165716944,4812,574994,117028,16,143999,2696,0,531,144444.0,43333.0,-67.0,-72.0,-65.0,-71.0,-66.0,-72.0,-65.0,-71.0,-78.0,-86.0,-78.0,-87.0,11.0,14.0,13.0,16.0,1
4049,CC:2F:71:3E:C5:1F,3226792,407524015,11406,1395371,3215386,406128644,6,48679,4076825,40228,3075453,8451,1001372,12026,34,16370,186,6,827,144444.0,39000.0,-69.0,-71.0,-68.0,-60.0,-69.0,-72.0,-67.0,-61.0,-78.0,-86.0,-78.0,-87.0,9.0,15.0,10.0,27.0,1
4050,CC:2F:71:3F:1F:24,8870271,9038968645,5654885,8632840001,3215386,406128644,80,1314159,804003889,1305618,802978211,8541,1025678,1260952,619,5659577,576711,80,5846,130000.0,39000.0,-68.0,-65.0,-72.0,-68.0,-68.0,-65.0,-71.0,-68.0,-78.0,-86.0,-78.0,-87.0,10.0,21.0,6.0,19.0,1
4051,F8:59:71:5A:E0:3D,3356739,614032472,141350,207903564,3215389,406128908,0,139489,166392038,134677,165817044,4812,574994,117093,16,144064,2697,0,531,144444.0,43333.0,-66.0,-72.0,-65.0,-70.0,-66.0,-71.0,-64.0,-70.0,-78.0,-86.0,-78.0,-87.0,12.0,14.0,13.0,17.0,1
4052,CC:2F:71:3E:C5:1F,3226795,407524279,11406,1395371,3215389,406128908,6,48679,4076825,40228,3075453,8451,1001372,12026,34,16370,186,6,827,144444.0,39000.0,-69.0,-71.0,-68.0,-60.0,-69.0,-72.0,-67.0,-61.0,-78.0,-86.0,-78.0,-87.0,9.0,15.0,10.0,27.0,1
4053,CC:2F:71:3F:1F:24,8871470,9040814573,5656081,8634685665,3215389,406128908,80,1314415,804125901,1305873,803100105,8542,1025796,1261207,619,5660800,576910,80,5846,130000.0,43333.0,-70.0,-64.0,-72.0,-67.0,-69.0,-64.0,-71.0,-67.0,-78.0,-86.0,-78.0,-87.0,8.0,22.0,6.0,20.0,1
4054,F8:59:71:5A:E0:3D,3356806,614130778,141413,208001466,3215393,406129312,0,139552,166489058,134740,165914064,4812,574994,117156,16,144127,2697,0,531,144444.0,43333.0,-66.0,-72.0,-65.0,-70.0,-66.0,-71.0,-64.0,-70.0,-78.0,-86.0,-78.0,-87.0,12.0,14.0,13.0,17.0,1
4055,CC:2F:71:3E:C5:1F,3226801,407524885,11406,1395371,3215395,406129514,6,48679,4076825,40228,3075453,8451,1001372,12026,34,16370,186,6,827,144444.0,39000.0,-69.0,-71.0,-68.0,-60.0,-69.0,-72.0,-67.0,-61.0,-78.0,-86.0,-78.0,-87.0,9.0,15.0,10.0,27.0,1
4056,CC:2F:71:3F:1F:24,8872644,9042596831,5657249,8636467317,3215395,406129514,80,1314679,804250150,1306137,803224354,8542,1025796,1261471,619,5661968,577006,80,5846,130000.0,43333.0,-70.0,-64.0,-71.0,-69.0,-70.0,-63.0,-70.0,-68.0,-78.0,-86.0,-78.0,-87.0,8.0,22.0,7.0,18.0,1
4057,F8:59:71:5A:E0:3D,3356874,614229144,141476,208099368,3215398,406129776,0,139616,166587632,134804,166012638,4812,574994,117219,16,144190,2697,0,531,144444.0,43333.0,-66.0,-71.0,-65.0,-70.0,-66.0,-71.0,-64.0,-70.0,-78.0,-86.0,-78.0,-87.0,12.0,15.0,13.0,17.0,1
4058,CC:2F:71:3E:C5:1F,3226804,407525147,11406,1395371,3215398,406129776,6,48679,4076825,40228,3075453,8451,1001372,12026,34,16370,186,6,827,144444.0,39000.0,-69.0,-71.0,-68.0,-60.0,-69.0,-72.0,-67.0,-61.0,-78.0,-86.0,-78.0,-87.0,9.0,15.0,10.0,27.0,1
4059,CC:2F:71:3F:1F:24,8873613,9044079721,5658215,8637949945,3215398,406129776,80,1314896,804366348,1306354,803340552,8542,1025796,1261687,619,5662934,577053,80,5846,130000.0,43333.0,-70.0,-64.0,-71.0,-68.0,-70.0,-64.0,-71.0,-68.0,-78.0,-86.0,-78.0,-87.0,8.0,22.0,7.0,19.0,1
4060,F8:59:71:5A:E0:3D,3356940,614325896,141538,208195716,3215402,406130180,0,139678,166683112,134866,166108118,4812,574994,117281,16,144252,2697,0,531,144444.0,43333.0,-66.0,-72.0,-65.0,-70.0,-66.0,-71.0,-64.0,-70.0,-78.0,-86.0,-78.0,-87.0,12.0,14.0,13.0,17.0,1
4061,CC:2F:71:3E:C5:1F,3226808,407525551,11406,1395371,3215402,406130180,6,48679,4076825,40228,3075453,8451,1001372,12026,34,16370,186,6,827,144444.0,39000.0,-69.0,-71.0,-68.0,-60.0,-69.0,-72.0,-67.0,-61.0,-78.0,-86.0,-78.0,-87.0,9.0,15.0,10.0,27.0,1
4062,CC:2F:71:3F:1F:24,8874593,9045578709,5659191,8639448529,3215402,406130180,80,1315118,804481496,1306576,803455700,8542,1025796,1261909,619,5663910,577080,80,5846,130000.0,43333.0,-69.0,-64.0,-71.0,-67.0,-69.0,-64.0,-71.0,-67.0,-78.0,-86.0,-78.0,-87.0,9.0,22.0,7.0,20.0,1
4063,F8:59:71:5A:E0:3D,3357006,614425554,141602,208295172,3215404,406130382,0,139742,166781672,134930,166206678,4812,574994,117345,16,144316,2698,0,531,144444.0,43333.0,-66.0,-72.0,-65.0,-70.0,-66.0,-71.0,-64.0,-70.0,-78.0,-86.0,-78.0,-87.0,12.0,14.0,13.0,17.0,1
4064,CC:2F:71:3E:C5:1F,3226810,407525753,11406,1395371,3215404,406130382,6,48679,4076825,40228,3075453,8451,1001372,12026,34,16370,186,6,827,144444.0,39000.0,-69.0,-71.0,-68.0,-60.0,-69.0,-72.0,-67.0,-61.0,-78.0,-86.0,-78.0,-87.0,9.0,15.0,10.0,27.0,1
4065,CC:2F:71:3F:1F:24,8875849,9047512883,5660442,8641382239,3215407,406130644,80,1315323,804598996,1306781,803573200,8542,1025796,1262114,619,5665150,577225,80,5846,130000.0,43333.0,-69.0,-64.0,-71.0,-67.0,-69.0,-64.0,-71.0,-67.0,-78.0,-86.0,-78.0,-87.0,9.0,22.0,7.0,20.0,1
4066,F8:59:71:5A:E0:3D,3357079,614530198,141669,208399290,3215410,406130908,0,139810,166886406,134998,166311412,4812,574994,117412,16,144383,2699,0,531,144444.0,43333.0,-66.0,-72.0,-65.0,-71.0,-65.0,-71.0,-64.0,-69.0,-78.0,-86.0,-78.0,-87.0,12.0,14.0,13.0,16.0,1
4067,CC:2F:71:3E:C5:1F,3226818,407526481,11406,1395371,3215412,406131110,6,48681,4077013,40229,3075523,8452,1001490,12027,34,16370,186,6,827,144444.0,39000.0,-69.0,-70.0,-67.0,-60.0,-67.0,-69.0,-66.0,-60.0,-78.0,-86.0,-78.0,-87.0,9.0,16.0,11.0,27.0,1
4068,CC:2F:71:3F:1F:24,8877302,9049747865,5661890,8643616755,3215412,406131110,80,1315589,804729940,1307047,803704144,8542,1025796,1262380,619,5666561,577340,80,5847,130000.0,43333.0,-70.0,-64.0,-71.0,-67.0,-70.0,-64.0,-71.0,-67.0,-78.0,-86.0,-78.0,-87.0,8.0,22.0,7.0,20.0,1
4069,F8:59:71:5A:E0:3D,3357150,614634608,141736,208503296,3215414,406131312,0,139876,166988046,135064,166413052,4812,574994,117478,16,144450,2699,0,531,144444.0,39000.0,-66.0,-72.0,-65.0,-70.0,-66.0,-71.0,-65.0,-70.0,-78.0,-86.0,-78.0,-87.0,12.0,14.0,13.0,17.0,1
4070,CC:2F:71:3E:C5:1F,3226820,407526683,11406,1395371,3215414,406131312,6,48681,4077013,40229,3075523,8452,1001490,12027,34,16370,186,6,827,144444.0,39000.0,-69.0,-70.0,-67.0,-60.0,-67.0,-69.0,-66.0,-60.0,-78.0,-86.0,-78.0,-87.0,9.0,16.0,11.0,27.0,1
4071,CC:2F:71:3F:1F:24,8878785,9052044573,5663371,8645913261,3215414,406131312,80,1315843,804851778,1307301,803825982,8542,1025796,1262634,619,5668090,577503,80,5847,130000.0,43333.0,-70.0,-65.0,-71.0,-68.0,-69.0,-64.0,-71.0,-67.0,-78.0,-86.0,-78.0,-87.0,8.0,21.0,7.0,19.0,1
4072,F8:59:71:5A:E0:3D,3357220,614734745,141800,208602696,3215420,406132049,0,139942,167089700,135130,166514706,4812,574994,117543,16,144514,2701,0,531,144444.0,43333.0,-66.0,-72.0,-65.0,-70.0,-66.0,-72.0,-65.0,-70.0,-78.0,-86.0,-78.0,-87.0,12.0,14.0,13.0,17.0,1
4073,CC:2F:71:3E:C5:1F,3226826,407527420,11406,1395371,3215420,406132049,6,48681,4077013,40229,3075523,8452,1001490,12027,34,16370,186,6,827,144444.0,39000.0,-69.0,-70.0,-67.0,-60.0,-67.0,-69.0,-66.0,-60.0,-78.0,-86.0,-78.0,-87.0,9.0,16.0,11.0,27.0,1
4074,CC:2F:71:3F:1F:24,8879874,9053711154,5664452,8647578903,3215422,406132251,80,1316091,804972946,1307549,803947150,8542,1025796,1262882,619,5669171,577509,80,5848,130000.0,43333.0,-70.0,-65.0,-71.0,-67.0,-69.0,-64.0,-71.0,-67.0,-78.0,-86.0,-78.0,-87.0,8.0,21.0,7.0,20.0,1
4075,F8:59:71:5A:E0:3D,3357287,614833051,141863,208700598,3215424,406132453,0,140004,167185180,135192,166610186,4812,574994,117605,16,144577,2701,0,531,144444.0,43333.0,-66.0,-72.0,-65.0,-70.0,-66.0,-72.0,-64.0,-70.0,-78.0,-86.0,-78.0,-87.0,12.0,14.0,13.0,17.0,1
4076,CC:2F:71:3E:C5:1F,3226830,407527824,11406,1395371,3215424,406132453,6,48681,4077013,40229,3075523,8452,1001490,12027,34,16370,186,6,827,144444.0,39000.0,-69.0,-70.0,-67.0,-60.0,-67.0,-69.0,-66.0,-60.0,-78.0,-86.0,-78.0,-87.0,9.0,16.0,11.0,27.0,1
4077,CC:2F:71:3F:1F:24,8880786,9055105232,5665362,8648972779,3215424,406132453,80,1316301,805088222,1307759,804062426,8542,1025796,1263092,619,5670063,577830,80,5848,117000.0,39000.0,-68.0,-64.0,-71.0,-69.0,-68.0,-64.0,-70.0,-69.0,-78.0,-86.0,-78.0,-87.0,10.0,22.0,7.0,18.0,1
4078,F8:59:71:5A:E0:3D,3357355,614932911,141927,208800054,3215428,406132857,0,140070,167286834,135258,166711840,4812,574994,117670,16,144641,2701,0,531,144444.0,43333.0,-66.0,-72.0,-65.0,-71.0,-66.0,-71.0,-64.0,-70.0,-78.0,-86.0,-78.0,-87.0,12.0,14.0,13.0,16.0,1
4079,CC:2F:71:3E:C5:1F,3226834,407528228,11406,1395371,3215428,406132857,6,48681,4077013,40229,3075523,8452,1001490,12027,34,16370,186,6,827,144444.0,39000.0,-69.0,-70.0,-67.0,-60.0,-67.0,-69.0,-66.0,-60.0,-78.0,-86.0,-78.0,-87.0,9.0,16.0,11.0,27.0,1
4080,CC:2F:71:3F:1F:24,8881884,9056791712,5666456,8650658855,3215428,406132857,80,1316525,805208034,1307983,804182238,8542,1025796,1263316,619,5671167,578005,80,5848,130000.0,43333.0,-69.0,-64.0,-70.0,-68.0,-69.0,-64.0,-71.0,-68.0,-78.0,-86.0,-78.0,-87.0,9.0,22.0,8.0,19.0,1
4081,F8:59:71:5A:E0:3D,3357425,615032893,141991,208899510,3215434,406133383,0,140136,167387066,135323,166811954,4813,575112,117735,16,144705,2702,0,531,144444.0,43333.0,-66.0,-71.0,-65.0,-70.0,-66.0,-71.0,-64.0,-70.0,-78.0,-86.0,-78.0,-87.0,12.0,15.0,13.0,17.0,1
4082,CC:2F:71:3E:C5:1F,3226840,407528754,11406,1395371,3215434,406133383,6,48681,4077013,40229,3075523,8452,1001490,12027,34,16370,186,6,827,144444.0,39000.0,-69.0,-70.0,-67.0,-60.0,-67.0,-69.0,-66.0,-60.0,-78.0,-86.0,-78.0,-87.0,9.0,16.0,11.0,27.0,1
4083,CC:2F:71:3F:1F:24,8883500,9059283454,5668066,8653150071,3215434,406133383,80,1316834,805336715,1308292,804310919,8542,1025796,1263625,619,5672785,578035,80,5848,130000.0,43333.0,-70.0,-64.0,-72.0,-68.0,-70.0,-64.0,-71.0,-68.0,-78.0,-86.0,-78.0,-87.0,8.0,22.0,6.0,19.0,1
4084,F8:59:71:5A:E0:3D,3357492,615132667,142056,208999082,3215436,406133585,0,140201,167485732,135388,166910620,4813,575112,117800,16,144770,2702,0,531,144444.0,43333.0,-66.0,-71.0,-65.0,-70.0,-66.0,-71.0,-65.0,-70.0,-78.0,-86.0,-78.0,-87.0,12.0,15.0,13.0,17.0,1
4085,CC:2F:71:3E:C5:1F,3226842,407528956,11406,1395371,3215436,406133585,6,48681,4077013,40229,3075523,8452,1001490,12027,34,16370,186,6,827,144444.0,39000.0,-69.0,-70.0,-67.0,-60.0,-67.0,-69.0,-66.0,-60.0,-78.0,-86.0,-78.0,-87.0,9.0,16.0,11.0,27.0,1
4086,CC:2F:71:3F:1F:24,8884965,9061546286,5669527,8655412499,3215438,406133787,80,1317117,805460381,1308575,804434585,8542,1025796,1263908,619,5674200,578121,80,5849,130000.0,43333.0,-70.0,-64.0,-72.0,-68.0,-69.0,-63.0,-71.0,-68.0,-78.0,-86.0,-78.0,-87.0,8.0,22.0,6.0,19.0,1
4087,F8:59:71:5A:E0:3D,3357562,615235635,142122,209101646,3215440,406133989,0,140267,167587386,135454,167012274,4813,575112,117865,16,144836,2704,0,531,144444.0,43333.0,-66.0,-72.0,-66.0,-71.0,-66.0,-72.0,-65.0,-71.0,-78.0,-86.0,-78.0,-87.0,12.0,14.0,12.0,16.0,1
4088,CC:2F:71:3E:C5:1F,3226848,407529562,11406,1395371,3215442,406134191,6,48681,4077013,40229,3075523,8452,1001490,12027,34,16370,186,6,827,144444.0,39000.0,-69.0,-70.0,-67.0,-60.0,-67.0,-69.0,-66.0,-60.0,-78.0,-86.0,-78.0,-87.0,9.0,16.0,11.0,27.0,1
4089,CC:2F:71:3F:1F:24,8886945,9064624674,5671503,8658490483,3215442,406134191,80,1317417,805590345,1308875,804564549,8542,1025796,1264208,619,5676222,578196,80,5849,130000.0,43333.0,-70.0,-64.0,-71.0,-68.0,-70.0,-64.0,-71.0,-68.0,-78.0,-86.0,-78.0,-87.0,8.0,22.0,7.0,19.0,1
4090,F8:59:71:5A:E0:3D,3357631,615335555,142186,209201102,3215445,406134453,0,140332,167687542,135519,167112430,4813,575112,117930,16,144900,2706,0,532,144444.0,43333.0,-66.0,-72.0,-66.0,-71.0,-66.0,-72.0,-65.0,-71.0,-78.0,-86.0,-78.0,-87.0,12.0,14.0,12.0,16.0,1
4091,CC:2F:71:3E:C5:1F,3226851,407529824,11406,1395371,3215445,406134453,6,48681,4077013,40229,3075523,8452,1001490,12027,34,16370,186,6,827,144444.0,39000.0,-69.0,-70.0,-67.0,-60.0,-67.0,-69.0,-66.0,-60.0,-78.0,-86.0,-78.0,-87.0,9.0,16.0,11.0,27.0,1
4092,CC:2F:71:3F:1F:24,8888454,9066961036,5673009,8660826583,3215445,406134453,80,1317672,805712229,1309130,804686433,8542,1025796,1264463,619,5677728,578343,80,5849,130000.0,43333.0,-69.0,-64.0,-71.0,-67.0,-69.0,-64.0,-71.0,-67.0,-78.0,-86.0,-78.0,-87.0,9.0,22.0,7.0,20.0,1
4093,F8:59:71:5A:E0:3D,3357698,615433861,142249,209299004,3215449,406134857,0,140394,167783022,135581,167207910,4813,575112,117992,16,144963,2706,0,532,144444.0,43333.0,-66.0,-72.0,-66.0,-71.0,-66.0,-72.0,-65.0,-70.0,-78.0,-86.0,-78.0,-87.0,12.0,14.0,12.0,16.0,1
4094,CC:2F:71:3E:C5:1F,3226855,407530228,11406,1395371,3215449,406134857,6,48681,4077013,40229,3075523,8452,1001490,12027,34,16370,186,6,827,144444.0,39000.0,-69.0,-70.0,-67.0,-60.0,-67.0,-69.0,-66.0,-60.0,-78.0,-86.0,-78.0,-87.0,9.0,16.0,11.0,27.0,1
4095,CC:2F:71:3F:1F:24,8890314,9069840986,5674863,8663705927,3215451,406135059,80,1317985,805844243,1309443,804818447,8542,1025796,1264776,619,5679582,578576,80,5849,130000.0,43333.0,-70.0,-65.0,-71.0,-68.0,-69.0,-64.0,-71.0,-67.0,-79.0,-87.0,-79.0,-87.0,9.0,22.0,8.0,19.0,1
4096,F8:59:71:5A:E0:3D,3357769,615538383,142316,209403122,3215453,406135261,0,140462,167887742,135649,167312630,4813,575112,118060,16,145030,2707,0,532,144444.0,43333.0,-66.0,-72.0,-65.0,-70.0,-66.0,-72.0,-65.0,-70.0,-79.0,-87.0,-79.0,-87.0,13.0,15.0,14.0,17.0,1
4097,CC:2F:71:3E:C5:1F,3226859,407530632,11406,1395371,3215453,406135261,6,48681,4077013,40229,3075523,8452,1001490,12027,34,16370,186,6,827,144444.0,39000.0,-69.0,-70.0,-67.0,-60.0,-67.0,-69.0,-66.0,-60.0,-79.0,-87.0,-79.0,-87.0,10.0,17.0,12.0,27.0,1
4098,CC:2F:71:3F:1F:24,8891681,9071953062,5676228,8665817801,3215453,406135261,80,1318243,805966559,1309701,804940763,8542,1025796,1265034,619,5680947,578993,80,5849,115556.0,28889.0,-69.0,-64.0,-72.0,-69.0,-68.0,-64.0,-71.0,-69.0,-79.0,-87.0,-79.0,-87.0,10.0,23.0,7.0,18.0,1
4099,F8:59:71:5A:E0:3D,3357837,615636749,142379,209501024,3215458,406135725,0,140524,167983222,135711,167408110,4813,575112,118122,16,145093,2707,0,532,144444.0,43333.0,-66.0,-72.0,-65.0,-70.0,-66.0,-71.0,-64.0,-70.0,-79.0,-87.0,-79.0,-87.0,13.0,15.0,14.0,17.0,1
4100,CC:2F:71:3E:C5:1F,3226864,407531096,11406,1395371,3215458,406135725,6,48681,4077013,40229,3075523,8452,1001490,12027,34,16370,186,6,827,144444.0,39000.0,-69.0,-70.0,-67.0,-60.0,-67.0,-69.0,-66.0,-60.0,-79.0,-87.0,-79.0,-87.0,10.0,17.0,12.0,27.0,1
4101,CC:2F:71:3F:1F:24,8892803,9073674608,5677345,8667538883,3215458,406135725,80,1318467,806084951,1309925,805059155,8542,1025796,1265258,619,5682040,579111,80,5849,115556.0,28889.0,-69.0,-64.0,-71.0,-67.0,-69.0,-64.0,-71.0,-67.0,-79.0,-87.0,-79.0,-87.0,10.0,23.0,8.0,20.0,1
4102,F8:59:71:5A:E0:3D,3357905,615736609,142443,209600480,3215462,406136129,0,140589,168083336,135776,167508224,4813,575112,118186,16,145157,2709,0,532,144444.0,43333.0,-66.0,-72.0,-65.0,-70.0,-66.0,-72.0,-64.0,-70.0,-79.0,-87.0,-79.0,-87.0,13.0,15.0,14.0,17.0,1
4103,CC:2F:71:3E:C5:1F,3226868,407531500,11406,1395371,3215462,406136129,6,48681,4077013,40229,3075523,8452,1001490,12027,34,16370,186,6,827,144444.0,39000.0,-69.0,-70.0,-67.0,-60.0,-67.0,-69.0,-66.0,-60.0,-79.0,-87.0,-79.0,-87.0,10.0,17.0,12.0,27.0,1
4104,CC:2F:71:3F:1F:24,8893731,9075092900,5678269,8668956771,3215462,406136129,80,1318653,806195947,1310111,805170151,8542,1025796,1265444,619,5682959,579183,80,5849,130000.0,39000.0,-69.0,-64.0,-71.0,-68.0,-69.0,-64.0,-71.0,-68.0,-79.0,-87.0,-79.0,-87.0,10.0,23.0,8.0,19.0,1
4105,F8:59:71:5A:E0:3D,3357970,615834713,142506,209698382,3215464,406136331,0,140652,168180356,135839,167605244,4813,575112,118249,16,145220,2709,0,532,144444.0,43333.0,-65.0,-72.0,-65.0,-70.0,-65.0,-72.0,-65.0,-70.0,-79.0,-87.0,-79.0,-87.0,14.0,15.0,14.0,17.0,1
4106,CC:2F:71:3E:C5:1F,3226870,407531702,11406,1395371,3215464,406136331,6,48681,4077013,40229,3075523,8452,1001490,12027,34,16370,186,6,827,144444.0,39000.0,-69.0,-70.0,-67.0,-60.0,-67.0,-69.0,-66.0,-60.0,-79.0,-87.0,-79.0,-87.0,10.0,17.0,12.0,27.0,1
4107,CC:2F:71:3F:1F:24,8894880,9076853590,5679414,8670717057,3215466,406136533,80,1318878,806313520,1310336,805287724,8542,1025796,1265669,619,5684133,579318,80,5850,130000.0,43333.0,-69.0,-65.0,-71.0,-68.0,-69.0,-64.0,-71.0,-68.0,-79.0,-87.0,-79.0,-87.0,10.0,22.0,8.0,19.0,1
4108,F8:59:71:5A:E0:3D,3358040,615933281,142569,209796284,3215471,406136997,0,140715,168277376,135902,167702264,4813,575112,118312,16,145283,2709,0,532,144444.0,43333.0,-66.0,-72.0,-65.0,-70.0,-66.0,-72.0,-64.0,-70.0,-79.0,-87.0,-79.0,-87.0,13.0,15.0,14.0,17.0,1
4109,CC:2F:71:3E:C5:1F,3226877,407532368,11406,1395371,3215471,406136997,6,48681,4077013,40229,3075523,8452,1001490,12027,34,16370,186,6,827,144444.0,39000.0,-69.0,-70.0,-67.0,-60.0,-67.0,-69.0,-66.0,-60.0,-79.0,-87.0,-79.0,-87.0,10.0,17.0,12.0,27.0,1
4110,CC:2F:71:3F:1F:24,8896566,9079464680,5681095,8673327683,3215471,406136997,80,1319156,806438186,1310614,805412390,8542,1025796,1265947,619,5685796,579616,80,5850,130000.0,43333.0,-69.0,-65.0,-72.0,-68.0,-69.0,-64.0,-71.0,-67.0,-79.0,-87.0,-79.0,-87.0,10.0,22.0,7.0,19.0,1
4111,F8:59:71:5A:E0:3D,3358104,616029831,142631,209892632,3215473,406137199,0,140778,168374396,135965,167799284,4813,575112,118375,16,145345,2710,0,532,144444.0,43333.0,-66.0,-72.0,-65.0,-70.0,-66.0,-71.0,-64.0,-70.0,-79.0,-87.0,-79.0,-87.0,13.0,15.0,14.0,17.0,1
4112,CC:2F:71:3E:C5:1F,3226879,407532570,11406,1395371,3215473,406137199,6,48681,4077013,40229,3075523,8452,1001490,12027,34,16370,186,6,827,144444.0,39000.0,-69.0,-70.0,-67.0,-60.0,-67.0,-69.0,-66.0,-60.0,-79.0,-87.0,-79.0,-87.0,10.0,17.0,12.0,27.0,1
4113,CC:2F:71:3F:1F:24,8898328,9082200642,5682855,8676063443,3215473,406137199,80,1319471,806564532,1310929,805538736,8542,1025796,1266262,619,5687540,579717,80,5850,130000.0,43333.0,-70.0,-64.0,-72.0,-68.0,-69.0,-64.0,-71.0,-68.0,-79.0,-87.0,-79.0,-87.0,9.0,23.0,7.0,19.0,1
4114,F8:59:71:5A:E0:3D,3358172,616128410,142694,209990534,3215478,406137876,0,140840,168469876,136027,167894764,4813,575112,118437,16,145408,2712,0,532,144444.0,43333.0,-66.0,-72.0,-64.0,-71.0,-66.0,-71.0,-64.0,-70.0,-79.0,-87.0,-79.0,-87.0,13.0,15.0,15.0,16.0,1
4115,CC:2F:71:3E:C5:1F,3226885,407533307,11406,1395371,3215479,406137936,6,48681,4077013,40229,3075523,8452,1001490,12027,34,16370,186,6,827,144444.0,39000.0,-69.0,-70.0,-67.0,-60.0,-67.0,-69.0,-66.0,-60.0,-79.0,-87.0,-79.0,-87.0,10.0,17.0,12.0,27.0,1
4116,CC:2F:71:3F:1F:24,8899868,9084577509,5684387,8678439371,3215481,406138138,80,1319745,806687148,1311203,805661352,8542,1025796,1266536,619,5689106,579841,80,5850,130000.0,43333.0,-69.0,-65.0,-71.0,-68.0,-68.0,-64.0,-71.0,-68.0,-79.0,-87.0,-79.0,-87.0,10.0,22.0,8.0,19.0,1
4117,F8:59:71:5A:E0:3D,3358241,616228330,142758,210089990,3215483,406138340,0,140904,168568436,136091,167993324,4813,575112,118501,16,145472,2712,0,532,144444.0,43333.0,-66.0,-72.0,-65.0,-70.0,-66.0,-72.0,-64.0,-70.0,-79.0,-87.0,-79.0,-87.0,13.0,15.0,14.0,17.0,1
4118,CC:2F:71:3E:C5:1F,3226889,407533711,11406,1395371,3215483,406138340,6,48681,4077013,40229,3075523,8452,1001490,12027,34,16370,186,6,827,144444.0,39000.0,-69.0,-70.0,-67.0,-60.0,-67.0,-69.0,-66.0,-60.0,-79.0,-87.0,-79.0,-87.0,10.0,17.0,12.0,27.0,1
4119,CC:2F:71:3F:1F:24,8901403,9086955003,5685920,8680816663,3215483,406138340,80,1320000,806809398,1311458,805783602,8542,1025796,1266791,619,5690616,579903,80,5851,130000.0,43333.0,-70.0,-64.0,-71.0,-68.0,-70.0,-64.0,-71.0,-68.0,-79.0,-87.0,-79.0,-87.0,9.0,23.0,8.0,19.0,1
4120,F8:59:71:5A:E0:3D,3358310,616328306,142823,210189562,3215487,406138744,0,140969,168667102,136156,168091990,4813,575112,118566,16,145536,2713,0,532,144444.0,43333.0,-66.0,-71.0,-65.0,-70.0,-66.0,-71.0,-64.0,-70.0,-79.0,-87.0,-79.0,-87.0,13.0,16.0,14.0,17.0,1
4121,CC:2F:71:3E:C5:1F,3226893,407534115,11406,1395371,3215487,406138744,6,48681,4077013,40229,3075523,8452,1001490,12027,34,16370,186,6,827,144444.0,39000.0,-69.0,-70.0,-67.0,-60.0,-67.0,-69.0,-66.0,-60.0,-79.0,-87.0,-79.0,-87.0,10.0,17.0,12.0,27.0,1
4122,CC:2F:71:3F:1F:24,8902817,9089132719,5687330,8682993975,3215487,406138744,80,1320258,806930801,1311716,805905005,8542,1025796,1267049,619,5692049,580047,80,5852,130000.0,43333.0,-70.0,-64.0,-72.0,-69.0,-70.0,-64.0,-71.0,-68.0,-79.0,-87.0,-79.0,-87.0,9.0,23.0,7.0,18.0,1
4123,F8:59:71:5A:E0:3D,3358375,616424916,142885,210285910,3215490,406139006,0,141031,168762582,136218,168187470,4813,575112,118628,16,145599,2713,0,532,144444.0,43333.0,-66.0,-72.0,-65.0,-71.0,-66.0,-71.0,-65.0,-70.0,-79.0,-87.0,-79.0,-87.0,13.0,15.0,14.0,16.0,1
4124,CC:2F:71:3E:C5:1F,3226898,407534579,11406,1395371,3215492,406139208,6,48681,4077013,40229,3075523,8452,1001490,12027,34,16370,186,6,827,144444.0,39000.0,-69.0,-70.0,-67.0,-60.0,-67.0,-69.0,-66.0,-60.0,-79.0,-87.0,-79.0,-87.0,10.0,17.0,12.0,27.0,1
4125,CC:2F:71:3F:1F:24,8903878,9090758007,5688386,8684618799,3215492,406139208,80,1320467,807046033,1311925,806020237,8542,1025796,1267258,619,5693105,580191,80,5853,130000.0,43333.0,-70.0,-64.0,-72.0,-68.0,-70.0,-64.0,-71.0,-67.0,-79.0,-87.0,-79.0,-87.0,9.0,23.0,7.0,19.0,1
4126,F8:59:71:5A:E0:3D,3358442,616523222,142948,210383812,3215494,406139410,0,141094,168859602,136281,168284490,4813,575112,118691,16,145662,2713,0,532,144444.0,43333.0,-66.0,-72.0,-65.0,-70.0,-66.0,-71.0,-65.0,-70.0,-79.0,-87.0,-79.0,-87.0,13.0,15.0,14.0,17.0,1
4127,CC:2F:71:3E:C5:1F,3226900,407534781,11406,1395371,3215494,406139410,6,48681,4077013,40229,3075523,8452,1001490,12027,34,16370,186,6,827,144444.0,39000.0,-69.0,-70.0,-67.0,-60.0,-67.0,-69.0,-66.0,-60.0,-79.0,-87.0,-79.0,-87.0,10.0,17.0,12.0,27.0,1
4128,CC:2F:71:3F:1F:24,8904608,9091866305,5689114,8685726895,3215494,406139410,80,1320642,807155929,1312100,806130133,8542,1025796,1267433,619,5693833,580283,80,5853,130000.0,39000.0,-70.0,-64.0,-72.0,-68.0,-70.0,-64.0,-71.0,-67.0,-79.0,-87.0,-79.0,-87.0,9.0,23.0,7.0,19.0,1
4129,F8:59:71:5A:E0:3D,3358511,616620458,143011,210480276,3215500,406140182,0,141156,168955082,136343,168379970,4813,575112,118753,16,145725,2714,0,532,144444.0,43333.0,-66.0,-72.0,-65.0,-70.0,-66.0,-71.0,-65.0,-70.0,-79.0,-87.0,-79.0,-87.0,13.0,15.0,14.0,17.0,1
4130,CC:2F:71:3E:C5:1F,3226907,407535669,11407,1395487,3215500,406140182,6,48683,4077153,40231,3075663,8452,1001490,12027,34,16371,186,6,827,144444.0,39000.0,-68.0,-71.0,-68.0,-61.0,-67.0,-68.0,-66.0,-60.0,-79.0,-87.0,-79.0,-87.0,11.0,16.0,11.0,26.0,1
4131,CC:2F:71:3F:1F:24,8905614,9093401991,5690114,8687261809,3215500,406140182,80,1320895,807276197,1312353,806250401,8542,1025796,1267684,619,5694833,580303,80,5853,130000.0,43333.0,-70.0,-64.0,-71.0,-68.0,-69.0,-64.0,-71.0,-68.0,-79.0,-87.0,-79.0,-87.0,9.0,23.0,8.0,19.0,1
4132,F8:59:71:5A:E0:3D,3358577,616718622,143074,210578178,3215503,406140444,0,141219,169052102,136406,168476990,4813,575112,118816,16,145788,2714,0,532,144444.0,43333.0,-66.0,-72.0,-64.0,-71.0,-66.0,-71.0,-64.0,-70.0,-79.0,-87.0,-79.0,-87.0,13.0,15.0,15.0,16.0,1
4133,CC:2F:71:3E:C5:1F,3226910,407535931,11407,1395487,3215503,406140444,6,48683,4077153,40231,3075663,8452,1001490,12027,34,16371,186,6,827,144444.0,39000.0,-68.0,-71.0,-68.0,-61.0,-67.0,-68.0,-66.0,-60.0,-79.0,-87.0,-79.0,-87.0,11.0,16.0,11.0,26.0,1
4134,CC:2F:71:3F:1F:24,8906673,9095017919,5691170,8688877475,3215503,406140444,80,1321166,807399013,1312624,806373217,8542,1025796,1267955,619,5695889,580427,80,5853,130000.0,43333.0,-70.0,-64.0,-72.0,-68.0,-70.0,-64.0,-71.0,-68.0,-79.0,-87.0,-79.0,-87.0,9.0,23.0,7.0,19.0,1
4135,F8:59:71:5A:E0:3D,3358647,616818684,143138,210677634,3215509,406141050,0,141283,169150662,136470,168575550,4813,575112,118880,16,145852,2714,0,532,144444.0,43333.0,-66.0,-72.0,-65.0,-71.0,-66.0,-71.0,-64.0,-70.0,-79.0,-87.0,-79.0,-87.0,13.0,15.0,14.0,16.0,1
4136,CC:2F:71:3E:C5:1F,3226916,407536537,11407,1395487,3215509,406141050,6,48683,4077153,40231,3075663,8452,1001490,12027,34,16371,186,6,827,144444.0,39000.0,-68.0,-71.0,-68.0,-61.0,-67.0,-68.0,-66.0,-60.0,-79.0,-87.0,-79.0,-87.0,11.0,16.0,11.0,26.0,1
4137,CC:2F:71:3F:1F:24,8907894,9096895675,5692385,8690754625,3215509,406141050,80,1321435,807522523,1312893,806496727,8542,1025796,1268223,619,5697098,580479,80,5853,130000.0,43333.0,-70.0,-64.0,-71.0,-68.0,-70.0,-64.0,-71.0,-67.0,-79.0,-87.0,-79.0,-87.0,9.0,23.0,8.0,19.0,1
4138,F8:59:71:5A:E0:3D,3358711,616915122,143200,210773870,3215511,406141252,0,141346,169247710,136533,168672598,4813,575112,118943,16,145914,2715,0,532,144444.0,43333.0,-66.0,-72.0,-65.0,-71.0,-66.0,-71.0,-65.0,-71.0,-79.0,-87.0,-79.0,-87.0,13.0,15.0,14.0,16.0,1
4139,CC:2F:71:3E:C5:1F,3226918,407536739,11407,1395487,3215511,406141252,6,48683,4077153,40231,3075663,8452,1001490,12027,34,16371,186,6,827,144444.0,39000.0,-68.0,-71.0,-68.0,-61.0,-67.0,-68.0,-66.0,-60.0,-79.0,-87.0,-79.0,-87.0,11.0,16.0,11.0,26.0,1
4140,CC:2F:71:3F:1F:24,8908807,9098291771,5693296,8692150519,3215511,406141252,80,1321656,807640607,1313114,806614811,8542,1025796,1268444,619,5698015,580579,80,5853,130000.0,43333.0,-69.0,-64.0,-71.0,-68.0,-70.0,-64.0,-71.0,-68.0,-79.0,-87.0,-79.0,-87.0,10.0,23.0,8.0,19.0,1
4141,F8:59:71:5A:E0:3D,3358783,617016742,143265,210874824,3215518,406141918,0,141410,169346298,136597,168771186,4813,575112,119007,16,145979,2716,0,533,144444.0,43333.0,-66.0,-72.0,-65.0,-70.0,-66.0,-71.0,-65.0,-70.0,-79.0,-87.0,-79.0,-87.0,13.0,15.0,14.0,17.0,1
4142,CC:2F:71:3E:C5:1F,3226925,407537405,11407,1395487,3215518,406141918,6,48683,4077153,40231,3075663,8452,1001490,12027,34,16371,186,6,827,144444.0,39000.0,-68.0,-71.0,-68.0,-61.0,-67.0,-68.0,-66.0,-60.0,-79.0,-87.0,-79.0,-87.0,11.0,16.0,11.0,26.0,1
4143,CC:2F:71:3F:1F:24,8909758,9099741949,5694240,8693600031,3215518,406141918,80,1321881,807759139,1313339,806733343,8542,1025796,1268669,619,5698959,580582,80,5853,130000.0,43333.0,-70.0,-64.0,-71.0,-68.0,-70.0,-64.0,-71.0,-68.0,-79.0,-87.0,-79.0,-87.0,9.0,23.0,8.0,19.0,1
4144,F8:59:71:5A:E0:3D,3358849,617114908,143328,210972726,3215521,406142182,0,141475,169446412,136662,168871300,4813,575112,119071,16,146042,2716,0,533,144444.0,43333.0,-66.0,-72.0,-65.0,-70.0,-65.0,-71.0,-64.0,-70.0,-79.0,-87.0,-79.0,-87.0,13.0,15.0,14.0,17.0,1
4145,CC:2F:71:3E:C5:1F,3226928,407537669,11407,1395487,3215521,406142182,6,48683,4077153,40231,3075663,8452,1001490,12027,34,16371,186,6,827,144444.0,39000.0,-68.0,-71.0,-68.0,-61.0,-67.0,-68.0,-66.0,-60.0,-79.0,-87.0,-79.0,-87.0,11.0,16.0,11.0,26.0,1
4146,CC:2F:71:3F:1F:24,8910908,9101501471,5695387,8695359289,3215521,406142182,80,1322123,807878572,1313580,806852658,8543,1025914,1268911,619,5700106,580746,80,5854,144444.0,43333.0,-70.0,-64.0,-71.0,-68.0,-69.0,-64.0,-71.0,-68.0,-79.0,-87.0,-79.0,-87.0,9.0,23.0,8.0,19.0,1
4147,F8:59:71:5A:E0:3D,3358919,617213478,143391,211070628,3215528,406142850,0,141538,169543432,136725,168968320,4813,575112,119134,16,146105,2716,0,533,144444.0,43333.0,-66.0,-72.0,-65.0,-70.0,-65.0,-71.0,-64.0,-70.0,-79.0,-87.0,-79.0,-87.0,13.0,15.0,14.0,17.0,1
4148,CC:2F:71:3E:C5:1F,3226935,407538337,11407,1395487,3215528,406142850,6,48685,4077341,40232,3075733,8453,1001608,12028,34,16371,186,6,827,144444.0,39000.0,-73.0,-82.0,-73.0,-71.0,-67.0,-70.0,-67.0,-61.0,-79.0,-87.0,-79.0,-87.0,6.0,5.0,6.0,16.0,1
4149,CC:2F:71:3F:1F:24,8912120,9103361781,5696592,8697218931,3215528,406142850,80,1322321,807993946,1313778,806968032,8543,1025914,1269109,619,5701311,580950,80,5855,130000.0,43333.0,-70.0,-64.0,-72.0,-68.0,-70.0,-63.0,-71.0,-68.0,-79.0,-87.0,-79.0,-87.0,9.0,23.0,7.0,19.0,1
4150,F8:59:71:5A:E0:3D,3358997,617318620,143455,211170084,3215542,406148536,0,141601,169640536,136788,169065424,4813,575112,119197,16,146169,2716,0,533,144444.0,43333.0,-66.0,-72.0,-65.0,-71.0,-66.0,-71.0,-64.0,-70.0,-79.0,-87.0,-79.0,-87.0,13.0,15.0,14.0,16.0,1
4151,CC:2F:71:3E:C5:1F,3226960,407549447,11407,1395487,3215553,406153960,6,48685,4077341,40232,3075733,8453,1001608,12028,34,16371,186,6,827,144444.0,39000.0,-73.0,-82.0,-73.0,-71.0,-67.0,-70.0,-67.0,-61.0,-79.0,-87.0,-79.0,-87.0,6.0,5.0,6.0,16.0,1
4152,CC:2F:71:3F:1F:24,8912915,9104547807,5697362,8698393847,3215553,406153960,80,1322500,808108536,1313957,807082622,8543,1025914,1269288,619,5702072,580995,80,5855,130000.0,43333.0,-70.0,-64.0,-72.0,-68.0,-70.0,-64.0,-72.0,-68.0,-79.0,-87.0,-79.0,-87.0,9.0,23.0,7.0,19.0,1
4153,F8:59:71:5A:E0:3D,3359077,617423966,143519,211269540,3215558,406154426,0,141666,169739214,136852,169163984,4814,575230,119262,16,146233,2717,0,533,144444.0,43333.0,-67.0,-72.0,-64.0,-71.0,-66.0,-72.0,-64.0,-70.0,-79.0,-87.0,-79.0,-87.0,12.0,15.0,15.0,16.0,1
4154,CC:2F:71:3E:C5:1F,3226967,407550115,11407,1395487,3215560,406154628,6,48685,4077341,40232,3075733,8453,1001608,12028,34,16371,186,6,827,144444.0,39000.0,-73.0,-82.0,-73.0,-71.0,-67.0,-70.0,-67.0,-61.0,-79.0,-87.0,-79.0,-87.0,6.0,5.0,6.0,16.0,1
4155,CC:2F:71:3F:1F:24,8913821,9105925553,5698261,8699770925,3215560,406154628,80,1322692,808220252,1314149,807194338,8543,1025914,1269480,619,5702959,581000,80,5855,130000.0,43333.0,-69.0,-64.0,-71.0,-68.0,-69.0,-63.0,-71.0,-68.0,-79.0,-87.0,-79.0,-87.0,10.0,23.0,8.0,19.0,1
4156,F8:59:71:5A:E0:3D,3359147,617525653,143584,211370550,3215563,406155103,0,141732,169840868,136918,169265638,4814,575230,119327,16,146298,2717,0,533,144444.0,43333.0,-66.0,-72.0,-65.0,-70.0,-66.0,-71.0,-64.0,-70.0,-79.0,-87.0,-79.0,-87.0,13.0,15.0,14.0,17.0,1
4157,CC:2F:71:3E:C5:1F,3226970,407550590,11407,1395487,3215563,406155103,6,48685,4077341,40232,3075733,8453,1001608,12028,34,16371,186,6,827,144444.0,39000.0,-73.0,-82.0,-73.0,-71.0,-67.0,-70.0,-67.0,-61.0,-79.0,-87.0,-79.0,-87.0,6.0,5.0,6.0,16.0,1
4158,CC:2F:71:3F:1F:24,8914877,9107538074,5699314,8701382971,3215563,406155103,80,1322935,808342749,1314392,807316835,8543,1025914,1269723,619,5704033,581058,80,5855,130000.0,43333.0,-71.0,-64.0,-72.0,-68.0,-70.0,-64.0,-71.0,-68.0,-79.0,-87.0,-79.0,-87.0,8.0,23.0,7.0,19.0,1
4159,F8:59:71:5A:E0:3D,3359211,617623615,143647,211468452,3215564,406155163,0,141795,169937888,136981,169362658,4814,575230,119390,16,146361,2717,0,533,144444.0,43333.0,-66.0,-72.0,-65.0,-71.0,-66.0,-72.0,-65.0,-71.0,-79.0,-87.0,-79.0,-87.0,13.0,15.0,14.0,16.0,1
4160,CC:2F:71:3E:C5:1F,3226975,407551054,11407,1395487,3215568,406155567,6,48685,4077341,40232,3075733,8453,1001608,12028,34,16371,186,6,827,144444.0,39000.0,-73.0,-82.0,-73.0,-71.0,-67.0,-70.0,-67.0,-61.0,-79.0,-87.0,-79.0,-87.0,6.0,5.0,6.0,16.0,1
4161,CC:2F:71:3F:1F:24,8916261,9109674432,5700693,8703518865,3215568,406155567,80,1323185,808465451,1314642,807439537,8543,1025914,1269973,619,5705411,581181,80,5855,130000.0,43333.0,-71.0,-64.0,-72.0,-68.0,-70.0,-64.0,-71.0,-68.0,-79.0,-87.0,-79.0,-87.0,8.0,23.0,7.0,19.0,1
4162,F8:59:71:5A:E0:3D,3359284,617725433,143712,211569462,3215572,406155971,0,141861,170039528,137047,169464298,4814,575230,119456,16,146426,2717,0,533,144444.0,43333.0,-66.0,-72.0,-64.0,-71.0,-66.0,-71.0,-64.0,-70.0,-79.0,-87.0,-79.0,-87.0,13.0,15.0,15.0,16.0,1
4163,CC:2F:71:3E:C5:1F,3226979,407551458,11407,1395487,3215572,406155971,6,48685,4077341,40232,3075733,8453,1001608,12028,34,16371,186,6,827,144444.0,39000.0,-73.0,-82.0,-73.0,-71.0,-67.0,-70.0,-67.0,-61.0,-79.0,-87.0,-79.0,-87.0,6.0,5.0,6.0,16.0,1
4164,CC:2F:71:3F:1F:24,8917802,9112059902,5702230,8705903931,3215572,406155971,80,1323427,808584459,1314884,807558545,8543,1025914,1270215,619,5706949,581404,80,5855,130000.0,43333.0,-70.0,-64.0,-72.0,-68.0,-69.0,-64.0,-71.0,-68.0,-79.0,-87.0,-79.0,-87.0,9.0,23.0,7.0,19.0,1
4165,F8:59:71:5A:E0:3D,3359347,617823335,143775,211667364,3215572,406155971,0,141925,170138102,137111,169562872,4814,575230,119519,16,146489,2717,0,533,144444.0,43333.0,-67.0,-72.0,-65.0,-71.0,-66.0,-72.0,-64.0,-70.0,-79.0,-87.0,-79.0,-87.0,12.0,15.0,14.0,16.0,1
4166,CC:2F:71:3E:C5:1F,3226979,407551458,11407,1395487,3215572,406155971,6,48685,4077341,40232,3075733,8453,1001608,12028,34,16371,186,6,827,144444.0,39000.0,-73.0,-82.0,-73.0,-71.0,-67.0,-70.0,-67.0,-61.0,-79.0,-87.0,-79.0,-87.0,6.0,5.0,6.0,16.0,1
4167,CC:2F:71:3F:1F:24,8919069,9114017684,5703497,8707861713,3215572,406155971,80,1323670,808703543,1315127,807677629,8543,1025914,1270458,619,5708216,581464,80,5855,130000.0,43333.0,-70.0,-64.0,-72.0,-69.0,-70.0,-64.0,-71.0,-68.0,-79.0,-87.0,-79.0,-87.0,9.0,23.0,7.0,18.0,1
4168,F8:59:71:5A:E0:3D,3359417,617921903,143838,211765266,3215579,406156637,0,141988,170235136,137174,169659906,4814,575230,119581,16,146552,2717,0,533,144444.0,43333.0,-66.0,-72.0,-64.0,-70.0,-65.0,-71.0,-64.0,-70.0,-79.0,-87.0,-79.0,-87.0,13.0,15.0,15.0,17.0,1
4169,CC:2F:71:3E:C5:1F,3226986,407552124,11407,1395487,3215579,406156637,6,48685,4077341,40232,3075733,8453,1001608,12028,34,16371,186,6,827,144444.0,39000.0,-73.0,-82.0,-73.0,-71.0,-67.0,-70.0,-67.0,-61.0,-79.0,-87.0,-79.0,-87.0,6.0,5.0,6.0,16.0,1
4170,CC:2F:71:3F:1F:24,8920145,9115661926,5704564,8709505087,3215581,406156839,80,1323846,808813689,1315303,807787775,8543,1025914,1270634,619,5709283,581701,80,5856,130000.0,39000.0,-70.0,-64.0,-71.0,-68.0,-69.0,-64.0,-71.0,-68.0,-79.0,-87.0,-79.0,-87.0,9.0,23.0,8.0,19.0,1
4171,F8:59:71:5A:E0:3D,3359481,618018453,143900,211861614,3215581,406156839,0,142051,170332156,137237,169756926,4814,575230,119644,16,146614,2718,0,533,144444.0,43333.0,-66.0,-72.0,-65.0,-70.0,-66.0,-72.0,-64.0,-70.0,-79.0,-87.0,-79.0,-87.0,13.0,15.0,14.0,17.0,1
4172,CC:2F:71:3E:C5:1F,3226988,407552326,11407,1395487,3215581,406156839,6,48685,4077341,40232,3075733,8453,1001608,12028,34,16371,186,6,827,144444.0,39000.0,-73.0,-82.0,-73.0,-71.0,-67.0,-70.0,-67.0,-61.0,-79.0,-87.0,-79.0,-87.0,6.0,5.0,6.0,16.0,1
4173,CC:2F:71:3F:1F:24,8921454,9117679692,5705873,8711522853,3215581,406156839,80,1324084,808934129,1315541,807908215,8543,1025914,1270872,619,5710592,581800,80,5856,130000.0,43333.0,-70.0,-64.0,-72.0,-68.0,-70.0,-64.0,-71.0,-68.0,-79.0,-87.0,-79.0,-87.0,9.0,23.0,7.0,19.0,1
4174,F8:59:71:5A:E0:3D,3359551,618118515,143964,211961070,3215587,406157445,0,142114,170429176,137300,169853946,4814,575230,119707,16,146678,2719,0,533,144444.0,43333.0,-66.0,-72.0,-65.0,-71.0,-66.0,-71.0,-64.0,-70.0,-79.0,-87.0,-79.0,-87.0,13.0,15.0,14.0,16.0,1
4175,CC:2F:71:3E:C5:1F,3226995,407552992,11407,1395487,3215588,406157505,6,48685,4077341,40232,3075733,8453,1001608,12028,34,16371,186,6,827,144444.0,39000.0,-73.0,-82.0,-73.0,-71.0,-67.0,-70.0,-67.0,-61.0,-79.0,-87.0,-79.0,-87.0,6.0,5.0,6.0,16.0,1
4176,CC:2F:71:3F:1F:24,8922552,9119361692,5706964,8713204187,3215588,406157505,80,1324284,809048321,1315741,808022407,8543,1025914,1271072,619,5711683,581982,80,5857,144444.0,43333.0,-70.0,-64.0,-72.0,-68.0,-69.0,-64.0,-72.0,-68.0,-79.0,-87.0,-79.0,-87.0,9.0,23.0,7.0,19.0,1
4177,F8:59:71:5A:E0:3D,3359617,618216679,144027,212058972,3215590,406157707,0,142178,170527736,137364,169952506,4814,575230,119771,16,146741,2720,0,533,144444.0,43333.0,-66.0,-72.0,-65.0,-70.0,-66.0,-72.0,-64.0,-70.0,-79.0,-87.0,-79.0,-87.0,13.0,15.0,14.0,17.0,1
4178,CC:2F:71:3E:C5:1F,3227005,407556104,11407,1395487,3215598,406160617,6,48685,4077341,40232,3075733,8453,1001608,12028,34,16371,186,6,827,144444.0,39000.0,-73.0,-82.0,-73.0,-71.0,-67.0,-70.0,-67.0,-61.0,-79.0,-87.0,-79.0,-87.0,6.0,5.0,6.0,16.0,1
4179,CC:2F:71:3F:1F:24,8923328,9120531952,5707730,8714371335,3215598,406160617,80,1324524,809167177,1315981,808141263,8543,1025914,1271312,619,5712449,581988,80,5857,130000.0,43333.0,-70.0,-64.0,-71.0,-69.0,-70.0,-64.0,-71.0,-68.0,-79.0,-87.0,-79.0,-87.0,9.0,23.0,8.0,18.0,1
4180,F8:59:71:5A:E0:3D,3359694,618318097,144090,212156874,3215604,406161223,0,142240,170623216,137426,170047986,4814,575230,119833,16,146804,2720,0,533,144444.0,43333.0,-66.0,-72.0,-65.0,-70.0,-66.0,-71.0,-65.0,-70.0,-79.0,-87.0,-79.0,-87.0,13.0,15.0,14.0,17.0,1
4181,CC:2F:71:3E:C5:1F,3227011,407556710,11407,1395487,3215604,406161223,6,48685,4077341,40232,3075733,8453,1001608,12028,34,16371,186,6,827,144444.0,39000.0,-73.0,-82.0,-73.0,-71.0,-67.0,-70.0,-67.0,-61.0,-79.0,-87.0,-79.0,-87.0,6.0,5.0,6.0,16.0,1
4182,CC:2F:71:3F:1F:24,8924267,9121963096,5708663,8715801873,3215604,406161223,80,1324731,809283493,1316188,808257579,8543,1025914,1271519,619,5713382,582012,80,5857,144444.0,43333.0,-69.0,-64.0,-71.0,-68.0,-69.0,-64.0,-71.0,-68.0,-79.0,-87.0,-79.0,-87.0,10.0,23.0,8.0,19.0,1
4183,F8:59:71:5A:E0:3D,3359760,618416261,144153,212254776,3215607,406161485,0,142304,170721776,137490,170146546,4814,575230,119897,16,146867,2721,0,533,144444.0,43333.0,-67.0,-72.0,-64.0,-71.0,-66.0,-71.0,-64.0,-70.0,-79.0,-87.0,-79.0,-87.0,12.0,15.0,15.0,16.0,1
4184,CC:2F:71:3E:C5:1F,3227014,407556972,11407,1395487,3215607,406161485,6,48685,4077341,40232,3075733,8453,1001608,12028,34,16371,186,6,827,144444.0,39000.0,-73.0,-82.0,-73.0,-71.0,-67.0,-70.0,-67.0,-61.0,-79.0,-87.0,-79.0,-87.0,6.0,5.0,6.0,16.0,1
4185,CC:2F:71:3F:1F:24,8925273,9123498448,5709666,8717336963,3215607,406161485,80,1324961,809400180,1316418,808374266,8543,1025914,1271749,619,5714385,582090,80,5857,144444.0,43333.0,-71.0,-64.0,-71.0,-68.0,-70.0,-64.0,-71.0,-68.0,-79.0,-87.0,-79.0,-87.0,8.0,23.0,8.0,19.0,1
4186,F8:59:71:5A:E0:3D,3359829,618514769,144216,212352678,3215613,406162091,0,142367,170818796,137553,170243566,4814,575230,119960,16,146930,2722,0,533,144444.0,43333.0,-66.0,-71.0,-65.0,-70.0,-66.0,-71.0,-64.0,-70.0,-79.0,-87.0,-79.0,-87.0,13.0,16.0,14.0,17.0,1
4187,CC:2F:71:3E:C5:1F,3227020,407557578,11407,1395487,3215613,406162091,6,48685,4077341,40232,3075733,8453,1001608,12028,34,16371,186,6,827,144444.0,39000.0,-73.0,-82.0,-73.0,-71.0,-67.0,-70.0,-67.0,-61.0,-79.0,-87.0,-79.0,-87.0,6.0,5.0,6.0,16.0,1
4188,CC:2F:71:3F:1F:24,8926371,9125182054,5710758,8719019963,3215613,406162091,80,1325218,809522398,1316675,808496484,8543,1025914,1272006,619,5715477,582188,80,5858,130000.0,43333.0,-70.0,-64.0,-72.0,-68.0,-70.0,-64.0,-71.0,-68.0,-79.0,-87.0,-79.0,-87.0,9.0,23.0,7.0,19.0,1
4189,F8:59:71:5A:E0:3D,3359894,618612873,144279,212450580,3215615,406162293,0,142430,170915830,137616,170340600,4814,575230,120022,16,146993,2722,0,533,144444.0,43333.0,-66.0,-72.0,-65.0,-70.0,-66.0,-71.0,-64.0,-70.0,-79.0,-87.0,-79.0,-87.0,13.0,15.0,14.0,17.0,1
4190,CC:2F:71:3E:C5:1F,3227022,407557780,11407,1395487,3215615,406162293,6,48685,4077341,40232,3075733,8453,1001608,12028,34,16371,186,6,827,144444.0,39000.0,-73.0,-82.0,-73.0,-71.0,-67.0,-70.0,-67.0,-61.0,-79.0,-87.0,-79.0,-87.0,6.0,5.0,6.0,16.0,1
4191,CC:2F:71:3F:1F:24,8927232,9126496014,5711617,8720333721,3215615,406162293,80,1325444,809636754,1316901,808610840,8543,1025914,1272232,619,5716336,582230,80,5858,130000.0,43333.0,-70.0,-64.0,-71.0,-68.0,-70.0,-64.0,-71.0,-68.0,-79.0,-87.0,-79.0,-87.0,9.0,23.0,8.0,19.0,1
4192,F8:59:71:5A:E0:3D,3359957,618709281,144341,212546928,3215616,406162353,0,142492,171011310,137678,170436080,4814,575230,120084,16,147055,2722,0,533,144444.0,43333.0,-66.0,-72.0,-65.0,-71.0,-66.0,-72.0,-65.0,-70.0,-79.0,-87.0,-79.0,-87.0,13.0,15.0,14.0,16.0,1
4193,CC:2F:71:3E:C5:1F,3227027,407558244,11407,1395487,3215620,406162757,6,48685,4077341,40232,3075733,8453,1001608,12028,34,16371,186,6,827,144444.0,39000.0,-73.0,-82.0,-73.0,-71.0,-67.0,-70.0,-67.0,-61.0,-79.0,-87.0,-79.0,-87.0,6.0,5.0,6.0,16.0,1
4194,CC:2F:71:3F:1F:24,8928409,9128302788,5712787,8722139829,3215622,406162959,80,1325699,809757196,1317156,808731282,8543,1025914,1272487,619,5717477,582341,80,5858,130000.0,39000.0,-70.0,-64.0,-71.0,-68.0,-70.0,-64.0,-71.0,-68.0,-79.0,-87.0,-79.0,-87.0,9.0,23.0,8.0,19.0,1
4195,F8:59:71:5A:E0:3D,3360028,618807991,144404,212644830,3215624,406163161,0,142556,171109870,137742,170534640,4814,575230,120148,16,147118,2723,0,533,144444.0,43333.0,-66.0,-73.0,-65.0,-70.0,-66.0,-72.0,-65.0,-70.0,-79.0,-87.0,-79.0,-87.0,13.0,14.0,14.0,17.0,1
4196,CC:2F:71:3E:C5:1F,3227031,407558648,11407,1395487,3215624,406163161,6,48685,4077341,40232,3075733,8453,1001608,12028,34,16371,186,6,827,144444.0,39000.0,-73.0,-82.0,-73.0,-71.0,-67.0,-70.0,-67.0,-61.0,-79.0,-87.0,-79.0,-87.0,6.0,5.0,6.0,16.0,1
4197,CC:2F:71:3F:1F:24,8929192,9129484396,5713568,8723321235,3215624,406163161,80,1325939,809877975,1317396,808852061,8543,1025914,1272727,619,5718287,582502,80,5858,115556.0,28889.0,-69.0,-64.0,-73.0,-70.0,-68.0,-64.0,-72.0,-69.0,-79.0,-87.0,-79.0,-87.0,10.0,23.0,6.0,17.0,1
4198,F8:59:71:5A:E0:3D,3360093,618907720,144468,212744286,3215625,406163434,0,142620,171208430,137806,170633200,4814,575230,120212,16,147182,2724,0,533,144444.0,43333.0,-67.0,-72.0,-64.0,-70.0,-67.0,-72.0,-64.0,-70.0,-79.0,-87.0,-79.0,-87.0,12.0,15.0,15.0,17.0,1
4199,CC:2F:71:3E:C5:1F,3227032,407558921,11407,1395487,3215625,406163434,6,48685,4077341,40232,3075733,8453,1001608,12028,34,16371,186,6,827,144444.0,39000.0,-73.0,-82.0,-73.0,-71.0,-67.0,-70.0,-67.0,-61.0,-79.0,-87.0,-79.0,-87.0,6.0,5.0,6.0,16.0,1
4200,CC:2F:71:3F:1F:24,8930218,9131060575,5714593,8724897141,3215625,406163434,80,1326147,809991589,1317604,808965675,8543,1025914,1272935,619,5719312,582611,80,5858,115556.0,28889.0,-69.0,-64.0,-72.0,-70.0,-68.0,-64.0,-72.0,-70.0,-79.0,-87.0,-79.0,-87.0,10.0,23.0,7.0,17.0,1
4201,F8:59:71:5A:E0:3D,3360162,619004734,144530,212840634,3215632,406164100,0,142682,171303910,137868,170728680,4814,575230,120274,16,147244,2726,0,533,144444.0,43333.0,-67.0,-72.0,-64.0,-71.0,-66.0,-72.0,-64.0,-70.0,-79.0,-87.0,-79.0,-87.0,12.0,15.0,15.0,16.0,1
4202,CC:2F:71:3E:C5:1F,3227041,407559789,11407,1395487,3215634,406164302,6,48685,4077341,40232,3075733,8453,1001608,12028,34,16371,186,6,827,144444.0,39000.0,-73.0,-82.0,-73.0,-71.0,-67.0,-70.0,-67.0,-61.0,-79.0,-87.0,-79.0,-87.0,6.0,5.0,6.0,16.0,1
4203,CC:2F:71:3F:1F:24,8931341,9132779095,5715707,8726614793,3215634,406164302,80,1326373,810108741,1317830,809082827,8543,1025914,1273161,619,5720426,582692,80,5858,115556.0,26000.0,-68.0,-65.0,-70.0,-69.0,-68.0,-64.0,-70.0,-68.0,-79.0,-87.0,-79.0,-87.0,11.0,22.0,9.0,18.0,1
4204,F8:59:71:5A:E0:3D,3360229,619105946,144595,212941644,3215634,406164302,0,142747,171404010,137933,170828780,4814,575230,120339,16,147309,2726,0,533,144444.0,43333.0,-66.0,-72.0,-64.0,-71.0,-66.0,-72.0,-64.0,-70.0,-79.0,-87.0,-79.0,-87.0,13.0,15.0,15.0,16.0,1
4205,CC:2F:71:3E:C5:1F,3227041,407559789,11407,1395487,3215634,406164302,6,48685,4077341,40232,3075733,8453,1001608,12028,34,16371,186,6,827,144444.0,39000.0,-73.0,-82.0,-73.0,-71.0,-67.0,-70.0,-67.0,-61.0,-79.0,-87.0,-79.0,-87.0,6.0,5.0,6.0,16.0,1
4206,CC:2F:71:3F:1F:24,8932574,9134681659,5716940,8728517357,3215634,406164302,80,1326609,810229943,1318066,809204029,8543,1025914,1273397,619,5721658,582726,80,5858,115556.0,28889.0,-68.0,-64.0,-70.0,-68.0,-68.0,-64.0,-70.0,-68.0,-79.0,-87.0,-79.0,-87.0,11.0,23.0,9.0,19.0,1
4207,F8:59:71:5A:E0:3D,3360300,619205956,144660,213041048,3215640,406164908,0,142813,171504244,137999,170929014,4814,575230,120403,16,147374,2727,0,533,144444.0,43333.0,-66.0,-73.0,-65.0,-71.0,-66.0,-72.0,-65.0,-70.0,-79.0,-87.0,-79.0,-87.0,13.0,14.0,14.0,16.0,1
4208,CC:2F:71:3E:C5:1F,3227047,407560395,11407,1395487,3215640,406164908,6,48685,4077341,40232,3075733,8453,1001608,12028,34,16371,186,6,827,144444.0,39000.0,-73.0,-82.0,-73.0,-71.0,-67.0,-70.0,-67.0,-61.0,-79.0,-87.0,-79.0,-87.0,6.0,5.0,6.0,16.0,1
4209,CC:2F:71:3F:1F:24,8933785,9136537617,5718143,8730372507,3215642,406165110,80,1326853,810354891,1318310,809328977,8543,1025914,1273641,619,5722862,582848,80,5858,115556.0,28889.0,-69.0,-64.0,-71.0,-68.0,-68.0,-64.0,-70.0,-68.0,-79.0,-87.0,-79.0,-87.0,10.0,23.0,8.0,19.0,1
4210,F8:59:71:5A:E0:3D,3360369,619308782,144726,213143612,3215643,406165170,0,142880,171607424,138066,171032194,4814,575230,120470,16,147440,2727,0,533,144444.0,43333.0,-66.0,-72.0,-65.0,-70.0,-66.0,-72.0,-64.0,-70.0,-79.0,-87.0,-79.0,-87.0,13.0,15.0,14.0,17.0,1
4211,CC:2F:71:3E:C5:1F,3227050,407560657,11407,1395487,3215643,406165170,6,48685,4077341,40232,3075733,8453,1001608,12028,34,16371,186,6,827,144444.0,39000.0,-73.0,-82.0,-73.0,-71.0,-67.0,-70.0,-67.0,-61.0,-79.0,-87.0,-79.0,-87.0,6.0,5.0,6.0,16.0,1
4212,CC:2F:71:3F:1F:24,8935092,9138551903,5719449,8732386733,3215643,406165170,80,1327142,810478430,1318599,809452516,8543,1025914,1273930,619,5724168,582958,80,5858,115556.0,28889.0,-68.0,-64.0,-71.0,-69.0,-68.0,-64.0,-70.0,-68.0,-79.0,-87.0,-79.0,-87.0,11.0,23.0,8.0,18.0,1
4213,F8:59:71:5A:E0:3D,3360437,619405736,144788,213239960,3215649,406165776,0,142941,171701364,138127,171126134,4814,575230,120531,16,147502,2727,0,533,144444.0,43333.0,-66.0,-72.0,-65.0,-70.0,-66.0,-71.0,-64.0,-70.0,-79.0,-87.0,-79.0,-87.0,13.0,15.0,14.0,17.0,1
4214,CC:2F:71:3E:C5:1F,3227056,407561263,11407,1395487,3215649,406165776,6,48685,4077341,40232,3075733,8453,1001608,12028,34,16371,186,6,827,144444.0,39000.0,-73.0,-82.0,-73.0,-71.0,-67.0,-70.0,-67.0,-61.0,-79.0,-87.0,-79.0,-87.0,6.0,5.0,6.0,16.0,1
4215,CC:2F:71:3F:1F:24,8936466,9140669397,5720817,8734503621,3215649,406165776,80,1327422,810603166,1318879,809577252,8543,1025914,1274210,619,5725536,583153,80,5858,115556.0,28889.0,-69.0,-64.0,-71.0,-68.0,-68.0,-64.0,-70.0,-68.0,-79.0,-87.0,-79.0,-87.0,10.0,23.0,8.0,19.0,1
4216,F8:59:71:5A:E0:3D,3360505,619505572,144853,213339532,3215652,406166040,0,143006,171800042,138191,171224694,4815,575348,120596,16,147567,2727,0,533,144444.0,43333.0,-67.0,-72.0,-64.0,-70.0,-66.0,-72.0,-64.0,-70.0,-79.0,-87.0,-79.0,-87.0,12.0,15.0,15.0,17.0,1
4217,CC:2F:71:3E:C5:1F,3227060,407561643,11408,1395603,3215652,406166040,6,48687,4077481,40234,3075873,8453,1001608,12028,34,16372,186,6,827,144444.0,39000.0,-69.0,-71.0,-67.0,-60.0,-68.0,-70.0,-67.0,-61.0,-79.0,-87.0,-79.0,-87.0,10.0,16.0,12.0,27.0,1
4218,CC:2F:71:3F:1F:24,8937565,9142356143,5721913,8736190103,3215652,406166040,80,1327680,810725474,1319137,809699560,8543,1025914,1274468,619,5726607,583210,80,5858,115556.0,28889.0,-68.0,-64.0,-71.0,-69.0,-68.0,-64.0,-71.0,-69.0,-79.0,-87.0,-79.0,-87.0,11.0,23.0,8.0,18.0,1
4219,F8:59:71:5A:E0:3D,3360576,619605694,144917,213438988,3215659,406166706,0,143071,171900142,138256,171324794,4815,575348,120661,16,147631,2727,0,533,144444.0,43333.0,-66.0,-72.0,-65.0,-70.0,-66.0,-72.0,-65.0,-70.0,-79.0,-87.0,-79.0,-87.0,13.0,15.0,14.0,17.0,1
4220,CC:2F:71:3E:C5:1F,3227067,407562309,11408,1395603,3215659,406166706,6,48687,4077481,40234,3075873,8453,1001608,12028,34,16372,186,6,827,144444.0,39000.0,-69.0,-71.0,-67.0,-60.0,-68.0,-70.0,-67.0,-61.0,-79.0,-87.0,-79.0,-87.0,10.0,16.0,12.0,27.0,1
4221,CC:2F:71:3F:1F:24,8938860,9144347481,5723201,8738180775,3215659,406166706,80,1327933,810847128,1319390,809821214,8543,1025914,1274721,619,5727914,583342,80,5858,115556.0,28889.0,-68.0,-64.0,-71.0,-69.0,-68.0,-64.0,-71.0,-68.0,-79.0,-87.0,-79.0,-87.0,11.0,23.0,8.0,18.0,1
4222,F8:59:71:5A:E0:3D,3360641,619703798,144980,213536890,3215661,406166908,0,143135,171998716,138320,171423368,4815,575348,120724,16,147694,2727,0,533,144444.0,43333.0,-67.0,-72.0,-64.0,-70.0,-66.0,-72.0,-64.0,-70.0,-79.0,-87.0,-79.0,-87.0,12.0,15.0,15.0,17.0,1
4223,CC:2F:71:3E:C5:1F,3227069,407562511,11408,1395603,3215661,406166908,6,48687,4077481,40234,3075873,8453,1001608,12028,34,16372,186,6,827,144444.0,39000.0,-69.0,-71.0,-67.0,-60.0,-68.0,-70.0,-67.0,-61.0,-79.0,-87.0,-79.0,-87.0,10.0,16.0,12.0,27.0,1
4224,CC:2F:71:3F:1F:24,8940593,9147028804,5724930,8740861447,3215663,406167357,80,1328246,810977893,1319703,809951979,8543,1025914,1275027,619,5729649,583422,80,5858,115556.0,28889.0,-68.0,-64.0,-70.0,-68.0,-68.0,-64.0,-70.0,-68.0,-79.0,-87.0,-79.0,-87.0,11.0,23.0,9.0,19.0,1
4225,F8:59:71:5A:E0:3D,3360712,619805661,145045,213637900,3215667,406167761,0,143200,172098816,138385,171523468,4815,575348,120789,16,147759,2729,0,533,144444.0,43333.0,-67.0,-73.0,-65.0,-71.0,-66.0,-72.0,-65.0,-70.0,-79.0,-87.0,-79.0,-87.0,12.0,14.0,14.0,16.0,1
4226,CC:2F:71:3E:C5:1F,3227075,407563364,11408,1395603,3215667,406167761,6,48687,4077481,40234,3075873,8453,1001608,12028,34,16372,186,6,827,144444.0,39000.0,-69.0,-71.0,-67.0,-60.0,-68.0,-70.0,-67.0,-61.0,-79.0,-87.0,-79.0,-87.0,10.0,16.0,12.0,27.0,1
4227,CC:2F:71:3F:1F:24,8942116,9149383116,5726447,8743215153,3215669,406167963,80,1328534,811106623,1319991,810080709,8543,1025914,1275306,619,5731166,583664,80,5858,115556.0,28889.0,-68.0,-64.0,-71.0,-68.0,-68.0,-64.0,-70.0,-68.0,-79.0,-87.0,-79.0,-87.0,11.0,23.0,8.0,19.0,1
4228,F8:59:71:5A:E0:3D,3360782,619904476,145108,213735802,3215674,406168674,0,143263,172195836,138448,171620488,4815,575348,120852,16,147822,2729,0,533,144444.0,43333.0,-67.0,-72.0,-65.0,-71.0,-66.0,-72.0,-64.0,-70.0,-79.0,-87.0,-79.0,-87.0,12.0,15.0,14.0,16.0,1
4229,CC:2F:71:3E:C5:1F,3227082,407564277,11408,1395603,3215674,406168674,6,48687,4077481,40234,3075873,8453,1001608,12028,34,16372,186,6,827,144444.0,39000.0,-69.0,-71.0,-67.0,-60.0,-68.0,-70.0,-67.0,-61.0,-79.0,-87.0,-79.0,-87.0,10.0,16.0,12.0,27.0,1
4230,CC:2F:71:3F:1F:24,8943564,9151618833,5727890,8745450159,3215674,406168674,80,1328875,811250703,1320332,810224789,8543,1025914,1275614,619,5732609,583975,80,5858,115556.0,28889.0,-69.0,-64.0,-71.0,-68.0,-68.0,-64.0,-70.0,-68.0,-79.0,-87.0,-79.0,-87.0,10.0,23.0,8.0,19.0,1
4231,F8:59:71:5A:E0:3D,3360849,620004359,145172,213835258,3215677,406169101,0,143326,172292856,138511,171717508,4815,575348,120915,16,147886,2730,0,533,144444.0,43333.0,-67.0,-72.0,-64.0,-71.0,-66.0,-72.0,-64.0,-70.0,-79.0,-87.0,-79.0,-87.0,12.0,15.0,15.0,16.0,1
4232,CC:2F:71:3E:C5:1F,3227086,407564928,11408,1395603,3215678,406169325,6,48687,4077481,40234,3075873,8453,1001608,12028,34,16372,186,6,827,144444.0,39000.0,-69.0,-71.0,-67.0,-60.0,-68.0,-70.0,-67.0,-61.0,-79.0,-87.0,-79.0,-87.0,10.0,16.0,12.0,27.0,1
4233,CC:2F:71:3F:1F:24,8944950,9153758736,5729272,8747589411,3215678,406169325,80,1329169,811374373,1320626,810348459,8543,1025914,1275904,619,5733981,584055,80,5858,115556.0,28889.0,-68.0,-64.0,-70.0,-68.0,-68.0,-64.0,-69.0,-68.0,-79.0,-87.0,-79.0,-87.0,11.0,23.0,9.0,19.0,1
4234,F8:59:71:5A:E0:3D,3360922,620106261,145237,213936268,3215685,406169993,0,143392,172394510,138577,171819162,4815,575348,120980,16,147951,2730,0,533,144444.0,43333.0,-66.0,-72.0,-64.0,-71.0,-66.0,-72.0,-64.0,-70.0,-79.0,-87.0,-79.0,-87.0,13.0,15.0,15.0,16.0,1
4235,CC:2F:71:3E:C5:1F,3227094,407565656,11408,1395603,3215686,406170053,6,48689,4077669,40235,3075943,8454,1001726,12029,34,16372,186,6,827,144444.0,39000.0,-69.0,-71.0,-67.0,-60.0,-69.0,-72.0,-68.0,-61.0,-79.0,-87.0,-79.0,-87.0,10.0,16.0,12.0,27.0,1
4236,CC:2F:71:3F:1F:24,8946586,9156279286,5730900,8750109233,3215686,406170053,80,1329458,811503678,1320915,810477764,8543,1025914,1276192,619,5735598,584119,80,5859,115556.0,28889.0,-69.0,-64.0,-70.0,-68.0,-69.0,-64.0,-70.0,-68.0,-79.0,-87.0,-79.0,-87.0,10.0,23.0,9.0,19.0,1
4237,F8:59:71:5A:E0:3D,3360991,620206428,145301,214035724,3215690,406170704,0,143458,172496178,138643,171920830,4815,575348,121044,16,148015,2730,0,533,144444.0,43333.0,-66.0,-72.0,-65.0,-70.0,-66.0,-72.0,-64.0,-70.0,-79.0,-87.0,-79.0,-87.0,13.0,15.0,14.0,17.0,1
4238,CC:2F:71:3E:C5:1F,3227098,407566307,11408,1395603,3215690,406170704,6,48689,4077669,40235,3075943,8454,1001726,12029,34,16372,186,6,827,144444.0,39000.0,-69.0,-71.0,-67.0,-60.0,-69.0,-72.0,-68.0,-61.0,-79.0,-87.0,-79.0,-87.0,10.0,16.0,12.0,27.0,1
4239,CC:2F:71:3F:1F:24,8948228,9158822741,5732538,8752652037,3215690,406170704,80,1329729,811628832,1321186,810602918,8543,1025914,1276462,619,5737241,584231,80,5859,130000.0,43333.0,-70.0,-64.0,-70.0,-68.0,-69.0,-64.0,-69.0,-68.0,-79.0,-87.0,-79.0,-87.0,9.0,23.0,9.0,19.0,1
4240,F8:59:71:5A:E0:3D,3361063,620309598,145367,214138288,3215696,406171310,0,143524,172597818,138709,172022470,4815,575348,121110,16,148081,2730,0,533,144444.0,43333.0,-66.0,-72.0,-66.0,-70.0,-66.0,-71.0,-65.0,-70.0,-79.0,-87.0,-79.0,-87.0,13.0,15.0,13.0,17.0,1
4241,CC:2F:71:3E:C5:1F,3227104,407566913,11408,1395603,3215696,406171310,6,48689,4077669,40235,3075943,8454,1001726,12029,34,16372,186,6,827,144444.0,39000.0,-69.0,-71.0,-67.0,-60.0,-69.0,-72.0,-68.0,-61.0,-79.0,-87.0,-79.0,-87.0,10.0,16.0,12.0,27.0,1
4242,CC:2F:71:3F:1F:24,8949541,9160842712,5733844,8754671129,3215697,406171583,80,1330003,811758772,1321460,810732858,8543,1025914,1276734,619,5738562,584430,80,5860,117000.0,39000.0,-67.0,-65.0,-72.0,-68.0,-67.0,-64.0,-71.0,-68.0,-79.0,-87.0,-79.0,-87.0,12.0,22.0,7.0,19.0,1
4243,F8:59:71:5A:E0:3D,3361129,620409387,145431,214237744,3215698,406171643,0,143588,172696378,138773,172121030,4815,575348,121174,16,148145,2730,0,533,144444.0,43333.0,-66.0,-72.0,-64.0,-70.0,-66.0,-71.0,-64.0,-70.0,-79.0,-87.0,-79.0,-87.0,13.0,15.0,15.0,17.0,1
4244,CC:2F:71:3E:C5:1F,3227108,407567448,11408,1395603,3215700,406171845,6,48689,4077669,40235,3075943,8454,1001726,12029,34,16372,186,6,827,144444.0,39000.0,-69.0,-71.0,-67.0,-60.0,-69.0,-72.0,-68.0,-61.0,-79.0,-87.0,-79.0,-87.0,10.0,16.0,12.0,27.0,1
4245,CC:2F:71:3F:1F:24,8950543,9162377708,5734843,8756205863,3215700,406171845,80,1330214,811872708,1321671,810846794,8543,1025914,1276945,619,5739562,584587,80,5860,115556.0,28889.0,-68.0,-64.0,-71.0,-68.0,-68.0,-64.0,-71.0,-68.0,-79.0,-87.0,-79.0,-87.0,11.0,23.0,8.0,19.0,1
4246,F8:59:71:5A:E0:3D,3361198,620507895,145494,214335646,3215704,406172249,0,143651,172793398,138836,172218050,4815,575348,121237,16,148208,2730,0,533,144444.0,43333.0,-66.0,-72.0,-65.0,-70.0,-66.0,-72.0,-64.0,-70.0,-79.0,-87.0,-79.0,-87.0,13.0,15.0,14.0,17.0,1
4247,CC:2F:71:3E:C5:1F,3227112,407567852,11408,1395603,3215704,406172249,6,48689,4077669,40235,3075943,8454,1001726,12029,34,16372,186,6,827,144444.0,39000.0,-69.0,-71.0,-67.0,-60.0,-69.0,-72.0,-68.0,-61.0,-79.0,-87.0,-79.0,-87.0,10.0,16.0,12.0,27.0,1
4248,CC:2F:71:3F:1F:24,8951879,9164436150,5736173,8758263699,3215706,406172451,80,1330525,812001208,1321982,810975294,8543,1025914,1277256,619,5740860,584879,80,5861,130000.0,43333.0,-69.0,-63.0,-72.0,-70.0,-68.0,-63.0,-71.0,-69.0,-79.0,-87.0,-79.0,-87.0,10.0,24.0,7.0,17.0,1
4249,F8:59:71:5A:E0:3D,3361263,620605999,145557,214433548,3215706,406172451,0,143714,172890418,138899,172315070,4815,575348,121300,16,148271,2730,0,533,144444.0,43333.0,-66.0,-72.0,-65.0,-71.0,-66.0,-72.0,-65.0,-71.0,-79.0,-87.0,-79.0,-87.0,13.0,15.0,14.0,16.0,1
4250,CC:2F:71:3E:C5:1F,3227114,407568054,11408,1395603,3215706,406172451,6,48689,4077669,40235,3075943,8454,1001726,12029,34,16372,186,6,827,144444.0,39000.0,-69.0,-71.0,-67.0,-60.0,-69.0,-72.0,-68.0,-61.0,-79.0,-87.0,-79.0,-87.0,10.0,16.0,12.0,27.0,1
4251,CC:2F:71:3F:1F:24,8953069,9166264350,5737363,8760091899,3215706,406172451,80,1330757,812119519,1322214,811093605,8543,1025914,1277488,619,5742051,585113,80,5861,115556.0,28889.0,-69.0,-64.0,-71.0,-68.0,-69.0,-64.0,-71.0,-67.0,-79.0,-87.0,-79.0,-87.0,10.0,23.0,8.0,19.0,1
4252,F8:59:71:5A:E0:3D,3361333,620704567,145620,214531450,3215713,406173117,0,143777,172987438,138962,172412090,4815,575348,121363,16,148334,2731,0,533,144444.0,43333.0,-67.0,-72.0,-65.0,-71.0,-66.0,-72.0,-65.0,-71.0,-79.0,-87.0,-79.0,-87.0,12.0,15.0,14.0,16.0,1
4253,CC:2F:71:3E:C5:1F,3227121,407568720,11408,1395603,3215713,406173117,6,48689,4077669,40235,3075943,8454,1001726,12029,34,16372,186,6,827,144444.0,39000.0,-69.0,-71.0,-67.0,-60.0,-69.0,-72.0,-68.0,-61.0,-79.0,-87.0,-79.0,-87.0,10.0,16.0,12.0,27.0,1
4254,CC:2F:71:3F:1F:24,8954307,9168162772,5738592,8761989453,3215715,406173319,80,1331033,812258167,1322490,811232253,8543,1025914,1277764,619,5743310,585183,80,5862,115556.0,28889.0,-70.0,-64.0,-72.0,-68.0,-70.0,-64.0,-71.0,-67.0,-79.0,-87.0,-79.0,-87.0,9.0,23.0,7.0,19.0,1
4255,F8:59:71:5A:E0:3D,3361410,620819827,145694,214646446,3215716,406173381,0,143852,173103078,139037,172527730,4815,575348,121438,16,148408,2734,0,533,144444.0,43333.0,-66.0,-72.0,-65.0,-70.0,-66.0,-71.0,-64.0,-70.0,-79.0,-87.0,-79.0,-87.0,13.0,15.0,14.0,17.0,1
4256,CC:2F:71:3E:C5:1F,3227124,407568984,11408,1395603,3215716,406173381,6,48689,4077669,40235,3075943,8454,1001726,12029,34,16372,186,6,827,144444.0,39000.0,-69.0,-71.0,-67.0,-60.0,-69.0,-72.0,-68.0,-61.0,-79.0,-87.0,-79.0,-87.0,10.0,16.0,12.0,27.0,1
4257,CC:2F:71:3F:1F:24,8955703,9170322624,5739987,8764149243,3215716,406173381,80,1331275,812377259,1322731,811351227,8544,1026032,1278006,619,5744697,585363,80,5862,115556.0,28889.0,-69.0,-64.0,-71.0,-68.0,-69.0,-64.0,-71.0,-67.0,-79.0,-87.0,-79.0,-87.0,10.0,23.0,8.0,19.0,1
4258,F8:59:71:5A:E0:3D,3361480,620918635,145757,214744348,3215723,406174287,0,143914,173198558,139099,172623210,4815,575348,121500,16,148471,2734,0,533,144444.0,43333.0,-66.0,-71.0,-65.0,-70.0,-66.0,-71.0,-65.0,-70.0,-79.0,-87.0,-79.0,-87.0,13.0,16.0,14.0,17.0,1
4259,CC:2F:71:3E:C5:1F,3227132,407569958,11408,1395603,3215724,406174355,6,48689,4077669,40235,3075943,8454,1001726,12029,34,16372,186,6,827,144444.0,39000.0,-69.0,-71.0,-67.0,-60.0,-69.0,-72.0,-68.0,-61.0,-79.0,-87.0,-79.0,-87.0,10.0,16.0,12.0,27.0,1
4260,CC:2F:71:3F:1F:24,8957002,9172318836,5741278,8766144481,3215724,406174355,80,1331562,812501527,1323018,811475495,8544,1026032,1278293,619,5745997,585436,80,5862,130000.0,43333.0,-70.0,-64.0,-72.0,-68.0,-70.0,-64.0,-71.0,-67.0,-79.0,-87.0,-79.0,-87.0,9.0,23.0,7.0,19.0,1
4261,F8:59:71:5A:E0:3D,3361547,621016867,145820,214842250,3215727,406174617,0,143978,173297118,139163,172721770,4815,575348,121564,16,148534,2735,0,533,144444.0,43333.0,-66.0,-71.0,-65.0,-71.0,-66.0,-71.0,-65.0,-70.0,-79.0,-87.0,-79.0,-87.0,13.0,16.0,14.0,16.0,1
4262,CC:2F:71:3E:C5:1F,3227135,407570220,11408,1395603,3215727,406174617,6,48689,4077669,40235,3075943,8454,1001726,12029,34,16372,186,6,827,144444.0,39000.0,-69.0,-71.0,-67.0,-60.0,-69.0,-72.0,-68.0,-61.0,-79.0,-87.0,-79.0,-87.0,10.0,16.0,12.0,27.0,1
4263,CC:2F:71:3F:1F:24,8958305,9174321406,5742578,8768146789,3215727,406174617,80,1331820,812622862,1323276,811596830,8544,1026032,1278551,619,5747268,585513,80,5862,130000.0,43333.0,-70.0,-64.0,-71.0,-68.0,-69.0,-64.0,-71.0,-67.0,-79.0,-87.0,-79.0,-87.0,9.0,23.0,8.0,19.0,1
4264,F8:59:71:5A:E0:3D,3361615,621116727,145884,214941706,3215731,406175021,0,144041,173394138,139226,172818790,4815,575348,121627,16,148598,2736,0,533,144444.0,43333.0,-66.0,-71.0,-65.0,-70.0,-66.0,-71.0,-65.0,-70.0,-79.0,-87.0,-79.0,-87.0,13.0,16.0,14.0,17.0,1
4265,CC:2F:71:3E:C5:1F,3227139,407570624,11408,1395603,3215731,406175021,6,48689,4077669,40235,3075943,8454,1001726,12029,34,16372,186,6,827,144444.0,39000.0,-69.0,-71.0,-67.0,-60.0,-69.0,-72.0,-68.0,-61.0,-79.0,-87.0,-79.0,-87.0,10.0,16.0,12.0,27.0,1
4266,CC:2F:71:3F:1F:24,8959426,9176044260,5743695,8769869239,3215731,406175021,80,1332023,812737258,1323479,811711226,8544,1026032,1278754,619,5748381,585592,80,5862,130000.0,39000.0,-70.0,-65.0,-72.0,-68.0,-70.0,-64.0,-71.0,-68.0,-79.0,-87.0,-79.0,-87.0,9.0,22.0,7.0,19.0,1
4267,F8:59:71:5A:E0:3D,3361682,621215033,145947,215039608,3215735,406175425,0,144104,173491158,139289,172915810,4815,575348,121690,16,148661,2738,0,533,144444.0,43333.0,-65.0,-71.0,-65.0,-71.0,-65.0,-71.0,-65.0,-70.0,-79.0,-87.0,-79.0,-87.0,14.0,16.0,14.0,16.0,1
4268,CC:2F:71:3E:C5:1F,3227143,407571028,11408,1395603,3215735,406175425,6,48689,4077669,40235,3075943,8454,1001726,12029,34,16372,186,6,827,144444.0,39000.0,-69.0,-71.0,-67.0,-60.0,-69.0,-72.0,-68.0,-61.0,-79.0,-87.0,-79.0,-87.0,10.0,16.0,12.0,27.0,1
4269,CC:2F:71:3F:1F:24,8960689,9177989654,5744954,8771814229,3215735,406175425,80,1332256,812855274,1323712,811829242,8544,1026032,1278987,619,5749673,585679,80,5862,130000.0,43333.0,-70.0,-64.0,-71.0,-68.0,-70.0,-64.0,-71.0,-68.0,-79.0,-87.0,-79.0,-87.0,9.0,23.0,8.0,19.0,1
4270,F8:59:71:5A:E0:3D,3361749,621314751,146011,215139064,3215738,406175687,0,144168,173589718,139353,173014370,4815,575348,121754,16,148725,2739,0,533,144444.0,43333.0,-66.0,-72.0,-65.0,-71.0,-65.0,-71.0,-65.0,-70.0,-79.0,-87.0,-79.0,-87.0,13.0,15.0,14.0,16.0,1
4271,CC:2F:71:3E:C5:1F,3227148,407571492,11408,1395603,3215740,406175889,6,48689,4077669,40235,3075943,8454,1001726,12029,34,16372,186,6,827,144444.0,39000.0,-69.0,-71.0,-67.0,-60.0,-69.0,-72.0,-68.0,-61.0,-79.0,-87.0,-79.0,-87.0,10.0,16.0,12.0,27.0,1
4272,CC:2F:71:3F:1F:24,8962127,9180209800,5746387,8774033911,3215740,406175889,80,1332509,812979804,1323965,811953772,8544,1026032,1279240,619,5751065,585801,80,5862,130000.0,43333.0,-70.0,-64.0,-72.0,-67.0,-70.0,-64.0,-71.0,-67.0,-79.0,-87.0,-79.0,-87.0,9.0,23.0,7.0,20.0,1
4273,F8:59:71:5A:E0:3D,3361820,621416311,146076,215240018,3215744,406176293,0,144233,173689818,139418,173114470,4815,575348,121819,16,148790,2740,0,533,130000.0,39000.0,-66.0,-72.0,-65.0,-71.0,-66.0,-71.0,-65.0,-70.0,-79.0,-87.0,-79.0,-87.0,13.0,15.0,14.0,16.0,1
4274,CC:2F:71:3E:C5:1F,3227152,407571896,11408,1395603,3215744,406176293,6,48689,4077669,40235,3075943,8454,1001726,12029,34,16372,186,6,827,144444.0,39000.0,-69.0,-71.0,-67.0,-60.0,-69.0,-72.0,-68.0,-61.0,-79.0,-87.0,-79.0,-87.0,10.0,16.0,12.0,27.0,1
4275,CC:2F:71:3F:1F:24,8963684,9182611314,5747940,8776435021,3215744,406176293,80,1332785,813106206,1324241,812080174,8544,1026032,1279516,619,5752659,585959,80,5862,117000.0,39000.0,-70.0,-64.0,-71.0,-68.0,-69.0,-64.0,-71.0,-67.0,-79.0,-87.0,-79.0,-87.0,9.0,23.0,8.0,19.0,1
4276,F8:59:71:5A:E0:3D,3361886,621515857,146140,215339362,3215746,406176495,0,144298,173789918,139483,173214570,4815,575348,121884,16,148854,2740,0,533,144444.0,43333.0,-66.0,-72.0,-65.0,-71.0,-65.0,-71.0,-65.0,-70.0,-79.0,-87.0,-79.0,-87.0,13.0,15.0,14.0,16.0,1
4277,CC:2F:71:3E:C5:1F,3227155,407572158,11408,1395603,3215747,406176555,6,48689,4077669,40235,3075943,8454,1001726,12029,34,16372,186,6,827,144444.0,39000.0,-69.0,-71.0,-67.0,-60.0,-69.0,-72.0,-68.0,-61.0,-79.0,-87.0,-79.0,-87.0,10.0,16.0,12.0,27.0,1
4278,CC:2F:71:3F:1F:24,8964939,9184545688,5749192,8778369133,3215747,406176555,80,1333049,813229344,1324505,812203312,8544,1026032,1279780,619,5753911,586007,80,5864,117000.0,39000.0,-71.0,-65.0,-71.0,-68.0,-70.0,-64.0,-71.0,-68.0,-79.0,-87.0,-79.0,-87.0,8.0,22.0,8.0,19.0,1
4279,F8:59:71:5A:E0:3D,3361958,621616105,146204,215438818,3215754,406177287,0,144362,173888478,139547,173313130,4815,575348,121948,16,148918,2740,0,533,144444.0,43333.0,-66.0,-71.0,-65.0,-70.0,-66.0,-71.0,-64.0,-70.0,-79.0,-87.0,-79.0,-87.0,13.0,16.0,14.0,17.0,1
4280,CC:2F:71:3E:C5:1F,3227162,407572890,11408,1395603,3215754,406177287,6,48689,4077669,40235,3075943,8454,1001726,12029,34,16372,186,6,827,144444.0,39000.0,-69.0,-71.0,-67.0,-60.0,-69.0,-72.0,-68.0,-61.0,-79.0,-87.0,-79.0,-87.0,10.0,16.0,12.0,27.0,1
4281,CC:2F:71:3F:1F:24,8966455,9186884867,5750701,8780707580,3215754,406177287,80,1333327,813352502,1324783,812326470,8544,1026032,1280058,619,5755420,586070,80,5864,130000.0,43333.0,-70.0,-64.0,-71.0,-67.0,-70.0,-64.0,-71.0,-67.0,-79.0,-87.0,-79.0,-87.0,9.0,23.0,8.0,20.0,1
4282,F8:59:71:5A:E0:3D,3362023,621714209,146267,215536720,3215756,406177489,0,144425,173985498,139610,173410150,4815,575348,122011,16,148981,2741,0,533,144444.0,43333.0,-66.0,-71.0,-65.0,-70.0,-66.0,-71.0,-65.0,-70.0,-79.0,-87.0,-79.0,-87.0,13.0,16.0,14.0,17.0,1
4283,CC:2F:71:3E:C5:1F,3227164,407573092,11408,1395603,3215756,406177489,6,48689,4077669,40235,3075943,8454,1001726,12029,34,16372,186,6,827,144444.0,39000.0,-69.0,-71.0,-67.0,-60.0,-69.0,-72.0,-68.0,-61.0,-79.0,-87.0,-79.0,-87.0,10.0,16.0,12.0,27.0,1
4284,CC:2F:71:3F:1F:24,8968092,9189423195,5752336,8783245706,3215756,406177489,80,1333605,813478606,1325061,812452574,8544,1026032,1280332,619,5757055,586274,80,5864,130000.0,39000.0,-70.0,-64.0,-71.0,-68.0,-70.0,-64.0,-71.0,-68.0,-79.0,-87.0,-79.0,-87.0,9.0,23.0,8.0,19.0,1
4285,F8:59:71:5A:E0:3D,3362096,621816158,146332,215637730,3215764,406178428,0,144489,174084058,139674,173508710,4815,575348,122075,16,149045,2741,0,533,144444.0,43333.0,-66.0,-71.0,-65.0,-71.0,-66.0,-71.0,-65.0,-70.0,-79.0,-87.0,-79.0,-87.0,13.0,16.0,14.0,16.0,1
4286,CC:2F:71:3E:C5:1F,3227172,407574031,11408,1395603,3215764,406178428,6,48689,4077669,40235,3075943,8454,1001726,12029,34,16372,186,6,827,144444.0,39000.0,-69.0,-71.0,-67.0,-60.0,-69.0,-72.0,-68.0,-61.0,-79.0,-87.0,-79.0,-87.0,10.0,16.0,12.0,27.0,1
4287,CC:2F:71:3F:1F:24,8969458,9191519110,5753694,8785340682,3215764,406178428,80,1333916,813607675,1325372,812581643,8544,1026032,1280643,619,5758413,586397,80,5864,130000.0,43333.0,-70.0,-64.0,-71.0,-68.0,-70.0,-64.0,-71.0,-68.0,-79.0,-87.0,-79.0,-87.0,9.0,23.0,8.0,19.0,1
4288,F8:59:71:5A:E0:3D,3362161,621914262,146395,215735632,3215766,406178630,0,144552,174181078,139737,173605730,4815,575348,122138,16,149108,2742,0,533,144444.0,43333.0,-66.0,-72.0,-65.0,-70.0,-66.0,-71.0,-64.0,-70.0,-79.0,-87.0,-79.0,-87.0,13.0,15.0,14.0,17.0,1
4289,CC:2F:71:3E:C5:1F,3227174,407574233,11408,1395603,3215766,406178630,6,48689,4077669,40235,3075943,8454,1001726,12029,34,16372,186,6,827,144444.0,39000.0,-69.0,-71.0,-67.0,-60.0,-69.0,-72.0,-68.0,-61.0,-79.0,-87.0,-79.0,-87.0,10.0,16.0,12.0,27.0,1
4290,CC:2F:71:3F:1F:24,8970721,9193467626,5754955,8787288996,3215766,406178630,80,1334165,813727475,1325621,812701443,8544,1026032,1280892,619,5759649,586464,80,5864,130000.0,43333.0,-70.0,-64.0,-72.0,-68.0,-70.0,-64.0,-71.0,-68.0,-79.0,-87.0,-79.0,-87.0,9.0,23.0,7.0,19.0,1
4291,F8:59:71:5A:E0:3D,3362236,622018470,146466,215839436,3215770,406179034,0,144625,174285083,139810,173709735,4815,575348,122211,16,149180,2742,0,533,144444.0,43333.0,-66.0,-72.0,-65.0,-70.0,-66.0,-71.0,-65.0,-70.0,-79.0,-87.0,-79.0,-87.0,13.0,15.0,14.0,17.0,1
4292,CC:2F:71:3E:C5:1F,3227178,407574637,11408,1395603,3215770,406179034,6,48689,4077669,40235,3075943,8454,1001726,12029,34,16372,186,6,827,144444.0,39000.0,-69.0,-71.0,-67.0,-60.0,-69.0,-72.0,-68.0,-61.0,-79.0,-87.0,-79.0,-87.0,10.0,16.0,12.0,27.0,1
4293,CC:2F:71:3F:1F:24,8972282,9195881606,5756510,8789702370,3215772,406179236,80,1334437,813855731,1325893,812829699,8544,1026032,1281164,619,5761229,586527,80,5864,130000.0,43333.0,-69.0,-64.0,-71.0,-70.0,-69.0,-64.0,-71.0,-69.0,-79.0,-87.0,-79.0,-87.0,10.0,23.0,8.0,17.0,1
4294,F8:59:71:5A:E0:3D,3362305,622118390,146530,215938892,3215775,406179498,0,144690,174385197,139875,173809849,4815,575348,122275,16,149244,2742,0,533,144444.0,43333.0,-66.0,-72.0,-65.0,-70.0,-65.0,-71.0,-65.0,-70.0,-79.0,-87.0,-79.0,-87.0,13.0,15.0,14.0,17.0,1
4295,CC:2F:71:3E:C5:1F,3227183,407575101,11408,1395603,3215775,406179498,6,48689,4077669,40235,3075943,8454,1001726,12029,34,16372,186,6,827,144444.0,39000.0,-69.0,-71.0,-67.0,-60.0,-69.0,-72.0,-68.0,-61.0,-79.0,-87.0,-79.0,-87.0,10.0,16.0,12.0,27.0,1
4296,CC:2F:71:3F:1F:24,8973532,9197808090,5757757,8791628592,3215775,406179498,80,1334665,813971813,1326121,812945781,8544,1026032,1281392,619,5762476,586582,80,5864,130000.0,43333.0,-70.0,-64.0,-72.0,-70.0,-69.0,-64.0,-72.0,-70.0,-79.0,-87.0,-79.0,-87.0,9.0,23.0,7.0,17.0,1
4297,F8:59:71:5A:E0:3D,3362371,622216754,146593,216036794,3215778,406179960,0,144753,174482217,139938,173906869,4815,575348,122338,16,149307,2742,0,533,144444.0,43333.0,-67.0,-72.0,-65.0,-71.0,-66.0,-72.0,-65.0,-71.0,-79.0,-87.0,-79.0,-87.0,12.0,15.0,14.0,16.0,1
4298,CC:2F:71:3E:C5:1F,3227188,407575765,11408,1395603,3215780,406180162,6,48689,4077669,40235,3075943,8454,1001726,12029,34,16372,186,6,827,144444.0,39000.0,-69.0,-71.0,-67.0,-60.0,-69.0,-72.0,-68.0,-61.0,-79.0,-87.0,-79.0,-87.0,10.0,16.0,12.0,27.0,1
4299,CC:2F:71:3F:1F:24,8974969,9200026882,5759189,8793846720,3215780,406180162,80,1334967,814100581,1326423,813074549,8544,1026032,1281694,619,5763870,586604,80,5865,130000.0,43333.0,-69.0,-64.0,-73.0,-70.0,-68.0,-64.0,-71.0,-69.0,-79.0,-87.0,-79.0,-87.0,10.0,23.0,6.0,17.0,1
4300,F8:59:71:5A:E0:3D,3362440,622316730,146658,216136366,3215782,406180364,0,144817,174580777,140002,174005429,4815,575348,122402,16,149372,2742,0,533,144444.0,43333.0,-66.0,-72.0,-65.0,-71.0,-66.0,-72.0,-65.0,-70.0,-79.0,-87.0,-79.0,-87.0,13.0,15.0,14.0,16.0,1
4301,CC:2F:71:3E:C5:1F,3227191,407576083,11409,1395719,3215782,406180364,6,48691,4077809,40237,3076083,8454,1001726,12029,34,16373,186,6,827,144444.0,39000.0,-69.0,-72.0,-67.0,-60.0,-69.0,-72.0,-68.0,-61.0,-79.0,-87.0,-79.0,-87.0,10.0,15.0,12.0,27.0,1
4302,CC:2F:71:3F:1F:24,8976516,9202414234,5760732,8796233668,3215784,406180566,80,1335246,814224468,1326702,813198436,8544,1026032,1281973,619,5765451,586814,80,5865,130000.0,43333.0,-69.0,-64.0,-72.0,-70.0,-69.0,-64.0,-71.0,-70.0,-79.0,-87.0,-79.0,-87.0,10.0,23.0,7.0,17.0,1
4303,F8:59:71:5A:E0:3D,3362506,622414894,146721,216234268,3215785,406180626,0,144879,174676257,140064,174100909,4815,575348,122464,16,149435,2744,0,533,144444.0,43333.0,-66.0,-72.0,-65.0,-70.0,-66.0,-71.0,-65.0,-70.0,-79.0,-87.0,-79.0,-87.0,13.0,15.0,14.0,17.0,1
4304,CC:2F:71:3E:C5:1F,3227194,407576345,11409,1395719,3215785,406180626,6,48691,4077809,40237,3076083,8454,1001726,12029,34,16373,186,6,827,144444.0,39000.0,-69.0,-72.0,-67.0,-60.0,-69.0,-72.0,-68.0,-61.0,-79.0,-87.0,-79.0,-87.0,10.0,15.0,12.0,27.0,1
4305,CC:2F:71:3F:1F:24,8977454,9203851151,5761669,8797670525,3215785,406180626,80,1335479,814342651,1326935,813316619,8544,1026032,1282206,619,5766388,586832,80,5865,130000.0,43333.0,-69.0,-64.0,-72.0,-70.0,-69.0,-64.0,-71.0,-70.0,-79.0,-87.0,-79.0,-87.0,10.0,23.0,7.0,17.0,1
4306,F8:59:71:5A:E0:3D,3362575,622513402,146784,216332170,3215791,406181232,0,144942,174773277,140127,174197929,4815,575348,122527,16,149498,2745,0,533,144444.0,43333.0,-66.0,-72.0,-65.0,-70.0,-65.0,-71.0,-65.0,-70.0,-79.0,-87.0,-79.0,-87.0,13.0,15.0,14.0,17.0,1
4307,CC:2F:71:3E:C5:1F,3227200,407576951,11409,1395719,3215791,406181232,6,48691,4077809,40237,3076083,8454,1001726,12029,34,16373,186,6,827,144444.0,39000.0,-69.0,-72.0,-67.0,-60.0,-69.0,-72.0,-68.0,-61.0,-79.0,-87.0,-79.0,-87.0,10.0,15.0,12.0,27.0,1
4308,CC:2F:71:3F:1F:24,8978378,9205260017,5762587,8799078785,3215791,406181232,80,1335704,814459627,1327160,813433595,8544,1026032,1282431,619,5767306,586888,80,5866,130000.0,43333.0,-70.0,-64.0,-72.0,-69.0,-69.0,-64.0,-71.0,-69.0,-79.0,-87.0,-79.0,-87.0,9.0,23.0,7.0,18.0,1
4309,F8:59:71:5A:E0:3D,3362640,622611506,146847,216430072,3215793,406181434,0,145006,174871851,140191,174296503,4815,575348,122590,16,149561,2745,0,533,144444.0,43333.0,-66.0,-71.0,-65.0,-71.0,-66.0,-71.0,-65.0,-70.0,-79.0,-87.0,-79.0,-87.0,13.0,16.0,14.0,16.0,1
4310,CC:2F:71:3E:C5:1F,3227202,407577153,11409,1395719,3215793,406181434,6,48691,4077809,40237,3076083,8454,1001726,12029,34,16373,186,6,827,144444.0,39000.0,-69.0,-72.0,-67.0,-60.0,-69.0,-72.0,-68.0,-61.0,-79.0,-87.0,-79.0,-87.0,10.0,15.0,12.0,27.0,1
4311,CC:2F:71:3F:1F:24,8979707,9207315601,5763914,8801134167,3215793,406181434,80,1335917,814575175,1327373,813549143,8544,1026032,1282644,619,5768592,586956,80,5866,130000.0,43333.0,-69.0,-64.0,-72.0,-70.0,-69.0,-64.0,-72.0,-70.0,-79.0,-87.0,-79.0,-87.0,10.0,23.0,7.0,17.0,1
4312,F8:59:71:5A:E0:3D,3362710,622710074,146910,216527974,3215800,406182100,0,145070,174970411,140255,174395063,4815,575348,122654,16,149624,2745,0,533,144444.0,43333.0,-67.0,-72.0,-66.0,-71.0,-66.0,-72.0,-65.0,-70.0,-79.0,-87.0,-79.0,-87.0,12.0,15.0,13.0,16.0,1
4313,CC:2F:71:3E:C5:1F,3227209,407577819,11409,1395719,3215800,406182100,6,48691,4077809,40237,3076083,8454,1001726,12029,34,16373,186,6,827,144444.0,39000.0,-69.0,-72.0,-67.0,-60.0,-69.0,-72.0,-68.0,-61.0,-79.0,-87.0,-79.0,-87.0,10.0,15.0,12.0,27.0,1
4314,CC:2F:71:3F:1F:24,8980788,9208948831,5764988,8802766731,3215800,406182100,80,1336181,814698018,1327637,813671986,8544,1026032,1282908,619,5769707,587018,80,5866,130000.0,39000.0,-69.0,-64.0,-71.0,-70.0,-69.0,-64.0,-71.0,-70.0,-79.0,-87.0,-79.0,-87.0,10.0,23.0,8.0,17.0,1
4315,F8:59:71:5A:E0:3D,3362776,622808294,146974,216625992,3215802,406182302,0,145134,175067537,140319,174492189,4815,575348,122718,16,149688,2746,0,533,144444.0,43333.0,-66.0,-72.0,-66.0,-71.0,-66.0,-72.0,-65.0,-71.0,-79.0,-87.0,-79.0,-87.0,13.0,15.0,13.0,16.0,1
4316,CC:2F:71:3E:C5:1F,3227211,407578021,11409,1395719,3215802,406182302,6,48691,4077809,40237,3076083,8454,1001726,12029,34,16373,186,6,827,144444.0,39000.0,-69.0,-72.0,-67.0,-60.0,-69.0,-72.0,-68.0,-61.0,-79.0,-87.0,-79.0,-87.0,10.0,15.0,12.0,27.0,1
4317,CC:2F:71:3F:1F:24,8981733,9210395407,5765931,8804213105,3215802,406182302,80,1336428,814817618,1327884,813791586,8544,1026032,1283155,619,5770650,587041,80,5866,130000.0,43333.0,-68.0,-64.0,-72.0,-69.0,-68.0,-63.0,-72.0,-69.0,-79.0,-87.0,-79.0,-87.0,11.0,23.0,7.0,18.0,1
4318,F8:59:71:5A:E0:3D,3362846,622906918,147038,216724010,3215808,406182908,0,145199,175166217,140384,174590869,4815,575348,122782,16,149752,2746,0,533,144444.0,43333.0,-67.0,-72.0,-65.0,-70.0,-66.0,-72.0,-65.0,-70.0,-79.0,-87.0,-79.0,-87.0,12.0,15.0,14.0,17.0,1
4319,CC:2F:71:3E:C5:1F,3227217,407578627,11409,1395719,3215808,406182908,6,48691,4077809,40237,3076083,8454,1001726,12029,34,16373,186,6,827,144444.0,39000.0,-69.0,-72.0,-67.0,-60.0,-69.0,-72.0,-68.0,-61.0,-79.0,-87.0,-79.0,-87.0,10.0,15.0,12.0,27.0,1
4320,CC:2F:71:3F:1F:24,8982925,9212224539,5767117,8806041631,3215808,406182908,80,1336683,814938088,1328139,813912056,8544,1026032,1283410,619,5771836,587108,80,5866,130000.0,43333.0,-68.0,-64.0,-72.0,-69.0,-68.0,-64.0,-71.0,-69.0,-79.0,-87.0,-79.0,-87.0,11.0,23.0,7.0,18.0,1
4321,F8:59:71:5A:E0:3D,3362915,623005354,147101,216821912,3215814,406183442,0,145263,175263355,140447,174687889,4816,575466,122846,16,149815,2746,0,533,144444.0,43333.0,-66.0,-71.0,-65.0,-70.0,-66.0,-71.0,-65.0,-70.0,-79.0,-87.0,-79.0,-87.0,13.0,16.0,14.0,17.0,1
4322,CC:2F:71:3E:C5:1F,3227223,407579161,11409,1395719,3215814,406183442,6,48691,4077809,40237,3076083,8454,1001726,12029,34,16373,186,6,827,144444.0,39000.0,-69.0,-72.0,-67.0,-60.0,-69.0,-72.0,-68.0,-61.0,-79.0,-87.0,-79.0,-87.0,10.0,15.0,12.0,27.0,1
4323,CC:2F:71:3F:1F:24,8983929,9213757901,5768115,8807574459,3215814,406183442,80,1336911,815055598,1328367,814029566,8544,1026032,1283638,619,5772834,587197,80,5866,130000.0,43333.0,-68.0,-64.0,-71.0,-70.0,-68.0,-64.0,-71.0,-69.0,-79.0,-87.0,-79.0,-87.0,11.0,23.0,8.0,17.0,1
4324,F8:59:71:5A:E0:3D,3362984,623103862,147164,216919814,3215820,406184048,0,145326,175360375,140510,174784909,4816,575466,122909,16,149878,2746,0,533,144444.0,43333.0,-66.0,-71.0,-65.0,-70.0,-66.0,-71.0,-64.0,-70.0,-79.0,-87.0,-79.0,-87.0,13.0,16.0,14.0,17.0,1
4325,CC:2F:71:3E:C5:1F,3227229,407579767,11409,1395719,3215820,406184048,6,48691,4077809,40237,3076083,8454,1001726,12029,34,16373,186,6,827,144444.0,39000.0,-69.0,-72.0,-67.0,-60.0,-69.0,-72.0,-68.0,-61.0,-79.0,-87.0,-79.0,-87.0,10.0,15.0,12.0,27.0,1
4326,CC:2F:71:3F:1F:24,8985295,9215855447,5769475,8809671399,3215820,406184048,80,1337198,815183097,1328654,814157065,8544,1026032,1283925,619,5774194,587248,80,5866,130000.0,43333.0,-68.0,-64.0,-72.0,-69.0,-68.0,-63.0,-71.0,-69.0,-79.0,-87.0,-79.0,-87.0,11.0,23.0,7.0,18.0,1
4327,F8:59:71:5A:E0:3D,3363053,623205463,147230,217020940,3215823,406184523,0,145393,175462163,140577,174886697,4816,575466,122975,16,149944,2747,0,533,144444.0,43333.0,-66.0,-72.0,-65.0,-70.0,-66.0,-71.0,-65.0,-70.0,-79.0,-87.0,-79.0,-87.0,13.0,15.0,14.0,17.0,1
4328,CC:2F:71:3E:C5:1F,3227232,407580242,11409,1395719,3215823,406184523,6,48691,4077809,40237,3076083,8454,1001726,12029,34,16373,186,6,827,144444.0,39000.0,-69.0,-72.0,-67.0,-60.0,-69.0,-72.0,-68.0,-61.0,-79.0,-87.0,-79.0,-87.0,10.0,15.0,12.0,27.0,1
4329,CC:2F:71:3F:1F:24,8986259,9217327832,5770435,8811143249,3215824,406184583,80,1337468,815306925,1328924,814280893,8544,1026032,1284195,619,5775146,587261,80,5866,130000.0,43333.0,-69.0,-64.0,-72.0,-69.0,-68.0,-63.0,-71.0,-69.0,-79.0,-87.0,-79.0,-87.0,10.0,23.0,7.0,18.0,1
4330,F8:59:71:5A:E0:3D,3363119,623306533,147295,217121950,3215824,406184583,0,145457,175560723,140641,174985257,4816,575466,123039,16,150009,2747,0,533,144444.0,43333.0,-66.0,-72.0,-65.0,-70.0,-66.0,-71.0,-65.0,-70.0,-79.0,-87.0,-79.0,-87.0,13.0,15.0,14.0,17.0,1
4331,CC:2F:71:3E:C5:1F,3227237,407580706,11409,1395719,3215828,406184987,6,48691,4077809,40237,3076083,8454,1001726,12029,34,16373,186,6,827,144444.0,39000.0,-69.0,-72.0,-67.0,-60.0,-69.0,-72.0,-68.0,-61.0,-79.0,-87.0,-79.0,-87.0,10.0,15.0,12.0,27.0,1
4332,CC:2F:71:3F:1F:24,8987078,9218569472,5771248,8812384283,3215830,406185189,80,1337701,815424881,1329157,814398849,8544,1026032,1284428,619,5775957,587337,80,5866,117000.0,39000.0,-69.0,-64.0,-72.0,-69.0,-69.0,-63.0,-71.0,-69.0,-79.0,-87.0,-79.0,-87.0,10.0,23.0,7.0,18.0,1
4333,F8:59:71:5A:E0:3D,3363190,623405243,147358,217219852,3215832,406185391,0,145521,175659283,140705,175083817,4816,575466,123103,16,150072,2747,0,533,144444.0,43333.0,-66.0,-72.0,-65.0,-70.0,-66.0,-71.0,-65.0,-70.0,-79.0,-87.0,-79.0,-87.0,13.0,15.0,14.0,17.0,1
4334,CC:2F:71:3E:C5:1F,3227241,407581110,11409,1395719,3215832,406185391,6,48691,4077809,40237,3076083,8454,1001726,12029,34,16373,186,6,827,144444.0,39000.0,-69.0,-72.0,-67.0,-60.0,-69.0,-72.0,-68.0,-61.0,-79.0,-87.0,-79.0,-87.0,10.0,15.0,12.0,27.0,1
4335,CC:2F:71:3F:1F:24,8988504,9220776394,5772672,8814591003,3215832,406185391,80,1337977,815554867,1329433,814528835,8544,1026032,1284703,619,5777391,587373,80,5866,130000.0,43333.0,-69.0,-64.0,-72.0,-70.0,-69.0,-64.0,-71.0,-69.0,-79.0,-87.0,-79.0,-87.0,10.0,23.0,7.0,17.0,1
4336,F8:59:71:5A:E0:3D,3363258,623509421,147425,217323970,3215833,406185451,0,145588,175762491,140772,175187025,4816,575466,123170,16,150139,2747,0,534,144444.0,43333.0,-67.0,-72.0,-66.0,-71.0,-66.0,-72.0,-65.0,-71.0,-79.0,-87.0,-79.0,-87.0,12.0,15.0,13.0,16.0,1
4337,CC:2F:71:3E:C5:1F,3227242,407581170,11409,1395719,3215833,406185451,6,48691,4077809,40237,3076083,8454,1001726,12029,34,16373,186,6,827,144444.0,39000.0,-69.0,-72.0,-67.0,-60.0,-69.0,-72.0,-68.0,-61.0,-79.0,-87.0,-79.0,-87.0,10.0,15.0,12.0,27.0,1
4338,CC:2F:71:3F:1F:24,8989834,9222818592,5773997,8816632737,3215837,406185855,80,1338236,815678015,1329692,814651983,8544,1026032,1284962,619,5778716,587554,80,5868,130000.0,43333.0,-70.0,-64.0,-71.0,-69.0,-69.0,-63.0,-71.0,-69.0,-79.0,-87.0,-79.0,-87.0,9.0,23.0,8.0,18.0,1
4339,F8:59:71:5A:E0:3D,3363331,623609747,147489,217423426,3215842,406186321,0,145652,175861051,140836,175285585,4816,575466,123234,16,150203,2747,0,534,144444.0,43333.0,-67.0,-73.0,-65.0,-71.0,-67.0,-72.0,-64.0,-70.0,-79.0,-87.0,-79.0,-87.0,12.0,14.0,14.0,16.0,1
4340,CC:2F:71:3E:C5:1F,3227251,407582040,11409,1395719,3215842,406186321,6,48691,4077809,40237,3076083,8454,1001726,12029,34,16373,186,6,827,144444.0,39000.0,-69.0,-72.0,-67.0,-60.0,-69.0,-72.0,-68.0,-61.0,-79.0,-87.0,-79.0,-87.0,10.0,15.0,12.0,27.0,1
4341,CC:2F:71:3F:1F:24,8990853,9224378614,5775011,8818192293,3215842,406186321,80,1338474,815799341,1329929,814773191,8545,1026150,1285200,619,5779726,587725,80,5868,115556.0,28889.0,-69.0,-64.0,-73.0,-68.0,-69.0,-64.0,-73.0,-68.0,-79.0,-87.0,-79.0,-87.0,10.0,23.0,6.0,19.0,1
4342,F8:59:71:5A:E0:3D,3363397,623710707,147554,217524324,3215843,406186383,0,145717,175961207,140901,175385741,4816,575466,123299,16,150268,2748,0,535,144444.0,39000.0,-67.0,-72.0,-65.0,-70.0,-67.0,-72.0,-64.0,-70.0,-79.0,-87.0,-79.0,-87.0,12.0,15.0,14.0,17.0,1
4343,CC:2F:71:3E:C5:1F,3227252,407582102,11409,1395719,3215843,406186383,6,48693,4077997,40238,3076153,8455,1001844,12030,34,16373,186,6,827,144444.0,39000.0,-69.0,-71.0,-67.0,-60.0,-68.0,-71.0,-67.0,-60.0,-79.0,-87.0,-79.0,-87.0,10.0,16.0,12.0,27.0,1
4344,CC:2F:71:3F:1F:24,8992068,9226254128,5776225,8820067745,3215843,406186383,80,1338748,815921997,1330203,814895847,8545,1026150,1285474,619,5780944,587757,80,5868,115556.0,28889.0,-68.0,-64.0,-72.0,-69.0,-68.0,-64.0,-71.0,-68.0,-79.0,-87.0,-79.0,-87.0,11.0,23.0,7.0,18.0,1
4345,F8:59:71:5A:E0:3D,3363468,623810773,147618,217623724,3215850,406187049,0,145781,176059767,140965,175484301,4816,575466,123363,16,150332,2749,0,535,144444.0,43333.0,-67.0,-72.0,-65.0,-70.0,-67.0,-72.0,-64.0,-70.0,-79.0,-87.0,-79.0,-87.0,12.0,15.0,14.0,17.0,1
4346,CC:2F:71:3E:C5:1F,3227259,407582768,11409,1395719,3215850,406187049,6,48693,4077997,40238,3076153,8455,1001844,12030,34,16373,186,6,827,144444.0,39000.0,-69.0,-71.0,-67.0,-60.0,-68.0,-71.0,-67.0,-60.0,-79.0,-87.0,-79.0,-87.0,10.0,16.0,12.0,27.0,1
4347,CC:2F:71:3F:1F:24,8993728,9228818626,5777876,8822631375,3215852,406187251,80,1339054,816049885,1330509,815023735,8545,1026150,1285780,619,5782573,587795,80,5868,104000.0,26000.0,-68.0,-64.0,-72.0,-69.0,-68.0,-64.0,-71.0,-69.0,-79.0,-87.0,-79.0,-87.0,11.0,23.0,7.0,18.0,1
4348,F8:59:71:5A:E0:3D,3363534,623910431,147682,217723180,3215852,406187251,0,145845,176158327,141029,175582861,4816,575466,123427,16,150396,2749,0,535,144444.0,43333.0,-67.0,-72.0,-65.0,-70.0,-67.0,-72.0,-64.0,-70.0,-79.0,-87.0,-79.0,-87.0,12.0,15.0,14.0,17.0,1
4349,CC:2F:71:3E:C5:1F,3227261,407582970,11409,1395719,3215852,406187251,6,48693,4077997,40238,3076153,8455,1001844,12030,34,16373,186,6,827,144444.0,39000.0,-69.0,-71.0,-67.0,-60.0,-68.0,-71.0,-67.0,-60.0,-79.0,-87.0,-79.0,-87.0,10.0,16.0,12.0,27.0,1
4350,CC:2F:71:3F:1F:24,8994764,9230412642,5778912,8824225391,3215852,406187251,80,1339310,816171991,1330765,815145841,8545,1026150,1286036,619,5783631,587923,80,5868,130000.0,39000.0,-68.0,-64.0,-72.0,-69.0,-68.0,-63.0,-72.0,-69.0,-79.0,-87.0,-79.0,-87.0,11.0,23.0,7.0,18.0,1
4351,F8:59:71:5A:E0:3D,3363605,624012047,147747,217824190,3215858,406187857,0,145906,176252267,141090,175676801,4816,575466,123488,16,150461,2750,0,535,144444.0,43333.0,-67.0,-72.0,-64.0,-71.0,-66.0,-72.0,-64.0,-70.0,-79.0,-87.0,-79.0,-87.0,12.0,15.0,15.0,16.0,1
4352,CC:2F:71:3E:C5:1F,3227267,407583576,11409,1395719,3215858,406187857,6,48693,4077997,40238,3076153,8455,1001844,12030,34,16373,186,6,827,144444.0,39000.0,-69.0,-71.0,-67.0,-60.0,-68.0,-71.0,-67.0,-60.0,-79.0,-87.0,-79.0,-87.0,10.0,16.0,12.0,27.0,1
4353,CC:2F:71:3F:1F:24,8995528,9231555758,5779668,8825367699,3215860,406188059,80,1339525,816298368,1330980,815272218,8545,1026150,1286251,619,5784387,587940,80,5868,130000.0,43333.0,-68.0,-64.0,-72.0,-70.0,-68.0,-64.0,-72.0,-69.0,-79.0,-87.0,-79.0,-87.0,11.0,23.0,7.0,17.0,1
4354,F8:59:71:5A:E0:3D,3363676,624117981,147815,217929862,3215861,406188119,0,145977,176361607,141161,175786141,4816,575466,123559,16,150529,2752,0,535,144444.0,43333.0,-67.0,-73.0,-64.0,-70.0,-67.0,-72.0,-64.0,-70.0,-79.0,-87.0,-79.0,-87.0,12.0,14.0,15.0,17.0,1
4355,CC:2F:71:3E:C5:1F,3227270,407583838,11409,1395719,3215861,406188119,6,48693,4077997,40238,3076153,8455,1001844,12030,34,16373,186,6,827,144444.0,39000.0,-69.0,-71.0,-67.0,-60.0,-68.0,-71.0,-67.0,-60.0,-79.0,-87.0,-79.0,-87.0,10.0,16.0,12.0,27.0,1
4356,CC:2F:71:3F:1F:24,8996551,9233126654,5780690,8826938535,3215861,406188119,80,1339785,816419432,1331240,815393282,8545,1026150,1286511,619,5785409,588001,80,5868,117000.0,39000.0,-68.0,-64.0,-72.0,-69.0,-68.0,-63.0,-72.0,-69.0,-79.0,-87.0,-79.0,-87.0,11.0,23.0,7.0,18.0,1
4357,F8:59:71:5A:E0:3D,3363746,624218043,147879,218029318,3215867,406188725,0,146043,176463261,141227,175887795,4816,575466,123624,16,150593,2752,0,535,144444.0,43333.0,-67.0,-72.0,-65.0,-70.0,-67.0,-72.0,-64.0,-70.0,-79.0,-87.0,-79.0,-87.0,12.0,15.0,14.0,17.0,1
4358,CC:2F:71:3E:C5:1F,3227276,407584444,11409,1395719,3215867,406188725,6,48693,4077997,40238,3076153,8455,1001844,12030,34,16373,186,6,827,144444.0,39000.0,-69.0,-71.0,-67.0,-60.0,-68.0,-71.0,-67.0,-60.0,-79.0,-87.0,-79.0,-87.0,10.0,16.0,12.0,27.0,1
4359,CC:2F:71:3F:1F:24,8997435,9234472488,5781568,8828283763,3215867,406188725,80,1340019,816539046,1331474,815512896,8545,1026150,1286744,619,5786287,588038,80,5868,130000.0,43333.0,-68.0,-64.0,-72.0,-70.0,-68.0,-63.0,-72.0,-69.0,-79.0,-87.0,-79.0,-87.0,11.0,23.0,7.0,17.0,1
4360,F8:59:71:5A:E0:3D,3363811,624316147,147942,218127220,3215869,406188927,0,146106,176560281,141290,175984815,4816,575466,123687,16,150656,2752,0,535,144444.0,43333.0,-67.0,-72.0,-64.0,-70.0,-67.0,-72.0,-64.0,-70.0,-79.0,-87.0,-79.0,-87.0,12.0,15.0,15.0,17.0,1
4361,CC:2F:71:3E:C5:1F,3227278,407584646,11409,1395719,3215869,406188927,6,48693,4077997,40238,3076153,8455,1001844,12030,34,16373,186,6,827,144444.0,39000.0,-69.0,-71.0,-67.0,-60.0,-68.0,-71.0,-67.0,-60.0,-79.0,-87.0,-79.0,-87.0,10.0,16.0,12.0,27.0,1
4362,CC:2F:71:3F:1F:24,8998317,9235821258,5782448,8829632331,3215869,406188927,80,1340256,816655994,1331711,815629844,8545,1026150,1286981,619,5787167,588075,80,5868,130000.0,43333.0,-69.0,-64.0,-72.0,-69.0,-68.0,-63.0,-72.0,-69.0,-79.0,-87.0,-79.0,-87.0,10.0,23.0,7.0,18.0,1
4363,F8:59:71:5A:E0:3D,3363882,624416269,148006,218226676,3215876,406189593,0,146169,176657301,141353,176081835,4816,575466,123750,16,150720,2754,0,535,144444.0,43333.0,-67.0,-73.0,-65.0,-71.0,-66.0,-72.0,-64.0,-70.0,-79.0,-87.0,-79.0,-87.0,12.0,14.0,14.0,16.0,1
4364,CC:2F:71:3E:C5:1F,3227285,407585312,11409,1395719,3215876,406189593,6,48693,4077997,40238,3076153,8455,1001844,12030,34,16373,186,6,827,144444.0,39000.0,-69.0,-71.0,-67.0,-60.0,-68.0,-71.0,-67.0,-60.0,-79.0,-87.0,-79.0,-87.0,10.0,16.0,12.0,27.0,1
4365,CC:2F:71:3F:1F:24,8999231,9237205254,5783355,8831015661,3215876,406189593,80,1340470,816773707,1331925,815747557,8545,1026150,1287195,619,5788074,588179,80,5868,130000.0,43333.0,-68.0,-64.0,-71.0,-69.0,-68.0,-64.0,-71.0,-69.0,-79.0,-87.0,-79.0,-87.0,11.0,23.0,8.0,18.0,1
4366,F8:59:71:5A:E0:3D,3363946,624512819,148068,218323024,3215878,406189795,0,146232,176754419,141416,176178953,4816,575466,123813,16,150782,2754,0,535,144444.0,43333.0,-66.0,-72.0,-65.0,-70.0,-66.0,-72.0,-65.0,-70.0,-79.0,-87.0,-79.0,-87.0,13.0,15.0,14.0,17.0,1
4367,CC:2F:71:3E:C5:1F,3227287,407585514,11409,1395719,3215878,406189795,6,48693,4077997,40238,3076153,8455,1001844,12030,34,16373,186,6,827,144444.0,39000.0,-69.0,-71.0,-67.0,-60.0,-68.0,-71.0,-67.0,-60.0,-79.0,-87.0,-79.0,-87.0,10.0,16.0,12.0,27.0,1
4368,CC:2F:71:3F:1F:24,8999914,9238238330,5784036,8832048535,3215878,406189795,80,1340659,816885123,1332114,815858973,8545,1026150,1287384,619,5788743,588289,80,5868,130000.0,43333.0,-69.0,-64.0,-70.0,-68.0,-69.0,-64.0,-69.0,-68.0,-79.0,-87.0,-79.0,-87.0,10.0,23.0,9.0,19.0,1
4369,F8:59:71:5A:E0:3D,3364013,624612750,148132,218422480,3215881,406190270,0,146295,176851439,141479,176275973,4816,575466,123876,16,150846,2755,0,535,144444.0,43333.0,-67.0,-72.0,-65.0,-70.0,-66.0,-72.0,-65.0,-70.0,-79.0,-87.0,-79.0,-87.0,12.0,15.0,14.0,17.0,1
4370,CC:2F:71:3E:C5:1F,3227292,407586191,11409,1395719,3215883,406190472,6,48693,4077997,40238,3076153,8455,1001844,12030,34,16373,186,6,827,144444.0,39000.0,-69.0,-71.0,-67.0,-60.0,-68.0,-71.0,-67.0,-60.0,-79.0,-87.0,-79.0,-87.0,10.0,16.0,12.0,27.0,1
4371,CC:2F:71:3F:1F:24,9000732,9239481743,5784847,8833291069,3215885,406190674,80,1340883,817003399,1332338,815977249,8545,1026150,1287608,619,5789559,588364,80,5868,130000.0,43333.0,-68.0,-64.0,-70.0,-69.0,-67.0,-64.0,-70.0,-69.0,-79.0,-87.0,-79.0,-87.0,11.0,23.0,9.0,18.0,1
4372,F8:59:71:5A:E0:3D,3364082,624709764,148194,218518828,3215888,406190936,0,146358,176948459,141542,176372993,4816,575466,123939,16,150908,2755,0,535,144444.0,43333.0,-66.0,-72.0,-65.0,-70.0,-66.0,-71.0,-65.0,-70.0,-79.0,-87.0,-79.0,-87.0,13.0,15.0,14.0,17.0,1
4373,CC:2F:71:3E:C5:1F,3227297,407586655,11409,1395719,3215888,406190936,6,48693,4077997,40238,3076153,8455,1001844,12030,34,16373,186,6,827,144444.0,39000.0,-69.0,-71.0,-67.0,-60.0,-68.0,-71.0,-67.0,-60.0,-79.0,-87.0,-79.0,-87.0,10.0,16.0,12.0,27.0,1
4374,CC:2F:71:3F:1F:24,9001566,9240751555,5785678,8834560619,3215888,406190936,80,1341104,817121461,1332559,816095311,8545,1026150,1287829,619,5790397,588460,80,5868,130000.0,43333.0,-68.0,-64.0,-70.0,-68.0,-68.0,-64.0,-70.0,-68.0,-79.0,-87.0,-79.0,-87.0,11.0,23.0,9.0,19.0,1
4375,F8:59:71:5A:E0:3D,3364145,624807666,148257,218616730,3215888,406190936,0,146421,177045479,141605,176470013,4816,575466,124002,16,150971,2755,0,535,144444.0,43333.0,-67.0,-72.0,-65.0,-70.0,-66.0,-72.0,-65.0,-70.0,-79.0,-87.0,-79.0,-87.0,12.0,15.0,14.0,17.0,1
4376,CC:2F:71:3E:C5:1F,3227299,407586857,11409,1395719,3215890,406191138,6,48693,4077997,40238,3076153,8455,1001844,12030,34,16373,186,6,827,144444.0,39000.0,-69.0,-71.0,-67.0,-60.0,-68.0,-71.0,-67.0,-60.0,-79.0,-87.0,-79.0,-87.0,10.0,16.0,12.0,27.0,1
4377,CC:2F:71:3F:1F:24,9002521,9242205051,5786631,8836013913,3215890,406191138,80,1341352,817240214,1332807,816214064,8545,1026150,1288077,619,5791328,588491,80,5868,130000.0,43333.0,-68.0,-64.0,-71.0,-68.0,-67.0,-64.0,-70.0,-68.0,-79.0,-87.0,-79.0,-87.0,11.0,23.0,8.0,19.0,1
4378,F8:59:71:5A:E0:3D,3364216,624905493,148320,218713749,3215896,406191744,0,146485,177142663,141669,176567197,4816,575466,124065,16,151034,2757,0,535,144444.0,43333.0,-67.0,-72.0,-65.0,-70.0,-66.0,-72.0,-64.0,-70.0,-79.0,-87.0,-79.0,-87.0,12.0,15.0,14.0,17.0,1
4379,CC:2F:71:3E:C5:1F,3227306,407587523,11409,1395719,3215897,406191804,6,48693,4077997,40238,3076153,8455,1001844,12030,34,16373,186,6,827,144444.0,39000.0,-69.0,-71.0,-67.0,-60.0,-68.0,-71.0,-67.0,-60.0,-79.0,-87.0,-79.0,-87.0,10.0,16.0,12.0,27.0,1
4380,CC:2F:71:3F:1F:24,9003565,9243801567,5787668,8837609763,3215897,406191804,80,1341598,817362620,1333053,816336470,8545,1026150,1288323,619,5792387,588789,80,5868,130000.0,39000.0,-69.0,-64.0,-71.0,-68.0,-68.0,-64.0,-70.0,-68.0,-79.0,-87.0,-79.0,-87.0,10.0,23.0,8.0,19.0,1
4381,F8:59:71:5A:E0:3D,3364286,625012779,148389,218820975,3215897,406191804,0,146554,177248923,141738,176673457,4816,575466,124134,16,151103,2757,0,535,144444.0,43333.0,-66.0,-72.0,-65.0,-70.0,-66.0,-72.0,-64.0,-70.0,-79.0,-87.0,-79.0,-87.0,13.0,15.0,14.0,17.0,1
4382,CC:2F:71:3E:C5:1F,3227306,407587523,11409,1395719,3215897,406191804,6,48693,4077997,40238,3076153,8455,1001844,12030,34,16373,186,6,827,144444.0,39000.0,-69.0,-71.0,-67.0,-60.0,-68.0,-71.0,-67.0,-60.0,-79.0,-87.0,-79.0,-87.0,10.0,16.0,12.0,27.0,1
4383,CC:2F:71:3F:1F:24,9004619,9245424275,5788722,8839232471,3215897,406191804,80,1341811,817482656,1333266,816456506,8545,1026150,1288536,619,5793404,589253,80,5868,115556.0,28889.0,-72.0,-64.0,-70.0,-67.0,-71.0,-64.0,-70.0,-67.0,-79.0,-87.0,-79.0,-87.0,7.0,23.0,9.0,20.0,1
4384,F8:59:71:5A:E0:3D,3364362,625115081,148455,218922101,3215907,406192980,0,146619,177349037,141803,176773571,4816,575466,124198,16,151169,2758,0,535,144444.0,43333.0,-67.0,-73.0,-65.0,-71.0,-66.0,-73.0,-65.0,-70.0,-79.0,-87.0,-79.0,-87.0,12.0,14.0,14.0,16.0,1
4385,CC:2F:71:3E:C5:1F,3227317,407588815,11410,1395835,3215907,406192980,6,48695,4078137,40240,3076293,8455,1001844,12030,34,16374,186,6,827,144444.0,39000.0,-70.0,-71.0,-67.0,-60.0,-69.0,-71.0,-67.0,-60.0,-79.0,-87.0,-79.0,-87.0,9.0,16.0,12.0,27.0,1
4386,CC:2F:71:3F:1F:24,9006153,9247768621,5790246,8841575641,3215907,406192980,80,1342130,817618679,1333585,816592529,8545,1026150,1288855,619,5794932,589631,80,5868,86667.0,14444.0,-69.0,-63.0,-71.0,-70.0,-68.0,-63.0,-70.0,-69.0,-79.0,-87.0,-79.0,-87.0,10.0,24.0,8.0,17.0,1
4387,F8:59:71:5A:E0:3D,3364429,625217705,148521,219024665,3215908,406193040,0,146685,177450677,141869,176875211,4816,575466,124264,16,151235,2758,0,535,144444.0,43333.0,-67.0,-73.0,-66.0,-71.0,-67.0,-73.0,-66.0,-70.0,-79.0,-87.0,-79.0,-87.0,12.0,14.0,13.0,16.0,1
4388,CC:2F:71:3E:C5:1F,3227318,407588875,11410,1395835,3215908,406193040,6,48695,4078137,40240,3076293,8455,1001844,12030,34,16374,186,6,827,144444.0,39000.0,-70.0,-71.0,-67.0,-60.0,-69.0,-71.0,-67.0,-60.0,-79.0,-87.0,-79.0,-87.0,9.0,16.0,12.0,27.0,1
4389,CC:2F:71:3F:1F:24,9008041,9250690971,5792133,8844497931,3215908,406193040,80,1342457,817751134,1333912,816724984,8545,1026150,1289182,619,5796819,589780,80,5868,115556.0,28889.0,-71.0,-63.0,-70.0,-67.0,-71.0,-63.0,-70.0,-67.0,-79.0,-87.0,-79.0,-87.0,8.0,24.0,9.0,20.0,1
4390,F8:59:71:5A:E0:3D,3364504,625322631,148588,219128783,3215916,406193848,0,146754,177556951,141938,176981485,4816,575466,124332,16,151302,2760,0,535,144444.0,43333.0,-67.0,-74.0,-65.0,-70.0,-66.0,-73.0,-65.0,-70.0,-79.0,-87.0,-79.0,-87.0,12.0,13.0,14.0,17.0,1
4391,CC:2F:71:3E:C5:1F,3227326,407589683,11410,1395835,3215916,406193848,6,48695,4078137,40240,3076293,8455,1001844,12030,34,16374,186,6,827,144444.0,39000.0,-70.0,-71.0,-67.0,-60.0,-69.0,-71.0,-67.0,-60.0,-79.0,-87.0,-79.0,-87.0,9.0,16.0,12.0,27.0,1
4392,CC:2F:71:3F:1F:24,9009639,9253158479,5793723,8846964631,3215916,406193848,80,1342778,817883868,1334233,816857718,8545,1026150,1289503,619,5798442,590010,80,5868,86667.0,14444.0,-71.0,-64.0,-74.0,-68.0,-70.0,-64.0,-74.0,-68.0,-79.0,-87.0,-79.0,-87.0,8.0,23.0,5.0,19.0,1
4393,F8:59:71:5A:E0:3D,3364567,625420533,148651,219226685,3215916,406193848,0,146818,177655539,142002,177080073,4816,575466,124394,16,151365,2761,0,535,144444.0,43333.0,-67.0,-73.0,-65.0,-71.0,-66.0,-73.0,-65.0,-70.0,-79.0,-87.0,-79.0,-87.0,12.0,14.0,14.0,16.0,1
4394,CC:2F:71:3E:C5:1F,3227326,407589683,11410,1395835,3215916,406193848,6,48695,4078137,40240,3076293,8455,1001844,12030,34,16374,186,6,827,144444.0,39000.0,-70.0,-71.0,-67.0,-60.0,-69.0,-71.0,-67.0,-60.0,-79.0,-87.0,-79.0,-87.0,9.0,16.0,12.0,27.0,1
4395,CC:2F:71:3F:1F:24,9010736,9254831716,5794820,8848637868,3215916,406193848,80,1343052,818008046,1334507,816981896,8545,1026150,1289777,619,5799539,590036,80,5868,65000.0,13000.0,-70.0,-66.0,-72.0,-68.0,-70.0,-65.0,-71.0,-68.0,-79.0,-87.0,-79.0,-87.0,9.0,21.0,7.0,19.0,1
4396,F8:59:71:5A:E0:3D,3364639,625519225,148714,219324587,3215925,406194638,0,146883,177754217,142066,177178633,4817,575584,124459,16,151428,2762,0,535,144444.0,43333.0,-67.0,-73.0,-66.0,-71.0,-67.0,-72.0,-65.0,-70.0,-79.0,-87.0,-79.0,-87.0,12.0,14.0,13.0,16.0,1
4397,CC:2F:71:3E:C5:1F,3227337,407590675,11410,1395835,3215927,406194840,6,48696,4078255,40240,3076293,8456,1001962,12031,34,16374,186,6,827,144444.0,39000.0,-69.0,-70.0,-67.0,-60.0,-69.0,-70.0,-67.0,-60.0,-79.0,-87.0,-79.0,-87.0,10.0,17.0,12.0,27.0,1
4398,CC:2F:71:3F:1F:24,9011936,9256667982,5796009,8850473142,3215927,406194840,80,1343341,818132750,1334796,817106600,8545,1026150,1290066,619,5800700,590051,80,5870,115556.0,26000.0,-70.0,-66.0,-73.0,-69.0,-69.0,-65.0,-72.0,-69.0,-79.0,-87.0,-79.0,-87.0,9.0,21.0,6.0,18.0,1
4399,F8:59:71:5A:E0:3D,3364707,625621991,148780,219427151,3215927,406194840,0,146948,177854317,142131,177278733,4817,575584,124524,16,151494,2762,0,535,144444.0,43333.0,-67.0,-74.0,-65.0,-71.0,-67.0,-73.0,-64.0,-71.0,-79.0,-87.0,-79.0,-87.0,12.0,13.0,14.0,16.0,1
4400,CC:2F:71:3E:C5:1F,3227337,407590675,11410,1395835,3215927,406194840,6,48697,4078325,40241,3076363,8456,1001962,12031,34,16374,186,6,827,144444.0,39000.0,-74.0,-83.0,-73.0,-72.0,-69.0,-72.0,-68.0,-61.0,-79.0,-87.0,-79.0,-87.0,5.0,4.0,6.0,15.0,1
4401,CC:2F:71:3F:1F:24,9012938,9258206042,5797011,8852011202,3215927,406194840,80,1343585,818256484,1335040,817230334,8545,1026150,1290310,619,5801730,590353,80,5870,86667.0,14444.0,-70.0,-65.0,-72.0,-69.0,-69.0,-64.0,-72.0,-69.0,-79.0,-87.0,-79.0,-87.0,9.0,22.0,7.0,18.0,1
4402,F8:59:71:5A:E0:3D,3364777,625722053,148844,219526607,3215933,406195446,0,147013,177954431,142196,177378847,4817,575584,124588,16,151558,2762,0,535,144444.0,43333.0,-67.0,-73.0,-65.0,-71.0,-67.0,-73.0,-64.0,-70.0,-79.0,-87.0,-79.0,-87.0,12.0,14.0,14.0,16.0,1
4403,CC:2F:71:3E:C5:1F,3227343,407591281,11410,1395835,3215933,406195446,6,48697,4078325,40241,3076363,8456,1001962,12031,34,16374,186,6,827,144444.0,39000.0,-74.0,-83.0,-73.0,-72.0,-69.0,-72.0,-68.0,-61.0,-79.0,-87.0,-79.0,-87.0,5.0,4.0,6.0,15.0,1
4404,CC:2F:71:3F:1F:24,9013785,9259480893,5797850,8853285245,3215935,406195648,80,1343807,818373595,1335262,817347445,8545,1026150,1290532,619,5802566,590358,80,5870,86667.0,14444.0,-68.0,-64.0,-71.0,-69.0,-68.0,-64.0,-70.0,-68.0,-79.0,-87.0,-79.0,-87.0,11.0,23.0,8.0,18.0,1
4405,F8:59:71:5A:E0:3D,3364865,625831065,148907,219624509,3215958,406206556,0,147077,178053075,142260,177477491,4817,575584,124652,16,151621,2766,0,536,144444.0,43333.0,-67.0,-73.0,-65.0,-70.0,-67.0,-73.0,-65.0,-70.0,-79.0,-87.0,-79.0,-87.0,12.0,14.0,14.0,17.0,1
4406,CC:2F:71:3E:C5:1F,3227368,407602391,11410,1395835,3215958,406206556,6,48697,4078325,40241,3076363,8456,1001962,12031,34,16374,186,6,827,144444.0,39000.0,-74.0,-83.0,-73.0,-72.0,-69.0,-72.0,-68.0,-61.0,-79.0,-87.0,-79.0,-87.0,5.0,4.0,6.0,15.0,1
4407,CC:2F:71:3F:1F:24,9014704,9260863297,5798746,8854656741,3215958,406206556,80,1344033,818499181,1335488,817473031,8545,1026150,1290758,619,5803465,590508,80,5870,115556.0,28889.0,-69.0,-65.0,-72.0,-69.0,-69.0,-65.0,-72.0,-68.0,-79.0,-87.0,-79.0,-87.0,10.0,22.0,7.0,18.0,1
4408,F8:59:71:5A:E0:3D,3364939,625937343,148975,219730181,3215964,406207162,0,147144,178156255,142327,177580671,4817,575584,124719,16,151689,2766,0,536,144444.0,43333.0,-67.0,-74.0,-65.0,-70.0,-67.0,-73.0,-65.0,-70.0,-79.0,-87.0,-79.0,-87.0,12.0,13.0,14.0,17.0,1
4409,CC:2F:71:3E:C5:1F,3227374,407602997,11410,1395835,3215964,406207162,6,48697,4078325,40241,3076363,8456,1001962,12031,34,16374,186,6,827,144444.0,39000.0,-74.0,-83.0,-73.0,-72.0,-69.0,-72.0,-68.0,-61.0,-79.0,-87.0,-79.0,-87.0,5.0,4.0,6.0,15.0,1
4410,CC:2F:71:3F:1F:24,9015910,9262715711,5799946,8856508549,3215964,406207162,80,1344269,818617495,1335724,817591345,8545,1026150,1290994,619,5804665,590710,80,5870,115556.0,28889.0,-69.0,-64.0,-69.0,-67.0,-69.0,-64.0,-71.0,-67.0,-79.0,-87.0,-79.0,-87.0,10.0,23.0,10.0,20.0,1
4411,F8:59:71:5A:E0:3D,3365007,626038660,149040,219831023,3215967,406207637,0,147209,178256355,142392,177680771,4817,575584,124784,16,151754,2767,0,536,144444.0,43333.0,-67.0,-75.0,-66.0,-70.0,-67.0,-74.0,-65.0,-70.0,-79.0,-87.0,-79.0,-87.0,12.0,12.0,13.0,17.0,1
4412,CC:2F:71:3E:C5:1F,3227377,407603472,11410,1395835,3215967,406207637,6,48697,4078325,40241,3076363,8456,1001962,12031,34,16374,186,6,827,144444.0,39000.0,-74.0,-83.0,-73.0,-72.0,-69.0,-72.0,-68.0,-61.0,-79.0,-87.0,-79.0,-87.0,5.0,4.0,6.0,15.0,1
4413,CC:2F:71:3F:1F:24,9017332,9264912146,5801364,8858704449,3215968,406207697,80,1344531,818741723,1335986,817715573,8545,1026150,1291256,619,5806083,590847,80,5870,115556.0,28889.0,-70.0,-64.0,-70.0,-67.0,-70.0,-64.0,-71.0,-67.0,-79.0,-87.0,-79.0,-87.0,9.0,23.0,9.0,20.0,1
4414,F8:59:71:5A:E0:3D,3365079,626140330,149105,219932033,3215974,406208297,0,147274,178356455,142457,177780871,4817,575584,124849,16,151818,2767,0,536,144444.0,43333.0,-67.0,-74.0,-66.0,-70.0,-67.0,-74.0,-65.0,-70.0,-79.0,-87.0,-79.0,-87.0,12.0,13.0,13.0,17.0,1
4415,CC:2F:71:3E:C5:1F,3227385,407604200,11410,1395835,3215975,406208365,6,48697,4078325,40241,3076363,8456,1001962,12031,34,16374,186,6,827,144444.0,39000.0,-74.0,-83.0,-73.0,-72.0,-69.0,-72.0,-68.0,-61.0,-79.0,-87.0,-79.0,-87.0,5.0,4.0,6.0,15.0,1
4416,CC:2F:71:3F:1F:24,9019011,9267498332,5803036,8861289967,3215975,406208365,80,1344859,818877100,1336313,817850832,8546,1026268,1291583,619,5807755,591212,80,5871,86667.0,14444.0,-69.0,-64.0,-71.0,-68.0,-69.0,-64.0,-70.0,-67.0,-79.0,-87.0,-79.0,-87.0,10.0,23.0,8.0,19.0,1
4417,F8:59:71:5A:E0:3D,3365146,626240056,149169,220031489,3215977,406208567,0,147338,178455015,142521,177879431,4817,575584,124913,16,151883,2767,0,536,144444.0,43333.0,-68.0,-74.0,-65.0,-70.0,-67.0,-73.0,-65.0,-70.0,-79.0,-87.0,-79.0,-87.0,11.0,13.0,14.0,17.0,1
4418,CC:2F:71:3E:C5:1F,3227387,407604402,11410,1395835,3215977,406208567,6,48697,4078325,40241,3076363,8456,1001962,12031,34,16374,186,6,827,144444.0,39000.0,-74.0,-83.0,-73.0,-72.0,-69.0,-72.0,-68.0,-61.0,-79.0,-87.0,-79.0,-87.0,5.0,4.0,6.0,15.0,1
4419,CC:2F:71:3F:1F:24,9020412,9269666748,5804435,8863458181,3215977,406208567,80,1345122,819000120,1336576,817973852,8546,1026268,1291843,619,5809154,591271,80,5871,130000.0,39000.0,-71.0,-64.0,-72.0,-67.0,-70.0,-64.0,-71.0,-67.0,-79.0,-87.0,-79.0,-87.0,8.0,23.0,7.0,20.0,1
4420,F8:59:71:5A:E0:3D,3365214,626341328,149234,220132499,3215980,406208829,0,147403,178555143,142586,177979559,4817,575584,124978,16,151948,2768,0,536,144444.0,43333.0,-68.0,-74.0,-65.0,-70.0,-67.0,-74.0,-65.0,-70.0,-79.0,-87.0,-79.0,-87.0,11.0,13.0,14.0,17.0,1
4421,CC:2F:71:3E:C5:1F,3227390,407604664,11410,1395835,3215980,406208829,6,48697,4078325,40241,3076363,8456,1001962,12031,34,16374,186,6,827,144444.0,39000.0,-74.0,-83.0,-73.0,-72.0,-69.0,-72.0,-68.0,-61.0,-79.0,-87.0,-79.0,-87.0,5.0,4.0,6.0,15.0,1
4422,CC:2F:71:3F:1F:24,9021853,9271890628,5805871,8865681597,3215982,406209031,80,1345352,819120802,1336806,818094534,8546,1026268,1292073,619,5810590,591583,80,5871,115556.0,28889.0,-70.0,-64.0,-70.0,-67.0,-69.0,-64.0,-70.0,-67.0,-79.0,-87.0,-79.0,-87.0,9.0,23.0,9.0,20.0,1
4423,F8:59:71:5A:E0:3D,3365284,626441390,149298,220231955,3215986,406209435,0,147468,178655243,142651,178079659,4817,575584,125043,16,152012,2768,0,536,144444.0,43333.0,-68.0,-74.0,-65.0,-70.0,-67.0,-74.0,-65.0,-70.0,-79.0,-87.0,-79.0,-87.0,11.0,13.0,14.0,17.0,1
4424,CC:2F:71:3E:C5:1F,3227396,407605270,11410,1395835,3215986,406209435,6,48697,4078325,40241,3076363,8456,1001962,12031,34,16374,186,6,827,144444.0,39000.0,-74.0,-83.0,-73.0,-72.0,-69.0,-72.0,-68.0,-61.0,-79.0,-87.0,-79.0,-87.0,5.0,4.0,6.0,15.0,1
4425,CC:2F:71:3F:1F:24,9023080,9273779334,5807094,8867569899,3215986,406209435,80,1345614,819246460,1337068,818220192,8546,1026268,1292335,619,5811793,591840,80,5872,115556.0,28889.0,-70.0,-65.0,-71.0,-69.0,-69.0,-64.0,-71.0,-68.0,-79.0,-87.0,-79.0,-87.0,9.0,22.0,8.0,18.0,1
4426,F8:59:71:5A:E0:3D,3365350,626543954,149364,220334519,3215986,406209435,0,147533,178755343,142716,178179759,4817,575584,125108,16,152078,2768,0,536,144444.0,43333.0,-67.0,-74.0,-65.0,-70.0,-67.0,-74.0,-65.0,-70.0,-79.0,-87.0,-79.0,-87.0,12.0,13.0,14.0,17.0,1
4427,CC:2F:71:3E:C5:1F,3227398,407605472,11410,1395835,3215988,406209637,6,48697,4078325,40241,3076363,8456,1001962,12031,34,16374,186,6,827,144444.0,39000.0,-74.0,-83.0,-73.0,-72.0,-69.0,-72.0,-68.0,-61.0,-79.0,-87.0,-79.0,-87.0,5.0,4.0,6.0,15.0,1
4428,CC:2F:71:3F:1F:24,9024012,9275191834,5808024,8868982197,3215988,406209637,80,1345852,819370252,1337306,818343984,8546,1026268,1292573,619,5812743,592152,80,5872,104000.0,26000.0,-70.0,-65.0,-71.0,-69.0,-70.0,-64.0,-71.0,-68.0,-79.0,-87.0,-79.0,-87.0,9.0,22.0,8.0,18.0,1
4429,F8:59:71:5A:E0:3D,3365423,626644278,149428,220433975,3215995,406210303,0,147598,178855443,142781,178279859,4817,575584,125173,16,152142,2768,0,536,144444.0,43333.0,-67.0,-73.0,-65.0,-70.0,-67.0,-73.0,-65.0,-70.0,-79.0,-87.0,-79.0,-87.0,12.0,14.0,14.0,17.0,1
4430,CC:2F:71:3E:C5:1F,3227405,407606138,11410,1395835,3215995,406210303,6,48697,4078325,40241,3076363,8456,1001962,12031,34,16374,186,6,827,144444.0,39000.0,-74.0,-83.0,-73.0,-72.0,-69.0,-72.0,-68.0,-61.0,-79.0,-87.0,-79.0,-87.0,5.0,4.0,6.0,15.0,1
4431,CC:2F:71:3F:1F:24,9024992,9276686214,5808997,8870475911,3215995,406210303,80,1346080,819489142,1337534,818462874,8546,1026268,1292801,619,5813716,592360,80,5872,115556.0,28889.0,-70.0,-65.0,-71.0,-69.0,-70.0,-64.0,-71.0,-68.0,-79.0,-87.0,-79.0,-87.0,9.0,22.0,8.0,18.0,1
4432,F8:59:71:5A:E0:3D,3365487,626743734,149492,220533431,3215995,406210303,0,147662,178954003,142845,178378419,4817,575584,125237,16,152206,2768,0,536,144444.0,43333.0,-67.0,-74.0,-66.0,-70.0,-67.0,-73.0,-65.0,-70.0,-79.0,-87.0,-79.0,-87.0,12.0,13.0,13.0,17.0,1
4433,CC:2F:71:3E:C5:1F,3227405,407606138,11410,1395835,3215995,406210303,6,48697,4078325,40241,3076363,8456,1001962,12031,34,16374,186,6,827,144444.0,39000.0,-74.0,-83.0,-73.0,-72.0,-69.0,-72.0,-68.0,-61.0,-79.0,-87.0,-79.0,-87.0,5.0,4.0,6.0,15.0,1
4434,CC:2F:71:3F:1F:24,9025962,9278174266,5809967,8871963963,3215995,406210303,80,1346347,819609668,1337801,818583400,8546,1026268,1293068,619,5814673,592513,80,5873,86667.0,14444.0,-70.0,-64.0,-72.0,-68.0,-70.0,-64.0,-71.0,-68.0,-79.0,-87.0,-79.0,-87.0,9.0,23.0,7.0,19.0,1
4435,F8:59:71:5A:E0:3D,3365560,626845552,149557,220634441,3216003,406211111,0,147726,179052563,142909,178476979,4817,575584,125301,16,152271,2768,0,536,144444.0,43333.0,-67.0,-73.0,-66.0,-70.0,-67.0,-73.0,-65.0,-70.0,-79.0,-87.0,-79.0,-87.0,12.0,14.0,13.0,17.0,1
4436,CC:2F:71:3E:C5:1F,3227413,407606946,11410,1395835,3216003,406211111,6,48697,4078325,40241,3076363,8456,1001962,12031,34,16374,186,6,827,144444.0,39000.0,-74.0,-83.0,-73.0,-72.0,-69.0,-72.0,-68.0,-61.0,-79.0,-87.0,-79.0,-87.0,5.0,4.0,6.0,15.0,1
4437,CC:2F:71:3F:1F:24,9026949,9279677392,5810946,8873466281,3216003,406211111,80,1346591,819733244,1338045,818706976,8546,1026268,1293311,619,5815634,592530,80,5873,86667.0,14444.0,-71.0,-65.0,-71.0,-68.0,-70.0,-65.0,-71.0,-68.0,-79.0,-87.0,-79.0,-87.0,8.0,22.0,8.0,19.0,1
4438,F8:59:71:5A:E0:3D,3365626,626946622,149622,220735451,3216004,406211171,0,147791,179152663,142974,178577079,4817,575584,125366,16,152336,2768,0,536,144444.0,43333.0,-67.0,-74.0,-65.0,-70.0,-67.0,-73.0,-65.0,-69.0,-79.0,-87.0,-79.0,-87.0,12.0,13.0,14.0,17.0,1
4439,CC:2F:71:3E:C5:1F,3227414,407607006,11410,1395835,3216004,406211171,6,48697,4078325,40241,3076363,8456,1001962,12031,34,16374,186,6,827,144444.0,39000.0,-74.0,-83.0,-73.0,-72.0,-69.0,-72.0,-68.0,-61.0,-79.0,-87.0,-79.0,-87.0,5.0,4.0,6.0,15.0,1
4440,CC:2F:71:3F:1F:24,9028008,9281298253,5812004,8875087082,3216004,406211171,80,1346850,819857676,1338304,818831408,8546,1026268,1293570,619,5816700,592547,80,5874,104000.0,26000.0,-70.0,-64.0,-70.0,-68.0,-69.0,-64.0,-70.0,-68.0,-79.0,-87.0,-79.0,-87.0,9.0,23.0,9.0,19.0,1
4441,F8:59:71:5A:E0:3D,3365699,627048440,149687,220836461,3216012,406211979,0,147856,179252763,143039,178677179,4817,575584,125431,16,152401,2771,0,536,144444.0,43333.0,-67.0,-73.0,-65.0,-70.0,-67.0,-73.0,-65.0,-70.0,-79.0,-87.0,-79.0,-87.0,12.0,14.0,14.0,17.0,1
4442,CC:2F:71:3E:C5:1F,3227422,407607814,11410,1395835,3216012,406211979,6,48697,4078325,40241,3076363,8456,1001962,12031,34,16374,186,6,827,144444.0,39000.0,-74.0,-83.0,-73.0,-72.0,-69.0,-72.0,-68.0,-61.0,-79.0,-87.0,-79.0,-87.0,5.0,4.0,6.0,15.0,1
4443,CC:2F:71:3F:1F:24,9028901,9282653687,5812889,8876441708,3216012,406211979,80,1347078,819977982,1338532,818951714,8546,1026268,1293796,619,5817608,592692,80,5874,115556.0,28889.0,-70.0,-64.0,-70.0,-68.0,-69.0,-64.0,-70.0,-68.0,-79.0,-87.0,-79.0,-87.0,9.0,23.0,9.0,19.0,1
4444,F8:59:71:5A:E0:3D,3365764,627149450,149752,220937471,3216012,406211979,0,147921,179352863,143104,178777279,4817,575584,125496,16,152466,2771,0,536,144444.0,43333.0,-67.0,-74.0,-66.0,-70.0,-67.0,-73.0,-65.0,-70.0,-78.0,-87.0,-78.0,-87.0,11.0,13.0,12.0,17.0,1
4445,CC:2F:71:3E:C5:1F,3227422,407607814,11410,1395835,3216012,406211979,6,48697,4078325,40241,3076363,8456,1001962,12031,34,16374,186,6,827,144444.0,39000.0,-74.0,-83.0,-73.0,-72.0,-69.0,-72.0,-68.0,-61.0,-78.0,-87.0,-78.0,-87.0,4.0,4.0,5.0,15.0,1
4446,CC:2F:71:3F:1F:24,9030119,9284535299,5814107,8878323320,3216012,406211979,80,1347330,820101328,1338784,819075060,8546,1026268,1294048,619,5818825,592767,80,5874,115556.0,28889.0,-70.0,-65.0,-71.0,-68.0,-69.0,-64.0,-70.0,-68.0,-78.0,-87.0,-78.0,-87.0,8.0,22.0,7.0,19.0,1
4447,F8:59:71:5A:E0:3D,3365838,627249890,149817,221037043,3216021,406212847,0,147988,179454623,143171,178879039,4817,575584,125562,16,152531,2771,0,536,144444.0,43333.0,-68.0,-74.0,-65.0,-70.0,-67.0,-73.0,-65.0,-69.0,-78.0,-87.0,-78.0,-87.0,10.0,13.0,13.0,17.0,1
4448,CC:2F:71:3E:C5:1F,3227431,407608682,11410,1395835,3216021,406212847,6,48697,4078325,40241,3076363,8456,1001962,12031,34,16374,186,6,827,144444.0,39000.0,-74.0,-83.0,-73.0,-72.0,-69.0,-72.0,-68.0,-61.0,-78.0,-87.0,-78.0,-87.0,4.0,4.0,5.0,15.0,1
4449,CC:2F:71:3F:1F:24,9031294,9286334309,5815273,8880121462,3216021,406212847,80,1347575,820222094,1339029,819195826,8546,1026268,1294293,619,5819992,592813,80,5874,115556.0,28889.0,-69.0,-64.0,-70.0,-68.0,-69.0,-64.0,-70.0,-68.0,-78.0,-87.0,-78.0,-87.0,9.0,23.0,8.0,19.0,1
4450,F8:59:71:5A:E0:3D,3365903,627350900,149882,221138053,3216021,406212847,0,148052,179553183,143235,178977599,4817,575584,125626,16,152596,2771,0,536,144444.0,43333.0,-67.0,-74.0,-65.0,-70.0,-66.0,-74.0,-65.0,-70.0,-78.0,-87.0,-78.0,-87.0,11.0,13.0,13.0,17.0,1
4451,CC:2F:71:3E:C5:1F,3227431,407608682,11410,1395835,3216021,406212847,6,48697,4078325,40241,3076363,8456,1001962,12031,34,16374,186,6,827,144444.0,39000.0,-74.0,-83.0,-73.0,-72.0,-69.0,-72.0,-68.0,-61.0,-78.0,-87.0,-78.0,-87.0,4.0,4.0,5.0,15.0,1
4452,CC:2F:71:3F:1F:24,9032395,9288030143,5816374,8881817296,3216021,406212847,80,1347847,820346022,1339301,819319754,8546,1026268,1294565,619,5821093,592865,80,5874,115556.0,28889.0,-69.0,-64.0,-70.0,-69.0,-69.0,-64.0,-70.0,-68.0,-78.0,-87.0,-78.0,-87.0,9.0,23.0,8.0,18.0,1
4453,F8:59:71:5A:E0:3D,3365973,627449681,149945,221235955,3216028,406213726,0,148116,179651757,143299,179076173,4817,575584,125689,16,152659,2771,0,536,144444.0,43333.0,-67.0,-74.0,-65.0,-70.0,-67.0,-73.0,-65.0,-70.0,-78.0,-87.0,-78.0,-87.0,11.0,13.0,13.0,17.0,1
4454,CC:2F:71:3E:C5:1F,3227440,407609763,11410,1395835,3216030,406213928,6,48697,4078325,40241,3076363,8456,1001962,12031,34,16374,186,6,827,144444.0,39000.0,-74.0,-83.0,-73.0,-72.0,-69.0,-72.0,-68.0,-61.0,-78.0,-87.0,-78.0,-87.0,4.0,4.0,5.0,15.0,1
4455,CC:2F:71:3F:1F:24,9033665,9289970018,5817634,8883756030,3216031,406213988,80,1348093,820471627,1339547,819445359,8546,1026268,1294811,619,5822332,593093,80,5874,86667.0,13000.0,-69.0,-64.0,-70.0,-69.0,-69.0,-64.0,-70.0,-69.0,-78.0,-87.0,-78.0,-87.0,9.0,23.0,8.0,18.0,1
4456,F8:59:71:5A:E0:3D,3366045,627557169,150014,221343181,3216031,406213988,0,148185,179758017,143368,179182433,4817,575584,125758,16,152728,2771,0,536,144444.0,43333.0,-68.0,-74.0,-65.0,-70.0,-67.0,-73.0,-65.0,-70.0,-78.0,-87.0,-78.0,-87.0,10.0,13.0,13.0,17.0,1
4457,CC:2F:71:3E:C5:1F,3227441,407609823,11410,1395835,3216031,406213988,6,48697,4078325,40241,3076363,8456,1001962,12031,34,16374,186,6,827,144444.0,39000.0,-74.0,-83.0,-73.0,-72.0,-69.0,-72.0,-68.0,-61.0,-78.0,-87.0,-78.0,-87.0,4.0,4.0,5.0,15.0,1
4458,CC:2F:71:3F:1F:24,9035139,9292253206,5819108,8886039218,3216031,406213988,80,1348405,820604689,1339859,819578421,8546,1026268,1295119,619,5823827,593216,80,5874,104000.0,26000.0,-69.0,-65.0,-71.0,-68.0,-69.0,-65.0,-70.0,-68.0,-78.0,-87.0,-78.0,-87.0,9.0,22.0,7.0,19.0,1
4459,F8:59:71:5A:E0:3D,3366114,627658583,150079,221444191,3216035,406214392,0,148251,179859657,143434,179284073,4817,575584,125824,16,152793,2772,0,536,144444.0,43333.0,-67.0,-74.0,-66.0,-70.0,-67.0,-74.0,-65.0,-70.0,-78.0,-87.0,-78.0,-87.0,11.0,13.0,12.0,17.0,1
4460,CC:2F:71:3E:C5:1F,3227447,407610429,11410,1395835,3216037,406214594,6,48697,4078325,40241,3076363,8456,1001962,12031,34,16374,186,6,827,144444.0,39000.0,-74.0,-83.0,-73.0,-72.0,-69.0,-72.0,-68.0,-61.0,-78.0,-87.0,-78.0,-87.0,4.0,4.0,5.0,15.0,1
4461,CC:2F:71:3F:1F:24,9036862,9294921446,5820825,8888706852,3216037,406214594,80,1348716,820734691,1340170,819708423,8546,1026268,1295430,619,5825525,593335,80,5874,104000.0,26000.0,-69.0,-65.0,-71.0,-69.0,-69.0,-65.0,-70.0,-68.0,-78.0,-87.0,-78.0,-87.0,9.0,22.0,7.0,18.0,1
4462,F8:59:71:5A:E0:3D,3366187,627764719,150147,221549863,3216040,406214856,0,148318,179962837,143501,179387253,4817,575584,125891,16,152860,2772,0,536,144444.0,43333.0,-67.0,-73.0,-66.0,-70.0,-67.0,-73.0,-65.0,-70.0,-78.0,-87.0,-78.0,-87.0,11.0,14.0,12.0,17.0,1
4463,CC:2F:71:3E:C5:1F,3227450,407610691,11410,1395835,3216040,406214856,6,48697,4078325,40241,3076363,8456,1001962,12031,34,16374,186,6,827,144444.0,39000.0,-74.0,-83.0,-73.0,-72.0,-69.0,-72.0,-68.0,-61.0,-78.0,-87.0,-78.0,-87.0,4.0,4.0,5.0,15.0,1
4464,CC:2F:71:3F:1F:24,9038813,9297952564,5822773,8891737708,3216040,406214856,80,1349105,820879839,1340559,819853571,8546,1026268,1295817,619,5827485,593439,80,5874,86667.0,14444.0,-71.0,-65.0,-70.0,-68.0,-70.0,-65.0,-70.0,-68.0,-78.0,-87.0,-78.0,-87.0,7.0,22.0,8.0,19.0,1
4465,F8:59:71:5A:E0:3D,3366257,627867687,150213,221652427,3216044,406215260,0,148384,180064477,143567,179488893,4817,575584,125957,16,152927,2772,0,536,144444.0,43333.0,-67.0,-75.0,-66.0,-70.0,-67.0,-74.0,-65.0,-70.0,-78.0,-87.0,-78.0,-87.0,11.0,12.0,12.0,17.0,1
4466,CC:2F:71:3E:C5:1F,3227456,407611297,11410,1395835,3216046,406215462,6,48697,4078325,40241,3076363,8456,1001962,12031,34,16374,186,6,827,144444.0,39000.0,-74.0,-83.0,-73.0,-72.0,-69.0,-72.0,-68.0,-61.0,-78.0,-87.0,-78.0,-87.0,4.0,4.0,5.0,15.0,1
4467,CC:2F:71:3F:1F:24,9040346,9300314109,5824300,8894098647,3216046,406215462,80,1349431,821011002,1340885,819984734,8546,1026268,1296142,619,5829018,593477,80,5874,86667.0,14444.0,-71.0,-64.0,-71.0,-69.0,-70.0,-64.0,-70.0,-69.0,-78.0,-87.0,-78.0,-87.0,7.0,23.0,7.0,18.0,1
4468,F8:59:71:5A:E0:3D,3366326,627967663,150278,221751999,3216048,406215664,0,148448,180163037,143631,179587453,4817,575584,126021,16,152992,2773,0,536,144444.0,43333.0,-67.0,-73.0,-66.0,-71.0,-67.0,-72.0,-65.0,-70.0,-78.0,-87.0,-78.0,-87.0,11.0,14.0,12.0,16.0,1
4469,CC:2F:71:3E:C5:1F,3227461,407611825,11411,1395951,3216050,406215874,6,48700,4078535,40244,3076573,8456,1001962,12031,34,16375,186,6,827,144444.0,39000.0,-68.0,-70.0,-68.0,-60.0,-69.0,-72.0,-68.0,-63.0,-78.0,-87.0,-78.0,-87.0,10.0,17.0,10.0,27.0,1
4470,CC:2F:71:3F:1F:24,9041663,9302343933,5825613,8896128059,3216050,406215874,80,1349725,821140364,1341179,820114096,8546,1026268,1296436,619,5830332,593653,80,5875,86667.0,14444.0,-70.0,-64.0,-70.0,-68.0,-69.0,-64.0,-70.0,-68.0,-78.0,-87.0,-78.0,-87.0,8.0,23.0,8.0,19.0,1
4471,F8:59:71:5A:E0:3D,3366396,628069145,150343,221853009,3216053,406216136,0,148515,180266231,143698,179690647,4817,575584,126087,16,153057,2773,0,536,144444.0,43333.0,-67.0,-73.0,-65.0,-70.0,-67.0,-72.0,-65.0,-70.0,-78.0,-87.0,-78.0,-87.0,11.0,14.0,13.0,17.0,1
4472,CC:2F:71:3E:C5:1F,3227466,407612289,11411,1395951,3216055,406216338,6,48700,4078535,40244,3076573,8456,1001962,12031,34,16375,186,6,827,144444.0,39000.0,-68.0,-70.0,-68.0,-60.0,-69.0,-72.0,-68.0,-63.0,-78.0,-87.0,-78.0,-87.0,10.0,17.0,10.0,27.0,1
4473,CC:2F:71:3F:1F:24,9042956,9304334421,5826901,8898118083,3216055,406216338,80,1350020,821265780,1341474,820239512,8546,1026268,1296730,619,5831614,593672,80,5875,86667.0,14444.0,-70.0,-64.0,-73.0,-66.0,-69.0,-64.0,-71.0,-66.0,-78.0,-87.0,-78.0,-87.0,8.0,23.0,5.0,21.0,1
4474,F8:59:71:5A:E0:3D,3366466,628169207,150407,221952465,3216059,406216742,0,148578,180363251,143761,179787667,4817,575584,126150,16,153121,2773,0,536,144444.0,43333.0,-67.0,-73.0,-66.0,-71.0,-67.0,-73.0,-65.0,-70.0,-78.0,-87.0,-78.0,-87.0,11.0,14.0,12.0,16.0,1
4475,CC:2F:71:3E:C5:1F,3227470,407612693,11411,1395951,3216059,406216742,6,48700,4078535,40244,3076573,8456,1001962,12031,34,16375,186,6,827,144444.0,39000.0,-68.0,-70.0,-68.0,-60.0,-69.0,-72.0,-68.0,-63.0,-78.0,-87.0,-78.0,-87.0,10.0,17.0,10.0,27.0,1
4476,CC:2F:71:3F:1F:24,9044455,9306651479,5828396,8900434737,3216059,406216742,80,1350342,821398712,1341796,820372444,8546,1026268,1297052,619,5833115,593685,80,5875,86667.0,14444.0,-70.0,-64.0,-73.0,-67.0,-69.0,-63.0,-72.0,-67.0,-78.0,-87.0,-78.0,-87.0,8.0,23.0,5.0,20.0,1
4477,F8:59:71:5A:E0:3D,3366534,628271805,150473,222054861,3216061,406216944,0,148646,180467985,143829,179892401,4817,575584,126217,16,153187,2773,0,536,144444.0,43333.0,-66.0,-73.0,-65.0,-70.0,-66.0,-73.0,-64.0,-70.0,-78.0,-87.0,-78.0,-87.0,12.0,14.0,13.0,17.0,1
4478,CC:2F:71:3E:C5:1F,3227472,407612895,11411,1395951,3216061,406216944,6,48700,4078535,40244,3076573,8456,1001962,12031,34,16375,186,6,827,144444.0,39000.0,-68.0,-70.0,-68.0,-60.0,-69.0,-72.0,-68.0,-63.0,-78.0,-87.0,-78.0,-87.0,10.0,17.0,10.0,27.0,1
4479,CC:2F:71:3F:1F:24,9045947,9308949544,5829884,8902732398,3216063,406217146,80,1350666,821532433,1342120,820506165,8546,1026268,1297376,619,5834587,593946,80,5876,86667.0,14444.0,-70.0,-63.0,-71.0,-69.0,-70.0,-63.0,-70.0,-68.0,-78.0,-87.0,-78.0,-87.0,8.0,24.0,7.0,18.0,1
4480,F8:59:71:5A:E0:3D,3366609,628376651,150540,222158979,3216069,406217672,0,148713,180571165,143896,179995581,4817,575584,126284,16,153254,2774,0,536,144444.0,43333.0,-66.0,-74.0,-65.0,-70.0,-66.0,-74.0,-64.0,-70.0,-78.0,-86.0,-78.0,-86.0,12.0,12.0,13.0,16.0,1
4481,CC:2F:71:3E:C5:1F,3227480,407613623,11411,1395951,3216069,406217672,6,48702,4078723,40245,3076643,8457,1002080,12032,34,16375,186,6,827,144444.0,39000.0,-68.0,-69.0,-67.0,-60.0,-69.0,-72.0,-68.0,-62.0,-78.0,-86.0,-78.0,-86.0,10.0,17.0,11.0,26.0,1
4482,CC:2F:71:3F:1F:24,9047129,9310763310,5831060,8904545638,3216069,406217672,80,1350939,821657979,1342393,820631711,8546,1026268,1297649,619,5835779,593964,80,5876,86667.0,14444.0,-70.0,-64.0,-71.0,-69.0,-70.0,-64.0,-70.0,-69.0,-78.0,-86.0,-78.0,-86.0,8.0,22.0,7.0,17.0,1
4483,F8:59:71:5A:E0:3D,3366673,628476107,150604,222258435,3216069,406217672,0,148778,180671279,143961,180095695,4817,575584,126348,16,153318,2774,0,536,144444.0,43333.0,-67.0,-74.0,-65.0,-71.0,-66.0,-73.0,-64.0,-70.0,-78.0,-86.0,-78.0,-86.0,11.0,12.0,13.0,15.0,1
4484,CC:2F:71:3E:C5:1F,3227482,407613825,11411,1395951,3216071,406217874,6,48702,4078723,40245,3076643,8457,1002080,12032,34,16375,186,6,827,144444.0,39000.0,-68.0,-69.0,-67.0,-60.0,-69.0,-72.0,-68.0,-62.0,-78.0,-86.0,-78.0,-86.0,10.0,17.0,11.0,26.0,1
4485,CC:2F:71:3F:1F:24,9048386,9312702862,5832315,8906484988,3216071,406217874,80,1351223,821784699,1342677,820758431,8546,1026268,1297933,619,5837034,593989,80,5876,86667.0,14444.0,-71.0,-64.0,-71.0,-68.0,-70.0,-64.0,-71.0,-68.0,-78.0,-86.0,-78.0,-86.0,7.0,22.0,7.0,18.0,1
4486,F8:59:71:5A:E0:3D,3366745,628576371,150668,222357891,3216077,406218480,0,148841,180768299,144024,180192715,4817,575584,126411,16,153382,2776,0,536,144444.0,43333.0,-66.0,-73.0,-65.0,-71.0,-66.0,-73.0,-64.0,-70.0,-78.0,-86.0,-78.0,-86.0,12.0,13.0,13.0,15.0,1
4487,CC:2F:71:3E:C5:1F,3227488,407614431,11411,1395951,3216077,406218480,6,48702,4078723,40245,3076643,8457,1002080,12032,34,16375,186,6,827,144444.0,39000.0,-68.0,-69.0,-67.0,-60.0,-69.0,-72.0,-68.0,-62.0,-78.0,-86.0,-78.0,-86.0,10.0,17.0,11.0,26.0,1
4488,CC:2F:71:3F:1F:24,9049544,9314479052,5833467,8908260572,3216077,406218480,80,1351467,821904129,1342921,820877861,8546,1026268,1298177,619,5838186,594169,80,5879,115556.0,28889.0,-70.0,-64.0,-71.0,-68.0,-69.0,-64.0,-71.0,-68.0,-78.0,-86.0,-78.0,-86.0,8.0,22.0,7.0,18.0,1
4489,F8:59:71:5A:E0:3D,3366809,628674333,150731,222455793,3216078,406218540,0,148905,180866859,144088,180291275,4817,575584,126475,16,153445,2776,0,536,144444.0,43333.0,-66.0,-73.0,-65.0,-70.0,-65.0,-73.0,-64.0,-70.0,-78.0,-86.0,-78.0,-86.0,12.0,13.0,13.0,16.0,1
4490,CC:2F:71:3E:C5:1F,3227490,407614553,11411,1395951,3216079,406218602,6,48702,4078723,40245,3076643,8457,1002080,12032,34,16375,186,6,827,144444.0,39000.0,-68.0,-69.0,-67.0,-60.0,-69.0,-72.0,-68.0,-62.0,-78.0,-86.0,-78.0,-86.0,10.0,17.0,11.0,26.0,1
4491,CC:2F:71:3F:1F:24,9050370,9315732387,5834291,8909513785,3216079,406218602,80,1351680,822020314,1343133,820993928,8547,1026386,1298390,619,5839010,594328,80,5879,115556.0,26000.0,-69.0,-63.0,-71.0,-69.0,-69.0,-63.0,-71.0,-69.0,-78.0,-86.0,-78.0,-86.0,9.0,23.0,7.0,17.0,1
4492,F8:59:71:5A:E0:3D,3366878,628771349,150793,222552141,3216085,406219208,0,148967,180962339,144150,180386755,4817,575584,126537,16,153507,2776,0,536,144444.0,43333.0,-66.0,-74.0,-66.0,-71.0,-66.0,-74.0,-66.0,-70.0,-78.0,-86.0,-78.0,-86.0,12.0,12.0,12.0,15.0,1
4493,CC:2F:71:3E:C5:1F,3227499,407615423,11411,1395951,3216088,406219472,6,48702,4078723,40245,3076643,8457,1002080,12032,34,16375,186,6,827,144444.0,39000.0,-68.0,-69.0,-67.0,-60.0,-69.0,-72.0,-68.0,-62.0,-78.0,-86.0,-78.0,-86.0,10.0,17.0,11.0,26.0,1
4494,CC:2F:71:3F:1F:24,9051286,9317122247,5835198,8910902775,3216088,406219472,80,1351927,822144244,1343380,821117858,8547,1026386,1298637,619,5839917,594483,80,5879,115556.0,28889.0,-69.0,-64.0,-71.0,-68.0,-68.0,-63.0,-71.0,-67.0,-78.0,-86.0,-78.0,-86.0,9.0,22.0,7.0,18.0,1
4495,F8:59:71:5A:E0:3D,3366950,628877446,150861,222657701,3216089,406219745,0,149035,181065637,144217,180489935,4818,575702,126605,16,153575,2776,0,536,144444.0,43333.0,-67.0,-73.0,-65.0,-70.0,-66.0,-73.0,-65.0,-70.0,-78.0,-86.0,-78.0,-86.0,11.0,13.0,13.0,16.0,1
4496,CC:2F:71:3E:C5:1F,3227501,407615756,11411,1395951,3216090,406219805,6,48702,4078723,40245,3076643,8457,1002080,12032,34,16375,186,6,827,144444.0,39000.0,-68.0,-69.0,-67.0,-60.0,-69.0,-72.0,-68.0,-62.0,-78.0,-86.0,-78.0,-86.0,10.0,17.0,11.0,26.0,1
4497,CC:2F:71:3F:1F:24,9052243,9318587522,5836153,8912367717,3216090,406219805,80,1352183,822266238,1343636,821239852,8547,1026386,1298893,619,5840872,594725,80,5879,86667.0,14444.0,-69.0,-64.0,-70.0,-68.0,-69.0,-63.0,-70.0,-67.0,-78.0,-86.0,-78.0,-86.0,9.0,22.0,8.0,18.0,1
4498,F8:59:71:5A:E0:3D,3367022,628979122,150926,222758711,3216096,406220411,0,149101,181167277,144283,180591575,4818,575702,126671,16,153640,2777,0,536,144444.0,43333.0,-67.0,-74.0,-65.0,-71.0,-67.0,-74.0,-65.0,-71.0,-78.0,-86.0,-78.0,-86.0,11.0,12.0,13.0,15.0,1
4499,CC:2F:71:3E:C5:1F,3227509,407616564,11411,1395951,3216098,406220613,6,48702,4078723,40245,3076643,8457,1002080,12032,34,16375,186,6,827,144444.0,39000.0,-68.0,-69.0,-67.0,-60.0,-69.0,-72.0,-68.0,-62.0,-78.0,-86.0,-78.0,-86.0,10.0,17.0,11.0,26.0,1
4500,CC:2F:71:3F:1F:24,9053622,9320712016,5837524,8914491403,3216098,406220613,80,1352468,822396056,1343921,821369670,8547,1026386,1299178,619,5842242,594968,80,5880,86667.0,14444.0,-70.0,-63.0,-73.0,-67.0,-68.0,-63.0,-72.0,-67.0,-78.0,-86.0,-78.0,-86.0,8.0,23.0,5.0,19.0,1
4501,F8:59:71:5A:E0:3D,3367089,629080334,150991,222859721,3216098,406220613,0,149166,181267391,144348,180691689,4818,575702,126735,16,153705,2777,0,536,144444.0,43333.0,-67.0,-74.0,-66.0,-71.0,-67.0,-73.0,-65.0,-71.0,-78.0,-86.0,-78.0,-86.0,11.0,12.0,12.0,15.0,1
4502,CC:2F:71:3E:C5:1F,3227509,407616564,11411,1395951,3216098,406220613,6,48702,4078723,40245,3076643,8457,1002080,12032,34,16375,186,6,827,144444.0,39000.0,-68.0,-69.0,-67.0,-60.0,-69.0,-72.0,-68.0,-62.0,-78.0,-86.0,-78.0,-86.0,10.0,17.0,11.0,26.0,1
4503,CC:2F:71:3F:1F:24,9055117,9323020008,5839019,8916799395,3216098,406220613,80,1352793,822528025,1344246,821501639,8547,1026386,1299503,619,5843710,595040,80,5880,86667.0,14444.0,-71.0,-64.0,-73.0,-67.0,-70.0,-64.0,-72.0,-66.0,-78.0,-86.0,-78.0,-86.0,7.0,22.0,5.0,19.0,1
4504,F8:59:71:5A:E0:3D,3367161,629182010,151056,222960731,3216105,406221279,0,149232,181369045,144414,180793343,4818,575702,126800,16,153770,2778,0,536,144444.0,43333.0,-67.0,-73.0,-66.0,-71.0,-66.0,-73.0,-65.0,-71.0,-78.0,-86.0,-78.0,-86.0,11.0,13.0,12.0,15.0,1
4505,CC:2F:71:3E:C5:1F,3227516,407617230,11411,1395951,3216105,406221279,6,48702,4078723,40245,3076643,8457,1002080,12032,34,16375,186,6,827,144444.0,39000.0,-68.0,-69.0,-67.0,-60.0,-69.0,-72.0,-68.0,-62.0,-78.0,-86.0,-78.0,-86.0,10.0,17.0,11.0,26.0,1
4506,CC:2F:71:3F:1F:24,9056453,9325076900,5840348,8918855621,3216105,406221279,80,1353080,822652545,1344533,821626159,8547,1026386,1299787,619,5845033,595072,80,5882,86667.0,14444.0,-70.0,-63.0,-73.0,-67.0,-70.0,-63.0,-73.0,-67.0,-78.0,-86.0,-78.0,-86.0,8.0,23.0,5.0,19.0,1
4507,F8:59:71:5A:E0:3D,3367227,629281668,151120,223060187,3216107,406221481,0,149297,181469187,144479,180893485,4818,575702,126865,16,153834,2780,0,536,144444.0,43333.0,-67.0,-75.0,-65.0,-71.0,-67.0,-74.0,-65.0,-70.0,-78.0,-86.0,-78.0,-86.0,11.0,11.0,13.0,15.0,1
4508,CC:2F:71:3E:C5:1F,3227518,407617432,11411,1395951,3216107,406221481,6,48702,4078723,40245,3076643,8457,1002080,12032,34,16375,186,6,827,144444.0,39000.0,-68.0,-69.0,-67.0,-60.0,-69.0,-72.0,-68.0,-62.0,-78.0,-86.0,-78.0,-86.0,10.0,17.0,11.0,26.0,1
4509,CC:2F:71:3F:1F:24,9057633,9326894754,5841526,8920673273,3216107,406221481,80,1353343,822777069,1344796,821750683,8547,1026386,1300047,619,5846245,595548,80,5882,86667.0,14444.0,-71.0,-63.0,-73.0,-69.0,-70.0,-63.0,-72.0,-68.0,-78.0,-86.0,-78.0,-86.0,7.0,23.0,5.0,17.0,1
4510,F8:59:71:5A:E0:3D,3367300,629383652,151185,223161197,3216115,406222455,0,149362,181569287,144544,180993585,4818,575702,126930,16,153899,2780,0,536,144444.0,43333.0,-67.0,-74.0,-66.0,-71.0,-66.0,-74.0,-65.0,-71.0,-78.0,-86.0,-78.0,-86.0,11.0,12.0,12.0,15.0,1
4511,CC:2F:71:3E:C5:1F,3227526,407618406,11411,1395951,3216115,406222455,6,48702,4078723,40245,3076643,8457,1002080,12032,34,16375,186,6,827,144444.0,39000.0,-68.0,-69.0,-67.0,-60.0,-69.0,-72.0,-68.0,-62.0,-78.0,-86.0,-78.0,-86.0,10.0,17.0,11.0,26.0,1
4512,CC:2F:71:3F:1F:24,9059019,9329029140,5842904,8922806685,3216115,406222455,80,1353644,822906041,1345097,821879655,8547,1026386,1300348,619,5847623,595598,80,5884,86667.0,14444.0,-70.0,-64.0,-72.0,-69.0,-70.0,-64.0,-72.0,-69.0,-78.0,-86.0,-78.0,-86.0,8.0,22.0,6.0,17.0,1
4513,F8:59:71:5A:E0:3D,3367368,629484924,151250,223262207,3216118,406222717,0,149426,181667847,144608,181092145,4818,575702,126994,16,153963,2781,0,536,144444.0,43333.0,-66.0,-75.0,-65.0,-70.0,-66.0,-74.0,-65.0,-70.0,-78.0,-86.0,-78.0,-86.0,12.0,11.0,13.0,16.0,1
4514,CC:2F:71:3E:C5:1F,3227529,407618668,11411,1395951,3216118,406222717,6,48702,4078723,40245,3076643,8457,1002080,12032,34,16375,186,6,827,144444.0,39000.0,-68.0,-69.0,-67.0,-60.0,-69.0,-72.0,-68.0,-62.0,-78.0,-86.0,-78.0,-86.0,10.0,17.0,11.0,26.0,1
4515,CC:2F:71:3F:1F:24,9060156,9330777894,5844038,8924555177,3216118,406222717,80,1353928,823031473,1345381,822005087,8547,1026386,1300632,619,5848757,595618,80,5884,78000.0,13000.0,-71.0,-64.0,-73.0,-69.0,-71.0,-63.0,-73.0,-69.0,-78.0,-86.0,-78.0,-86.0,7.0,22.0,5.0,17.0,1
4516,F8:59:71:5A:E0:3D,3367438,629586454,151316,223363333,3216122,406223121,0,149495,181772701,144677,181196999,4818,575702,127061,16,154030,2784,0,536,144444.0,43333.0,-66.0,-74.0,-66.0,-71.0,-66.0,-74.0,-65.0,-71.0,-78.0,-86.0,-78.0,-86.0,12.0,12.0,12.0,15.0,1
4517,CC:2F:71:3E:C5:1F,3227535,407619274,11411,1395951,3216124,406223323,6,48702,4078723,40245,3076643,8457,1002080,12032,34,16375,186,6,827,144444.0,39000.0,-68.0,-69.0,-67.0,-60.0,-69.0,-72.0,-68.0,-62.0,-78.0,-86.0,-78.0,-86.0,10.0,17.0,11.0,26.0,1
4518,CC:2F:71:3F:1F:24,9061238,9332426169,5845114,8926202846,3216124,406223323,80,1354177,823157652,1345630,822131266,8547,1026386,1300881,619,5849816,595886,80,5884,86667.0,14444.0,-72.0,-64.0,-74.0,-67.0,-71.0,-64.0,-72.0,-67.0,-78.0,-86.0,-78.0,-86.0,6.0,22.0,4.0,19.0,1
4519,F8:59:71:5A:E0:3D,3367507,629687868,151381,223464343,3216126,406223525,0,149560,181872801,144742,181297099,4818,575702,127126,16,154095,2784,0,536,144444.0,43333.0,-68.0,-74.0,-66.0,-71.0,-67.0,-74.0,-65.0,-70.0,-78.0,-86.0,-78.0,-86.0,10.0,12.0,12.0,15.0,1
4520,CC:2F:71:3E:C5:1F,3227537,407619476,11411,1395951,3216126,406223525,6,48702,4078723,40245,3076643,8457,1002080,12032,34,16375,186,6,827,144444.0,39000.0,-68.0,-69.0,-67.0,-60.0,-69.0,-72.0,-68.0,-62.0,-78.0,-86.0,-78.0,-86.0,10.0,17.0,11.0,26.0,1
4521,CC:2F:71:3F:1F:24,9061925,9333466253,5845799,8927242728,3216126,406223525,80,1354402,823276326,1345855,822249940,8547,1026386,1301106,619,5850518,595955,80,5884,65000.0,14444.0,-70.0,-63.0,-74.0,-68.0,-69.0,-63.0,-72.0,-68.0,-78.0,-86.0,-78.0,-86.0,8.0,23.0,4.0,18.0,1
4522,F8:59:71:5A:E0:3D,3367572,629787384,151445,223563799,3216127,406223585,0,149624,181971361,144806,181395659,4818,575702,127190,16,154159,2785,0,536,144444.0,43333.0,-66.0,-71.0,-66.0,-69.0,-66.0,-73.0,-65.0,-70.0,-78.0,-86.0,-78.0,-86.0,12.0,15.0,12.0,17.0,1
4523,CC:2F:71:3E:C5:1F,3227542,407619940,11411,1395951,3216131,406223989,6,48702,4078723,40245,3076643,8457,1002080,12032,34,16375,186,6,827,144444.0,39000.0,-68.0,-69.0,-67.0,-60.0,-69.0,-72.0,-68.0,-62.0,-78.0,-86.0,-78.0,-86.0,10.0,17.0,11.0,26.0,1
4524,CC:2F:71:3F:1F:24,9062673,9334598347,5846542,8928374358,3216131,406223989,80,1354625,823393050,1346078,822366664,8547,1026386,1301329,619,5851261,595980,80,5884,86667.0,14444.0,-70.0,-63.0,-72.0,-69.0,-70.0,-63.0,-73.0,-68.0,-78.0,-86.0,-78.0,-86.0,8.0,23.0,6.0,17.0,1
4525,F8:59:71:5A:E0:3D,3367645,629887218,151508,223661701,3216137,406225517,0,149687,182068395,144869,181492693,4818,575702,127252,16,154222,2785,0,536,144444.0,43333.0,-66.0,-73.0,-65.0,-71.0,-66.0,-73.0,-65.0,-70.0,-78.0,-86.0,-78.0,-86.0,12.0,13.0,13.0,15.0,1
4526,CC:2F:71:3E:C5:1F,3227548,407621468,11411,1395951,3216137,406225517,6,48702,4078723,40245,3076643,8457,1002080,12032,34,16375,186,6,827,144444.0,39000.0,-68.0,-69.0,-67.0,-60.0,-69.0,-72.0,-68.0,-62.0,-78.0,-86.0,-78.0,-86.0,10.0,17.0,11.0,26.0,1
4527,CC:2F:71:3F:1F:24,9063487,9335834019,5847350,8929608502,3216137,406225517,80,1354847,823508366,1346300,822481980,8547,1026386,1301547,619,5852068,596002,80,5885,86667.0,14444.0,-69.0,-63.0,-72.0,-68.0,-69.0,-63.0,-71.0,-68.0,-78.0,-86.0,-78.0,-86.0,9.0,23.0,6.0,18.0,1
4528,F8:59:71:5A:E0:3D,3367709,629986674,151572,223761157,3216137,406225517,0,149751,182166955,144933,181591253,4818,575702,127316,16,154286,2786,0,536,144444.0,43333.0,-66.0,-75.0,-65.0,-70.0,-66.0,-75.0,-65.0,-70.0,-78.0,-86.0,-78.0,-86.0,12.0,11.0,13.0,16.0,1
4529,CC:2F:71:3E:C5:1F,3227548,407621468,11411,1395951,3216137,406225517,6,48702,4078723,40245,3076643,8457,1002080,12032,34,16375,186,6,827,144444.0,39000.0,-68.0,-69.0,-67.0,-60.0,-69.0,-72.0,-68.0,-62.0,-78.0,-86.0,-78.0,-86.0,10.0,17.0,11.0,26.0,1
4530,CC:2F:71:3F:1F:24,9064452,9337306366,5848313,8931080647,3216139,406225719,80,1355093,823632707,1346546,822606321,8547,1026386,1301793,619,5853032,596128,80,5886,86667.0,14444.0,-69.0,-64.0,-71.0,-70.0,-68.0,-63.0,-72.0,-69.0,-78.0,-86.0,-78.0,-86.0,9.0,22.0,7.0,16.0,1
4531,F8:59:71:5A:E0:3D,3367783,630089474,151637,223862167,3216146,406227307,0,149817,182268595,144999,181692893,4818,575702,127382,16,154351,2787,0,536,144444.0,43333.0,-67.0,-73.0,-65.0,-70.0,-67.0,-73.0,-65.0,-70.0,-78.0,-86.0,-78.0,-85.0,11.0,13.0,13.0,15.0,1
4532,CC:2F:71:3E:C5:1F,3227558,407623392,11411,1395951,3216147,406227441,6,48702,4078723,40245,3076643,8457,1002080,12032,34,16375,186,6,827,144444.0,39000.0,-68.0,-69.0,-67.0,-60.0,-69.0,-72.0,-68.0,-62.0,-78.0,-86.0,-78.0,-85.0,10.0,17.0,11.0,25.0,1
4533,CC:2F:71:3F:1F:24,9065608,9339077082,5849460,8932849573,3216148,406227509,80,1355374,823760395,1346827,822734009,8547,1026386,1302074,619,5854179,596137,80,5886,86667.0,14444.0,-70.0,-64.0,-73.0,-67.0,-70.0,-63.0,-72.0,-67.0,-78.0,-86.0,-78.0,-85.0,8.0,22.0,5.0,18.0,1
4534,F8:59:71:5A:E0:3D,3367850,630189258,151701,223961623,3216149,406227635,0,149881,182367155,145063,181791453,4818,575702,127446,16,154415,2787,0,536,144444.0,43333.0,-67.0,-74.0,-65.0,-70.0,-67.0,-73.0,-65.0,-70.0,-78.0,-86.0,-78.0,-85.0,11.0,12.0,13.0,15.0,1
4535,CC:2F:71:3E:C5:1F,3227560,407623586,11411,1395951,3216149,406227635,6,48702,4078723,40245,3076643,8457,1002080,12032,34,16375,186,6,827,144444.0,39000.0,-68.0,-69.0,-67.0,-60.0,-69.0,-72.0,-68.0,-62.0,-78.0,-86.0,-78.0,-85.0,10.0,17.0,11.0,25.0,1
4536,CC:2F:71:3F:1F:24,9066529,9340486776,5850380,8934259141,3216149,406227635,80,1355590,823875039,1347043,822848653,8547,1026386,1302290,619,5855082,596175,80,5886,86667.0,14444.0,-69.0,-64.0,-71.0,-68.0,-69.0,-64.0,-71.0,-67.0,-78.0,-86.0,-78.0,-85.0,9.0,22.0,7.0,17.0,1
4537,F8:59:71:5A:E0:3D,3367923,630290717,151765,224061079,3216158,406229638,0,149946,182467269,145128,181891567,4818,575702,127510,16,154479,2788,0,536,144444.0,43333.0,-67.0,-73.0,-65.0,-70.0,-66.0,-73.0,-65.0,-70.0,-78.0,-86.0,-78.0,-85.0,11.0,13.0,13.0,15.0,1
4538,CC:2F:71:3E:C5:1F,3227570,407625649,11411,1395951,3216159,406229698,6,48702,4078723,40245,3076643,8457,1002080,12032,34,16375,186,6,827,144444.0,39000.0,-68.0,-69.0,-67.0,-60.0,-69.0,-72.0,-68.0,-62.0,-78.0,-86.0,-78.0,-85.0,10.0,17.0,11.0,25.0,1
4539,CC:2F:71:3F:1F:24,9067454,9341891973,5851295,8935662275,3216159,406229698,80,1355814,824000455,1347267,822974069,8547,1026386,1302514,619,5856014,596254,80,5886,115556.0,28889.0,-69.0,-64.0,-71.0,-68.0,-69.0,-64.0,-70.0,-67.0,-78.0,-86.0,-78.0,-85.0,9.0,22.0,7.0,17.0,1
4540,F8:59:71:5A:E0:3D,3367996,630399759,151835,224169859,3216161,406229900,0,150018,182578205,145200,182002503,4818,575702,127580,16,154549,2788,0,536,144444.0,43333.0,-67.0,-74.0,-65.0,-70.0,-67.0,-73.0,-65.0,-69.0,-78.0,-86.0,-78.0,-85.0,11.0,12.0,13.0,15.0,1
4541,CC:2F:71:3E:C5:1F,3227572,407625851,11411,1395951,3216161,406229900,6,48702,4078723,40245,3076643,8457,1002080,12032,34,16375,186,6,827,144444.0,39000.0,-68.0,-69.0,-67.0,-60.0,-69.0,-72.0,-68.0,-62.0,-78.0,-86.0,-78.0,-85.0,10.0,17.0,11.0,25.0,1
4542,CC:2F:71:3F:1F:24,9068548,9343565667,5852387,8937335767,3216161,406229900,80,1356032,824121396,1347485,823095010,8547,1026386,1302732,619,5857105,596619,80,5886,115556.0,28889.0,-69.0,-64.0,-71.0,-67.0,-68.0,-64.0,-70.0,-67.0,-78.0,-86.0,-78.0,-85.0,9.0,22.0,7.0,18.0,1
4543,F8:59:71:5A:E0:3D,3368066,630499765,151899,224269259,3216167,406230506,0,150081,182675225,145263,182099523,4818,575702,127643,16,154613,2789,0,536,130000.0,39000.0,-67.0,-74.0,-65.0,-70.0,-66.0,-73.0,-65.0,-69.0,-78.0,-85.0,-78.0,-85.0,11.0,11.0,13.0,15.0,1
4544,CC:2F:71:3E:C5:1F,3227578,407626457,11411,1395951,3216167,406230506,6,48702,4078723,40245,3076643,8457,1002080,12032,34,16375,186,6,827,144444.0,39000.0,-68.0,-69.0,-67.0,-60.0,-69.0,-72.0,-68.0,-62.0,-78.0,-85.0,-78.0,-85.0,10.0,16.0,11.0,25.0,1
4545,CC:2F:71:3F:1F:24,9070085,9345939799,5853918,8939709293,3216167,406230506,80,1356350,824256502,1347803,823230116,8547,1026386,1303050,619,5858637,597169,80,5886,78000.0,13000.0,-68.0,-64.0,-71.0,-68.0,-68.0,-64.0,-70.0,-67.0,-78.0,-85.0,-78.0,-85.0,10.0,21.0,7.0,17.0,1
4546,F8:59:71:5A:E0:3D,3368141,630610309,151970,224379481,3216171,406230828,0,150153,182786105,145335,182210403,4818,575702,127715,16,154684,2789,0,536,144444.0,43333.0,-67.0,-73.0,-65.0,-69.0,-67.0,-73.0,-64.0,-69.0,-78.0,-85.0,-78.0,-85.0,11.0,12.0,13.0,16.0,1
4547,CC:2F:71:3E:C5:1F,3227582,407626779,11411,1395951,3216171,406230828,6,48702,4078723,40245,3076643,8457,1002080,12032,34,16375,186,6,827,144444.0,39000.0,-68.0,-69.0,-67.0,-60.0,-69.0,-72.0,-68.0,-62.0,-78.0,-85.0,-78.0,-85.0,10.0,16.0,11.0,25.0,1
4548,CC:2F:71:3F:1F:24,9072108,9349083063,5855937,8942852235,3216171,406230828,80,1356736,824396538,1348189,823370152,8547,1026386,1303436,619,5860627,597216,80,5886,86667.0,14444.0,-68.0,-64.0,-71.0,-68.0,-68.0,-64.0,-71.0,-68.0,-78.0,-85.0,-78.0,-85.0,10.0,21.0,7.0,17.0,1
4549,F8:59:71:5A:E0:3D,3368215,630715093,152037,224483599,3216178,406231494,0,150219,182887745,145401,182312043,4818,575702,127781,16,154751,2789,0,536,144444.0,43333.0,-66.0,-73.0,-66.0,-70.0,-66.0,-73.0,-65.0,-69.0,-78.0,-85.0,-78.0,-85.0,12.0,12.0,12.0,15.0,1
4550,CC:2F:71:3E:C5:1F,3227589,407627445,11411,1395951,3216178,406231494,6,48702,4078723,40245,3076643,8457,1002080,12032,34,16375,186,6,827,144444.0,39000.0,-68.0,-69.0,-67.0,-60.0,-69.0,-72.0,-68.0,-62.0,-78.0,-85.0,-78.0,-85.0,10.0,16.0,11.0,25.0,1
4551,CC:2F:71:3F:1F:24,9074059,9352107345,5857881,8945875851,3216178,406231494,80,1357127,824544326,1348580,823517940,8547,1026386,1303827,619,5862600,597296,80,5886,86667.0,14444.0,-69.0,-64.0,-71.0,-68.0,-69.0,-63.0,-72.0,-67.0,-78.0,-85.0,-78.0,-85.0,9.0,21.0,7.0,17.0,1
4552,F8:59:71:5A:E0:3D,3368286,630819589,152105,224587833,3216181,406231756,0,150288,182994019,145470,182418317,4818,575702,127849,16,154819,2789,0,536,144444.0,43333.0,-67.0,-73.0,-65.0,-70.0,-66.0,-73.0,-65.0,-70.0,-78.0,-85.0,-78.0,-85.0,11.0,12.0,13.0,15.0,1
4553,CC:2F:71:3E:C5:1F,3227593,407627823,11412,1396067,3216181,406231756,6,48704,4078863,40247,3076783,8457,1002080,12032,34,16376,186,6,827,144444.0,39000.0,-68.0,-70.0,-68.0,-60.0,-69.0,-71.0,-68.0,-63.0,-78.0,-85.0,-78.0,-85.0,10.0,15.0,10.0,25.0,1
4554,CC:2F:71:3F:1F:24,9075863,9354895393,5859682,8948663637,3216181,406231756,80,1357447,824678757,1348900,823652371,8547,1026386,1304147,619,5864383,597624,80,5889,115556.0,28889.0,-68.0,-64.0,-71.0,-67.0,-68.0,-63.0,-71.0,-67.0,-78.0,-85.0,-78.0,-85.0,10.0,21.0,7.0,18.0,1
4555,F8:59:71:5A:E0:3D,3368360,630924373,152172,224691951,3216188,406232422,0,150355,183097255,145537,182521553,4818,575702,127916,16,154886,2791,0,536,144444.0,43333.0,-67.0,-74.0,-65.0,-69.0,-66.0,-73.0,-64.0,-69.0,-78.0,-85.0,-78.0,-85.0,11.0,11.0,13.0,16.0,1
4556,CC:2F:71:3E:C5:1F,3227600,407628489,11412,1396067,3216188,406232422,6,48704,4078863,40247,3076783,8457,1002080,12032,34,16376,186,6,827,144444.0,39000.0,-68.0,-70.0,-68.0,-60.0,-69.0,-71.0,-68.0,-63.0,-78.0,-85.0,-78.0,-85.0,10.0,15.0,10.0,25.0,1
4557,CC:2F:71:3F:1F:24,9077722,9357778171,5861534,8951545749,3216188,406232422,80,1357779,824809801,1349232,823783415,8547,1026386,1304479,619,5866239,597874,80,5889,115556.0,28889.0,-69.0,-64.0,-72.0,-67.0,-68.0,-63.0,-71.0,-67.0,-78.0,-85.0,-78.0,-85.0,9.0,21.0,6.0,18.0,1
4558,F8:59:71:5A:E0:3D,3368431,631031801,152241,224799177,3216190,406232624,0,150424,183203515,145606,182627813,4818,575702,127985,16,154955,2792,0,536,144444.0,43333.0,-66.0,-73.0,-65.0,-70.0,-66.0,-73.0,-64.0,-69.0,-78.0,-85.0,-78.0,-85.0,12.0,12.0,13.0,15.0,1
4559,CC:2F:71:3E:C5:1F,3227602,407628691,11412,1396067,3216190,406232624,6,48704,4078863,40247,3076783,8457,1002080,12032,34,16376,186,6,827,144444.0,39000.0,-68.0,-70.0,-68.0,-60.0,-69.0,-71.0,-68.0,-63.0,-78.0,-85.0,-78.0,-85.0,10.0,15.0,10.0,25.0,1
4560,CC:2F:71:3F:1F:24,9079723,9360889371,5863533,8954656747,3216190,406232624,80,1358136,824952755,1349589,823926369,8547,1026386,1304836,619,5868252,598699,80,5889,115556.0,28889.0,-69.0,-64.0,-72.0,-67.0,-68.0,-63.0,-72.0,-67.0,-78.0,-85.0,-78.0,-85.0,9.0,21.0,6.0,18.0,1
4561,F8:59:71:5A:E0:3D,3368501,631134769,152307,224901741,3216194,406233028,0,150489,183303615,145671,182727913,4818,575702,128050,16,155021,2792,0,536,144444.0,43333.0,-66.0,-71.0,-65.0,-69.0,-66.0,-73.0,-64.0,-69.0,-78.0,-85.0,-78.0,-85.0,12.0,14.0,13.0,16.0,1
4562,CC:2F:71:3E:C5:1F,3227608,407629297,11412,1396067,3216196,406233230,6,48704,4078863,40247,3076783,8457,1002080,12032,34,16376,186,6,827,144444.0,39000.0,-68.0,-70.0,-68.0,-60.0,-69.0,-71.0,-68.0,-63.0,-78.0,-85.0,-78.0,-85.0,10.0,15.0,10.0,25.0,1
4563,CC:2F:71:3F:1F:24,9081007,9362863551,5864810,8956630261,3216197,406233290,80,1358427,825079129,1349880,824052743,8547,1026386,1305127,619,5869517,598934,80,5889,115556.0,28889.0,-69.0,-64.0,-72.0,-67.0,-68.0,-63.0,-71.0,-67.0,-78.0,-85.0,-78.0,-85.0,9.0,21.0,6.0,18.0,1
4564,F8:59:71:5A:E0:3D,3368569,631233135,152370,224999643,3216199,406233492,0,150552,183400635,145734,182824933,4818,575702,128113,16,155084,2792,0,536,144444.0,43333.0,-67.0,-73.0,-65.0,-69.0,-66.0,-73.0,-65.0,-69.0,-78.0,-85.0,-77.0,-85.0,11.0,12.0,12.0,16.0,1
4565,CC:2F:71:3E:C5:1F,3227611,407629559,11412,1396067,3216199,406233492,6,48704,4078863,40247,3076783,8457,1002080,12032,34,16376,186,6,827,144444.0,39000.0,-68.0,-70.0,-68.0,-60.0,-69.0,-71.0,-68.0,-63.0,-78.0,-85.0,-77.0,-85.0,10.0,15.0,9.0,25.0,1
4566,CC:2F:71:3F:1F:24,9082054,9364451169,5865855,8958217677,3216199,406233492,80,1358708,825203922,1350161,824177536,8547,1026386,1305408,619,5870570,599397,80,5889,65000.0,14444.0,-68.0,-64.0,-72.0,-68.0,-68.0,-63.0,-71.0,-67.0,-78.0,-85.0,-77.0,-85.0,10.0,21.0,5.0,17.0,1
4567,F8:59:71:5A:E0:3D,3368639,631333173,152435,225099215,3216204,406233958,0,150617,183499329,145799,182923627,4818,575702,128178,16,155149,2792,0,536,144444.0,43333.0,-67.0,-73.0,-65.0,-70.0,-66.0,-73.0,-64.0,-70.0,-78.0,-85.0,-77.0,-85.0,11.0,12.0,12.0,15.0,1
4568,CC:2F:71:3E:C5:1F,3227616,407630025,11412,1396067,3216204,406233958,6,48706,4079051,40248,3076853,8458,1002198,12033,34,16376,186,6,827,144444.0,39000.0,-68.0,-70.0,-68.0,-60.0,-68.0,-71.0,-68.0,-61.0,-78.0,-85.0,-77.0,-85.0,10.0,15.0,9.0,25.0,1
4569,CC:2F:71:3F:1F:24,9083188,9366190471,5866984,8959956513,3216204,406233958,80,1359000,825331604,1350453,824305218,8547,1026386,1305700,619,5871703,599421,80,5889,65000.0,14444.0,-68.0,-64.0,-72.0,-68.0,-68.0,-63.0,-72.0,-67.0,-78.0,-85.0,-77.0,-85.0,10.0,21.0,5.0,17.0,1
4570,F8:59:71:5A:E0:3D,3368709,631433155,152499,225198671,3216210,406234484,0,150681,183597889,145863,183022187,4818,575702,128242,16,155213,2792,0,536,144444.0,43333.0,-67.0,-74.0,-65.0,-70.0,-66.0,-73.0,-65.0,-69.0,-78.0,-85.0,-77.0,-85.0,11.0,11.0,12.0,15.0,1
4571,CC:2F:71:3E:C5:1F,3227622,407630551,11412,1396067,3216210,406234484,6,48706,4079051,40248,3076853,8458,1002198,12033,34,16376,186,6,827,144444.0,39000.0,-68.0,-70.0,-68.0,-60.0,-68.0,-71.0,-68.0,-61.0,-78.0,-85.0,-77.0,-85.0,10.0,15.0,9.0,25.0,1
4572,CC:2F:71:3F:1F:24,9084196,9367731329,5867986,8961496845,3216210,406234484,80,1359243,825452140,1350695,824425636,8548,1026504,1305942,619,5872687,599457,80,5890,86667.0,14444.0,-68.0,-64.0,-72.0,-68.0,-68.0,-64.0,-71.0,-67.0,-78.0,-85.0,-77.0,-85.0,10.0,21.0,5.0,17.0,1
4573,F8:59:71:5A:E0:3D,3368777,631533015,152563,225298127,3216214,406234888,0,150747,183699557,145929,183123855,4818,575702,128306,16,155276,2792,0,536,144444.0,43333.0,-67.0,-74.0,-65.0,-70.0,-66.0,-74.0,-65.0,-70.0,-78.0,-85.0,-77.0,-85.0,11.0,11.0,12.0,15.0,1
4574,CC:2F:71:3E:C5:1F,3227626,407630955,11412,1396067,3216214,406234888,6,48706,4079051,40248,3076853,8458,1002198,12033,34,16376,186,6,827,144444.0,39000.0,-68.0,-70.0,-68.0,-60.0,-68.0,-71.0,-68.0,-61.0,-78.0,-85.0,-77.0,-85.0,10.0,15.0,9.0,25.0,1
4575,CC:2F:71:3F:1F:24,9085188,9369249477,5868974,8963014589,3216214,406234888,80,1359509,825575578,1350961,824549074,8548,1026504,1306208,619,5873693,599577,80,5892,86667.0,14444.0,-68.0,-64.0,-72.0,-68.0,-68.0,-64.0,-71.0,-68.0,-78.0,-85.0,-77.0,-85.0,10.0,21.0,5.0,17.0,1
4576,F8:59:71:5A:E0:3D,3368844,631631321,152626,225396029,3216218,406235292,0,150811,183798117,145993,183222415,4818,575702,128370,16,155340,2793,0,536,144444.0,43333.0,-67.0,-74.0,-65.0,-70.0,-66.0,-74.0,-65.0,-70.0,-78.0,-85.0,-77.0,-85.0,11.0,11.0,12.0,15.0,1
4577,CC:2F:71:3E:C5:1F,3227630,407631359,11412,1396067,3216218,406235292,6,48706,4079051,40248,3076853,8458,1002198,12033,34,16376,186,6,827,144444.0,39000.0,-68.0,-70.0,-68.0,-60.0,-68.0,-71.0,-68.0,-61.0,-78.0,-85.0,-77.0,-85.0,10.0,15.0,9.0,25.0,1
4578,CC:2F:71:3F:1F:24,9086056,9370569528,5869837,8964333963,3216219,406235565,80,1359764,825697546,1351216,824671042,8548,1026504,1306463,619,5874556,599590,80,5892,86667.0,14444.0,-68.0,-63.0,-71.0,-68.0,-68.0,-63.0,-70.0,-68.0,-78.0,-85.0,-77.0,-85.0,10.0,22.0,6.0,17.0,1
4579,F8:59:71:5A:E0:3D,3368914,631731514,152690,225495485,3216224,406236029,0,150875,183896691,146057,183320989,4818,575702,128433,16,155404,2795,0,536,144444.0,43333.0,-67.0,-73.0,-65.0,-69.0,-66.0,-73.0,-65.0,-69.0,-78.0,-85.0,-77.0,-85.0,11.0,12.0,12.0,16.0,1
4580,CC:2F:71:3E:C5:1F,3227636,407632096,11412,1396067,3216224,406236029,6,48706,4079051,40248,3076853,8458,1002198,12033,34,16376,186,6,827,144444.0,39000.0,-68.0,-70.0,-68.0,-60.0,-68.0,-71.0,-68.0,-61.0,-78.0,-85.0,-77.0,-85.0,10.0,15.0,9.0,25.0,1
4581,CC:2F:71:3F:1F:24,9086888,9371826547,5870664,8965590518,3216224,406236029,80,1360002,825816565,1351454,824790061,8548,1026504,1306701,619,5875383,599657,80,5892,86667.0,14444.0,-69.0,-63.0,-73.0,-67.0,-69.0,-63.0,-72.0,-67.0,-78.0,-85.0,-77.0,-85.0,9.0,22.0,4.0,18.0,1
4582,F8:59:71:5A:E0:3D,3368979,631829618,152753,225593387,3216226,406236231,0,150938,183993711,146120,183418009,4818,575702,128496,16,155467,2797,0,536,144444.0,43333.0,-67.0,-74.0,-65.0,-71.0,-67.0,-73.0,-65.0,-70.0,-78.0,-85.0,-77.0,-85.0,11.0,11.0,12.0,14.0,1
4583,CC:2F:71:3E:C5:1F,3227638,407632298,11412,1396067,3216226,406236231,6,48706,4079051,40248,3076853,8458,1002198,12033,34,16376,186,6,827,144444.0,39000.0,-68.0,-70.0,-68.0,-60.0,-68.0,-71.0,-68.0,-61.0,-78.0,-85.0,-77.0,-85.0,10.0,15.0,9.0,25.0,1
4584,CC:2F:71:3F:1F:24,9087994,9373524467,5871766,8967288034,3216228,406236433,80,1360285,825940311,1351737,824913807,8548,1026504,1306984,619,5876485,599731,80,5892,86667.0,14444.0,-68.0,-63.0,-71.0,-68.0,-68.0,-63.0,-70.0,-68.0,-78.0,-85.0,-77.0,-85.0,10.0,22.0,6.0,17.0,1
4585,F8:59:71:5A:E0:3D,3369047,631929478,152817,225692843,3216230,406236635,0,151003,184093825,146185,183518123,4818,575702,128560,16,155531,2797,0,536,144444.0,43333.0,-66.0,-74.0,-65.0,-71.0,-66.0,-73.0,-65.0,-70.0,-77.0,-84.0,-77.0,-85.0,11.0,10.0,12.0,14.0,1
4586,CC:2F:71:3E:C5:1F,3227642,407632702,11412,1396067,3216230,406236635,6,48706,4079051,40248,3076853,8458,1002198,12033,34,16376,186,6,827,144444.0,39000.0,-68.0,-70.0,-68.0,-60.0,-68.0,-71.0,-68.0,-61.0,-77.0,-84.0,-77.0,-85.0,9.0,14.0,9.0,25.0,1
4587,CC:2F:71:3F:1F:24,9088980,9375032139,5872748,8968795302,3216232,406236837,80,1360553,826062521,1352005,825036017,8548,1026504,1307252,619,5877457,599756,80,5893,86667.0,14444.0,-68.0,-64.0,-71.0,-68.0,-68.0,-63.0,-70.0,-68.0,-77.0,-84.0,-77.0,-85.0,9.0,20.0,6.0,17.0,1
4588,F8:59:71:5A:E0:3D,3369115,632027844,152880,225790745,3216235,406237099,0,151067,184192385,146249,183616683,4818,575702,128624,16,155594,2798,0,536,144444.0,43333.0,-66.0,-73.0,-65.0,-70.0,-66.0,-73.0,-65.0,-70.0,-77.0,-84.0,-77.0,-85.0,11.0,11.0,12.0,15.0,1
4589,CC:2F:71:3E:C5:1F,3227647,407633166,11412,1396067,3216235,406237099,6,48706,4079051,40248,3076853,8458,1002198,12033,34,16376,186,6,827,144444.0,39000.0,-68.0,-70.0,-68.0,-60.0,-68.0,-71.0,-68.0,-61.0,-77.0,-84.0,-77.0,-85.0,9.0,14.0,9.0,25.0,1
4590,CC:2F:71:3F:1F:24,9090008,9376607419,5873773,8970370320,3216235,406237099,80,1360814,826186617,1352266,825160113,8548,1026504,1307513,619,5878492,599797,80,5893,86667.0,14444.0,-68.0,-64.0,-71.0,-69.0,-68.0,-63.0,-71.0,-68.0,-77.0,-84.0,-77.0,-85.0,9.0,20.0,6.0,16.0,1
4591,F8:59:71:5A:E0:3D,3369183,632129118,152945,225891755,3216238,406237363,0,151134,184294157,146315,183718337,4819,575820,128690,16,155659,2799,0,536,144444.0,43333.0,-67.0,-73.0,-65.0,-70.0,-67.0,-73.0,-65.0,-70.0,-77.0,-84.0,-77.0,-85.0,10.0,11.0,12.0,15.0,1
4592,CC:2F:71:3E:C5:1F,3227652,407633632,11412,1396067,3216240,406237565,6,48706,4079051,40248,3076853,8458,1002198,12033,34,16376,186,6,827,144444.0,39000.0,-68.0,-70.0,-68.0,-60.0,-68.0,-71.0,-68.0,-61.0,-77.0,-84.0,-77.0,-85.0,9.0,14.0,9.0,25.0,1
4593,CC:2F:71:3F:1F:24,9091046,9378188844,5874806,8971951279,3216240,406237565,80,1361079,826311742,1352531,825285238,8548,1026504,1307778,619,5879525,599953,80,5895,65000.0,14444.0,-69.0,-64.0,-71.0,-68.0,-68.0,-64.0,-71.0,-68.0,-77.0,-84.0,-77.0,-85.0,8.0,20.0,6.0,17.0,1
4594,F8:59:71:5A:E0:3D,3369253,632229180,153009,225991211,3216244,406237969,0,151198,184392731,146379,183816911,4819,575820,128753,16,155723,2800,0,536,144444.0,43333.0,-67.0,-74.0,-65.0,-70.0,-66.0,-73.0,-65.0,-70.0,-77.0,-84.0,-77.0,-85.0,10.0,10.0,12.0,15.0,1
4595,CC:2F:71:3E:C5:1F,3227656,407634036,11412,1396067,3216244,406237969,6,48706,4079051,40248,3076853,8458,1002198,12033,34,16376,186,6,827,144444.0,39000.0,-68.0,-70.0,-68.0,-60.0,-68.0,-71.0,-68.0,-61.0,-77.0,-84.0,-77.0,-85.0,9.0,14.0,9.0,25.0,1
4596,CC:2F:71:3F:1F:24,9092229,9380007246,5875985,8973769277,3216244,406237969,80,1361357,826436436,1352809,825409932,8548,1026504,1308056,619,5880704,600008,80,5895,86667.0,14444.0,-69.0,-64.0,-71.0,-68.0,-68.0,-64.0,-70.0,-67.0,-77.0,-84.0,-77.0,-85.0,8.0,20.0,6.0,17.0,1
4597,F8:59:71:5A:E0:3D,3369321,632330452,153074,226092221,3216247,406238231,0,151264,184494371,146445,183918551,4819,575820,128819,16,155788,2800,0,536,144444.0,43333.0,-67.0,-73.0,-66.0,-70.0,-67.0,-73.0,-65.0,-70.0,-77.0,-84.0,-77.0,-84.0,10.0,11.0,11.0,14.0,1
4598,CC:2F:71:3E:C5:1F,3227661,407634500,11412,1396067,3216249,406238433,6,48706,4079051,40248,3076853,8458,1002198,12033,34,16376,186,6,827,144444.0,39000.0,-68.0,-70.0,-68.0,-60.0,-68.0,-71.0,-68.0,-61.0,-77.0,-84.0,-77.0,-84.0,9.0,14.0,9.0,24.0,1
4599,CC:2F:71:3F:1F:24,9093757,9382366764,5877508,8976128331,3216249,406238433,80,1361682,826574134,1353134,825547630,8548,1026504,1308381,619,5882211,600170,80,5896,86667.0,14444.0,-68.0,-64.0,-72.0,-68.0,-68.0,-63.0,-71.0,-68.0,-77.0,-84.0,-77.0,-84.0,9.0,20.0,5.0,16.0,1
4600,F8:59:71:5A:E0:3D,3369396,632438284,153143,226199447,3216253,406238837,0,151333,184600631,146514,184024811,4819,575820,128888,16,155857,2800,0,536,144444.0,43333.0,-67.0,-74.0,-65.0,-70.0,-66.0,-73.0,-65.0,-70.0,-77.0,-84.0,-77.0,-84.0,10.0,10.0,12.0,14.0,1
4601,CC:2F:71:3E:C5:1F,3227665,407634904,11412,1396067,3216253,406238837,6,48706,4079051,40248,3076853,8458,1002198,12033,34,16376,186,6,827,144444.0,39000.0,-68.0,-70.0,-68.0,-60.0,-68.0,-71.0,-68.0,-61.0,-77.0,-84.0,-77.0,-84.0,9.0,14.0,9.0,24.0,1
4602,CC:2F:71:3F:1F:24,9095307,9384765580,5879054,8978526743,3216253,406238837,80,1362017,826708454,1353469,825681950,8548,1026504,1308716,619,5883773,600177,80,5896,86667.0,14444.0,-68.0,-64.0,-71.0,-68.0,-68.0,-63.0,-71.0,-67.0,-77.0,-84.0,-77.0,-84.0,9.0,20.0,6.0,16.0,1
4603,F8:59:71:5A:E0:3D,3369464,632541050,153209,226302011,3216255,406239039,0,151400,184703839,146581,184128019,4819,575820,128953,16,155923,2800,0,536,144444.0,43333.0,-67.0,-73.0,-66.0,-70.0,-67.0,-73.0,-65.0,-70.0,-77.0,-84.0,-77.0,-84.0,10.0,11.0,11.0,14.0,1
4604,CC:2F:71:3E:C5:1F,3227667,407635106,11412,1396067,3216255,406239039,6,48706,4079051,40248,3076853,8458,1002198,12033,34,16376,186,6,827,144444.0,39000.0,-68.0,-70.0,-68.0,-60.0,-68.0,-71.0,-68.0,-61.0,-77.0,-84.0,-77.0,-84.0,9.0,14.0,9.0,24.0,1
4605,CC:2F:71:3F:1F:24,9096389,9386417033,5880132,8980177792,3216257,406239241,80,1362306,826834881,1353758,825808377,8548,1026504,1309005,619,5884851,600186,80,5896,86667.0,14444.0,-68.0,-64.0,-71.0,-68.0,-68.0,-63.0,-71.0,-68.0,-77.0,-84.0,-77.0,-84.0,9.0,20.0,6.0,16.0,1
4606,F8:59:71:5A:E0:3D,3369531,632637862,153271,226398359,3216260,406239503,0,151463,184800859,146644,184225039,4819,575820,129016,16,155985,2802,0,536,144444.0,43333.0,-67.0,-74.0,-65.0,-70.0,-66.0,-73.0,-65.0,-70.0,-77.0,-84.0,-77.0,-84.0,10.0,10.0,12.0,14.0,1
4607,CC:2F:71:3E:C5:1F,3227672,407635570,11412,1396067,3216260,406239503,6,48706,4079051,40248,3076853,8458,1002198,12033,34,16376,186,6,827,144444.0,39000.0,-68.0,-70.0,-68.0,-60.0,-68.0,-71.0,-68.0,-61.0,-77.0,-84.0,-77.0,-84.0,9.0,14.0,9.0,24.0,1
4608,CC:2F:71:3F:1F:24,9097836,9388650285,5881574,8982410580,3216262,406239705,80,1362611,826961401,1354063,825934897,8548,1026504,1309310,619,5886260,600290,80,5899,86667.0,14444.0,-69.0,-64.0,-71.0,-68.0,-68.0,-64.0,-71.0,-68.0,-77.0,-84.0,-77.0,-84.0,8.0,20.0,6.0,16.0,1
4609,F8:59:71:5A:E0:3D,3369600,632739276,153336,226499369,3216264,406239907,0,151529,184902513,146710,184326693,4819,575820,129081,16,156050,2802,0,536,144444.0,43333.0,-67.0,-73.0,-65.0,-70.0,-66.0,-73.0,-65.0,-70.0,-77.0,-84.0,-77.0,-84.0,10.0,11.0,12.0,14.0,1
4610,CC:2F:71:3E:C5:1F,3227676,407635974,11412,1396067,3216264,406239907,6,48706,4079051,40248,3076853,8458,1002198,12033,34,16376,186,6,827,144444.0,39000.0,-68.0,-70.0,-68.0,-60.0,-68.0,-71.0,-68.0,-61.0,-77.0,-84.0,-77.0,-84.0,9.0,14.0,9.0,24.0,1
4611,CC:2F:71:3F:1F:24,9099338,9390974775,5883074,8984734868,3216264,406239907,80,1362929,827093589,1354381,826067085,8548,1026504,1309628,619,5887771,600326,80,5899,86667.0,14444.0,-69.0,-64.0,-72.0,-68.0,-68.0,-64.0,-71.0,-67.0,-77.0,-84.0,-77.0,-84.0,8.0,20.0,5.0,16.0,1
4612,F8:59:71:5A:E0:3D,3369673,632842346,153402,226601765,3216271,406240581,0,151594,185002613,146775,184426793,4819,575820,129146,16,156115,2803,0,536,144444.0,43333.0,-67.0,-74.0,-65.0,-70.0,-66.0,-73.0,-65.0,-69.0,-77.0,-84.0,-77.0,-84.0,10.0,10.0,12.0,14.0,1
4613,CC:2F:71:3E:C5:1F,3227683,407636648,11412,1396067,3216271,406240581,6,48706,4079051,40248,3076853,8458,1002198,12033,34,16376,186,6,827,144444.0,39000.0,-68.0,-70.0,-68.0,-60.0,-68.0,-71.0,-68.0,-61.0,-77.0,-84.0,-77.0,-84.0,9.0,14.0,9.0,24.0,1
4614,CC:2F:71:3F:1F:24,9100714,9393094803,5884443,8986854222,3216271,406240581,80,1363227,827220703,1354679,826194199,8548,1026504,1309926,619,5889162,600336,80,5900,86667.0,14444.0,-68.0,-64.0,-72.0,-68.0,-68.0,-64.0,-71.0,-67.0,-77.0,-84.0,-77.0,-84.0,9.0,20.0,5.0,16.0,1
4615,F8:59:71:5A:E0:3D,3369740,632943558,153467,226702775,3216273,406240783,0,151660,185104267,146841,184528447,4819,575820,129211,16,156181,2803,0,536,144444.0,43333.0,-67.0,-73.0,-66.0,-70.0,-66.0,-73.0,-65.0,-70.0,-77.0,-84.0,-77.0,-84.0,10.0,11.0,11.0,14.0,1
4616,CC:2F:71:3E:C5:1F,3227687,407637052,11412,1396067,3216275,406240985,6,48706,4079051,40248,3076853,8458,1002198,12033,34,16376,186,6,827,144444.0,39000.0,-68.0,-70.0,-68.0,-60.0,-68.0,-71.0,-68.0,-61.0,-77.0,-84.0,-77.0,-84.0,9.0,14.0,9.0,24.0,1
4617,CC:2F:71:3F:1F:24,9102236,9395441832,5885961,8989200847,3216275,406240985,80,1363563,827354324,1355015,826327820,8548,1026504,1310262,619,5890656,600464,80,5901,86667.0,14444.0,-69.0,-64.0,-72.0,-68.0,-68.0,-63.0,-71.0,-67.0,-77.0,-84.0,-77.0,-84.0,8.0,20.0,5.0,16.0,1
4618,F8:59:71:5A:E0:3D,3369810,633043620,153531,226802231,3216279,406241389,0,151724,185202827,146905,184627007,4819,575820,129275,16,156244,2803,0,536,144444.0,43333.0,-67.0,-74.0,-65.0,-70.0,-66.0,-73.0,-65.0,-70.0,-77.0,-84.0,-77.0,-84.0,10.0,10.0,12.0,14.0,1
4619,CC:2F:71:3E:C5:1F,3227691,407637456,11412,1396067,3216279,406241389,6,48706,4079051,40248,3076853,8458,1002198,12033,34,16376,186,6,827,144444.0,39000.0,-68.0,-70.0,-68.0,-60.0,-68.0,-71.0,-68.0,-61.0,-77.0,-84.0,-77.0,-84.0,9.0,14.0,9.0,24.0,1
4620,CC:2F:71:3F:1F:24,9103917,9398044629,5887637,8991802967,3216280,406241662,80,1363905,827490810,1355357,826464306,8548,1026504,1310604,619,5892332,600540,80,5901,86667.0,14444.0,-68.0,-64.0,-71.0,-68.0,-68.0,-64.0,-71.0,-67.0,-77.0,-84.0,-77.0,-84.0,9.0,20.0,6.0,16.0,1
4621,F8:59:71:5A:E0:3D,3369881,633148273,153598,226906349,3216283,406241924,0,151792,185307547,146973,184731727,4819,575820,129343,16,156312,2803,0,536,144444.0,43333.0,-67.0,-74.0,-66.0,-70.0,-67.0,-73.0,-65.0,-70.0,-77.0,-84.0,-77.0,-84.0,10.0,10.0,11.0,14.0,1
4622,CC:2F:71:3E:C5:1F,3227695,407637991,11412,1396067,3216283,406241924,6,48706,4079051,40248,3076853,8458,1002198,12033,34,16376,186,6,827,144444.0,39000.0,-68.0,-70.0,-68.0,-60.0,-68.0,-71.0,-68.0,-61.0,-77.0,-84.0,-77.0,-84.0,9.0,14.0,9.0,24.0,1
4623,CC:2F:71:3F:1F:24,9105169,9399974773,5888886,8993732849,3216283,406241924,80,1364200,827617992,1355652,826591488,8548,1026504,1310899,619,5893605,600559,80,5902,86667.0,14444.0,-69.0,-64.0,-71.0,-68.0,-68.0,-63.0,-70.0,-67.0,-77.0,-84.0,-77.0,-84.0,8.0,20.0,6.0,16.0,1
4624,F8:59:71:5A:E0:3D,3369950,633246781,153661,227004251,3216289,406242530,0,151855,185404567,147036,184828747,4819,575820,129406,16,156375,2803,0,536,144444.0,43333.0,-67.0,-73.0,-65.0,-70.0,-66.0,-73.0,-65.0,-70.0,-77.0,-84.0,-77.0,-84.0,10.0,11.0,12.0,14.0,1
4625,CC:2F:71:3E:C5:1F,3227701,407638597,11412,1396067,3216289,406242530,6,48706,4079051,40248,3076853,8458,1002198,12033,34,16376,186,6,827,144444.0,39000.0,-68.0,-70.0,-68.0,-60.0,-68.0,-71.0,-68.0,-61.0,-77.0,-84.0,-77.0,-84.0,9.0,14.0,9.0,24.0,1
4626,CC:2F:71:3F:1F:24,9106008,9401247077,5889719,8995004547,3216289,406242530,80,1364423,827736358,1355875,826709854,8548,1026504,1311122,619,5894438,600623,80,5902,86667.0,14444.0,-68.0,-64.0,-70.0,-68.0,-68.0,-64.0,-71.0,-68.0,-77.0,-84.0,-77.0,-84.0,9.0,20.0,7.0,16.0,1
4627,F8:59:71:5A:E0:3D,3370016,633346439,153725,227103707,3216291,406242732,0,151919,185503127,147100,184927307,4819,575820,129470,16,156439,2804,0,536,144444.0,43333.0,-67.0,-74.0,-65.0,-70.0,-67.0,-73.0,-65.0,-70.0,-77.0,-84.0,-77.0,-84.0,10.0,10.0,12.0,14.0,1
4628,CC:2F:71:3E:C5:1F,3227703,407638799,11412,1396067,3216291,406242732,6,48706,4079051,40248,3076853,8458,1002198,12033,34,16376,186,6,827,144444.0,39000.0,-68.0,-70.0,-68.0,-60.0,-68.0,-71.0,-68.0,-61.0,-77.0,-84.0,-77.0,-84.0,9.0,14.0,9.0,24.0,1
4629,CC:2F:71:3F:1F:24,9106939,9402672201,5890648,8996429469,3216291,406242732,80,1364681,827858578,1356133,826832074,8548,1026504,1311380,619,5895367,600639,80,5902,86667.0,14444.0,-68.0,-64.0,-71.0,-68.0,-68.0,-64.0,-71.0,-68.0,-77.0,-84.0,-77.0,-84.0,9.0,20.0,6.0,16.0,1
4630,F8:59:71:5A:E0:3D,3370085,633446359,153789,227203163,3216296,406243196,0,151982,185600147,147163,185024327,4819,575820,129533,16,156503,2804,0,536,144444.0,43333.0,-67.0,-73.0,-65.0,-70.0,-67.0,-73.0,-65.0,-70.0,-77.0,-84.0,-77.0,-84.0,10.0,11.0,12.0,14.0,1
4631,CC:2F:71:3E:C5:1F,3227708,407639263,11412,1396067,3216296,406243196,6,48706,4079051,40248,3076853,8458,1002198,12033,34,16376,186,6,827,144444.0,39000.0,-68.0,-70.0,-68.0,-60.0,-68.0,-71.0,-68.0,-61.0,-77.0,-84.0,-77.0,-84.0,9.0,14.0,9.0,24.0,1
4632,CC:2F:71:3F:1F:24,9108074,9404408578,5891778,8998165382,3216296,406243196,80,1364953,827981655,1356405,826955151,8548,1026504,1311652,619,5896487,600802,80,5902,86667.0,14444.0,-67.0,-63.0,-71.0,-68.0,-68.0,-63.0,-71.0,-68.0,-77.0,-84.0,-77.0,-84.0,10.0,21.0,6.0,16.0,1
4633,F8:59:71:5A:E0:3D,3370154,633547773,153854,227304173,3216300,406243600,0,152048,185701787,147229,185125967,4819,575820,129599,16,156568,2806,0,536,144444.0,43333.0,-67.0,-74.0,-65.0,-70.0,-66.0,-73.0,-65.0,-70.0,-77.0,-84.0,-77.0,-84.0,10.0,10.0,12.0,14.0,1
4634,CC:2F:71:3E:C5:1F,3227712,407639667,11412,1396067,3216300,406243600,6,48706,4079051,40248,3076853,8458,1002198,12033,34,16376,186,6,827,144444.0,39000.0,-68.0,-70.0,-68.0,-60.0,-68.0,-71.0,-68.0,-61.0,-77.0,-84.0,-77.0,-84.0,9.0,14.0,9.0,24.0,1
4635,CC:2F:71:3F:1F:24,9109189,9406120900,5892889,8999877300,3216300,406243600,80,1365231,828107767,1356683,827081263,8548,1026504,1311930,619,5897608,600940,80,5902,86667.0,14444.0,-69.0,-64.0,-71.0,-68.0,-68.0,-63.0,-71.0,-68.0,-77.0,-84.0,-77.0,-84.0,8.0,20.0,6.0,16.0,1
4636,F8:59:71:5A:E0:3D,3370227,633651225,153921,227406853,3216306,406244372,0,152113,185801887,147294,185226067,4819,575820,129664,16,156635,2806,0,536,144444.0,43333.0,-67.0,-73.0,-65.0,-71.0,-66.0,-73.0,-65.0,-70.0,-77.0,-84.0,-77.0,-84.0,10.0,11.0,12.0,13.0,1
4637,CC:2F:71:3E:C5:1F,3227719,407640555,11413,1396183,3216306,406244372,6,48708,4079191,40250,3076993,8458,1002198,12033,34,16377,186,6,827,144444.0,43333.0,-68.0,-71.0,-68.0,-60.0,-67.0,-69.0,-67.0,-60.0,-77.0,-84.0,-77.0,-84.0,9.0,13.0,9.0,24.0,1
4638,CC:2F:71:3F:1F:24,9110601,9408297790,5894295,9002053418,3216306,406244372,80,1365549,828240301,1357001,827213797,8548,1026504,1312248,619,5899005,600991,80,5903,86667.0,14444.0,-69.0,-64.0,-71.0,-68.0,-68.0,-64.0,-71.0,-68.0,-77.0,-84.0,-77.0,-84.0,8.0,20.0,6.0,16.0,1
4639,F8:59:71:5A:E0:3D,3370296,633751145,153985,227506309,3216311,406244836,0,152178,185901987,147359,185326167,4819,575820,129729,16,156699,2806,0,536,144444.0,43333.0,-67.0,-73.0,-65.0,-70.0,-66.0,-73.0,-65.0,-70.0,-77.0,-84.0,-77.0,-84.0,10.0,11.0,12.0,14.0,1
4640,CC:2F:71:3E:C5:1F,3227724,407641019,11413,1396183,3216311,406244836,6,48708,4079191,40250,3076993,8458,1002198,12033,34,16377,186,6,827,144444.0,43333.0,-68.0,-71.0,-68.0,-60.0,-67.0,-69.0,-67.0,-60.0,-77.0,-84.0,-77.0,-84.0,9.0,13.0,9.0,24.0,1
4641,CC:2F:71:3F:1F:24,9111819,9410169712,5895508,9003924876,3216311,406244836,80,1365854,828370961,1357306,827344457,8548,1026504,1312553,619,5900227,601090,80,5904,86667.0,14444.0,-69.0,-64.0,-71.0,-68.0,-68.0,-64.0,-71.0,-68.0,-77.0,-84.0,-77.0,-84.0,8.0,20.0,6.0,16.0,1
4642,F8:59:71:5A:E0:3D,3370366,633852621,154050,227607319,3216316,406245302,0,152243,186002087,147424,185426267,4819,575820,129794,16,156764,2806,0,536,144444.0,43333.0,-67.0,-74.0,-65.0,-70.0,-66.0,-73.0,-65.0,-70.0,-77.0,-84.0,-77.0,-84.0,10.0,10.0,12.0,14.0,1
4643,CC:2F:71:3E:C5:1F,3227729,407641485,11413,1396183,3216316,406245302,6,48710,4079379,40251,3077063,8459,1002316,12034,34,16377,186,6,827,144444.0,43333.0,-68.0,-70.0,-68.0,-60.0,-67.0,-70.0,-68.0,-60.0,-77.0,-84.0,-77.0,-84.0,9.0,14.0,9.0,24.0,1
4644,CC:2F:71:3F:1F:24,9112751,9411580027,5896435,9005334725,3216316,406245302,80,1366105,828491622,1357557,827465118,8548,1026504,1312804,619,5901128,601098,80,5904,86667.0,14444.0,-69.0,-64.0,-72.0,-68.0,-69.0,-64.0,-71.0,-68.0,-77.0,-84.0,-77.0,-84.0,8.0,20.0,5.0,16.0,1
4645,F8:59:71:5A:E0:3D,3370432,633952279,154114,227706775,3216318,406245504,0,152306,186099107,147487,185523287,4819,575820,129857,16,156828,2806,0,536,144444.0,43333.0,-66.0,-73.0,-65.0,-70.0,-66.0,-72.0,-65.0,-69.0,-77.0,-84.0,-77.0,-84.0,11.0,11.0,12.0,14.0,1
4646,CC:2F:71:3E:C5:1F,3227733,407641889,11413,1396183,3216320,406245706,6,48710,4079379,40251,3077063,8459,1002316,12034,34,16377,186,6,827,144444.0,43333.0,-68.0,-70.0,-68.0,-60.0,-67.0,-70.0,-68.0,-60.0,-77.0,-84.0,-77.0,-84.0,9.0,14.0,9.0,24.0,1
4647,CC:2F:71:3F:1F:24,9113568,9412821105,5897248,9006575399,3216320,406245706,80,1366334,828611058,1357786,827584554,8548,1026504,1313033,619,5901967,601098,80,5905,86667.0,14444.0,-69.0,-64.0,-72.0,-69.0,-68.0,-64.0,-71.0,-68.0,-77.0,-84.0,-77.0,-84.0,8.0,20.0,5.0,15.0,1
4648,F8:59:71:5A:E0:3D,3370503,634052401,154178,227806231,3216325,406246170,0,152370,186197667,147551,185621847,4819,575820,129921,16,156892,2806,0,536,144444.0,43333.0,-66.0,-73.0,-66.0,-70.0,-66.0,-73.0,-65.0,-70.0,-77.0,-84.0,-77.0,-84.0,11.0,11.0,11.0,14.0,1
4649,CC:2F:71:3E:C5:1F,3227738,407642353,11413,1396183,3216325,406246170,6,48710,4079379,40251,3077063,8459,1002316,12034,34,16377,186,6,827,144444.0,43333.0,-68.0,-70.0,-68.0,-60.0,-67.0,-70.0,-68.0,-60.0,-77.0,-84.0,-77.0,-84.0,9.0,14.0,9.0,24.0,1
4650,CC:2F:71:3F:1F:24,9114412,9414104383,5898087,9007858213,3216325,406246170,80,1366556,828727902,1358008,827701398,8548,1026504,1313255,619,5902806,601195,80,5905,86667.0,14444.0,-68.0,-64.0,-70.0,-68.0,-68.0,-64.0,-71.0,-68.0,-77.0,-84.0,-77.0,-84.0,9.0,20.0,7.0,16.0,1
4651,F8:59:71:5A:E0:3D,3370572,634153823,154243,227907241,3216329,406246582,0,152436,186299335,147617,185723515,4819,575820,129987,16,156957,2806,0,537,144444.0,43333.0,-67.0,-73.0,-66.0,-70.0,-66.0,-73.0,-65.0,-69.0,-77.0,-84.0,-77.0,-84.0,10.0,11.0,11.0,14.0,1
4652,CC:2F:71:3E:C5:1F,3227742,407642765,11413,1396183,3216329,406246582,6,48710,4079379,40251,3077063,8459,1002316,12034,34,16377,186,6,827,144444.0,43333.0,-68.0,-70.0,-68.0,-60.0,-67.0,-70.0,-68.0,-60.0,-77.0,-84.0,-77.0,-84.0,9.0,14.0,9.0,24.0,1
4653,CC:2F:71:3F:1F:24,9115283,9415428951,5898952,9009182167,3216331,406246784,80,1366785,828849938,1358237,827823434,8548,1026504,1313484,619,5903671,601267,80,5905,86667.0,14444.0,-69.0,-64.0,-71.0,-69.0,-68.0,-64.0,-71.0,-68.0,-77.0,-84.0,-77.0,-84.0,8.0,20.0,6.0,15.0,1
4654,F8:59:71:5A:E0:3D,3370643,634255359,154308,228008251,3216335,406247108,0,152501,186398013,147681,185822075,4820,575938,130052,16,157022,2808,0,537,144444.0,43333.0,-67.0,-73.0,-66.0,-70.0,-67.0,-73.0,-65.0,-70.0,-77.0,-84.0,-77.0,-84.0,10.0,11.0,11.0,14.0,1
4655,CC:2F:71:3E:C5:1F,3227750,407643493,11413,1396183,3216337,406247310,6,48710,4079379,40251,3077063,8459,1002316,12034,34,16377,186,6,827,144444.0,43333.0,-68.0,-70.0,-68.0,-60.0,-67.0,-70.0,-68.0,-60.0,-77.0,-84.0,-77.0,-84.0,9.0,14.0,9.0,24.0,1
4656,CC:2F:71:3F:1F:24,9116522,9417314422,5900174,9011061688,3216348,406252734,80,1367069,828988775,1358521,827962271,8548,1026504,1313768,619,5904877,601323,80,5907,86667.0,14444.0,-69.0,-64.0,-71.0,-68.0,-68.0,-63.0,-71.0,-68.0,-77.0,-84.0,-77.0,-84.0,8.0,20.0,6.0,16.0,1
4657,F8:59:71:5A:E0:3D,3370741,634378499,154380,228120139,3216361,406258360,0,152574,186510433,147754,185934495,4820,575938,130125,16,157094,2808,0,537,144444.0,43333.0,-67.0,-74.0,-65.0,-70.0,-66.0,-73.0,-65.0,-70.0,-77.0,-84.0,-77.0,-84.0,10.0,10.0,12.0,14.0,1
4658,CC:2F:71:3E:C5:1F,3227774,407654543,11413,1396183,3216361,406258360,6,48710,4079379,40251,3077063,8459,1002316,12034,34,16377,186,6,827,144444.0,43333.0,-68.0,-70.0,-68.0,-60.0,-67.0,-70.0,-68.0,-60.0,-77.0,-84.0,-77.0,-84.0,9.0,14.0,9.0,24.0,1
4659,CC:2F:71:3F:1F:24,9117816,9419296816,5901453,9013038254,3216363,406258562,80,1367361,829123647,1358813,828097143,8548,1026504,1314060,619,5906172,601483,80,5909,86667.0,14444.0,-69.0,-64.0,-71.0,-68.0,-68.0,-63.0,-71.0,-67.0,-77.0,-84.0,-77.0,-84.0,8.0,20.0,6.0,16.0,1
4660,F8:59:71:5A:E0:3D,3370816,634486331,154449,228227365,3216367,406258966,0,152643,186616693,147823,186040755,4820,575938,130194,16,157163,2809,0,537,144444.0,43333.0,-67.0,-74.0,-65.0,-70.0,-66.0,-73.0,-65.0,-70.0,-77.0,-84.0,-77.0,-84.0,10.0,10.0,12.0,14.0,1
4661,CC:2F:71:3E:C5:1F,3227781,407655422,11413,1396183,3216368,406259239,6,48710,4079379,40251,3077063,8459,1002316,12034,34,16377,186,6,827,144444.0,43333.0,-68.0,-70.0,-68.0,-60.0,-67.0,-70.0,-68.0,-60.0,-77.0,-84.0,-77.0,-84.0,9.0,14.0,9.0,24.0,1
4662,CC:2F:71:3F:1F:24,9119093,9421263581,5902725,9015004342,3216368,406259239,80,1367684,829253983,1359136,828227479,8548,1026504,1314383,619,5907444,601485,80,5910,86667.0,14444.0,-69.0,-64.0,-71.0,-68.0,-68.0,-64.0,-71.0,-68.0,-77.0,-84.0,-77.0,-84.0,8.0,20.0,6.0,16.0,1
4663,F8:59:71:5A:E0:3D,3370886,634589430,154515,228329929,3216371,406259501,0,152708,186716793,147888,186140855,4820,575938,130259,16,157229,2809,0,537,144444.0,43333.0,-67.0,-73.0,-65.0,-70.0,-66.0,-73.0,-65.0,-70.0,-77.0,-84.0,-77.0,-84.0,10.0,11.0,12.0,14.0,1
4664,CC:2F:71:3E:C5:1F,3227784,407655684,11413,1396183,3216371,406259501,6,48710,4079379,40251,3077063,8459,1002316,12034,34,16377,186,6,827,144444.0,43333.0,-68.0,-70.0,-68.0,-60.0,-67.0,-70.0,-68.0,-60.0,-77.0,-84.0,-77.0,-84.0,9.0,14.0,9.0,24.0,1
4665,CC:2F:71:3F:1F:24,9120637,9423651531,5904264,9017391828,3216373,406259703,80,1368002,829387749,1359454,828361245,8548,1026504,1314701,619,5908955,601570,80,5910,78000.0,13000.0,-69.0,-64.0,-72.0,-69.0,-68.0,-64.0,-71.0,-68.0,-77.0,-84.0,-77.0,-84.0,8.0,20.0,5.0,15.0,1
4666,F8:59:71:5A:E0:3D,3370957,634693952,154582,228434047,3216375,406259905,0,152777,186823067,147957,186247129,4820,575938,130327,16,157296,2809,0,537,144444.0,43333.0,-66.0,-73.0,-65.0,-70.0,-66.0,-73.0,-65.0,-69.0,-77.0,-84.0,-77.0,-84.0,11.0,11.0,12.0,14.0,1
4667,CC:2F:71:3E:C5:1F,3227790,407656290,11413,1396183,3216377,406260107,6,48710,4079379,40251,3077063,8459,1002316,12034,34,16377,186,6,827,144444.0,43333.0,-68.0,-70.0,-68.0,-60.0,-67.0,-70.0,-68.0,-60.0,-77.0,-84.0,-77.0,-84.0,9.0,14.0,9.0,24.0,1
4668,CC:2F:71:3F:1F:24,9121859,9425523656,5905482,9019263549,3216377,406260107,80,1368303,829518430,1359755,828491926,8548,1026504,1315002,619,5910190,601595,80,5910,86667.0,14444.0,-68.0,-64.0,-71.0,-68.0,-68.0,-64.0,-71.0,-68.0,-77.0,-84.0,-77.0,-84.0,9.0,20.0,6.0,16.0,1
4669,F8:59:71:5A:E0:3D,3371025,634793812,154646,228533503,3216379,406260309,0,152841,186921627,148021,186345689,4820,575938,130391,16,157360,2809,0,537,144444.0,43333.0,-67.0,-72.0,-65.0,-69.0,-67.0,-73.0,-65.0,-69.0,-77.0,-84.0,-77.0,-84.0,10.0,12.0,12.0,15.0,1
4670,CC:2F:71:3E:C5:1F,3227792,407656492,11413,1396183,3216379,406260309,6,48710,4079379,40251,3077063,8459,1002316,12034,34,16377,186,6,827,144444.0,43333.0,-68.0,-70.0,-68.0,-60.0,-67.0,-70.0,-68.0,-60.0,-77.0,-84.0,-77.0,-84.0,9.0,14.0,9.0,24.0,1
4671,CC:2F:71:3F:1F:24,9122763,9426906310,5906384,9020646001,3216379,406260309,80,1368545,829638890,1359997,828612386,8548,1026504,1315244,619,5911103,601628,80,5910,86667.0,14444.0,-69.0,-64.0,-71.0,-68.0,-68.0,-64.0,-71.0,-68.0,-77.0,-84.0,-77.0,-84.0,8.0,20.0,6.0,16.0,1
4672,F8:59:71:5A:E0:3D,3371094,634895146,154711,228634513,3216383,406260633,0,152906,187021727,148086,186445789,4820,575938,130456,16,157425,2810,0,537,144444.0,43333.0,-67.0,-73.0,-66.0,-70.0,-67.0,-73.0,-65.0,-70.0,-77.0,-84.0,-77.0,-84.0,10.0,11.0,11.0,14.0,1
4673,CC:2F:71:3E:C5:1F,3227798,407657018,11413,1396183,3216385,406260835,6,48710,4079379,40251,3077063,8459,1002316,12034,34,16377,186,6,827,144444.0,43333.0,-68.0,-70.0,-68.0,-60.0,-67.0,-70.0,-68.0,-60.0,-77.0,-84.0,-77.0,-84.0,9.0,14.0,9.0,24.0,1
4674,CC:2F:71:3F:1F:24,9123770,9428442252,5907383,9022181215,3216387,406261037,80,1368799,829760696,1360250,828734074,8549,1026622,1315498,619,5912102,601706,80,5910,65000.0,13000.0,-69.0,-64.0,-71.0,-68.0,-68.0,-63.0,-71.0,-68.0,-77.0,-84.0,-77.0,-84.0,8.0,20.0,6.0,16.0,1
4675,F8:59:71:5A:E0:3D,3371162,634995006,154775,228733969,3216387,406261037,0,152970,187120301,148150,186544363,4820,575938,130519,16,157488,2810,0,537,144444.0,43333.0,-66.0,-73.0,-65.0,-70.0,-66.0,-73.0,-65.0,-70.0,-77.0,-84.0,-77.0,-84.0,11.0,11.0,12.0,14.0,1
4676,CC:2F:71:3E:C5:1F,3227800,407657220,11413,1396183,3216387,406261037,6,48710,4079379,40251,3077063,8459,1002316,12034,34,16377,186,6,827,144444.0,43333.0,-68.0,-70.0,-68.0,-60.0,-67.0,-70.0,-68.0,-60.0,-77.0,-84.0,-77.0,-84.0,9.0,14.0,9.0,24.0,1
4677,CC:2F:71:3F:1F:24,9124998,9430334586,5908609,9024073347,3216389,406261239,80,1369057,829882888,1360508,828856266,8549,1026622,1315756,619,5913328,601723,80,5910,86667.0,14444.0,-69.0,-64.0,-72.0,-68.0,-68.0,-63.0,-71.0,-67.0,-77.0,-84.0,-77.0,-84.0,8.0,20.0,5.0,16.0,1
4678,F8:59:71:5A:E0:3D,3371230,635094698,154839,228833257,3216391,406261441,0,153036,187222039,148216,186646101,4820,575938,130583,16,157553,2810,0,538,144444.0,43333.0,-67.0,-73.0,-66.0,-70.0,-66.0,-73.0,-65.0,-70.0,-77.0,-84.0,-77.0,-84.0,10.0,11.0,11.0,14.0,1
4679,CC:2F:71:3E:C5:1F,3227804,407657624,11413,1396183,3216391,406261441,6,48710,4079379,40251,3077063,8459,1002316,12034,34,16377,186,6,827,144444.0,43333.0,-68.0,-70.0,-68.0,-60.0,-67.0,-70.0,-68.0,-60.0,-77.0,-84.0,-77.0,-84.0,9.0,14.0,9.0,24.0,1
4680,CC:2F:71:3F:1F:24,9126058,9431954127,5909666,9025692626,3216392,406261501,80,1369341,830010099,1360792,828983477,8549,1026622,1316040,619,5914385,601758,80,5910,86667.0,14444.0,-69.0,-64.0,-71.0,-68.0,-68.0,-63.0,-71.0,-68.0,-77.0,-84.0,-77.0,-84.0,8.0,20.0,6.0,16.0,1
4681,F8:59:71:5A:E0:3D,3371299,635194618,154903,228932713,3216396,406261905,0,153101,187322139,148281,186746201,4820,575938,130648,16,157617,2810,0,538,144444.0,43333.0,-67.0,-73.0,-66.0,-70.0,-66.0,-73.0,-65.0,-69.0,-77.0,-84.0,-77.0,-84.0,10.0,11.0,11.0,14.0,1
4682,CC:2F:71:3E:C5:1F,3227809,407658088,11413,1396183,3216396,406261905,6,48710,4079379,40251,3077063,8459,1002316,12034,34,16377,186,6,827,144444.0,43333.0,-68.0,-70.0,-68.0,-60.0,-67.0,-70.0,-68.0,-60.0,-77.0,-84.0,-77.0,-84.0,9.0,14.0,9.0,24.0,1
4683,CC:2F:71:3F:1F:24,9127192,9433694735,5910796,9027432830,3216396,406261905,80,1369633,830137817,1361084,829111195,8549,1026622,1316332,619,5915515,601868,80,5910,86667.0,14444.0,-68.0,-64.0,-71.0,-68.0,-68.0,-63.0,-71.0,-68.0,-77.0,-84.0,-77.0,-84.0,9.0,20.0,6.0,16.0,1
4684,F8:59:71:5A:E0:3D,3371369,635297586,154969,229035277,3216400,406262309,0,153166,187422239,148346,186846301,4820,575938,130713,16,157683,2810,0,538,144444.0,43333.0,-67.0,-74.0,-65.0,-70.0,-67.0,-73.0,-65.0,-70.0,-77.0,-84.0,-77.0,-84.0,10.0,10.0,12.0,14.0,1
4685,CC:2F:71:3E:C5:1F,3227813,407658492,11413,1396183,3216400,406262309,6,48710,4079379,40251,3077063,8459,1002316,12034,34,16377,186,6,827,144444.0,43333.0,-68.0,-70.0,-68.0,-60.0,-67.0,-70.0,-68.0,-60.0,-77.0,-84.0,-77.0,-84.0,9.0,14.0,9.0,24.0,1
4686,CC:2F:71:3F:1F:24,9128593,9435858565,5912193,9029596256,3216400,406262309,80,1369942,830267377,1361393,829240755,8549,1026622,1316641,619,5916892,601885,80,5910,86667.0,14444.0,-68.0,-64.0,-71.0,-68.0,-68.0,-63.0,-71.0,-68.0,-77.0,-84.0,-77.0,-84.0,9.0,20.0,6.0,16.0,1
4687,F8:59:71:5A:E0:3D,3371438,635397506,155033,229134733,3216405,406262773,0,153231,187522339,148411,186946401,4820,575938,130778,16,157747,2811,0,538,144444.0,43333.0,-67.0,-73.0,-65.0,-70.0,-66.0,-73.0,-65.0,-70.0,-77.0,-84.0,-77.0,-84.0,10.0,11.0,12.0,14.0,1
4688,CC:2F:71:3E:C5:1F,3227818,407658956,11413,1396183,3216405,406262773,6,48710,4079379,40251,3077063,8459,1002316,12034,34,16377,186,6,827,144444.0,43333.0,-68.0,-70.0,-68.0,-60.0,-67.0,-70.0,-68.0,-60.0,-77.0,-84.0,-77.0,-84.0,9.0,14.0,9.0,24.0,1
4689,CC:2F:71:3F:1F:24,9129588,9437378921,5913183,9031116148,3216405,406262773,80,1370212,830389911,1361663,829363289,8549,1026622,1316911,619,5917902,601912,80,5911,65000.0,13000.0,-69.0,-64.0,-71.0,-68.0,-68.0,-63.0,-70.0,-68.0,-77.0,-84.0,-77.0,-84.0,8.0,20.0,6.0,16.0,1
4690,F8:59:71:5A:E0:3D,3371506,635497254,155097,229234077,3216409,406263177,0,153295,187620913,148475,187044975,4820,575938,130841,16,157811,2814,0,538,144444.0,43333.0,-67.0,-73.0,-65.0,-70.0,-66.0,-73.0,-65.0,-70.0,-77.0,-84.0,-77.0,-84.0,10.0,11.0,12.0,14.0,1
4691,CC:2F:71:3E:C5:1F,3227822,407659360,11413,1396183,3216409,406263177,6,48710,4079379,40251,3077063,8459,1002316,12034,34,16377,186,6,827,144444.0,43333.0,-68.0,-70.0,-68.0,-60.0,-67.0,-70.0,-68.0,-60.0,-77.0,-84.0,-77.0,-84.0,9.0,14.0,9.0,24.0,1
4692,CC:2F:71:3F:1F:24,9130529,9438807764,5914120,9032544587,3216409,406263177,80,1370450,830510308,1361901,829483686,8549,1026622,1317149,619,5918822,602012,80,5911,86667.0,14444.0,-68.0,-63.0,-70.0,-67.0,-68.0,-63.0,-71.0,-67.0,-77.0,-84.0,-77.0,-84.0,9.0,21.0,7.0,17.0,1
4693,F8:59:71:5A:E0:3D,3371574,635597114,155161,229333533,3216413,406263581,0,153360,187721013,148540,187145075,4820,575938,130906,16,157875,2815,0,538,144444.0,43333.0,-67.0,-74.0,-65.0,-70.0,-66.0,-73.0,-65.0,-70.0,-77.0,-84.0,-77.0,-84.0,10.0,10.0,12.0,14.0,1
4694,CC:2F:71:3E:C5:1F,3227826,407659764,11413,1396183,3216413,406263581,6,48710,4079379,40251,3077063,8459,1002316,12034,34,16377,186,6,827,144444.0,43333.0,-68.0,-70.0,-68.0,-60.0,-67.0,-70.0,-68.0,-60.0,-77.0,-84.0,-77.0,-84.0,9.0,14.0,9.0,24.0,1
4695,CC:2F:71:3F:1F:24,9131510,9440305858,5915097,9034042277,3216413,406263581,80,1370696,830632536,1362147,829605914,8549,1026622,1317395,619,5919816,602151,80,5911,86667.0,13000.0,-68.0,-64.0,-71.0,-68.0,-68.0,-63.0,-70.0,-68.0,-77.0,-84.0,-77.0,-84.0,9.0,20.0,6.0,16.0,1
4696,F8:59:71:5A:E0:3D,3371644,635698588,155226,229434543,3216418,406264045,0,153425,187821113,148605,187245175,4820,575938,130971,16,157940,2815,0,538,144444.0,43333.0,-67.0,-73.0,-65.0,-70.0,-66.0,-73.0,-65.0,-70.0,-77.0,-84.0,-77.0,-84.0,10.0,11.0,12.0,14.0,1
4697,CC:2F:71:3E:C5:1F,3227831,407660228,11413,1396183,3216418,406264045,6,48710,4079379,40251,3077063,8459,1002316,12034,34,16377,186,6,827,144444.0,43333.0,-68.0,-70.0,-68.0,-60.0,-67.0,-70.0,-68.0,-60.0,-77.0,-84.0,-77.0,-84.0,9.0,14.0,9.0,24.0,1
4698,CC:2F:71:3F:1F:24,9132858,9442384528,5916440,9036120483,3216418,406264045,80,1370998,830760016,1362449,829733394,8549,1026622,1317697,619,5921159,602156,80,5911,86667.0,13000.0,-68.0,-64.0,-71.0,-68.0,-68.0,-64.0,-70.0,-68.0,-77.0,-84.0,-77.0,-84.0,9.0,20.0,6.0,16.0,1
4699,F8:59:71:5A:E0:3D,3371712,635798448,155290,229533999,3216422,406264449,0,153488,187918133,148668,187342195,4820,575938,131034,16,158004,2817,0,538,144444.0,43333.0,-67.0,-73.0,-65.0,-70.0,-66.0,-73.0,-65.0,-69.0,-77.0,-84.0,-77.0,-84.0,10.0,11.0,12.0,14.0,1
4700,CC:2F:71:3E:C5:1F,3227835,407660632,11413,1396183,3216422,406264449,6,48710,4079379,40251,3077063,8459,1002316,12034,34,16377,186,6,827,144444.0,43333.0,-68.0,-70.0,-68.0,-60.0,-67.0,-70.0,-68.0,-60.0,-77.0,-84.0,-77.0,-84.0,9.0,14.0,9.0,24.0,1
4701,CC:2F:71:3F:1F:24,9133956,9444068800,5917534,9037804351,3216422,406264449,80,1371275,830884556,1362726,829857934,8549,1026622,1317974,619,5922245,602179,80,5911,86667.0,14444.0,-68.0,-64.0,-71.0,-68.0,-68.0,-63.0,-71.0,-68.0,-77.0,-84.0,-77.0,-84.0,9.0,20.0,6.0,16.0,1
4702,F8:59:71:5A:E0:3D,3371780,635899933,155355,229635009,3216425,406264924,0,153554,188019773,148734,187443835,4820,575938,131100,16,158069,2817,0,538,144444.0,43333.0,-67.0,-73.0,-65.0,-70.0,-66.0,-73.0,-65.0,-70.0,-77.0,-85.0,-77.0,-85.0,10.0,12.0,12.0,15.0,1
4703,CC:2F:71:3E:C5:1F,3227838,407661107,11413,1396183,3216425,406264924,6,48710,4079379,40251,3077063,8459,1002316,12034,34,16377,186,6,827,144444.0,43333.0,-68.0,-70.0,-68.0,-60.0,-67.0,-70.0,-68.0,-60.0,-77.0,-85.0,-77.0,-85.0,9.0,15.0,9.0,25.0,1
4704,CC:2F:71:3F:1F:24,9135005,9445674421,5918578,9039409295,3216427,406265126,80,1371563,831011880,1363014,829985258,8549,1026622,1318262,619,5923282,602295,80,5911,86667.0,14444.0,-68.0,-64.0,-72.0,-69.0,-68.0,-64.0,-71.0,-68.0,-77.0,-85.0,-77.0,-85.0,9.0,21.0,5.0,16.0,1
4705,F8:59:71:5A:E0:3D,3371851,636000055,155419,229734465,3216432,406265590,0,153618,188118333,148798,187542395,4820,575938,131164,16,158133,2817,0,538,144444.0,43333.0,-67.0,-73.0,-66.0,-70.0,-66.0,-73.0,-65.0,-70.0,-77.0,-85.0,-77.0,-85.0,10.0,12.0,11.0,15.0,1
4706,CC:2F:71:3E:C5:1F,3227845,407661773,11413,1396183,3216432,406265590,6,48710,4079379,40251,3077063,8459,1002316,12034,34,16377,186,6,827,144444.0,43333.0,-68.0,-70.0,-68.0,-60.0,-67.0,-70.0,-68.0,-60.0,-77.0,-85.0,-77.0,-85.0,9.0,15.0,9.0,25.0,1
4707,CC:2F:71:3F:1F:24,9136121,9447379432,5919689,9041113842,3216432,406265590,80,1371844,831137447,1363295,830110825,8549,1026622,1318543,619,5924408,602327,80,5912,86667.0,14444.0,-68.0,-64.0,-71.0,-68.0,-68.0,-63.0,-70.0,-68.0,-77.0,-85.0,-77.0,-85.0,9.0,21.0,6.0,17.0,1
4708,F8:59:71:5A:E0:3D,3371917,636099713,155483,229833921,3216434,406265792,0,153681,188215353,148861,187639415,4820,575938,131227,16,158197,2817,0,538,144444.0,43333.0,-66.0,-73.0,-66.0,-70.0,-66.0,-73.0,-65.0,-70.0,-77.0,-85.0,-77.0,-85.0,11.0,12.0,11.0,15.0,1
4709,CC:2F:71:3E:C5:1F,3227847,407661975,11413,1396183,3216434,406265792,6,48710,4079379,40251,3077063,8459,1002316,12034,34,16377,186,6,827,144444.0,43333.0,-68.0,-70.0,-68.0,-60.0,-67.0,-70.0,-68.0,-60.0,-77.0,-85.0,-77.0,-85.0,9.0,15.0,9.0,25.0,1
4710,CC:2F:71:3F:1F:24,9137426,9449393304,5920992,9043127512,3216434,406265792,80,1372143,831265763,1363594,830239141,8549,1026622,1318842,619,5925695,602360,80,5912,86667.0,14444.0,-69.0,-64.0,-71.0,-68.0,-68.0,-63.0,-70.0,-68.0,-77.0,-85.0,-77.0,-85.0,8.0,21.0,6.0,17.0,1
4711,F8:59:71:5A:E0:3D,3371988,636201329,155548,229934931,3216440,406266398,0,153747,188316993,148927,187741055,4820,575938,131293,16,158262,2817,0,538,144444.0,43333.0,-67.0,-74.0,-65.0,-70.0,-66.0,-73.0,-65.0,-70.0,-77.0,-85.0,-77.0,-85.0,10.0,11.0,12.0,15.0,1
4712,CC:2F:71:3E:C5:1F,3227853,407662581,11413,1396183,3216440,406266398,6,48710,4079379,40251,3077063,8459,1002316,12034,34,16377,186,6,827,144444.0,43333.0,-68.0,-70.0,-68.0,-60.0,-67.0,-70.0,-68.0,-60.0,-77.0,-85.0,-77.0,-85.0,9.0,15.0,9.0,25.0,1
4713,CC:2F:71:3F:1F:24,9138899,9451667572,5922459,9045401174,3216440,406266398,80,1372458,831396303,1363909,830369681,8549,1026622,1319157,619,5927163,602481,80,5912,86667.0,14444.0,-68.0,-64.0,-70.0,-68.0,-68.0,-64.0,-70.0,-68.0,-77.0,-85.0,-77.0,-85.0,9.0,21.0,7.0,17.0,1
4714,F8:59:71:5A:E0:3D,3372057,636305623,155616,230039165,3216441,406266458,0,153815,188420307,148995,187844369,4820,575938,131361,16,158330,2819,0,538,144444.0,43333.0,-67.0,-73.0,-65.0,-70.0,-67.0,-73.0,-65.0,-70.0,-77.0,-85.0,-77.0,-85.0,10.0,12.0,12.0,15.0,1
4715,CC:2F:71:3E:C5:1F,3227854,407662641,11413,1396183,3216441,406266458,6,48710,4079379,40251,3077063,8459,1002316,12034,34,16377,186,6,827,144444.0,43333.0,-68.0,-70.0,-68.0,-60.0,-67.0,-70.0,-68.0,-60.0,-77.0,-85.0,-77.0,-85.0,9.0,15.0,9.0,25.0,1
4716,CC:2F:71:3F:1F:24,9140770,9454574362,5924328,9048307770,3216442,406266592,80,1372844,831539359,1364295,830512737,8549,1026622,1319543,619,5929024,602493,80,5912,86667.0,14444.0,-69.0,-64.0,-72.0,-68.0,-68.0,-63.0,-71.0,-68.0,-77.0,-85.0,-77.0,-85.0,8.0,21.0,5.0,17.0,1
4717,F8:59:71:5A:E0:3D,3372132,636410549,155683,230143283,3216449,406267266,0,153882,188523529,149062,187947591,4820,575938,131427,16,158397,2821,0,538,144444.0,43333.0,-67.0,-73.0,-65.0,-70.0,-67.0,-73.0,-65.0,-70.0,-77.0,-85.0,-77.0,-85.0,10.0,12.0,12.0,15.0,1
4718,CC:2F:71:3E:C5:1F,3227862,407663449,11413,1396183,3216449,406267266,6,48710,4079379,40251,3077063,8459,1002316,12034,34,16377,186,6,827,144444.0,43333.0,-68.0,-70.0,-68.0,-60.0,-67.0,-70.0,-68.0,-60.0,-77.0,-85.0,-77.0,-85.0,9.0,15.0,9.0,25.0,1
4719,CC:2F:71:3F:1F:24,9142429,9457130115,5925980,9050862849,3216449,406267266,80,1373200,831683552,1364651,830656930,8549,1026622,1319898,619,5930698,602683,80,5912,115556.0,26000.0,-69.0,-64.0,-73.0,-68.0,-68.0,-64.0,-71.0,-67.0,-77.0,-85.0,-77.0,-85.0,8.0,21.0,4.0,17.0,1
4720,F8:59:71:5A:E0:3D,3372207,636524167,155757,230256841,3216450,406267326,0,153955,188635949,149135,188060011,4820,575938,131500,16,158471,2822,0,538,144444.0,43333.0,-66.0,-73.0,-66.0,-71.0,-66.0,-73.0,-65.0,-70.0,-77.0,-85.0,-77.0,-85.0,11.0,12.0,11.0,14.0,1
4721,CC:2F:71:3E:C5:1F,3227864,407663569,11414,1396243,3216450,406267326,6,48712,4079519,40253,3077203,8459,1002316,12034,34,16378,186,6,827,130000.0,39000.0,-68.0,-70.0,-69.0,-61.0,-67.0,-70.0,-68.0,-60.0,-77.0,-85.0,-77.0,-85.0,9.0,15.0,8.0,24.0,1
4722,CC:2F:71:3F:1F:24,9143826,9459290447,5927376,9053023121,3216450,406267326,80,1373478,831813848,1364929,830787226,8549,1026622,1320176,619,5932078,603080,80,5913,86667.0,14444.0,-69.0,-64.0,-72.0,-68.0,-68.0,-63.0,-71.0,-68.0,-77.0,-85.0,-77.0,-85.0,8.0,21.0,5.0,17.0,1
4723,F8:59:71:5A:E0:3D,3372281,636627539,155823,230359405,3216458,406268134,0,154022,188739129,149202,188163191,4820,575938,131567,16,158537,2822,0,538,144444.0,43333.0,-67.0,-74.0,-65.0,-70.0,-66.0,-73.0,-65.0,-70.0,-77.0,-85.0,-77.0,-85.0,10.0,11.0,12.0,15.0,1
4724,CC:2F:71:3E:C5:1F,3227872,407664377,11414,1396243,3216458,406268134,6,48712,4079519,40253,3077203,8459,1002316,12034,34,16378,186,6,827,130000.0,39000.0,-68.0,-70.0,-69.0,-61.0,-67.0,-70.0,-68.0,-60.0,-77.0,-85.0,-77.0,-85.0,9.0,15.0,8.0,24.0,1
4725,CC:2F:71:3F:1F:24,9145658,9462128303,5929200,9055860169,3216458,406268134,80,1373846,831956108,1365297,830929486,8549,1026622,1320544,619,5933919,603114,80,5914,86667.0,14444.0,-69.0,-64.0,-71.0,-68.0,-68.0,-64.0,-71.0,-68.0,-77.0,-85.0,-77.0,-85.0,8.0,21.0,6.0,17.0,1
4726,F8:59:71:5A:E0:3D,3372350,636732106,155890,230463523,3216460,406268583,0,154089,188842309,149269,188266371,4820,575938,131634,16,158604,2822,0,538,144444.0,43333.0,-67.0,-73.0,-64.0,-70.0,-67.0,-73.0,-64.0,-70.0,-77.0,-85.0,-77.0,-85.0,10.0,12.0,13.0,15.0,1
4727,CC:2F:71:3E:C5:1F,3227874,407664826,11414,1396243,3216460,406268583,6,48712,4079519,40253,3077203,8459,1002316,12034,34,16378,186,6,827,130000.0,39000.0,-68.0,-70.0,-69.0,-61.0,-67.0,-70.0,-68.0,-60.0,-77.0,-85.0,-77.0,-85.0,9.0,15.0,8.0,24.0,1
4728,CC:2F:71:3F:1F:24,9147234,9464571180,5930774,9058302597,3216460,406268583,80,1374181,832088918,1365632,831062296,8549,1026622,1320879,619,5935481,603177,80,5914,86667.0,14444.0,-68.0,-64.0,-70.0,-68.0,-68.0,-64.0,-71.0,-68.0,-77.0,-85.0,-77.0,-85.0,9.0,21.0,7.0,17.0,1
4729,F8:59:71:5A:E0:3D,3372425,636835538,155956,230566087,3216469,406269451,0,154155,188943949,149335,188368011,4820,575938,131700,16,158670,2823,0,538,144444.0,43333.0,-67.0,-74.0,-65.0,-70.0,-66.0,-73.0,-65.0,-70.0,-77.0,-85.0,-77.0,-85.0,10.0,11.0,12.0,15.0,1
4730,CC:2F:71:3E:C5:1F,3227884,407665919,11414,1396243,3216470,406269676,6,48712,4079519,40253,3077203,8459,1002316,12034,34,16378,186,6,827,130000.0,39000.0,-68.0,-70.0,-69.0,-61.0,-67.0,-70.0,-68.0,-60.0,-77.0,-85.0,-77.0,-85.0,9.0,15.0,8.0,24.0,1
4731,CC:2F:71:3F:1F:24,9148712,9466837364,5932241,9060567464,3216471,406269900,80,1374503,832222020,1365954,831195398,8549,1026622,1321201,619,5936960,603181,80,5914,86667.0,14444.0,-68.0,-64.0,-71.0,-68.0,-68.0,-63.0,-71.0,-68.0,-77.0,-85.0,-77.0,-85.0,9.0,21.0,6.0,17.0,1
4732,F8:59:71:5A:E0:3D,3372491,636935443,156020,230665543,3216471,406269900,0,154219,189042509,149399,188466571,4820,575938,131764,16,158734,2823,0,538,144444.0,43333.0,-67.0,-74.0,-65.0,-70.0,-66.0,-73.0,-65.0,-70.0,-77.0,-85.0,-77.0,-85.0,10.0,11.0,12.0,15.0,1
4733,CC:2F:71:3E:C5:1F,3227885,407666143,11414,1396243,3216471,406269900,6,48712,4079519,40253,3077203,8459,1002316,12034,34,16378,186,6,827,130000.0,39000.0,-68.0,-70.0,-69.0,-61.0,-67.0,-70.0,-68.0,-60.0,-77.0,-85.0,-77.0,-85.0,9.0,15.0,8.0,24.0,1
4734,CC:2F:71:3F:1F:24,9150305,9469307150,5933834,9063037250,3216471,406269900,80,1374830,832355418,1366281,831328796,8549,1026622,1321528,619,5938553,603223,80,5916,104000.0,26000.0,-70.0,-64.0,-71.0,-68.0,-69.0,-64.0,-70.0,-68.0,-77.0,-85.0,-77.0,-85.0,7.0,21.0,6.0,17.0,1
4735,F8:59:71:5A:E0:3D,3372568,637042232,156088,230771215,3216480,406271017,0,154287,189147229,149467,188571291,4820,575938,131832,16,158802,2823,0,538,144444.0,43333.0,-66.0,-74.0,-66.0,-71.0,-66.0,-73.0,-65.0,-70.0,-77.0,-85.0,-77.0,-85.0,11.0,11.0,11.0,14.0,1
4736,CC:2F:71:3E:C5:1F,3227896,407667462,11414,1396243,3216482,406271219,6,48712,4079519,40253,3077203,8459,1002316,12034,34,16378,186,6,827,130000.0,39000.0,-68.0,-70.0,-69.0,-61.0,-67.0,-70.0,-68.0,-60.0,-77.0,-85.0,-77.0,-85.0,9.0,15.0,8.0,24.0,1
4737,CC:2F:71:3F:1F:24,9151342,9470884729,5934860,9064613510,3216482,406271219,80,1375080,832479656,1366530,831452916,8550,1026740,1321778,619,5939579,603436,80,5916,86667.0,14444.0,-68.0,-63.0,-72.0,-69.0,-68.0,-63.0,-71.0,-68.0,-77.0,-85.0,-77.0,-85.0,9.0,22.0,5.0,16.0,1
4738,F8:59:71:5A:E0:3D,3372637,637142399,156152,230870671,3216485,406271728,0,154351,189245803,149531,188669865,4820,575938,131895,16,158866,2824,0,538,144444.0,43333.0,-66.0,-74.0,-66.0,-71.0,-66.0,-74.0,-65.0,-70.0,-77.0,-85.0,-77.0,-85.0,11.0,11.0,11.0,14.0,1
4739,CC:2F:71:3E:C5:1F,3227899,407667971,11414,1396243,3216485,406271728,6,48712,4079519,40253,3077203,8459,1002316,12034,34,16378,186,6,827,130000.0,39000.0,-68.0,-70.0,-69.0,-61.0,-67.0,-70.0,-68.0,-60.0,-77.0,-85.0,-77.0,-85.0,9.0,15.0,8.0,24.0,1
4740,CC:2F:71:3F:1F:24,9152413,9472528022,5935928,9066256294,3216485,406271728,80,1375343,832601240,1366793,831574500,8550,1026740,1322041,619,5940647,603458,80,5916,78000.0,13000.0,-68.0,-64.0,-71.0,-69.0,-68.0,-64.0,-71.0,-68.0,-77.0,-85.0,-77.0,-85.0,9.0,21.0,6.0,16.0,1
4741,F8:59:71:5A:E0:3D,3372705,637242259,156216,230970127,3216489,406272132,0,154415,189344363,149595,188768425,4820,575938,131959,16,158930,2827,0,538,144444.0,43333.0,-67.0,-73.0,-65.0,-70.0,-67.0,-73.0,-65.0,-70.0,-77.0,-85.0,-77.0,-85.0,10.0,12.0,12.0,15.0,1
4742,CC:2F:71:3E:C5:1F,3227905,407668577,11414,1396243,3216491,406272334,6,48712,4079519,40253,3077203,8459,1002316,12034,34,16378,186,6,827,130000.0,39000.0,-68.0,-70.0,-69.0,-61.0,-67.0,-70.0,-68.0,-60.0,-77.0,-85.0,-77.0,-85.0,9.0,15.0,8.0,24.0,1
4743,CC:2F:71:3F:1F:24,9153632,9474392569,5937141,9068120235,3216491,406272334,80,1375614,832728532,1367064,831701792,8550,1026740,1322312,619,5941860,603787,80,5917,78000.0,13000.0,-69.0,-64.0,-71.0,-68.0,-68.0,-63.0,-71.0,-68.0,-77.0,-85.0,-77.0,-85.0,8.0,21.0,6.0,17.0,1
4744,F8:59:71:5A:E0:3D,3372777,637346886,156283,231074077,3216494,406272809,0,154483,189449083,149663,188873145,4820,575938,132027,16,158997,2827,0,538,144444.0,43333.0,-66.0,-73.0,-66.0,-71.0,-66.0,-73.0,-65.0,-71.0,-77.0,-85.0,-77.0,-85.0,11.0,12.0,11.0,14.0,1
4745,CC:2F:71:3E:C5:1F,3227908,407669052,11414,1396243,3216494,406272809,6,48712,4079519,40253,3077203,8459,1002316,12034,34,16378,186,6,827,130000.0,39000.0,-68.0,-70.0,-69.0,-61.0,-67.0,-70.0,-68.0,-60.0,-77.0,-85.0,-77.0,-85.0,9.0,15.0,8.0,24.0,1
4746,CC:2F:71:3F:1F:24,9154991,9476485554,5938495,9070212623,3216496,406272931,80,1375917,832869004,1367367,831842264,8550,1026740,1322615,619,5943214,604213,80,5917,86667.0,13000.0,-68.0,-63.0,-71.0,-70.0,-67.0,-63.0,-71.0,-70.0,-77.0,-85.0,-77.0,-85.0,9.0,22.0,6.0,15.0,1
4747,F8:59:71:5A:E0:3D,3372854,637457746,156354,231184411,3216500,406273335,0,154554,189558423,149734,188982485,4820,575938,132098,16,159068,2827,0,538,144444.0,43333.0,-66.0,-74.0,-65.0,-71.0,-66.0,-73.0,-65.0,-71.0,-77.0,-85.0,-77.0,-85.0,11.0,11.0,12.0,14.0,1
4748,CC:2F:71:3E:C5:1F,3227916,407669780,11414,1396243,3216502,406273537,6,48714,4079707,40254,3077273,8460,1002434,12035,34,16378,186,6,827,130000.0,39000.0,-67.0,-70.0,-68.0,-60.0,-67.0,-70.0,-68.0,-60.0,-77.0,-85.0,-77.0,-85.0,10.0,15.0,9.0,25.0,1
4749,CC:2F:71:3F:1F:24,9156285,9478476104,5939783,9072202567,3216502,406273537,80,1376201,832994362,1367651,831967622,8550,1026740,1322899,619,5944502,604237,80,5917,86667.0,14444.0,-68.0,-64.0,-72.0,-69.0,-67.0,-63.0,-71.0,-68.0,-77.0,-85.0,-77.0,-85.0,9.0,21.0,5.0,16.0,1
4750,F8:59:71:5A:E0:3D,3372924,637557816,156418,231283867,3216506,406273949,0,154618,189656983,149798,189081045,4820,575938,132162,16,159132,2827,0,538,144444.0,43333.0,-67.0,-73.0,-65.0,-70.0,-66.0,-73.0,-65.0,-70.0,-77.0,-85.0,-77.0,-85.0,10.0,12.0,12.0,15.0,1
4751,CC:2F:71:3E:C5:1F,3227920,407670192,11414,1396243,3216506,406273949,6,48714,4079707,40254,3077273,8460,1002434,12035,34,16378,186,6,827,130000.0,39000.0,-67.0,-70.0,-68.0,-60.0,-67.0,-70.0,-68.0,-60.0,-77.0,-85.0,-77.0,-85.0,10.0,15.0,9.0,25.0,1
4752,CC:2F:71:3F:1F:24,9157851,9480900312,5941345,9074626363,3216506,406273949,80,1376534,833128396,1367984,832101656,8550,1026740,1323227,619,5946064,604254,80,5917,86667.0,14444.0,-69.0,-64.0,-71.0,-70.0,-68.0,-63.0,-71.0,-70.0,-77.0,-85.0,-77.0,-85.0,8.0,21.0,6.0,15.0,1
4753,F8:59:71:5A:E0:3D,3372995,637660844,156484,231386431,3216511,406274413,0,154683,189757083,149863,189181145,4820,575938,132227,16,159198,2827,0,538,144444.0,43333.0,-67.0,-73.0,-65.0,-70.0,-67.0,-73.0,-65.0,-70.0,-77.0,-85.0,-77.0,-85.0,10.0,12.0,12.0,15.0,1
4754,CC:2F:71:3E:C5:1F,3227925,407670656,11414,1396243,3216511,406274413,6,48714,4079707,40254,3077273,8460,1002434,12035,34,16378,186,6,827,130000.0,39000.0,-67.0,-70.0,-68.0,-60.0,-67.0,-70.0,-68.0,-60.0,-77.0,-85.0,-77.0,-85.0,10.0,15.0,9.0,25.0,1
4755,CC:2F:71:3F:1F:24,9159291,9483111825,5942778,9076837210,3216513,406274615,80,1376850,833258051,1368300,832231311,8550,1026740,1323543,619,5947497,604430,80,5917,86667.0,14444.0,-68.0,-64.0,-71.0,-70.0,-68.0,-63.0,-71.0,-70.0,-77.0,-85.0,-77.0,-85.0,9.0,21.0,6.0,15.0,1
4756,F8:59:71:5A:E0:3D,3373062,637759150,156547,231484333,3216515,406274817,0,154747,189855657,149927,189279719,4820,575938,132290,16,159261,2830,0,538,144444.0,43333.0,-67.0,-73.0,-65.0,-70.0,-66.0,-73.0,-65.0,-70.0,-77.0,-85.0,-77.0,-85.0,10.0,12.0,12.0,15.0,1
4757,CC:2F:71:3E:C5:1F,3227930,407671122,11414,1396243,3216516,406274879,6,48714,4079707,40254,3077273,8460,1002434,12035,34,16378,186,6,827,130000.0,39000.0,-67.0,-70.0,-68.0,-60.0,-67.0,-70.0,-68.0,-60.0,-77.0,-85.0,-77.0,-85.0,10.0,15.0,9.0,25.0,1
4758,CC:2F:71:3F:1F:24,9160218,9484529281,5943702,9078254402,3216516,406274879,80,1377112,833379457,1368562,832352717,8550,1026740,1323805,619,5948421,604434,80,5917,86667.0,14444.0,-68.0,-64.0,-71.0,-70.0,-68.0,-64.0,-70.0,-70.0,-77.0,-85.0,-77.0,-85.0,9.0,21.0,6.0,15.0,1
4759,F8:59:71:5A:E0:3D,3373131,637859238,156611,231583789,3216520,406275449,0,154812,189954335,149991,189378279,4821,576056,132355,16,159325,2830,0,538,144444.0,43333.0,-67.0,-73.0,-66.0,-70.0,-66.0,-72.0,-65.0,-70.0,-77.0,-85.0,-77.0,-85.0,10.0,12.0,11.0,15.0,1
4760,CC:2F:71:3E:C5:1F,3227936,407671894,11414,1396243,3216522,406275651,6,48714,4079707,40254,3077273,8460,1002434,12035,34,16378,186,6,827,130000.0,39000.0,-67.0,-70.0,-68.0,-60.0,-67.0,-70.0,-68.0,-60.0,-77.0,-85.0,-77.0,-85.0,10.0,15.0,9.0,25.0,1
4761,CC:2F:71:3F:1F:24,9161048,9485787749,5944526,9079512098,3216522,406275651,80,1377356,833498641,1368806,832471901,8550,1026740,1324049,619,5949235,604523,80,5917,86667.0,13000.0,-69.0,-64.0,-71.0,-70.0,-68.0,-63.0,-70.0,-70.0,-77.0,-85.0,-77.0,-85.0,8.0,21.0,6.0,15.0,1
4762,F8:59:71:5A:E0:3D,3373203,637959476,156676,231683361,3216527,406276115,0,154877,190053001,150056,189476945,4821,576056,132420,16,159390,2831,0,538,144444.0,43333.0,-67.0,-73.0,-65.0,-70.0,-67.0,-73.0,-65.0,-70.0,-77.0,-85.0,-77.0,-85.0,10.0,12.0,12.0,15.0,1
4763,CC:2F:71:3E:C5:1F,3227941,407672358,11414,1396243,3216527,406276115,6,48714,4079707,40254,3077273,8460,1002434,12035,34,16378,186,6,827,130000.0,39000.0,-67.0,-70.0,-68.0,-60.0,-67.0,-70.0,-68.0,-60.0,-77.0,-85.0,-77.0,-85.0,10.0,15.0,9.0,25.0,1
4764,CC:2F:71:3F:1F:24,9162309,9487727647,5945782,9081451532,3216527,406276115,80,1377642,833625547,1369092,832598807,8550,1026740,1324335,619,5950483,604528,80,5917,86667.0,14444.0,-69.0,-64.0,-72.0,-70.0,-68.0,-64.0,-71.0,-70.0,-77.0,-85.0,-77.0,-85.0,8.0,21.0,5.0,15.0,1
4765,F8:59:71:5A:E0:3D,3373274,638066904,156745,231790587,3216529,406276317,0,154947,190160801,150126,189584745,4821,576056,132490,16,159459,2832,0,538,144444.0,43333.0,-66.0,-73.0,-65.0,-70.0,-66.0,-72.0,-65.0,-70.0,-77.0,-85.0,-77.0,-85.0,11.0,12.0,12.0,15.0,1
4766,CC:2F:71:3E:C5:1F,3227945,407672762,11414,1396243,3216531,406276519,6,48714,4079707,40254,3077273,8460,1002434,12035,34,16378,186,6,827,130000.0,39000.0,-67.0,-70.0,-68.0,-60.0,-67.0,-70.0,-68.0,-60.0,-77.0,-85.0,-77.0,-85.0,10.0,15.0,9.0,25.0,1
4767,CC:2F:71:3F:1F:24,9163438,9489451594,5946907,9083175075,3216531,406276519,80,1377929,833761976,1369379,832735236,8550,1026740,1324622,619,5951622,604535,80,5918,86667.0,14444.0,-69.0,-64.0,-72.0,-70.0,-68.0,-64.0,-71.0,-70.0,-77.0,-85.0,-77.0,-85.0,8.0,21.0,5.0,15.0,1
4768,F8:59:71:5A:E0:3D,3373344,638166966,156809,231890043,3216535,406276923,0,155011,190259361,150190,189683305,4821,576056,132554,16,159523,2832,0,538,144444.0,43333.0,-67.0,-73.0,-65.0,-70.0,-67.0,-73.0,-65.0,-70.0,-77.0,-85.0,-77.0,-85.0,10.0,12.0,12.0,15.0,1
4769,CC:2F:71:3E:C5:1F,3227949,407673166,11414,1396243,3216535,406276923,6,48714,4079707,40254,3077273,8460,1002434,12035,34,16378,186,6,827,130000.0,39000.0,-67.0,-70.0,-68.0,-60.0,-67.0,-70.0,-68.0,-60.0,-77.0,-85.0,-77.0,-85.0,10.0,15.0,9.0,25.0,1
4770,CC:2F:71:3F:1F:24,9164561,9491175004,5948026,9084898081,3216535,406276923,80,1378197,833884026,1369647,832857286,8550,1026740,1324890,619,5952727,604665,80,5919,86667.0,14444.0,-68.0,-64.0,-71.0,-70.0,-68.0,-64.0,-71.0,-70.0,-77.0,-85.0,-77.0,-85.0,9.0,21.0,6.0,15.0,1
4771,F8:59:71:5A:E0:3D,3373410,638268036,156874,231991053,3216536,406276983,0,155076,190359461,150255,189783405,4821,576056,132619,16,159588,2833,0,538,144444.0,43333.0,-67.0,-73.0,-65.0,-71.0,-66.0,-73.0,-65.0,-70.0,-77.0,-85.0,-77.0,-85.0,10.0,12.0,12.0,14.0,1
4772,CC:2F:71:3E:C5:1F,3227952,407673428,11414,1396243,3216538,406277185,6,48714,4079707,40254,3077273,8460,1002434,12035,34,16378,186,6,827,130000.0,39000.0,-67.0,-70.0,-68.0,-60.0,-67.0,-70.0,-68.0,-60.0,-77.0,-85.0,-77.0,-85.0,10.0,15.0,9.0,25.0,1
4773,CC:2F:71:3F:1F:24,9165866,9493188838,5949328,9086911653,3216538,406277185,80,1378494,834012420,1369944,832985680,8550,1026740,1325187,619,5954047,604684,80,5919,86667.0,14444.0,-68.0,-64.0,-72.0,-70.0,-68.0,-64.0,-71.0,-69.0,-77.0,-85.0,-77.0,-85.0,9.0,21.0,5.0,15.0,1
4774,F8:59:71:5A:E0:3D,3373482,638368300,156938,232090509,3216544,406277791,0,155140,190458021,150319,189881965,4821,576056,132683,16,159652,2834,0,538,144444.0,43333.0,-67.0,-73.0,-65.0,-70.0,-66.0,-73.0,-65.0,-70.0,-77.0,-85.0,-77.0,-85.0,10.0,12.0,12.0,15.0,1
4775,CC:2F:71:3E:C5:1F,3227958,407674034,11414,1396243,3216544,406277791,6,48714,4079707,40254,3077273,8460,1002434,12035,34,16378,186,6,827,130000.0,39000.0,-67.0,-70.0,-68.0,-60.0,-67.0,-70.0,-68.0,-60.0,-77.0,-85.0,-77.0,-85.0,10.0,15.0,9.0,25.0,1
4776,CC:2F:71:3F:1F:24,9166741,9494518374,5950197,9088240583,3216544,406277791,80,1378733,834132640,1370183,833105900,8550,1026740,1325426,619,5954916,604697,80,5919,86667.0,14444.0,-68.0,-64.0,-71.0,-70.0,-68.0,-64.0,-71.0,-70.0,-77.0,-85.0,-77.0,-85.0,9.0,21.0,6.0,15.0,1
4777,F8:59:71:5A:E0:3D,3373546,638467756,157002,232189965,3216544,406277791,0,155203,190555041,150382,189978985,4821,576056,132746,16,159716,2834,0,538,144444.0,43333.0,-67.0,-73.0,-65.0,-70.0,-66.0,-73.0,-65.0,-70.0,-77.0,-85.0,-77.0,-85.0,10.0,12.0,12.0,15.0,1
4778,CC:2F:71:3E:C5:1F,3227958,407674034,11414,1396243,3216544,406277791,6,48714,4079707,40254,3077273,8460,1002434,12035,34,16378,186,6,827,130000.0,39000.0,-67.0,-70.0,-68.0,-60.0,-67.0,-70.0,-68.0,-60.0,-77.0,-85.0,-77.0,-85.0,10.0,15.0,9.0,25.0,1
4779,CC:2F:71:3F:1F:24,9167957,9496394534,5951413,9090116743,3216544,406277791,80,1379038,834259228,1370488,833232488,8550,1026740,1325731,619,5956132,604811,80,5919,86667.0,14444.0,-68.0,-64.0,-72.0,-70.0,-68.0,-64.0,-71.0,-70.0,-77.0,-85.0,-77.0,-85.0,9.0,21.0,5.0,15.0,1
4780,F8:59:71:5A:E0:3D,3373616,638566324,157065,232287867,3216551,406278457,0,155266,190652061,150445,190076005,4821,576056,132809,16,159779,2834,0,538,144444.0,43333.0,-67.0,-73.0,-65.0,-71.0,-66.0,-73.0,-65.0,-70.0,-77.0,-85.0,-77.0,-85.0,10.0,12.0,12.0,14.0,1
4781,CC:2F:71:3E:C5:1F,3227967,407674902,11414,1396243,3216553,406278659,6,48714,4079707,40254,3077273,8460,1002434,12035,34,16378,186,6,827,130000.0,39000.0,-67.0,-70.0,-68.0,-60.0,-67.0,-70.0,-68.0,-60.0,-77.0,-85.0,-77.0,-85.0,10.0,15.0,9.0,25.0,1
4782,CC:2F:71:3F:1F:24,9168958,9497912071,5952405,9091633412,3216553,406278659,80,1379294,834380329,1370744,833353589,8550,1026740,1325987,619,5957124,604845,80,5919,86667.0,14444.0,-69.0,-64.0,-72.0,-70.0,-68.0,-64.0,-71.0,-70.0,-77.0,-85.0,-77.0,-85.0,8.0,21.0,5.0,15.0,1
4783,F8:59:71:5A:E0:3D,3373684,638667662,157130,232388877,3216554,406278785,0,155331,190752161,150510,190176105,4821,576056,132874,16,159844,2836,0,538,144444.0,43333.0,-67.0,-73.0,-65.0,-70.0,-67.0,-73.0,-65.0,-70.0,-77.0,-85.0,-77.0,-85.0,10.0,12.0,12.0,15.0,1
4784,CC:2F:71:3E:C5:1F,3227968,407675028,11414,1396243,3216554,406278785,6,48714,4079707,40254,3077273,8460,1002434,12035,34,16378,186,6,827,130000.0,39000.0,-67.0,-70.0,-68.0,-60.0,-67.0,-70.0,-68.0,-60.0,-77.0,-85.0,-77.0,-85.0,10.0,15.0,9.0,25.0,1
4785,CC:2F:71:3F:1F:24,9170216,9499853287,5953662,9093574502,3216554,406278785,80,1379586,834509345,1371036,833482605,8550,1026740,1326279,619,5958381,604880,80,5919,86667.0,14444.0,-68.0,-64.0,-69.0,-70.0,-68.0,-64.0,-71.0,-70.0,-77.0,-85.0,-77.0,-85.0,9.0,21.0,8.0,15.0,1
4786,F8:59:71:5A:E0:3D,3373756,638769551,157195,232489887,3216561,406279664,0,155397,190853801,150576,190277745,4821,576056,132940,16,159909,2836,0,538,144444.0,43333.0,-67.0,-73.0,-65.0,-70.0,-66.0,-73.0,-64.0,-70.0,-77.0,-85.0,-77.0,-85.0,10.0,12.0,12.0,15.0,1
4787,CC:2F:71:3E:C5:1F,3227975,407675907,11414,1396243,3216561,406279664,6,48714,4079707,40254,3077273,8460,1002434,12035,34,16378,186,6,827,130000.0,39000.0,-67.0,-70.0,-68.0,-60.0,-67.0,-70.0,-68.0,-60.0,-77.0,-85.0,-77.0,-85.0,10.0,15.0,9.0,25.0,1
4788,CC:2F:71:3F:1F:24,9171469,9501773154,5954905,9095493228,3216564,406279926,80,1379866,834637337,1371316,833610597,8550,1026740,1326559,619,5959624,604996,80,5919,65000.0,14444.0,-68.0,-64.0,-71.0,-70.0,-68.0,-64.0,-71.0,-69.0,-77.0,-85.0,-77.0,-85.0,9.0,21.0,6.0,15.0,1
4789,F8:59:71:5A:E0:3D,3373826,638873931,157262,232594005,3216564,406279926,0,155463,190955441,150642,190379385,4821,576056,133006,16,159976,2837,0,538,144444.0,43333.0,-66.0,-73.0,-66.0,-70.0,-66.0,-73.0,-65.0,-70.0,-77.0,-85.0,-77.0,-85.0,11.0,12.0,11.0,15.0,1
4790,CC:2F:71:3E:C5:1F,3227978,407676169,11414,1396243,3216564,406279926,6,48714,4079707,40254,3077273,8460,1002434,12035,34,16378,186,6,827,130000.0,39000.0,-67.0,-70.0,-68.0,-60.0,-67.0,-70.0,-68.0,-60.0,-77.0,-85.0,-77.0,-85.0,10.0,15.0,9.0,25.0,1
4791,CC:2F:71:3F:1F:24,9172785,9503807418,5956221,9097527492,3216564,406279926,80,1380164,834765797,1371614,833739057,8550,1026740,1326857,619,5960940,605033,80,5919,86667.0,14444.0,-68.0,-64.0,-71.0,-70.0,-68.0,-64.0,-71.0,-70.0,-77.0,-85.0,-77.0,-85.0,9.0,21.0,6.0,15.0,1
4792,F8:59:71:5A:E0:3D,3373896,638973993,157326,232693461,3216570,406280532,0,155527,191054001,150706,190477945,4821,576056,133070,16,160040,2838,0,538,144444.0,43333.0,-67.0,-73.0,-65.0,-70.0,-66.0,-73.0,-65.0,-70.0,-77.0,-85.0,-77.0,-85.0,10.0,12.0,12.0,15.0,1
4793,CC:2F:71:3E:C5:1F,3227984,407676775,11414,1396243,3216570,406280532,6,48714,4079707,40254,3077273,8460,1002434,12035,34,16378,186,6,827,130000.0,39000.0,-67.0,-70.0,-68.0,-60.0,-67.0,-70.0,-68.0,-60.0,-77.0,-85.0,-77.0,-85.0,10.0,15.0,9.0,25.0,1
4794,CC:2F:71:3F:1F:24,9173963,9505606602,5957393,9099326070,3216570,406280532,80,1380451,834893534,1371901,833866794,8550,1026740,1327144,619,5962112,605058,80,5920,86667.0,14444.0,-69.0,-64.0,-72.0,-70.0,-68.0,-64.0,-71.0,-70.0,-77.0,-85.0,-77.0,-85.0,8.0,21.0,5.0,15.0,1
4795,F8:59:71:5A:E0:3D,3373962,639073651,157390,232792917,3216572,406280734,0,155592,191154101,150771,190578045,4821,576056,133135,16,160104,2838,0,538,144444.0,43333.0,-67.0,-73.0,-65.0,-70.0,-67.0,-73.0,-65.0,-70.0,-77.0,-85.0,-77.0,-85.0,10.0,12.0,12.0,15.0,1
4796,CC:2F:71:3E:C5:1F,3227987,407677037,11414,1396243,3216573,406280794,6,48714,4079707,40254,3077273,8460,1002434,12035,34,16378,186,6,827,130000.0,39000.0,-67.0,-70.0,-68.0,-60.0,-67.0,-70.0,-68.0,-60.0,-77.0,-85.0,-77.0,-85.0,10.0,15.0,9.0,25.0,1
4797,CC:2F:71:3F:1F:24,9175249,9507588862,5958676,9101308068,3216573,406280794,80,1380745,835020050,1372195,833993310,8550,1026740,1327438,619,5963395,605178,80,5921,86667.0,14444.0,-69.0,-64.0,-71.0,-69.0,-68.0,-64.0,-71.0,-69.0,-77.0,-85.0,-77.0,-85.0,8.0,21.0,6.0,16.0,1
4798,F8:59:71:5A:E0:3D,3374033,639173773,157454,232892373,3216579,406281400,0,155657,191254215,150836,190678159,4821,576056,133199,16,160168,2838,0,538,144444.0,43333.0,-67.0,-73.0,-64.0,-71.0,-66.0,-73.0,-64.0,-70.0,-77.0,-85.0,-77.0,-85.0,10.0,12.0,13.0,14.0,1
4799,CC:2F:71:3E:C5:1F,3227993,407677643,11414,1396243,3216579,406281400,6,48714,4079707,40254,3077273,8460,1002434,12035,34,16378,186,6,827,130000.0,39000.0,-67.0,-70.0,-68.0,-60.0,-67.0,-70.0,-68.0,-60.0,-77.0,-85.0,-77.0,-85.0,10.0,15.0,9.0,25.0,1
4800,CC:2F:71:3F:1F:24,9176592,9509656678,5960013,9103375278,3216579,406281400,80,1381046,835146028,1372496,834119288,8550,1026740,1327739,619,5964721,605189,80,5921,86667.0,14444.0,-69.0,-64.0,-71.0,-69.0,-68.0,-64.0,-70.0,-69.0,-77.0,-85.0,-77.0,-85.0,8.0,21.0,6.0,16.0,1
4801,F8:59:71:5A:E0:3D,3374101,639275101,157520,232993499,3216581,406281602,0,155721,191352775,150900,190776719,4821,576056,133263,16,160234,2839,0,538,144444.0,43333.0,-67.0,-73.0,-65.0,-71.0,-66.0,-73.0,-65.0,-70.0,-77.0,-85.0,-77.0,-85.0,10.0,12.0,12.0,14.0,1
4802,CC:2F:71:3E:C5:1F,3227996,407677905,11415,1396303,3216581,406281602,6,48717,4079917,40257,3077483,8460,1002434,12035,34,16379,186,6,827,130000.0,39000.0,-73.0,-84.0,-73.0,-71.0,-68.0,-71.0,-68.0,-61.0,-77.0,-85.0,-77.0,-85.0,4.0,1.0,4.0,14.0,1
4803,CC:2F:71:3F:1F:24,9177490,9511026930,5960909,9104745328,3216581,406281602,80,1381290,835269520,1372740,834242780,8550,1026740,1327983,619,5965628,605290,80,5921,78000.0,13000.0,-69.0,-64.0,-71.0,-69.0,-68.0,-64.0,-71.0,-69.0,-77.0,-85.0,-77.0,-85.0,8.0,21.0,6.0,16.0,1
4804,F8:59:71:5A:E0:3D,3374171,639376575,157585,233094509,3216586,406282066,0,155786,191452875,150965,190876819,4821,576056,133328,16,160299,2839,0,538,144444.0,43333.0,-67.0,-73.0,-65.0,-70.0,-66.0,-72.0,-65.0,-70.0,-77.0,-85.0,-77.0,-85.0,10.0,12.0,12.0,15.0,1
4805,CC:2F:71:3E:C5:1F,3228003,407678571,11415,1396303,3216588,406282268,6,48717,4079917,40257,3077483,8460,1002434,12035,34,16379,186,6,827,130000.0,39000.0,-73.0,-84.0,-73.0,-71.0,-68.0,-71.0,-68.0,-61.0,-77.0,-85.0,-77.0,-85.0,4.0,1.0,4.0,14.0,1
4806,CC:2F:71:3F:1F:24,9178349,9512324665,5961761,9106042397,3216588,406282268,80,1381530,835390131,1372980,834363391,8550,1026740,1328223,619,5966480,605361,80,5921,86667.0,14444.0,-69.0,-64.0,-71.0,-69.0,-68.0,-64.0,-71.0,-69.0,-77.0,-85.0,-77.0,-85.0,8.0,21.0,6.0,16.0,1
4807,F8:59:71:5A:E0:3D,3374238,639474881,157648,233192411,3216590,406282470,0,155850,191551435,151029,190975379,4821,576056,133392,16,160362,2839,0,538,144444.0,43333.0,-67.0,-73.0,-65.0,-70.0,-66.0,-72.0,-64.0,-70.0,-77.0,-85.0,-77.0,-85.0,10.0,12.0,12.0,15.0,1
4808,CC:2F:71:3E:C5:1F,3228005,407678773,11415,1396303,3216590,406282470,6,48717,4079917,40257,3077483,8460,1002434,12035,34,16379,186,6,827,130000.0,39000.0,-73.0,-84.0,-73.0,-71.0,-68.0,-71.0,-68.0,-61.0,-77.0,-85.0,-77.0,-85.0,4.0,1.0,4.0,14.0,1
4809,CC:2F:71:3F:1F:24,9179324,9513819405,5962734,9107536935,3216590,406282470,80,1381781,835511669,1373231,834484929,8550,1026740,1328474,619,5967453,605380,80,5922,86667.0,14444.0,-69.0,-64.0,-71.0,-69.0,-68.0,-64.0,-70.0,-69.0,-77.0,-85.0,-77.0,-85.0,8.0,21.0,6.0,16.0,1
4810,F8:59:71:5A:E0:3D,3374312,639586915,157720,233304243,3216592,406282672,0,155922,191662315,151101,191086259,4821,576056,133464,16,160434,2839,0,538,130000.0,39000.0,-67.0,-73.0,-65.0,-70.0,-66.0,-73.0,-65.0,-70.0,-77.0,-85.0,-77.0,-85.0,10.0,12.0,12.0,15.0,1
4811,CC:2F:71:3E:C5:1F,3228011,407679379,11415,1396303,3216596,406283076,6,48717,4079917,40257,3077483,8460,1002434,12035,34,16379,186,6,827,130000.0,39000.0,-73.0,-84.0,-73.0,-71.0,-68.0,-71.0,-68.0,-61.0,-77.0,-85.0,-77.0,-85.0,4.0,1.0,4.0,14.0,1
4812,CC:2F:71:3F:1F:24,9180068,9514940290,5963471,9108657152,3216597,406283138,80,1382008,835656160,1373457,834629302,8551,1026858,1328695,619,5968190,605441,80,5923,86667.0,14444.0,-69.0,-64.0,-71.0,-69.0,-69.0,-64.0,-70.0,-69.0,-77.0,-85.0,-77.0,-85.0,8.0,21.0,6.0,16.0,1
4813,F8:59:71:5A:E0:3D,3374406,639721175,157806,233437775,3216600,406283400,0,156007,191793271,151186,191217215,4821,576056,133549,16,160520,2851,0,538,144444.0,43333.0,-67.0,-73.0,-65.0,-70.0,-67.0,-73.0,-64.0,-70.0,-77.0,-85.0,-77.0,-85.0,10.0,12.0,12.0,15.0,1
4814,CC:2F:71:3E:C5:1F,3228015,407679703,11415,1396303,3216600,406283400,6,48717,4079917,40257,3077483,8460,1002434,12035,34,16379,186,6,827,130000.0,39000.0,-73.0,-84.0,-73.0,-71.0,-68.0,-71.0,-68.0,-61.0,-77.0,-85.0,-77.0,-85.0,4.0,1.0,4.0,14.0,1
4815,CC:2F:71:3F:1F:24,9180692,9515876818,5964092,9109593418,3216600,406283400,80,1382205,835790838,1373654,834763980,8551,1026858,1328879,619,5968790,605441,80,5923,86667.0,14444.0,-69.0,-64.0,-71.0,-69.0,-68.0,-63.0,-70.0,-69.0,-77.0,-85.0,-77.0,-85.0,8.0,21.0,6.0,16.0,1
4816,F8:59:71:5A:E0:3D,3374480,639827453,157874,233543447,3216606,406284006,0,156075,191898019,151254,191321963,4821,576056,133617,16,160588,2851,0,538,144444.0,43333.0,-67.0,-73.0,-65.0,-70.0,-67.0,-73.0,-65.0,-70.0,-77.0,-85.0,-77.0,-85.0,10.0,12.0,12.0,15.0,1
4817,CC:2F:71:3E:C5:1F,3228021,407680309,11415,1396303,3216606,406284006,6,48717,4079917,40257,3077483,8460,1002434,12035,34,16379,186,6,827,130000.0,39000.0,-73.0,-84.0,-73.0,-71.0,-68.0,-71.0,-68.0,-61.0,-77.0,-85.0,-77.0,-85.0,4.0,1.0,4.0,14.0,1
4818,CC:2F:71:3F:1F:24,9181521,9517112352,5964915,9110828346,3216606,406284006,80,1382460,835915483,1373909,834888625,8551,1026858,1329133,619,5969634,605474,80,5924,86667.0,14444.0,-68.0,-64.0,-71.0,-69.0,-68.0,-64.0,-71.0,-69.0,-77.0,-85.0,-77.0,-85.0,9.0,21.0,6.0,16.0,1
4819,F8:59:71:5A:E0:3D,3374546,639925617,157937,233641349,3216609,406284268,0,156139,191996579,151318,191420523,4821,576056,133681,16,160651,2851,0,538,144444.0,43333.0,-67.0,-73.0,-65.0,-70.0,-66.0,-73.0,-65.0,-70.0,-77.0,-85.0,-77.0,-85.0,10.0,12.0,12.0,15.0,1
4820,CC:2F:71:3E:C5:1F,3228024,407680571,11415,1396303,3216609,406284268,6,48717,4079917,40257,3077483,8460,1002434,12035,34,16379,186,6,827,130000.0,39000.0,-73.0,-84.0,-73.0,-71.0,-68.0,-71.0,-68.0,-61.0,-77.0,-85.0,-77.0,-85.0,4.0,1.0,4.0,14.0,1
4821,CC:2F:71:3F:1F:24,9182541,9518676368,5965932,9112392100,3216609,406284268,80,1382712,836038347,1374161,835011489,8551,1026858,1329385,619,5970635,605562,80,5924,65000.0,13000.0,-69.0,-64.0,-71.0,-69.0,-68.0,-64.0,-71.0,-69.0,-77.0,-85.0,-77.0,-85.0,8.0,21.0,6.0,16.0,1
4822,F8:59:71:5A:E0:3D,3374616,640028585,158003,233743913,3216613,406284672,0,156205,192098219,151384,191522163,4821,576056,133747,16,160717,2853,0,538,144444.0,43333.0,-67.0,-73.0,-65.0,-70.0,-66.0,-73.0,-65.0,-70.0,-77.0,-85.0,-77.0,-85.0,10.0,12.0,12.0,15.0,1
4823,CC:2F:71:3E:C5:1F,3228028,407680975,11415,1396303,3216613,406284672,6,48717,4079917,40257,3077483,8460,1002434,12035,34,16379,186,6,827,130000.0,39000.0,-73.0,-84.0,-73.0,-71.0,-68.0,-71.0,-68.0,-61.0,-77.0,-85.0,-77.0,-85.0,4.0,1.0,4.0,14.0,1
4824,CC:2F:71:3F:1F:24,9183856,9520701654,5967242,9114416848,3216614,406284806,80,1383008,836165157,1374457,835138299,8551,1026858,1329679,619,5971960,605580,80,5925,86667.0,14444.0,-69.0,-64.0,-72.0,-69.0,-69.0,-64.0,-72.0,-69.0,-77.0,-85.0,-77.0,-85.0,8.0,21.0,5.0,16.0,1
4825,F8:59:71:5A:E0:3D,3374684,640128445,158067,233843369,3216617,406285076,0,156269,192196793,151448,191620737,4821,576056,133810,16,160781,2853,0,538,144444.0,43333.0,-67.0,-73.0,-65.0,-70.0,-67.0,-73.0,-65.0,-70.0,-77.0,-85.0,-77.0,-85.0,10.0,12.0,12.0,15.0,1
4826,CC:2F:71:3E:C5:1F,3228032,407681379,11415,1396303,3216617,406285076,6,48717,4079917,40257,3077483,8460,1002434,12035,34,16379,186,6,827,130000.0,39000.0,-73.0,-84.0,-73.0,-71.0,-68.0,-71.0,-68.0,-61.0,-77.0,-85.0,-77.0,-85.0,4.0,1.0,4.0,14.0,1
4827,CC:2F:71:3F:1F:24,9185114,9522638353,5968496,9116353004,3216618,406285349,80,1383318,836295033,1374767,835268175,8551,1026858,1329988,619,5973208,605672,80,5925,86667.0,13000.0,-68.0,-64.0,-72.0,-69.0,-68.0,-64.0,-71.0,-69.0,-77.0,-85.0,-77.0,-85.0,9.0,21.0,5.0,16.0,1
4828,F8:59:71:5A:E0:3D,3374756,640231746,158133,233945933,3216623,406285813,0,156332,192293813,151511,191717757,4821,576056,133873,16,160847,2854,0,538,144444.0,43333.0,-67.0,-73.0,-65.0,-70.0,-66.0,-73.0,-65.0,-70.0,-77.0,-85.0,-77.0,-85.0,10.0,12.0,12.0,15.0,1
4829,CC:2F:71:3E:C5:1F,3228038,407682116,11415,1396303,3216623,406285813,6,48717,4079917,40257,3077483,8460,1002434,12035,34,16379,186,6,827,130000.0,39000.0,-73.0,-84.0,-73.0,-71.0,-68.0,-71.0,-68.0,-61.0,-77.0,-85.0,-77.0,-85.0,4.0,1.0,4.0,14.0,1
4830,CC:2F:71:3F:1F:24,9186209,9524308674,5969586,9118022861,3216623,406285813,80,1383603,836425266,1375052,835398408,8551,1026858,1330273,619,5974297,605697,80,5925,86667.0,14444.0,-68.0,-64.0,-72.0,-70.0,-68.0,-64.0,-71.0,-69.0,-77.0,-85.0,-77.0,-85.0,9.0,21.0,5.0,15.0,1
4831,F8:59:71:5A:E0:3D,3374825,640333160,158198,234046943,3216627,406286217,0,156401,192400087,151580,191824031,4821,576056,133941,16,160911,2855,0,538,144444.0,43333.0,-67.0,-73.0,-65.0,-71.0,-67.0,-73.0,-64.0,-70.0,-77.0,-85.0,-77.0,-85.0,10.0,12.0,12.0,14.0,1
4832,CC:2F:71:3E:C5:1F,3228042,407682520,11415,1396303,3216627,406286217,6,48717,4079917,40257,3077483,8460,1002434,12035,34,16379,186,6,827,130000.0,39000.0,-73.0,-84.0,-73.0,-71.0,-68.0,-71.0,-68.0,-61.0,-77.0,-85.0,-77.0,-85.0,4.0,1.0,4.0,14.0,1
4833,CC:2F:71:3F:1F:24,9187204,9525830628,5970577,9119544411,3216627,406286217,80,1383853,836545198,1375302,835518340,8551,1026858,1330523,619,5975296,605709,80,5925,86667.0,14444.0,-68.0,-64.0,-71.0,-70.0,-68.0,-63.0,-71.0,-69.0,-77.0,-85.0,-77.0,-85.0,9.0,21.0,6.0,15.0,1
4834,F8:59:71:5A:E0:3D,3374889,640432616,158262,234146399,3216627,406286217,0,156465,192498647,151644,191922591,4821,576056,134005,16,160976,2856,0,538,144444.0,43333.0,-67.0,-73.0,-65.0,-70.0,-66.0,-73.0,-65.0,-70.0,-77.0,-86.0,-77.0,-85.0,10.0,13.0,12.0,15.0,1
4835,CC:2F:71:3E:C5:1F,3228044,407682722,11415,1396303,3216629,406286419,6,48717,4079917,40257,3077483,8460,1002434,12035,34,16379,186,6,827,130000.0,39000.0,-73.0,-84.0,-73.0,-71.0,-68.0,-71.0,-68.0,-61.0,-77.0,-86.0,-77.0,-85.0,4.0,2.0,4.0,14.0,1
4836,CC:2F:71:3F:1F:24,9188455,9527757646,5971824,9121471025,3216631,406286621,80,1384138,836672030,1375587,835645172,8551,1026858,1330808,619,5976543,605811,80,5925,86667.0,14444.0,-68.0,-64.0,-71.0,-70.0,-68.0,-64.0,-71.0,-69.0,-77.0,-86.0,-77.0,-85.0,9.0,22.0,6.0,15.0,1
4837,F8:59:71:5A:E0:3D,3374963,640533002,158326,234245855,3216637,406287147,0,156530,192597325,151708,192021151,4822,576174,134070,16,161040,2858,0,538,144444.0,43333.0,-66.0,-72.0,-66.0,-70.0,-66.0,-72.0,-65.0,-70.0,-77.0,-86.0,-77.0,-85.0,11.0,14.0,11.0,15.0,1
4838,CC:2F:71:3E:C5:1F,3228052,407683450,11415,1396303,3216637,406287147,6,48717,4079917,40257,3077483,8460,1002434,12035,34,16379,186,6,827,130000.0,39000.0,-73.0,-84.0,-73.0,-71.0,-68.0,-71.0,-68.0,-61.0,-77.0,-86.0,-77.0,-85.0,4.0,2.0,4.0,14.0,1
4839,CC:2F:71:3F:1F:24,9189963,9530085616,5973326,9123798469,3216637,406287147,80,1384455,836802722,1375904,835775864,8551,1026858,1331124,619,5978026,605849,80,5925,65000.0,14444.0,-68.0,-64.0,-72.0,-69.0,-68.0,-64.0,-71.0,-69.0,-77.0,-86.0,-77.0,-85.0,9.0,22.0,5.0,16.0,1
4840,F8:59:71:5A:E0:3D,3375028,640632520,158390,234345311,3216638,406287209,0,156594,192695885,151772,192119711,4822,576174,134134,16,161104,2858,0,538,144444.0,43333.0,-66.0,-73.0,-65.0,-70.0,-66.0,-73.0,-65.0,-70.0,-77.0,-86.0,-77.0,-85.0,11.0,13.0,12.0,15.0,1
4841,CC:2F:71:3E:C5:1F,3228053,407683512,11415,1396303,3216638,406287209,6,48719,4080105,40258,3077553,8461,1002552,12036,34,16379,186,6,827,130000.0,39000.0,-69.0,-70.0,-67.0,-60.0,-68.0,-71.0,-68.0,-61.0,-77.0,-86.0,-77.0,-85.0,8.0,16.0,10.0,25.0,1
4842,CC:2F:71:3F:1F:24,9191118,9531859663,5974480,9125572454,3216638,406287209,80,1384749,836931057,1376198,835904199,8551,1026858,1331418,619,5979178,605865,80,5925,86667.0,14444.0,-69.0,-64.0,-72.0,-69.0,-68.0,-64.0,-71.0,-69.0,-77.0,-86.0,-77.0,-85.0,8.0,22.0,5.0,16.0,1
4843,F8:59:71:5A:E0:3D,3375100,640735690,158456,234447875,3216644,406287815,0,156660,192797525,151838,192221351,4822,576174,134200,16,161170,2858,0,538,144444.0,43333.0,-67.0,-73.0,-65.0,-70.0,-66.0,-73.0,-65.0,-70.0,-77.0,-86.0,-77.0,-85.0,10.0,13.0,12.0,15.0,1
4844,CC:2F:71:3E:C5:1F,3228061,407684320,11415,1396303,3216646,406288017,6,48719,4080105,40258,3077553,8461,1002552,12036,34,16379,186,6,827,130000.0,39000.0,-69.0,-70.0,-67.0,-60.0,-68.0,-71.0,-68.0,-61.0,-77.0,-86.0,-77.0,-85.0,8.0,16.0,10.0,25.0,1
4845,CC:2F:71:3F:1F:24,9192648,9534220843,5976002,9127932826,3216646,406288017,80,1385075,837062649,1376524,836035791,8551,1026858,1331744,619,5980706,606031,80,5925,86667.0,14444.0,-68.0,-64.0,-71.0,-69.0,-68.0,-64.0,-71.0,-69.0,-77.0,-86.0,-77.0,-85.0,9.0,22.0,6.0,16.0,1
4846,F8:59:71:5A:E0:3D,3375168,640836962,158521,234548885,3216647,406288077,0,156725,192897625,151903,192321451,4822,576174,134265,16,161235,2859,0,538,144444.0,43333.0,-67.0,-73.0,-65.0,-70.0,-66.0,-73.0,-65.0,-70.0,-77.0,-86.0,-77.0,-85.0,10.0,13.0,12.0,15.0,1
4847,CC:2F:71:3E:C5:1F,3228062,407684380,11415,1396303,3216647,406288077,6,48719,4080105,40258,3077553,8461,1002552,12036,34,16379,186,6,827,130000.0,39000.0,-69.0,-70.0,-67.0,-60.0,-68.0,-71.0,-68.0,-61.0,-77.0,-86.0,-77.0,-85.0,8.0,16.0,10.0,25.0,1
4848,CC:2F:71:3F:1F:24,9193769,9535945743,5977122,9129657666,3216647,406288077,80,1385382,837192259,1376831,836165401,8551,1026858,1332049,619,5981841,606039,80,5926,86667.0,14444.0,-69.0,-64.0,-72.0,-69.0,-68.0,-64.0,-71.0,-69.0,-77.0,-86.0,-77.0,-85.0,8.0,22.0,5.0,16.0,1
4849,F8:59:71:5A:E0:3D,3375237,640935470,158584,234646787,3216653,406288683,0,156789,192996185,151967,192420011,4822,576174,134329,16,161298,2860,0,538,144444.0,43333.0,-67.0,-73.0,-65.0,-70.0,-66.0,-73.0,-64.0,-69.0,-77.0,-86.0,-77.0,-85.0,10.0,13.0,12.0,15.0,1
4850,CC:2F:71:3E:C5:1F,3228068,407684986,11415,1396303,3216653,406288683,6,48719,4080105,40258,3077553,8461,1002552,12036,34,16379,186,6,827,130000.0,39000.0,-69.0,-70.0,-67.0,-60.0,-68.0,-71.0,-68.0,-61.0,-77.0,-86.0,-77.0,-85.0,8.0,16.0,10.0,25.0,1
4851,CC:2F:71:3F:1F:24,9194840,9537581445,5978185,9131292560,3216655,406288885,80,1385674,837318487,1377123,836291629,8551,1026858,1332341,619,5982904,606047,80,5926,86667.0,14444.0,-69.0,-64.0,-71.0,-69.0,-68.0,-64.0,-71.0,-68.0,-77.0,-86.0,-77.0,-85.0,8.0,22.0,6.0,16.0,1
4852,F8:59:71:5A:E0:3D,3375304,641036682,158649,234747797,3216655,406288885,0,156854,193096285,152032,192520111,4822,576174,134394,16,161363,2860,0,538,144444.0,43333.0,-66.0,-73.0,-65.0,-70.0,-66.0,-73.0,-65.0,-69.0,-77.0,-86.0,-77.0,-85.0,11.0,13.0,12.0,15.0,1
4853,CC:2F:71:3E:C5:1F,3228071,407685248,11415,1396303,3216656,406288945,6,48719,4080105,40258,3077553,8461,1002552,12036,34,16379,186,6,827,130000.0,39000.0,-69.0,-70.0,-67.0,-60.0,-68.0,-71.0,-68.0,-61.0,-77.0,-86.0,-77.0,-85.0,8.0,16.0,10.0,25.0,1
4854,CC:2F:71:3F:1F:24,9195991,9539353573,5979335,9133064628,3216656,406288945,80,1385938,837441745,1377387,836414887,8551,1026858,1332604,619,5984054,606193,80,5926,86667.0,14444.0,-69.0,-64.0,-72.0,-69.0,-68.0,-64.0,-71.0,-69.0,-77.0,-86.0,-77.0,-85.0,8.0,22.0,5.0,16.0,1
4855,F8:59:71:5A:E0:3D,3375372,641135048,158712,234845699,3216660,406289349,0,156917,193193305,152095,192617131,4822,576174,134457,16,161426,2860,0,538,144444.0,43333.0,-67.0,-73.0,-65.0,-70.0,-66.0,-73.0,-65.0,-70.0,-77.0,-86.0,-77.0,-85.0,10.0,13.0,12.0,15.0,1
4856,CC:2F:71:3E:C5:1F,3228075,407685652,11415,1396303,3216660,406289349,6,48719,4080105,40258,3077553,8461,1002552,12036,34,16379,186,6,827,130000.0,39000.0,-69.0,-70.0,-67.0,-60.0,-68.0,-71.0,-68.0,-61.0,-77.0,-86.0,-77.0,-85.0,8.0,16.0,10.0,25.0,1
4857,CC:2F:71:3F:1F:24,9196838,9540632802,5980176,9134343251,3216662,406289551,80,1386179,837562736,1377628,836535878,8551,1026858,1332845,619,5984895,606215,80,5927,86667.0,14444.0,-69.0,-64.0,-71.0,-69.0,-68.0,-64.0,-71.0,-69.0,-77.0,-86.0,-77.0,-85.0,8.0,22.0,6.0,16.0,1
4858,F8:59:71:5A:E0:3D,3375439,641233354,158775,234943601,3216664,406289753,0,156981,193291879,152159,192715705,4822,576174,134520,16,161489,2860,0,538,144444.0,43333.0,-67.0,-73.0,-64.0,-70.0,-66.0,-73.0,-65.0,-70.0,-77.0,-86.0,-77.0,-85.0,10.0,13.0,13.0,15.0,1
4859,CC:2F:71:3E:C5:1F,3228079,407686056,11415,1396303,3216664,406289753,6,48719,4080105,40258,3077553,8461,1002552,12036,34,16379,186,6,827,130000.0,39000.0,-69.0,-70.0,-67.0,-60.0,-68.0,-71.0,-68.0,-61.0,-77.0,-86.0,-77.0,-85.0,8.0,16.0,10.0,25.0,1
4860,CC:2F:71:3F:1F:24,9197659,9541883170,5980995,9135593417,3216664,406289753,80,1386395,837678690,1377844,836651832,8551,1026858,1333061,619,5985699,606232,80,5927,86667.0,14444.0,-69.0,-64.0,-71.0,-69.0,-69.0,-64.0,-71.0,-69.0,-77.0,-86.0,-77.0,-85.0,8.0,22.0,6.0,16.0,1
4861,F8:59:71:5A:E0:3D,3375510,641336382,158841,235046165,3216669,406290217,0,157047,193393519,152225,192817345,4822,576174,134586,16,161555,2861,0,538,144444.0,43333.0,-66.0,-73.0,-65.0,-70.0,-66.0,-73.0,-65.0,-70.0,-77.0,-86.0,-77.0,-85.0,11.0,13.0,12.0,15.0,1
4862,CC:2F:71:3E:C5:1F,3228084,407686520,11415,1396303,3216669,406290217,6,48719,4080105,40258,3077553,8461,1002552,12036,34,16379,186,6,827,130000.0,39000.0,-69.0,-70.0,-67.0,-60.0,-68.0,-71.0,-68.0,-61.0,-77.0,-86.0,-77.0,-85.0,8.0,16.0,10.0,25.0,1
4863,CC:2F:71:3F:1F:24,9198777,9543598860,5982108,9137308643,3216669,406290217,80,1386654,837804272,1378103,836777414,8551,1026858,1333314,619,5986827,606323,80,5928,86667.0,14444.0,-68.0,-64.0,-71.0,-69.0,-68.0,-64.0,-71.0,-69.0,-77.0,-86.0,-77.0,-85.0,9.0,22.0,6.0,16.0,1
4864,F8:59:71:5A:E0:3D,3375579,641437796,158906,235147175,3216673,406290621,0,157111,193492079,152289,192915905,4822,576174,134650,16,161619,2862,0,538,144444.0,43333.0,-66.0,-73.0,-65.0,-70.0,-66.0,-72.0,-65.0,-70.0,-77.0,-86.0,-77.0,-85.0,11.0,13.0,12.0,15.0,1
4865,CC:2F:71:3E:C5:1F,3228088,407686924,11415,1396303,3216673,406290621,6,48719,4080105,40258,3077553,8461,1002552,12036,34,16379,186,6,827,130000.0,39000.0,-69.0,-70.0,-67.0,-60.0,-68.0,-71.0,-68.0,-61.0,-77.0,-86.0,-77.0,-85.0,8.0,16.0,10.0,25.0,1
4866,CC:2F:71:3F:1F:24,9199742,9545074842,5983069,9138784221,3216673,406290621,80,1386890,837922838,1378339,836895980,8551,1026858,1333550,619,5987768,606325,80,5928,86667.0,14444.0,-69.0,-64.0,-71.0,-70.0,-68.0,-64.0,-71.0,-69.0,-77.0,-86.0,-77.0,-85.0,8.0,22.0,6.0,15.0,1
4867,F8:59:71:5A:E0:3D,3375645,641534548,158968,235243523,3216677,406291025,0,157173,193587559,152351,193011385,4822,576174,134712,16,161682,2862,0,538,144444.0,43333.0,-67.0,-73.0,-65.0,-70.0,-66.0,-72.0,-65.0,-69.0,-77.0,-86.0,-77.0,-85.0,10.0,13.0,12.0,15.0,1
4868,CC:2F:71:3E:C5:1F,3228092,407687328,11415,1396303,3216677,406291025,6,48719,4080105,40258,3077553,8461,1002552,12036,34,16379,186,6,827,130000.0,39000.0,-69.0,-70.0,-67.0,-60.0,-68.0,-71.0,-68.0,-61.0,-77.0,-86.0,-77.0,-85.0,8.0,16.0,10.0,25.0,1
4869,CC:2F:71:3F:1F:24,9200676,9546494167,5983999,9140203142,3216677,406291025,80,1387144,838045205,1378593,837018347,8551,1026858,1333804,619,5988718,606456,80,5928,65000.0,13000.0,-68.0,-64.0,-70.0,-69.0,-68.0,-64.0,-70.0,-69.0,-77.0,-86.0,-77.0,-85.0,9.0,22.0,7.0,16.0,1
4870,F8:59:71:5A:E0:3D,3375716,641636295,159033,235344533,3216683,406291762,0,157238,193687659,152416,193111485,4822,576174,134777,16,161747,2862,0,538,144444.0,43333.0,-66.0,-73.0,-65.0,-70.0,-66.0,-72.0,-65.0,-70.0,-77.0,-86.0,-77.0,-85.0,11.0,13.0,12.0,15.0,1
4871,CC:2F:71:3E:C5:1F,3228098,407688065,11415,1396303,3216683,406291762,6,48719,4080105,40258,3077553,8461,1002552,12036,34,16379,186,6,827,130000.0,39000.0,-69.0,-70.0,-67.0,-60.0,-68.0,-71.0,-68.0,-61.0,-77.0,-86.0,-77.0,-85.0,8.0,16.0,10.0,25.0,1
4872,CC:2F:71:3F:1F:24,9201677,9548023886,5984994,9141732124,3216683,406291762,80,1387395,838166655,1378844,837139797,8551,1026858,1334055,619,5989713,606457,80,5929,86667.0,14444.0,-68.0,-64.0,-69.0,-68.0,-68.0,-64.0,-70.0,-68.0,-77.0,-86.0,-77.0,-85.0,9.0,22.0,8.0,17.0,1
4873,F8:59:71:5A:E0:3D,3375782,641735953,159097,235443989,3216685,406291964,0,157302,193786219,152480,193210045,4822,576174,134841,16,161811,2862,0,538,144444.0,43333.0,-66.0,-73.0,-65.0,-70.0,-66.0,-73.0,-64.0,-70.0,-77.0,-86.0,-77.0,-85.0,11.0,13.0,12.0,15.0,1
4874,CC:2F:71:3E:C5:1F,3228102,407688469,11415,1396303,3216687,406292166,6,48719,4080105,40258,3077553,8461,1002552,12036,34,16379,186,6,827,130000.0,39000.0,-69.0,-70.0,-67.0,-60.0,-68.0,-71.0,-68.0,-61.0,-77.0,-86.0,-77.0,-85.0,8.0,16.0,10.0,25.0,1
4875,CC:2F:71:3F:1F:24,9202841,9549812218,5986154,9143520052,3216687,406292166,80,1387670,838289429,1379119,837262571,8551,1026858,1334330,619,5990858,606472,80,5929,86667.0,14444.0,-69.0,-64.0,-70.0,-69.0,-68.0,-64.0,-71.0,-69.0,-77.0,-86.0,-77.0,-85.0,8.0,22.0,7.0,16.0,1
4876,F8:59:71:5A:E0:3D,3375852,641835959,159161,235543389,3216691,406292570,0,157367,193886347,152545,193310173,4822,576174,134906,16,161875,2862,0,538,130000.0,39000.0,-67.0,-73.0,-64.0,-70.0,-66.0,-72.0,-64.0,-69.0,-77.0,-86.0,-77.0,-85.0,10.0,13.0,13.0,15.0,1
4877,CC:2F:71:3E:C5:1F,3228106,407688873,11415,1396303,3216691,406292570,6,48719,4080105,40258,3077553,8461,1002552,12036,34,16379,186,6,827,130000.0,39000.0,-69.0,-70.0,-67.0,-60.0,-68.0,-71.0,-68.0,-61.0,-77.0,-86.0,-77.0,-85.0,8.0,16.0,10.0,25.0,1
4878,CC:2F:71:3F:1F:24,9204293,9552054942,5987602,9145762372,3216691,406292570,80,1387981,838419377,1379430,837392519,8551,1026858,1334641,619,5992301,606604,80,5929,86667.0,14444.0,-68.0,-64.0,-71.0,-69.0,-68.0,-64.0,-71.0,-69.0,-77.0,-86.0,-77.0,-85.0,9.0,22.0,6.0,16.0,1
4879,F8:59:71:5A:E0:3D,3375920,641937119,159226,235644287,3216694,406292832,0,157432,193986447,152610,193410273,4822,576174,134971,16,161940,2862,0,538,144444.0,43333.0,-67.0,-73.0,-65.0,-70.0,-66.0,-72.0,-65.0,-70.0,-77.0,-86.0,-77.0,-85.0,10.0,13.0,12.0,15.0,1
4880,CC:2F:71:3E:C5:1F,3228109,407689135,11415,1396303,3216694,406292832,6,48719,4080105,40258,3077553,8461,1002552,12036,34,16379,186,6,827,130000.0,39000.0,-69.0,-70.0,-67.0,-60.0,-68.0,-71.0,-68.0,-61.0,-77.0,-86.0,-77.0,-85.0,8.0,16.0,10.0,25.0,1
4881,CC:2F:71:3F:1F:24,9205747,9554289047,5989051,9147996013,3216696,406293034,80,1388310,838551983,1379759,837525125,8551,1026858,1334970,619,5993770,606622,80,5929,86667.0,14444.0,-69.0,-64.0,-72.0,-69.0,-68.0,-64.0,-71.0,-69.0,-77.0,-86.0,-77.0,-85.0,8.0,22.0,5.0,16.0,1
4882,F8:59:71:5A:E0:3D,3375991,642040338,159292,235746851,3216699,406293487,0,157499,194089669,152677,193513495,4822,576174,135037,16,162006,2864,0,539,144444.0,43333.0,-67.0,-73.0,-65.0,-70.0,-66.0,-72.0,-65.0,-69.0,-77.0,-86.0,-77.0,-85.0,10.0,13.0,12.0,15.0,1
4883,CC:2F:71:3E:C5:1F,3228116,407689992,11415,1396303,3216701,406293689,6,48719,4080105,40258,3077553,8461,1002552,12036,34,16379,186,6,827,130000.0,39000.0,-69.0,-70.0,-67.0,-60.0,-68.0,-71.0,-68.0,-61.0,-77.0,-86.0,-77.0,-85.0,8.0,16.0,10.0,25.0,1
4884,CC:2F:71:3F:1F:24,9207032,9556267038,5990331,9149973349,3216701,406293689,80,1388608,838683079,1380057,837656221,8551,1026858,1335268,619,5995041,606651,80,5929,86667.0,14444.0,-69.0,-64.0,-72.0,-69.0,-69.0,-64.0,-71.0,-68.0,-77.0,-86.0,-77.0,-85.0,8.0,22.0,5.0,16.0,1
4885,F8:59:71:5A:E0:3D,3376061,642142034,159358,235847977,3216703,406294057,0,157564,194189769,152742,193613595,4822,576174,135102,16,162072,2865,0,539,144444.0,43333.0,-66.0,-71.0,-65.0,-69.0,-66.0,-72.0,-65.0,-69.0,-77.0,-86.0,-77.0,-85.0,11.0,15.0,12.0,16.0,1
4886,CC:2F:71:3E:C5:1F,3228121,407690678,11416,1396419,3216705,406294259,6,48721,4080245,40260,3077693,8461,1002552,12036,34,16380,186,6,827,130000.0,39000.0,-68.0,-70.0,-68.0,-60.0,-68.0,-71.0,-68.0,-61.0,-77.0,-86.0,-77.0,-85.0,9.0,16.0,9.0,25.0,1
4887,CC:2F:71:3F:1F:24,9208112,9557922946,5991407,9151628687,3216705,406294259,80,1388875,838807929,1380324,837781071,8551,1026858,1335535,619,5996111,606741,80,5930,86667.0,14444.0,-69.0,-64.0,-71.0,-69.0,-69.0,-64.0,-71.0,-69.0,-77.0,-86.0,-77.0,-85.0,8.0,22.0,6.0,16.0,1
4888,F8:59:71:5A:E0:3D,3376133,642243710,159423,235948987,3216710,406294723,0,157629,194289869,152807,193713695,4822,576174,135167,16,162137,2867,0,539,144444.0,43333.0,-67.0,-73.0,-65.0,-70.0,-66.0,-72.0,-64.0,-70.0,-77.0,-86.0,-77.0,-85.0,10.0,13.0,12.0,15.0,1
4889,CC:2F:71:3E:C5:1F,3228126,407691142,11416,1396419,3216710,406294723,6,48721,4080245,40260,3077693,8461,1002552,12036,34,16380,186,6,827,130000.0,39000.0,-68.0,-70.0,-68.0,-60.0,-68.0,-71.0,-68.0,-61.0,-77.0,-86.0,-77.0,-85.0,9.0,16.0,9.0,25.0,1
4890,CC:2F:71:3F:1F:24,9209348,9559820374,5992636,9153525449,3216712,406294925,80,1389161,838934893,1380610,837908035,8551,1026858,1335821,619,5997355,606775,80,5930,86667.0,14444.0,-69.0,-64.0,-72.0,-69.0,-69.0,-64.0,-71.0,-69.0,-77.0,-86.0,-77.0,-85.0,8.0,22.0,5.0,16.0,1
4891,F8:59:71:5A:E0:3D,3376200,642344922,159488,236049997,3216712,406294925,0,157693,194388429,152871,193812255,4822,576174,135231,16,162202,2867,0,539,144444.0,43333.0,-67.0,-73.0,-65.0,-70.0,-67.0,-72.0,-64.0,-70.0,-77.0,-86.0,-77.0,-85.0,10.0,13.0,12.0,15.0,1
4892,CC:2F:71:3E:C5:1F,3228128,407691344,11416,1396419,3216712,406294925,6,48721,4080245,40260,3077693,8461,1002552,12036,34,16380,186,6,827,130000.0,39000.0,-68.0,-70.0,-68.0,-60.0,-68.0,-71.0,-68.0,-61.0,-77.0,-86.0,-77.0,-85.0,9.0,16.0,9.0,25.0,1
4893,CC:2F:71:3F:1F:24,9210764,9562000399,5994050,9155705272,3216714,406295127,80,1389492,839067513,1380941,838040655,8551,1026858,1336152,619,5998768,606794,80,5930,86667.0,14444.0,-69.0,-64.0,-72.0,-69.0,-68.0,-64.0,-71.0,-69.0,-77.0,-86.0,-77.0,-85.0,8.0,22.0,5.0,16.0,1
4894,F8:59:71:5A:E0:3D,3376269,642444844,159552,236149453,3216717,406295391,0,157757,194486989,152935,193910815,4822,576174,135295,16,162266,2867,0,539,144444.0,43333.0,-66.0,-73.0,-65.0,-70.0,-66.0,-73.0,-65.0,-70.0,-77.0,-86.0,-77.0,-85.0,11.0,13.0,12.0,15.0,1
4895,CC:2F:71:3E:C5:1F,3228133,407691810,11416,1396419,3216717,406295391,6,48721,4080245,40260,3077693,8461,1002552,12036,34,16380,186,6,827,130000.0,39000.0,-68.0,-70.0,-68.0,-60.0,-68.0,-71.0,-68.0,-61.0,-77.0,-86.0,-77.0,-85.0,9.0,16.0,9.0,25.0,1
4896,CC:2F:71:3F:1F:24,9211823,9563621549,5995104,9157325956,3216719,406295593,80,1389756,839189327,1381204,838162351,8552,1026976,1336416,619,5999813,606930,80,5931,86667.0,14444.0,-69.0,-64.0,-72.0,-70.0,-69.0,-64.0,-72.0,-69.0,-77.0,-86.0,-77.0,-85.0,8.0,22.0,5.0,15.0,1
4897,F8:59:71:5A:E0:3D,3376339,642544826,159616,236248909,3216723,406295917,0,157821,194585549,152999,194009375,4822,576174,135359,16,162330,2868,0,539,144444.0,43333.0,-67.0,-73.0,-64.0,-70.0,-66.0,-72.0,-64.0,-69.0,-77.0,-86.0,-77.0,-85.0,10.0,13.0,13.0,15.0,1
4898,CC:2F:71:3E:C5:1F,3228139,407692336,11416,1396419,3216723,406295917,6,48723,4080433,40261,3077763,8462,1002670,12037,34,16380,186,6,827,130000.0,39000.0,-68.0,-70.0,-68.0,-60.0,-68.0,-71.0,-68.0,-61.0,-77.0,-86.0,-77.0,-85.0,9.0,16.0,9.0,25.0,1
4899,CC:2F:71:3F:1F:24,9212702,9564961719,5995979,9158665802,3216723,406295917,80,1389986,839308605,1381434,838281629,8552,1026976,1336646,619,6000698,606943,80,5933,86667.0,14444.0,-70.0,-64.0,-72.0,-69.0,-69.0,-64.0,-71.0,-69.0,-77.0,-86.0,-77.0,-85.0,7.0,22.0,5.0,16.0,1
4900,F8:59:71:5A:E0:3D,3376406,642643132,159679,236346811,3216727,406296321,0,157885,194684109,153063,194107935,4822,576174,135423,16,162393,2868,0,539,144444.0,43333.0,-66.0,-73.0,-65.0,-70.0,-66.0,-73.0,-64.0,-70.0,-77.0,-86.0,-77.0,-85.0,11.0,13.0,12.0,15.0,1
4901,CC:2F:71:3E:C5:1F,3228143,407692740,11416,1396419,3216727,406296321,6,48723,4080433,40261,3077763,8462,1002670,12037,34,16380,186,6,827,130000.0,39000.0,-68.0,-70.0,-68.0,-60.0,-68.0,-71.0,-68.0,-61.0,-77.0,-86.0,-77.0,-85.0,9.0,16.0,9.0,25.0,1
4902,CC:2F:71:3F:1F:24,9213801,9566647681,5997074,9160351360,3216727,406296321,80,1390246,839431021,1381694,838404045,8552,1026976,1336906,619,6001793,606959,80,5933,86667.0,14444.0,-69.0,-64.0,-72.0,-69.0,-68.0,-64.0,-71.0,-69.0,-77.0,-86.0,-77.0,-85.0,8.0,22.0,5.0,16.0,1
4903,F8:59:71:5A:E0:3D,3376474,642742992,159743,236446267,3216731,406296725,0,157949,194782669,153127,194206495,4822,576174,135487,16,162457,2869,0,539,144444.0,43333.0,-66.0,-73.0,-65.0,-70.0,-66.0,-73.0,-64.0,-70.0,-77.0,-86.0,-77.0,-85.0,11.0,13.0,12.0,15.0,1
4904,CC:2F:71:3E:C5:1F,3228148,407693204,11416,1396419,3216732,406296785,6,48723,4080433,40261,3077763,8462,1002670,12037,34,16380,186,6,827,130000.0,39000.0,-68.0,-70.0,-68.0,-60.0,-68.0,-71.0,-68.0,-61.0,-77.0,-86.0,-77.0,-85.0,9.0,16.0,9.0,25.0,1
4905,CC:2F:71:3F:1F:24,9214876,9568280711,5998133,9161978502,3216743,406302209,80,1390508,839559515,1381956,838532539,8552,1026976,1337168,619,6002852,607124,80,5933,65000.0,14444.0,-69.0,-64.0,-72.0,-70.0,-69.0,-64.0,-72.0,-69.0,-77.0,-86.0,-77.0,-85.0,8.0,22.0,5.0,15.0,1
4906,F8:59:71:5A:E0:3D,3376569,642859976,159811,236551939,3216758,406308037,0,158016,194885849,153194,194309675,4822,576174,135554,16,162525,2870,0,539,144444.0,43333.0,-67.0,-73.0,-65.0,-70.0,-66.0,-72.0,-65.0,-70.0,-77.0,-86.0,-77.0,-85.0,10.0,13.0,12.0,15.0,1
4907,CC:2F:71:3E:C5:1F,3228174,407704456,11416,1396419,3216758,406308037,6,48723,4080433,40261,3077763,8462,1002670,12037,34,16380,186,6,827,130000.0,39000.0,-68.0,-70.0,-68.0,-60.0,-68.0,-71.0,-68.0,-61.0,-77.0,-86.0,-77.0,-85.0,9.0,16.0,9.0,25.0,1
4908,CC:2F:71:3F:1F:24,9215563,9569298696,5998805,9162990659,3216758,406308037,80,1390711,839673234,1382159,838646258,8552,1026976,1337371,619,6003524,607143,80,5934,86667.0,14444.0,-69.0,-64.0,-71.0,-70.0,-69.0,-64.0,-71.0,-70.0,-77.0,-86.0,-77.0,-85.0,8.0,22.0,6.0,15.0,1
4909,F8:59:71:5A:E0:3D,3376636,642956844,159874,236648403,3216762,406308441,0,158080,194982975,153258,194406801,4822,576174,135618,16,162588,2870,0,539,144444.0,43333.0,-67.0,-72.0,-65.0,-70.0,-66.0,-72.0,-65.0,-70.0,-77.0,-86.0,-77.0,-85.0,10.0,14.0,12.0,15.0,1
4910,CC:2F:71:3E:C5:1F,3228178,407704860,11416,1396419,3216762,406308441,6,48723,4080433,40261,3077763,8462,1002670,12037,34,16380,186,6,827,130000.0,39000.0,-68.0,-70.0,-68.0,-60.0,-68.0,-71.0,-68.0,-61.0,-77.0,-86.0,-77.0,-85.0,9.0,16.0,9.0,25.0,1
4911,CC:2F:71:3F:1F:24,9216348,9570489280,5999586,9164180839,3216762,406308441,80,1390922,839787244,1382370,838760268,8552,1026976,1337582,619,6004290,607156,80,5934,104000.0,26000.0,-69.0,-64.0,-72.0,-70.0,-68.0,-64.0,-71.0,-70.0,-77.0,-86.0,-77.0,-85.0,8.0,22.0,5.0,15.0,1
4912,F8:59:71:5A:E0:3D,3376702,643053727,159936,236744751,3216766,406308976,0,158142,195078455,153320,194502281,4822,576174,135680,16,162650,2870,0,539,144444.0,43333.0,-67.0,-73.0,-65.0,-71.0,-66.0,-72.0,-65.0,-70.0,-77.0,-86.0,-77.0,-85.0,10.0,13.0,12.0,14.0,1
4913,CC:2F:71:3E:C5:1F,3228182,407705395,11416,1396419,3216766,406308976,6,48723,4080433,40261,3077763,8462,1002670,12037,34,16380,186,6,827,130000.0,39000.0,-68.0,-70.0,-68.0,-60.0,-68.0,-71.0,-68.0,-61.0,-77.0,-86.0,-77.0,-85.0,9.0,16.0,9.0,25.0,1
4914,CC:2F:71:3F:1F:24,9217313,9571965089,6000547,9165656113,3216766,406308976,80,1391180,839909496,1382628,838882520,8552,1026976,1337836,619,6005245,607218,80,5934,86667.0,14444.0,-69.0,-64.0,-72.0,-70.0,-68.0,-64.0,-71.0,-70.0,-77.0,-86.0,-77.0,-85.0,8.0,22.0,5.0,15.0,1
4915,F8:59:71:5A:E0:3D,3376771,643152235,159999,236842653,3216772,406309582,0,158204,195173935,153382,194597761,4822,576174,135742,16,162713,2871,0,539,144444.0,43333.0,-67.0,-73.0,-65.0,-70.0,-67.0,-73.0,-64.0,-70.0,-77.0,-86.0,-77.0,-85.0,10.0,13.0,12.0,15.0,1
4916,CC:2F:71:3E:C5:1F,3228188,407706001,11416,1396419,3216772,406309582,6,48723,4080433,40261,3077763,8462,1002670,12037,34,16380,186,6,827,130000.0,39000.0,-68.0,-70.0,-68.0,-60.0,-68.0,-71.0,-68.0,-61.0,-77.0,-86.0,-77.0,-85.0,9.0,16.0,9.0,25.0,1
4917,CC:2F:71:3F:1F:24,9218146,9573228405,6001374,9166918823,3216772,406309582,80,1391404,840029374,1382852,839002398,8552,1026976,1338060,619,6006091,607240,80,5934,104000.0,26000.0,-68.0,-64.0,-72.0,-70.0,-69.0,-64.0,-72.0,-69.0,-77.0,-86.0,-77.0,-85.0,9.0,22.0,5.0,15.0,1
4918,F8:59:71:5A:E0:3D,3376839,643255001,160065,236945217,3216774,406309784,0,158271,195277115,153449,194700941,4822,576174,135809,16,162779,2871,0,539,144444.0,43333.0,-67.0,-73.0,-65.0,-70.0,-66.0,-72.0,-64.0,-70.0,-77.0,-86.0,-77.0,-84.0,10.0,13.0,12.0,14.0,1
4919,CC:2F:71:3E:C5:1F,3228190,407706203,11416,1396419,3216774,406309784,6,48723,4080433,40261,3077763,8462,1002670,12037,34,16380,186,6,827,130000.0,39000.0,-68.0,-70.0,-68.0,-60.0,-68.0,-71.0,-68.0,-61.0,-77.0,-86.0,-77.0,-84.0,9.0,16.0,9.0,24.0,1
4920,CC:2F:71:3F:1F:24,9219069,9574633302,6002295,9168323518,3216774,406309784,80,1391669,840152939,1383117,839125963,8552,1026976,1338325,619,6007014,607293,80,5934,65000.0,13000.0,-69.0,-64.0,-72.0,-70.0,-68.0,-64.0,-71.0,-69.0,-77.0,-86.0,-77.0,-84.0,8.0,22.0,5.0,14.0,1
4921,F8:59:71:5A:E0:3D,3376908,643354921,160129,237044673,3216779,406310248,0,158335,195375675,153513,194799501,4822,576174,135873,16,162843,2871,0,539,144444.0,43333.0,-66.0,-73.0,-66.0,-70.0,-66.0,-72.0,-65.0,-70.0,-77.0,-86.0,-77.0,-84.0,11.0,13.0,11.0,14.0,1
4922,CC:2F:71:3E:C5:1F,3228195,407706667,11416,1396419,3216779,406310248,6,48723,4080433,40261,3077763,8462,1002670,12037,34,16380,186,6,827,130000.0,39000.0,-68.0,-70.0,-68.0,-60.0,-68.0,-71.0,-68.0,-61.0,-77.0,-86.0,-77.0,-84.0,9.0,16.0,9.0,24.0,1
4923,CC:2F:71:3F:1F:24,9220190,9576350820,6003409,9170040370,3216781,406310450,80,1391944,840278593,1383392,839251617,8552,1026976,1338599,619,6008128,607299,80,5934,86667.0,14444.0,-69.0,-64.0,-71.0,-70.0,-69.0,-64.0,-72.0,-69.0,-77.0,-86.0,-77.0,-84.0,8.0,22.0,6.0,14.0,1
4924,F8:59:71:5A:E0:3D,3376976,643454781,160193,237144129,3216783,406310652,0,158399,195474249,153577,194898075,4822,576174,135936,16,162907,2871,0,539,144444.0,43333.0,-67.0,-73.0,-65.0,-70.0,-66.0,-72.0,-65.0,-70.0,-77.0,-86.0,-77.0,-84.0,10.0,13.0,12.0,14.0,1
4925,CC:2F:71:3E:C5:1F,3228199,407707071,11416,1396419,3216783,406310652,6,48723,4080433,40261,3077763,8462,1002670,12037,34,16380,186,6,827,130000.0,39000.0,-68.0,-70.0,-68.0,-60.0,-68.0,-71.0,-68.0,-61.0,-77.0,-86.0,-77.0,-84.0,9.0,16.0,9.0,24.0,1
4926,CC:2F:71:3F:1F:24,9221409,9578228760,6004626,9171918108,3216783,406310652,80,1392218,840402713,1383666,839375737,8552,1026976,1338873,619,6009345,607386,80,5934,86667.0,14444.0,-69.0,-64.0,-72.0,-70.0,-68.0,-64.0,-71.0,-69.0,-77.0,-86.0,-77.0,-84.0,8.0,22.0,5.0,14.0,1
4927,F8:59:71:5A:E0:3D,3377046,643559163,160260,237248247,3216786,406310916,0,158469,195580641,153646,195004349,4823,576292,136005,16,162974,2872,0,539,144444.0,43333.0,-66.0,-73.0,-65.0,-70.0,-66.0,-72.0,-65.0,-70.0,-77.0,-86.0,-77.0,-84.0,11.0,13.0,12.0,14.0,1
4928,CC:2F:71:3E:C5:1F,3228204,407707537,11416,1396419,3216788,406311118,6,48723,4080433,40261,3077763,8462,1002670,12037,34,16380,186,6,827,130000.0,39000.0,-68.0,-70.0,-68.0,-60.0,-68.0,-71.0,-68.0,-61.0,-77.0,-86.0,-77.0,-84.0,9.0,16.0,9.0,24.0,1
4929,CC:2F:71:3F:1F:24,9222730,9580264618,6005942,9173953500,3216788,406311118,80,1392518,840536903,1383966,839509927,8552,1026976,1339172,619,6010659,607457,80,5934,86667.0,14444.0,-69.0,-64.0,-71.0,-70.0,-69.0,-64.0,-71.0,-70.0,-77.0,-86.0,-77.0,-84.0,8.0,22.0,6.0,14.0,1
4930,F8:59:71:5A:E0:3D,3377119,643662393,160326,237350811,3216793,406311582,0,158534,195680741,153711,195104449,4823,576292,136070,16,163040,2872,0,539,144444.0,43333.0,-67.0,-73.0,-65.0,-70.0,-66.0,-72.0,-64.0,-70.0,-77.0,-86.0,-77.0,-84.0,10.0,13.0,12.0,14.0,1
4931,CC:2F:71:3E:C5:1F,3228209,407708001,11416,1396419,3216793,406311582,6,48723,4080433,40261,3077763,8462,1002670,12037,34,16380,186,6,827,130000.0,39000.0,-68.0,-70.0,-68.0,-60.0,-68.0,-71.0,-68.0,-61.0,-77.0,-86.0,-77.0,-84.0,9.0,16.0,9.0,24.0,1
4932,CC:2F:71:3F:1F:24,9224249,9582604492,6007456,9176292910,3216793,406311582,80,1392856,840669048,1384304,839642072,8552,1026976,1339510,619,6012175,607507,80,5934,86667.0,14444.0,-68.0,-64.0,-71.0,-70.0,-68.0,-64.0,-71.0,-70.0,-77.0,-86.0,-77.0,-84.0,9.0,22.0,6.0,14.0,1
4933,F8:59:71:5A:E0:3D,3377183,643758943,160388,237447159,3216795,406311784,0,158597,195777761,153774,195201469,4823,576292,136133,16,163102,2872,0,539,144444.0,43333.0,-66.0,-71.0,-64.0,-70.0,-66.0,-72.0,-65.0,-70.0,-77.0,-86.0,-77.0,-84.0,11.0,15.0,13.0,14.0,1
4934,CC:2F:71:3E:C5:1F,3228211,407708203,11416,1396419,3216795,406311784,6,48723,4080433,40261,3077763,8462,1002670,12037,34,16380,186,6,827,130000.0,39000.0,-68.0,-70.0,-68.0,-60.0,-68.0,-71.0,-68.0,-61.0,-77.0,-86.0,-77.0,-84.0,9.0,16.0,9.0,24.0,1
4935,CC:2F:71:3F:1F:24,9225172,9584020048,6008377,9177708264,3216795,406311784,80,1393090,840788486,1384538,839761510,8552,1026976,1339743,619,6013096,607547,80,5934,86667.0,14444.0,-69.0,-64.0,-72.0,-70.0,-68.0,-64.0,-71.0,-69.0,-77.0,-86.0,-77.0,-84.0,8.0,22.0,5.0,14.0,1
4936,F8:59:71:5A:E0:3D,3377252,643857451,160451,237545061,3216801,406312390,0,158660,195874781,153837,195298489,4823,576292,136196,16,163165,2872,0,539,144444.0,43333.0,-67.0,-73.0,-64.0,-70.0,-66.0,-72.0,-64.0,-70.0,-77.0,-86.0,-77.0,-84.0,10.0,13.0,13.0,14.0,1
4937,CC:2F:71:3E:C5:1F,3228217,407708809,11416,1396419,3216801,406312390,6,48723,4080433,40261,3077763,8462,1002670,12037,34,16380,186,6,827,130000.0,39000.0,-68.0,-70.0,-68.0,-60.0,-68.0,-71.0,-68.0,-61.0,-77.0,-86.0,-77.0,-84.0,9.0,16.0,9.0,24.0,1
4938,CC:2F:71:3F:1F:24,9226260,9585688282,6009459,9179375892,3216801,406312390,80,1393369,840913106,1384817,839886130,8552,1026976,1340022,619,6014178,607617,80,5934,86667.0,14444.0,-68.0,-64.0,-71.0,-70.0,-68.0,-64.0,-71.0,-69.0,-77.0,-86.0,-77.0,-84.0,9.0,22.0,6.0,14.0,1
4939,F8:59:71:5A:E0:3D,3377318,643958521,160516,237646071,3216802,406312450,0,158724,195973341,153901,195397049,4823,576292,136260,16,163229,2874,0,539,144444.0,43333.0,-66.0,-73.0,-65.0,-71.0,-66.0,-72.0,-65.0,-70.0,-77.0,-86.0,-77.0,-84.0,11.0,13.0,12.0,13.0,1
4940,CC:2F:71:3E:C5:1F,3228218,407708869,11416,1396419,3216802,406312450,6,48723,4080433,40261,3077763,8462,1002670,12037,34,16380,186,6,827,130000.0,39000.0,-68.0,-70.0,-68.0,-60.0,-68.0,-71.0,-68.0,-61.0,-77.0,-86.0,-77.0,-84.0,9.0,16.0,9.0,24.0,1
4941,CC:2F:71:3F:1F:24,9227714,9587940184,6010912,9181627734,3216802,406312450,80,1393690,841041278,1385138,840014302,8552,1026976,1340343,619,6015617,607624,80,5935,86667.0,14444.0,-69.0,-64.0,-72.0,-70.0,-69.0,-64.0,-71.0,-70.0,-77.0,-86.0,-77.0,-84.0,8.0,22.0,5.0,14.0,1
4942,F8:59:71:5A:E0:3D,3377387,644057029,160579,237743973,3216808,406313056,0,158788,196071901,153965,195495609,4823,576292,136324,16,163293,2875,0,539,144444.0,43333.0,-67.0,-73.0,-65.0,-71.0,-66.0,-73.0,-65.0,-70.0,-77.0,-86.0,-77.0,-84.0,10.0,13.0,12.0,13.0,1
4943,CC:2F:71:3E:C5:1F,3228226,407709677,11416,1396419,3216810,406313258,6,48723,4080433,40261,3077763,8462,1002670,12037,34,16380,186,6,827,130000.0,39000.0,-68.0,-70.0,-68.0,-60.0,-68.0,-71.0,-68.0,-61.0,-77.0,-86.0,-77.0,-84.0,9.0,16.0,9.0,24.0,1
4944,CC:2F:71:3F:1F:24,9228491,9589102975,6011681,9182789717,3216810,406313258,80,1393922,841175011,1385370,840148035,8552,1026976,1340568,619,6016400,607639,80,5935,86667.0,14444.0,-69.0,-65.0,-71.0,-70.0,-69.0,-64.0,-71.0,-69.0,-77.0,-86.0,-77.0,-84.0,8.0,21.0,6.0,14.0,1
4945,F8:59:71:5A:E0:3D,3377477,644189415,160664,237875895,3216813,406313520,0,158873,196202801,154050,195626509,4823,576292,136409,16,163378,2875,0,539,144444.0,43333.0,-67.0,-73.0,-65.0,-71.0,-66.0,-72.0,-65.0,-70.0,-77.0,-86.0,-77.0,-84.0,10.0,13.0,12.0,13.0,1
4946,CC:2F:71:3E:C5:1F,3228229,407709939,11416,1396419,3216813,406313520,6,48723,4080433,40261,3077763,8462,1002670,12037,34,16380,186,6,827,130000.0,39000.0,-68.0,-70.0,-68.0,-60.0,-68.0,-71.0,-68.0,-61.0,-77.0,-86.0,-77.0,-84.0,9.0,16.0,9.0,24.0,1
4947,CC:2F:71:3F:1F:24,9229393,9590481995,6012580,9184168475,3216813,406313520,80,1394163,841318115,1385611,840291139,8552,1026976,1340799,619,6017299,607713,80,5935,86667.0,14444.0,-69.0,-64.0,-71.0,-69.0,-68.0,-63.0,-70.0,-68.0,-77.0,-86.0,-77.0,-84.0,8.0,22.0,6.0,15.0,1
4948,F8:59:71:5A:E0:3D,3377553,644298801,160734,237984675,3216819,406314126,0,158943,196310601,154120,195734309,4823,576292,136479,16,163448,2875,0,539,144444.0,43333.0,-67.0,-73.0,-65.0,-71.0,-66.0,-73.0,-65.0,-70.0,-77.0,-86.0,-77.0,-84.0,10.0,13.0,12.0,13.0,1
4949,CC:2F:71:3E:C5:1F,3228235,407710545,11416,1396419,3216819,406314126,6,48723,4080433,40261,3077763,8462,1002670,12037,34,16380,186,6,827,130000.0,39000.0,-68.0,-70.0,-68.0,-60.0,-68.0,-71.0,-68.0,-61.0,-77.0,-86.0,-77.0,-84.0,9.0,16.0,9.0,24.0,1
4950,CC:2F:71:3F:1F:24,9231128,9593169955,6014309,9186855829,3216819,406314126,80,1394527,841459041,1385975,840432065,8552,1026976,1341163,619,6019028,607763,80,5936,86667.0,14444.0,-69.0,-64.0,-72.0,-70.0,-68.0,-64.0,-71.0,-70.0,-77.0,-86.0,-77.0,-84.0,8.0,22.0,5.0,14.0,1
4951,F8:59:71:5A:E0:3D,3377622,644403326,160801,238088793,3216821,406314533,0,159010,196413781,154187,195837489,4823,576292,136546,16,163515,2875,0,539,144444.0,43333.0,-66.0,-72.0,-65.0,-70.0,-66.0,-72.0,-65.0,-70.0,-77.0,-85.0,-77.0,-84.0,11.0,13.0,12.0,14.0,1
4952,CC:2F:71:3E:C5:1F,3228238,407711020,11416,1396419,3216822,406314601,6,48723,4080433,40261,3077763,8462,1002670,12037,34,16380,186,6,827,130000.0,39000.0,-68.0,-70.0,-68.0,-60.0,-68.0,-71.0,-68.0,-61.0,-77.0,-85.0,-77.0,-84.0,9.0,15.0,9.0,24.0,1
4953,CC:2F:71:3F:1F:24,9232164,9594757768,6015342,9188443167,3216822,406314601,80,1394811,841586203,1386259,840559227,8552,1026976,1341447,619,6020061,607810,80,5936,86667.0,14444.0,-69.0,-64.0,-71.0,-70.0,-68.0,-64.0,-71.0,-69.0,-77.0,-85.0,-77.0,-84.0,8.0,21.0,6.0,14.0,1
4954,F8:59:71:5A:E0:3D,3377694,644503516,160865,238188249,3216829,406315267,0,159073,196510801,154250,195934509,4823,576292,136609,16,163578,2876,0,539,144444.0,43333.0,-67.0,-73.0,-65.0,-71.0,-66.0,-73.0,-65.0,-70.0,-77.0,-85.0,-77.0,-84.0,10.0,12.0,12.0,13.0,1
4955,CC:2F:71:3E:C5:1F,3228245,407711686,11416,1396419,3216829,406315267,6,48723,4080433,40261,3077763,8462,1002670,12037,34,16380,186,6,827,130000.0,39000.0,-68.0,-70.0,-68.0,-60.0,-68.0,-71.0,-68.0,-61.0,-77.0,-85.0,-77.0,-84.0,9.0,15.0,9.0,24.0,1
4956,CC:2F:71:3F:1F:24,9232845,9595772107,6016016,9189456840,3216829,406315267,80,1395029,841701753,1386477,840674777,8552,1026976,1341665,619,6020735,607823,80,5937,86667.0,14444.0,-69.0,-64.0,-72.0,-69.0,-68.0,-64.0,-71.0,-69.0,-77.0,-85.0,-77.0,-84.0,8.0,21.0,5.0,15.0,1
4957,F8:59:71:5A:E0:3D,3377756,644599864,160927,238284597,3216829,406315267,0,159136,196607821,154313,196031529,4823,576292,136672,16,163641,2877,0,539,144444.0,43333.0,-67.0,-73.0,-65.0,-70.0,-66.0,-73.0,-65.0,-70.0,-77.0,-85.0,-77.0,-84.0,10.0,12.0,12.0,14.0,1
4958,CC:2F:71:3E:C5:1F,3228245,407711686,11416,1396419,3216829,406315267,6,48723,4080433,40261,3077763,8462,1002670,12037,34,16380,186,6,827,130000.0,39000.0,-68.0,-70.0,-68.0,-60.0,-68.0,-71.0,-68.0,-61.0,-77.0,-85.0,-77.0,-84.0,9.0,15.0,9.0,24.0,1
4959,CC:2F:71:3F:1F:24,9233600,9596919857,6016771,9190604590,3216829,406315267,80,1395249,841822557,1386697,840795581,8552,1026976,1341885,619,6021490,607838,80,5937,86667.0,14444.0,-69.0,-64.0,-72.0,-70.0,-68.0,-64.0,-71.0,-69.0,-77.0,-85.0,-77.0,-84.0,8.0,21.0,5.0,14.0,1
4960,F8:59:71:5A:E0:3D,3377829,644703150,160994,238387277,3216835,406315873,0,159203,196709567,154380,196133275,4823,576292,136739,16,163708,2879,0,539,144444.0,43333.0,-67.0,-73.0,-65.0,-71.0,-66.0,-72.0,-64.0,-70.0,-77.0,-85.0,-77.0,-84.0,10.0,12.0,12.0,13.0,1
4961,CC:2F:71:3E:C5:1F,3228253,407712494,11416,1396419,3216837,406316075,6,48723,4080433,40261,3077763,8462,1002670,12037,34,16380,186,6,827,130000.0,39000.0,-68.0,-70.0,-68.0,-60.0,-68.0,-71.0,-68.0,-61.0,-77.0,-85.0,-77.0,-84.0,9.0,15.0,9.0,24.0,1
4962,CC:2F:71:3F:1F:24,9234675,9598560569,6017838,9192244494,3216837,406316075,80,1395490,841944317,1386938,840917341,8552,1026976,1342126,619,6022541,607944,80,5937,86667.0,14444.0,-69.0,-64.0,-71.0,-69.0,-68.0,-64.0,-71.0,-69.0,-77.0,-85.0,-77.0,-84.0,8.0,21.0,6.0,15.0,1
4963,F8:59:71:5A:E0:3D,3377897,644804422,161059,238488287,3216838,406316135,0,159267,196808127,154444,196231835,4823,576292,136803,16,163773,2880,0,539,144444.0,43333.0,-67.0,-73.0,-65.0,-70.0,-66.0,-73.0,-65.0,-70.0,-77.0,-85.0,-77.0,-84.0,10.0,12.0,12.0,14.0,1
4964,CC:2F:71:3E:C5:1F,3228254,407712554,11416,1396419,3216838,406316135,6,48723,4080433,40261,3077763,8462,1002670,12037,34,16380,186,6,827,130000.0,39000.0,-68.0,-70.0,-68.0,-60.0,-68.0,-71.0,-68.0,-61.0,-77.0,-85.0,-77.0,-84.0,9.0,15.0,9.0,24.0,1
4965,CC:2F:71:3F:1F:24,9235803,9600298155,6018965,9193982020,3216838,406316135,80,1395748,842065373,1387196,841038397,8552,1026976,1342384,619,6023684,607944,80,5937,86667.0,14444.0,-68.0,-64.0,-71.0,-70.0,-68.0,-64.0,-71.0,-69.0,-77.0,-85.0,-77.0,-84.0,9.0,21.0,6.0,14.0,1
4966,F8:59:71:5A:E0:3D,3377963,644901174,161121,238584635,3216842,406316539,0,159330,196905147,154507,196328855,4823,576292,136866,16,163835,2882,0,539,144444.0,43333.0,-67.0,-73.0,-65.0,-71.0,-67.0,-73.0,-65.0,-70.0,-77.0,-85.0,-77.0,-84.0,10.0,12.0,12.0,13.0,1
4967,CC:2F:71:3E:C5:1F,3228260,407713160,11416,1396419,3216844,406316741,6,48723,4080433,40261,3077763,8462,1002670,12037,34,16380,186,6,827,130000.0,39000.0,-68.0,-70.0,-68.0,-60.0,-68.0,-71.0,-68.0,-61.0,-77.0,-85.0,-77.0,-84.0,9.0,15.0,9.0,24.0,1
4968,CC:2F:71:3F:1F:24,9236811,9601836015,6019967,9195519274,3216844,406316741,80,1396001,842185601,1387449,841158625,8552,1026976,1342637,619,6024686,607966,80,5937,86667.0,14444.0,-69.0,-64.0,-72.0,-70.0,-69.0,-64.0,-71.0,-69.0,-77.0,-85.0,-77.0,-84.0,8.0,21.0,5.0,14.0,1
4969,F8:59:71:5A:E0:3D,3378035,645005812,161189,238688869,3216846,406316943,0,159397,197008327,154574,196432035,4823,576292,136933,16,163903,2882,0,539,144444.0,43333.0,-67.0,-73.0,-64.0,-71.0,-66.0,-73.0,-64.0,-70.0,-77.0,-85.0,-77.0,-84.0,10.0,12.0,13.0,13.0,1
4970,CC:2F:71:3E:C5:1F,3228263,407713478,11417,1396535,3216846,406316943,6,48725,4080573,40263,3077903,8462,1002670,12037,34,16381,186,6,827,130000.0,39000.0,-68.0,-70.0,-68.0,-60.0,-68.0,-69.0,-67.0,-60.0,-77.0,-85.0,-77.0,-84.0,9.0,15.0,9.0,24.0,1
4971,CC:2F:71:3F:1F:24,9237936,9603558022,6021089,9197241019,3216847,406317003,80,1396271,842314235,1387719,841287259,8552,1026976,1342907,619,6025808,608040,80,5937,86667.0,14444.0,-68.0,-64.0,-72.0,-70.0,-68.0,-64.0,-72.0,-69.0,-77.0,-85.0,-77.0,-84.0,9.0,21.0,5.0,14.0,1
4972,F8:59:71:5A:E0:3D,3378105,645107286,161254,238789879,3216851,406317407,0,159463,197109981,154640,196533689,4823,576292,136998,16,163968,2882,0,539,144444.0,43333.0,-67.0,-73.0,-64.0,-71.0,-66.0,-73.0,-64.0,-70.0,-77.0,-85.0,-77.0,-84.0,10.0,12.0,13.0,13.0,1
4973,CC:2F:71:3E:C5:1F,3228268,407713942,11417,1396535,3216851,406317407,6,48725,4080573,40263,3077903,8462,1002670,12037,34,16381,186,6,827,130000.0,39000.0,-68.0,-70.0,-68.0,-60.0,-68.0,-69.0,-67.0,-60.0,-77.0,-85.0,-77.0,-84.0,9.0,15.0,9.0,24.0,1
4974,CC:2F:71:3F:1F:24,9239170,9605456876,6022317,9199139267,3216853,406317609,80,1396561,842443529,1388009,841416553,8552,1026976,1343193,619,6027032,608042,80,5938,86667.0,14444.0,-69.0,-64.0,-72.0,-70.0,-69.0,-64.0,-72.0,-70.0,-77.0,-85.0,-77.0,-84.0,8.0,21.0,5.0,14.0,1
4975,F8:59:71:5A:E0:3D,3378175,645210254,161320,238892443,3216855,406317811,0,159528,197210081,154705,196633789,4823,576292,137063,16,164034,2883,0,539,144444.0,43333.0,-67.0,-73.0,-65.0,-71.0,-66.0,-72.0,-65.0,-70.0,-77.0,-85.0,-77.0,-84.0,10.0,12.0,12.0,13.0,1
4976,CC:2F:71:3E:C5:1F,3228272,407714346,11417,1396535,3216855,406317811,6,48725,4080573,40263,3077903,8462,1002670,12037,34,16381,186,6,827,130000.0,39000.0,-68.0,-70.0,-68.0,-60.0,-68.0,-69.0,-67.0,-60.0,-77.0,-85.0,-77.0,-84.0,9.0,15.0,9.0,24.0,1
4977,CC:2F:71:3F:1F:24,9240726,9607866442,6023871,9201548631,3216855,406317811,80,1396907,842579435,1388355,841552459,8552,1026976,1343539,619,6028590,608162,80,5941,86667.0,14444.0,-69.0,-64.0,-72.0,-69.0,-69.0,-64.0,-71.0,-69.0,-77.0,-85.0,-77.0,-84.0,8.0,21.0,5.0,15.0,1
4978,F8:59:71:5A:E0:3D,3378245,645310236,161384,238991899,3216861,406318337,0,159593,197310237,154770,196733945,4823,576292,137128,16,164098,2883,0,539,144444.0,43333.0,-67.0,-73.0,-64.0,-71.0,-66.0,-73.0,-65.0,-70.0,-77.0,-85.0,-77.0,-84.0,10.0,12.0,13.0,13.0,1
4979,CC:2F:71:3E:C5:1F,3228278,407714872,11417,1396535,3216861,406318337,6,48725,4080573,40263,3077903,8462,1002670,12037,34,16381,186,6,827,130000.0,39000.0,-68.0,-70.0,-68.0,-60.0,-68.0,-69.0,-67.0,-60.0,-77.0,-85.0,-77.0,-84.0,9.0,15.0,9.0,24.0,1
4980,CC:2F:71:3F:1F:24,9241579,9609161206,6024718,9202842869,3216861,406318337,80,1397162,842700091,1388609,841672997,8553,1027094,1343794,619,6029437,608210,80,5941,86667.0,14444.0,-69.0,-64.0,-72.0,-70.0,-68.0,-64.0,-71.0,-69.0,-77.0,-85.0,-77.0,-84.0,8.0,21.0,5.0,14.0,1
4981,F8:59:71:5A:E0:3D,3378312,645408542,161447,239089801,3216865,406318741,0,159656,197407271,154833,196830979,4823,576292,137190,16,164160,2883,0,539,144444.0,43333.0,-67.0,-73.0,-65.0,-71.0,-66.0,-72.0,-64.0,-70.0,-77.0,-85.0,-77.0,-84.0,10.0,12.0,12.0,13.0,1
4982,CC:2F:71:3E:C5:1F,3228282,407715276,11417,1396535,3216865,406318741,6,48725,4080573,40263,3077903,8462,1002670,12037,34,16381,186,6,827,130000.0,39000.0,-68.0,-70.0,-68.0,-60.0,-68.0,-69.0,-67.0,-60.0,-77.0,-85.0,-77.0,-84.0,9.0,15.0,9.0,24.0,1
4983,CC:2F:71:3F:1F:24,9242687,9610853463,6025822,9204534722,3216865,406318741,80,1397459,842826084,1388906,841798990,8553,1027094,1344091,619,6030541,608292,80,5942,86667.0,14444.0,-69.0,-64.0,-71.0,-69.0,-68.0,-64.0,-71.0,-69.0,-77.0,-85.0,-77.0,-84.0,8.0,21.0,6.0,15.0,1
4984,F8:59:71:5A:E0:3D,3378378,645508200,161511,239189257,3216867,406318943,0,159721,197507371,154898,196931079,4823,576292,137255,16,164225,2883,0,539,144444.0,43333.0,-67.0,-73.0,-65.0,-71.0,-66.0,-73.0,-65.0,-70.0,-77.0,-85.0,-77.0,-84.0,10.0,12.0,12.0,13.0,1
4985,CC:2F:71:3E:C5:1F,3228284,407715478,11417,1396535,3216867,406318943,6,48725,4080573,40263,3077903,8462,1002670,12037,34,16381,186,6,827,130000.0,39000.0,-68.0,-70.0,-68.0,-60.0,-68.0,-69.0,-67.0,-60.0,-77.0,-85.0,-77.0,-84.0,9.0,15.0,9.0,24.0,1
4986,CC:2F:71:3F:1F:24,9243924,9612760085,6027055,9206440940,3216869,406319145,80,1397744,842953028,1389191,841925934,8553,1027094,1344376,619,6031774,608298,80,5942,86667.0,14444.0,-68.0,-64.0,-68.0,-70.0,-68.0,-64.0,-70.0,-70.0,-77.0,-85.0,-77.0,-84.0,9.0,21.0,9.0,14.0,1
4987,F8:59:71:5A:E0:3D,3378452,645610082,161576,239290267,3216876,406319815,0,159786,197607471,154963,197031179,4823,576292,137320,16,164290,2884,0,539,144444.0,43333.0,-67.0,-73.0,-65.0,-70.0,-66.0,-73.0,-65.0,-70.0,-77.0,-85.0,-77.0,-84.0,10.0,12.0,12.0,14.0,1
4988,CC:2F:71:3E:C5:1F,3228293,407716350,11417,1396535,3216876,406319815,6,48725,4080573,40263,3077903,8462,1002670,12037,34,16381,186,6,827,130000.0,39000.0,-68.0,-70.0,-68.0,-60.0,-68.0,-69.0,-67.0,-60.0,-77.0,-85.0,-77.0,-84.0,9.0,15.0,9.0,24.0,1
4989,CC:2F:71:3F:1F:24,9244936,9614304021,6028060,9207984206,3216876,406319815,80,1397983,843074636,1389430,842047542,8553,1027094,1344615,619,6032779,608454,80,5942,86667.0,14444.0,-68.0,-64.0,-71.0,-69.0,-68.0,-64.0,-70.0,-69.0,-77.0,-85.0,-77.0,-84.0,9.0,21.0,6.0,15.0,1
4990,F8:59:71:5A:E0:3D,3378520,645711360,161641,239391277,3216879,406320083,0,159851,197707571,155028,197131279,4823,576292,137385,16,164355,2886,0,539,144444.0,43333.0,-67.0,-73.0,-65.0,-70.0,-66.0,-73.0,-64.0,-70.0,-77.0,-85.0,-77.0,-84.0,10.0,12.0,12.0,14.0,1
4991,CC:2F:71:3E:C5:1F,3228296,407716618,11417,1396535,3216879,406320083,6,48727,4080761,40264,3077973,8463,1002788,12038,34,16381,186,6,827,130000.0,39000.0,-68.0,-70.0,-67.0,-60.0,-67.0,-69.0,-67.0,-60.0,-77.0,-85.0,-77.0,-84.0,9.0,15.0,10.0,24.0,1
4992,CC:2F:71:3F:1F:24,9246141,9616155683,6029260,9209835398,3216881,406320285,80,1398268,843201528,1389715,842174434,8553,1027094,1344900,619,6033979,608460,80,5943,86667.0,14444.0,-69.0,-64.0,-71.0,-69.0,-68.0,-64.0,-70.0,-68.0,-77.0,-85.0,-77.0,-84.0,8.0,21.0,6.0,15.0,1
4993,F8:59:71:5A:E0:3D,3378594,645813451,161706,239492287,3216888,406321164,0,159915,197806131,155092,197229839,4823,576292,137449,16,164420,2886,0,539,144444.0,43333.0,-67.0,-73.0,-65.0,-70.0,-66.0,-73.0,-64.0,-70.0,-77.0,-85.0,-77.0,-84.0,10.0,12.0,12.0,14.0,1
4994,CC:2F:71:3E:C5:1F,3228305,407717699,11417,1396535,3216888,406321164,6,48727,4080761,40264,3077973,8463,1002788,12038,34,16381,186,6,827,130000.0,39000.0,-68.0,-70.0,-67.0,-60.0,-67.0,-69.0,-67.0,-60.0,-77.0,-85.0,-77.0,-84.0,9.0,15.0,10.0,24.0,1
4995,CC:2F:71:3F:1F:24,9247073,9617566201,6030185,9211245037,3216888,406321164,80,1398521,843322387,1389968,842295293,8553,1027094,1345153,619,6034903,608540,80,5943,86667.0,14444.0,-69.0,-64.0,-71.0,-68.0,-68.0,-64.0,-71.0,-68.0,-77.0,-85.0,-77.0,-84.0,8.0,21.0,6.0,16.0,1
4996,F8:59:71:5A:E0:3D,3378657,645909859,161768,239588635,3216889,406321224,0,159978,197903151,155155,197326859,4823,576292,137512,16,164482,2887,0,539,144444.0,43333.0,-67.0,-73.0,-65.0,-71.0,-66.0,-73.0,-65.0,-70.0,-77.0,-85.0,-77.0,-84.0,10.0,12.0,12.0,13.0,1
4997,CC:2F:71:3E:C5:1F,3228306,407717759,11417,1396535,3216889,406321224,6,48727,4080761,40264,3077973,8463,1002788,12038,34,16381,186,6,827,130000.0,39000.0,-68.0,-70.0,-67.0,-60.0,-67.0,-69.0,-67.0,-60.0,-77.0,-85.0,-77.0,-84.0,9.0,15.0,10.0,24.0,1
4998,CC:2F:71:3F:1F:24,9248239,9619363639,6031350,9213042415,3216889,406321224,80,1398814,843447315,1390261,842420221,8553,1027094,1345446,619,6036069,608557,80,5943,86667.0,14444.0,-68.0,-64.0,-71.0,-69.0,-68.0,-64.0,-70.0,-69.0,-77.0,-85.0,-77.0,-84.0,9.0,21.0,6.0,15.0,1
4999,F8:59:71:5A:E0:3D,3378730,646011677,161833,239689645,3216897,406322032,0,160043,198003251,155220,197426959,4823,576292,137577,16,164547,2887,0,539,144444.0,43333.0,-67.0,-73.0,-65.0,-70.0,-66.0,-72.0,-65.0,-70.0,-77.0,-85.0,-77.0,-84.0,10.0,12.0,12.0,14.0,1
5000,CC:2F:71:3E:C5:1F,3228314,407718567,11417,1396535,3216897,406322032,6,48727,4080761,40264,3077973,8463,1002788,12038,34,16381,186,6,827,130000.0,39000.0,-68.0,-70.0,-67.0,-60.0,-67.0,-69.0,-67.0,-60.0,-77.0,-85.0,-77.0,-84.0,9.0,15.0,10.0,24.0,1
5001,CC:2F:71:3F:1F:24,9249483,9621272511,6032586,9214950479,3216897,406322032,80,1399101,843574355,1390548,842547261,8553,1027094,1345729,619,6037305,608577,80,5943,86667.0,14444.0,-69.0,-64.0,-71.0,-69.0,-68.0,-64.0,-71.0,-69.0,-77.0,-85.0,-77.0,-84.0,8.0,21.0,6.0,15.0,1
5002,F8:59:71:5A:E0:3D,3378793,646109579,161896,239787547,3216897,406322032,0,160106,198100271,155283,197523979,4823,576292,137640,16,164610,2888,0,539,144444.0,43333.0,-66.0,-72.0,-65.0,-70.0,-66.0,-72.0,-64.0,-70.0,-77.0,-85.0,-77.0,-84.0,11.0,13.0,12.0,14.0,1
5003,CC:2F:71:3E:C5:1F,3228314,407718567,11417,1396535,3216897,406322032,6,48727,4080761,40264,3077973,8463,1002788,12038,34,16381,186,6,827,130000.0,39000.0,-68.0,-70.0,-67.0,-60.0,-67.0,-69.0,-67.0,-60.0,-77.0,-85.0,-77.0,-84.0,9.0,15.0,10.0,24.0,1
5004,CC:2F:71:3F:1F:24,9250522,9622869233,6033624,9216547139,3216898,406322094,80,1399381,843698083,1390828,842670989,8553,1027094,1346008,619,6038331,608637,80,5946,86667.0,14444.0,-69.0,-64.0,-71.0,-69.0,-68.0,-63.0,-70.0,-68.0,-77.0,-85.0,-77.0,-84.0,8.0,21.0,6.0,15.0,1
5005,F8:59:71:5A:E0:3D,3378865,646209763,161960,239887003,3216905,406322760,0,160170,198197437,155346,197621027,4824,576410,137704,16,164674,2888,0,540,144444.0,43333.0,-67.0,-73.0,-65.0,-70.0,-66.0,-72.0,-64.0,-70.0,-77.0,-85.0,-77.0,-84.0,10.0,12.0,12.0,14.0,1
5006,CC:2F:71:3E:C5:1F,3228324,407719497,11417,1396535,3216907,406322962,6,48727,4080761,40264,3077973,8463,1002788,12038,34,16381,186,6,827,130000.0,39000.0,-68.0,-70.0,-67.0,-60.0,-67.0,-69.0,-67.0,-60.0,-77.0,-85.0,-77.0,-84.0,9.0,15.0,10.0,24.0,1
5007,CC:2F:71:3F:1F:24,9251329,9624082430,6034422,9217759468,3216907,406322962,80,1399593,843814067,1391040,842786973,8553,1027094,1346220,619,6039141,608668,80,5946,86667.0,14444.0,-68.0,-64.0,-70.0,-68.0,-68.0,-64.0,-70.0,-68.0,-77.0,-85.0,-77.0,-84.0,9.0,21.0,7.0,16.0,1
5008,F8:59:71:5A:E0:3D,3378931,646309421,162024,239986459,3216907,406322962,0,160234,198295997,155410,197719587,4824,576410,137768,16,164738,2888,0,540,144444.0,43333.0,-67.0,-73.0,-65.0,-70.0,-66.0,-72.0,-65.0,-70.0,-77.0,-85.0,-77.0,-84.0,10.0,12.0,12.0,14.0,1
5009,CC:2F:71:3E:C5:1F,3228324,407719497,11417,1396535,3216907,406322962,6,48727,4080761,40264,3077973,8463,1002788,12038,34,16381,186,6,827,130000.0,39000.0,-68.0,-70.0,-67.0,-60.0,-67.0,-69.0,-67.0,-60.0,-77.0,-85.0,-77.0,-84.0,9.0,15.0,10.0,24.0,1
5010,CC:2F:71:3F:1F:24,9252578,9626012336,6035671,9219689374,3216907,406322962,80,1399892,843942779,1391339,842915685,8553,1027094,1346519,619,6040374,608672,80,5946,86667.0,14444.0,-69.0,-64.0,-71.0,-69.0,-68.0,-64.0,-70.0,-69.0,-77.0,-85.0,-77.0,-84.0,8.0,21.0,6.0,15.0,1
5011,F8:59:71:5A:E0:3D,3379001,646409481,162088,240085747,3216913,406323734,0,160298,198394557,155474,197818147,4824,576410,137832,16,164802,2889,0,540,144444.0,43333.0,-66.0,-73.0,-65.0,-70.0,-66.0,-73.0,-65.0,-70.0,-77.0,-85.0,-77.0,-84.0,11.0,12.0,12.0,14.0,1
5012,CC:2F:71:3E:C5:1F,3228332,407720471,11417,1396535,3216915,406323936,6,48727,4080761,40264,3077973,8463,1002788,12038,34,16381,186,6,827,130000.0,39000.0,-68.0,-70.0,-67.0,-60.0,-67.0,-69.0,-67.0,-60.0,-77.0,-85.0,-77.0,-84.0,9.0,15.0,10.0,24.0,1
5013,CC:2F:71:3F:1F:24,9253392,9627241208,6036475,9220917070,3216917,406324138,80,1400098,844059081,1391545,843031987,8553,1027094,1346725,619,6041170,608728,80,5946,86667.0,14444.0,-68.0,-64.0,-71.0,-69.0,-68.0,-64.0,-71.0,-69.0,-77.0,-85.0,-77.0,-84.0,9.0,21.0,6.0,15.0,1
5014,F8:59:71:5A:E0:3D,3379070,646509289,162152,240185091,3216918,406324198,0,160363,198494671,155539,197918261,4824,576410,137896,16,164865,2890,0,540,144444.0,43333.0,-66.0,-73.0,-65.0,-70.0,-66.0,-72.0,-65.0,-70.0,-77.0,-85.0,-77.0,-84.0,11.0,12.0,12.0,14.0,1
5015,CC:2F:71:3E:C5:1F,3228335,407720733,11417,1396535,3216918,406324198,6,48727,4080761,40264,3077973,8463,1002788,12038,34,16381,186,6,827,130000.0,39000.0,-68.0,-70.0,-67.0,-60.0,-67.0,-69.0,-67.0,-60.0,-77.0,-85.0,-77.0,-84.0,9.0,15.0,10.0,24.0,1
5016,CC:2F:71:3F:1F:24,9254605,9629111452,6037687,9222787254,3216918,406324198,80,1400384,844184961,1391831,843157867,8553,1027094,1347011,619,6042406,608734,80,5947,86667.0,14444.0,-68.0,-64.0,-71.0,-69.0,-68.0,-64.0,-70.0,-68.0,-77.0,-85.0,-77.0,-84.0,9.0,21.0,6.0,15.0,1
5017,F8:59:71:5A:E0:3D,3379138,646609149,162216,240284547,3216922,406324602,0,160428,198594771,155604,198018361,4824,576410,137961,16,164930,2890,0,540,144444.0,43333.0,-67.0,-71.0,-65.0,-70.0,-67.0,-72.0,-65.0,-70.0,-77.0,-85.0,-77.0,-84.0,10.0,14.0,12.0,14.0,1
5018,CC:2F:71:3E:C5:1F,3228339,407721137,11417,1396535,3216922,406324602,6,48727,4080761,40264,3077973,8463,1002788,12038,34,16381,186,6,827,130000.0,39000.0,-68.0,-70.0,-67.0,-60.0,-67.0,-69.0,-67.0,-60.0,-77.0,-85.0,-77.0,-84.0,9.0,15.0,10.0,24.0,1
5019,CC:2F:71:3F:1F:24,9255974,9631221832,6039050,9224897028,3216924,406324804,80,1400693,844314841,1392140,843287747,8553,1027094,1347320,619,6043753,608742,80,5947,86667.0,14444.0,-68.0,-64.0,-71.0,-69.0,-68.0,-64.0,-71.0,-69.0,-77.0,-85.0,-77.0,-84.0,9.0,21.0,6.0,15.0,1
5020,F8:59:71:5A:E0:3D,3379208,646710623,162281,240385557,3216927,406325066,0,160493,198694871,155669,198118461,4824,576410,138026,16,164995,2890,0,540,144444.0,43333.0,-67.0,-73.0,-64.0,-70.0,-66.0,-73.0,-65.0,-70.0,-77.0,-85.0,-77.0,-84.0,10.0,12.0,13.0,14.0,1
5021,CC:2F:71:3E:C5:1F,3228344,407721601,11417,1396535,3216927,406325066,6,48727,4080761,40264,3077973,8463,1002788,12038,34,16381,186,6,827,130000.0,39000.0,-68.0,-70.0,-67.0,-60.0,-67.0,-69.0,-67.0,-60.0,-77.0,-85.0,-77.0,-84.0,9.0,15.0,10.0,24.0,1
5022,CC:2F:71:3F:1F:24,9257495,9633568583,6040568,9227243517,3216927,406325066,80,1401010,844445910,1392457,843418816,8553,1027094,1347634,619,6045256,608833,80,5947,86667.0,14444.0,-69.0,-64.0,-72.0,-69.0,-68.0,-64.0,-71.0,-68.0,-77.0,-85.0,-77.0,-84.0,8.0,21.0,5.0,15.0,1
5023,F8:59:71:5A:E0:3D,3379275,646811835,162346,240486567,3216929,406325268,0,160557,198793431,155733,198217021,4824,576410,138090,16,165060,2891,0,540,144444.0,43333.0,-67.0,-73.0,-65.0,-70.0,-66.0,-73.0,-65.0,-70.0,-77.0,-85.0,-77.0,-84.0,10.0,12.0,12.0,14.0,1
5024,CC:2F:71:3E:C5:1F,3228348,407722005,11417,1396535,3216931,406325470,6,48727,4080761,40264,3077973,8463,1002788,12038,34,16381,186,6,827,130000.0,39000.0,-68.0,-70.0,-67.0,-60.0,-67.0,-69.0,-67.0,-60.0,-77.0,-85.0,-77.0,-84.0,9.0,15.0,10.0,24.0,1
5025,CC:2F:71:3F:1F:24,9258658,9635355537,6041727,9229030067,3216931,406325470,80,1401298,844574622,1392745,843547528,8553,1027094,1347921,619,6046446,608863,80,5948,86667.0,14444.0,-68.0,-64.0,-71.0,-69.0,-68.0,-64.0,-70.0,-69.0,-77.0,-85.0,-77.0,-84.0,9.0,21.0,6.0,15.0,1
5026,F8:59:71:5A:E0:3D,3379344,646910343,162409,240584469,3216935,406325874,0,160620,198890451,155796,198314041,4824,576410,138153,16,165123,2892,0,540,144444.0,43333.0,-67.0,-73.0,-65.0,-70.0,-66.0,-72.0,-64.0,-70.0,-77.0,-85.0,-77.0,-84.0,10.0,12.0,12.0,14.0,1
5027,CC:2F:71:3E:C5:1F,3228352,407722409,11417,1396535,3216935,406325874,6,48727,4080761,40264,3077973,8463,1002788,12038,34,16381,186,6,827,130000.0,39000.0,-68.0,-70.0,-67.0,-60.0,-67.0,-69.0,-67.0,-60.0,-77.0,-85.0,-77.0,-84.0,9.0,15.0,10.0,24.0,1
5028,CC:2F:71:3F:1F:24,9259568,9636744753,6042633,9230418879,3216935,406325874,80,1401543,844692582,1392990,843665488,8553,1027094,1348166,619,6047352,608877,80,5948,86667.0,14444.0,-69.0,-64.0,-72.0,-69.0,-68.0,-64.0,-72.0,-69.0,-77.0,-85.0,-77.0,-84.0,8.0,21.0,5.0,15.0,1
5029,F8:59:71:5A:E0:3D,3379408,647008305,162472,240682371,3216936,406325934,0,160684,198989011,155860,198412601,4824,576410,138217,16,165186,2893,0,540,144444.0,43333.0,-67.0,-72.0,-66.0,-71.0,-67.0,-72.0,-65.0,-70.0,-77.0,-85.0,-77.0,-84.0,10.0,13.0,11.0,13.0,1
5030,CC:2F:71:3E:C5:1F,3228353,407722469,11417,1396535,3216936,406325934,6,48727,4080761,40264,3077973,8463,1002788,12038,34,16381,186,6,827,130000.0,39000.0,-68.0,-70.0,-67.0,-60.0,-67.0,-69.0,-67.0,-60.0,-77.0,-85.0,-77.0,-84.0,9.0,15.0,10.0,24.0,1
5031,CC:2F:71:3F:1F:24,9260648,9638402337,6043710,9232076201,3216938,406326136,80,1401799,844813166,1393246,843786072,8553,1027094,1348422,619,6048414,609218,80,5948,115556.0,28889.0,-69.0,-64.0,-72.0,-70.0,-68.0,-64.0,-71.0,-70.0,-77.0,-85.0,-77.0,-84.0,8.0,21.0,5.0,14.0,1
5032,F8:59:71:5A:E0:3D,3379481,647110123,162537,240783381,3216944,406326742,0,160748,199087571,155924,198511161,4824,576410,138281,16,165251,2896,0,540,144444.0,43333.0,-67.0,-72.0,-65.0,-70.0,-66.0,-71.0,-65.0,-70.0,-77.0,-85.0,-77.0,-84.0,10.0,13.0,12.0,14.0,1
5033,CC:2F:71:3E:C5:1F,3228361,407723277,11417,1396535,3216944,406326742,6,48727,4080761,40264,3077973,8463,1002788,12038,34,16381,186,6,827,130000.0,39000.0,-68.0,-70.0,-67.0,-60.0,-67.0,-69.0,-67.0,-60.0,-77.0,-85.0,-77.0,-84.0,9.0,15.0,10.0,24.0,1
5034,CC:2F:71:3F:1F:24,9261745,9640074338,6044801,9233747596,3216944,406326742,80,1402069,844938717,1393516,843911623,8553,1027094,1348692,619,6049520,609344,80,5948,86667.0,14444.0,-69.0,-64.0,-70.0,-69.0,-68.0,-64.0,-70.0,-69.0,-77.0,-85.0,-77.0,-84.0,8.0,21.0,7.0,15.0,1
5035,F8:59:71:5A:E0:3D,3379546,647209705,162601,240882837,3216945,406326868,0,160813,199187671,155989,198611261,4824,576410,138346,16,165315,2896,0,540,144444.0,43333.0,-67.0,-72.0,-65.0,-71.0,-66.0,-72.0,-65.0,-70.0,-77.0,-85.0,-77.0,-84.0,10.0,13.0,12.0,13.0,1
5036,CC:2F:71:3E:C5:1F,3228362,407723403,11417,1396535,3216945,406326868,6,48727,4080761,40264,3077973,8463,1002788,12038,34,16381,186,6,827,130000.0,39000.0,-68.0,-70.0,-67.0,-60.0,-67.0,-69.0,-67.0,-60.0,-77.0,-85.0,-77.0,-84.0,9.0,15.0,10.0,24.0,1
5037,CC:2F:71:3F:1F:24,9262869,9641804101,6045923,9235476960,3216946,406327141,80,1402308,845058793,1393755,844031699,8553,1027094,1348931,619,6050642,609729,80,5948,86667.0,13000.0,-69.0,-63.0,-72.0,-68.0,-69.0,-63.0,-72.0,-68.0,-77.0,-85.0,-77.0,-84.0,8.0,22.0,5.0,16.0,1
5038,F8:59:71:5A:E0:3D,3379620,647310302,162665,240982293,3216955,406328009,0,160876,199284691,156052,198708281,4824,576410,138409,16,165379,2897,0,540,144444.0,43333.0,-67.0,-73.0,-66.0,-71.0,-67.0,-72.0,-65.0,-70.0,-77.0,-85.0,-77.0,-84.0,10.0,12.0,11.0,13.0,1
5039,CC:2F:71:3E:C5:1F,3228372,407724544,11417,1396535,3216955,406328009,6,48727,4080761,40264,3077973,8463,1002788,12038,34,16381,186,6,827,130000.0,39000.0,-68.0,-70.0,-67.0,-60.0,-67.0,-69.0,-67.0,-60.0,-77.0,-85.0,-77.0,-84.0,9.0,15.0,10.0,24.0,1
5040,CC:2F:71:3F:1F:24,9264065,9643637095,6047110,9237309086,3216955,406328009,80,1402589,845185177,1394036,844158083,8553,1027094,1349212,619,6051829,609732,80,5948,86667.0,14444.0,-69.0,-64.0,-71.0,-69.0,-68.0,-63.0,-70.0,-68.0,-77.0,-85.0,-77.0,-84.0,8.0,21.0,6.0,15.0,1
5041,F8:59:71:5A:E0:3D,3379686,647412866,162731,241084857,3216955,406328009,0,160942,199386387,156118,198809977,4824,576410,138475,16,165445,2898,0,541,144444.0,43333.0,-68.0,-73.0,-65.0,-71.0,-67.0,-72.0,-65.0,-70.0,-77.0,-85.0,-77.0,-84.0,9.0,12.0,12.0,13.0,1
5042,CC:2F:71:3E:C5:1F,3228372,407724544,11417,1396535,3216955,406328009,6,48727,4080761,40264,3077973,8463,1002788,12038,34,16381,186,6,827,130000.0,39000.0,-68.0,-70.0,-67.0,-60.0,-67.0,-69.0,-67.0,-60.0,-77.0,-85.0,-77.0,-84.0,9.0,15.0,10.0,24.0,1
5043,CC:2F:71:3F:1F:24,9264985,9645046327,6048030,9238718318,3216955,406328009,80,1402838,845307821,1394285,844280727,8553,1027094,1349461,619,6052749,609987,80,5948,78000.0,13000.0,-69.0,-63.0,-71.0,-69.0,-69.0,-63.0,-71.0,-69.0,-77.0,-85.0,-77.0,-84.0,8.0,22.0,6.0,15.0,1
5044,F8:59:71:5A:E0:3D,3379757,647511576,162794,241182759,3216963,406328817,0,161005,199483435,156181,198907025,4824,576410,138538,16,165508,2898,0,541,144444.0,43333.0,-67.0,-71.0,-65.0,-70.0,-66.0,-72.0,-65.0,-70.0,-77.0,-85.0,-77.0,-84.0,10.0,14.0,12.0,14.0,1
5045,CC:2F:71:3E:C5:1F,3228380,407725352,11417,1396535,3216963,406328817,6,48727,4080761,40264,3077973,8463,1002788,12038,34,16381,186,6,827,130000.0,39000.0,-68.0,-70.0,-67.0,-60.0,-67.0,-69.0,-67.0,-60.0,-77.0,-85.0,-77.0,-84.0,9.0,15.0,10.0,24.0,1
5046,CC:2F:71:3F:1F:24,9265899,9646428294,6048936,9240099477,3216963,406328817,80,1403083,845427750,1394530,844400656,8553,1027094,1349704,619,6053649,610005,80,5949,86667.0,14444.0,-70.0,-64.0,-71.0,-69.0,-69.0,-63.0,-71.0,-69.0,-77.0,-85.0,-77.0,-84.0,7.0,21.0,6.0,15.0,1
5047,F8:59:71:5A:E0:3D,3379822,647611092,162858,241282215,3216964,406328877,0,161070,199583549,156246,199007139,4824,576410,138602,16,165572,2899,0,541,144444.0,43333.0,-67.0,-73.0,-66.0,-71.0,-67.0,-72.0,-65.0,-70.0,-77.0,-85.0,-77.0,-84.0,10.0,12.0,11.0,13.0,1
5048,CC:2F:71:3E:C5:1F,3228381,407725412,11417,1396535,3216964,406328877,6,48727,4080761,40264,3077973,8463,1002788,12038,34,16381,186,6,827,130000.0,39000.0,-68.0,-70.0,-67.0,-60.0,-67.0,-69.0,-67.0,-60.0,-77.0,-85.0,-77.0,-84.0,9.0,15.0,10.0,24.0,1
5049,CC:2F:71:3F:1F:24,9267024,9648161122,6050060,9241832245,3216964,406328877,80,1403345,845550488,1394792,844523394,8553,1027094,1349966,619,6054779,610027,80,5949,86667.0,14444.0,-69.0,-63.0,-72.0,-69.0,-69.0,-63.0,-71.0,-68.0,-77.0,-85.0,-77.0,-84.0,8.0,22.0,5.0,15.0,1
5050,F8:59:71:5A:E0:3D,3379894,647709862,162921,241380117,3216973,406329745,0,161133,199680569,156309,199104159,4824,576410,138665,16,165635,2901,0,541,144444.0,43333.0,-66.0,-72.0,-66.0,-71.0,-66.0,-72.0,-65.0,-70.0,-77.0,-85.0,-77.0,-84.0,11.0,13.0,11.0,13.0,1
5051,CC:2F:71:3E:C5:1F,3228390,407726280,11417,1396535,3216973,406329745,6,48727,4080761,40264,3077973,8463,1002788,12038,34,16381,186,6,827,130000.0,39000.0,-68.0,-70.0,-67.0,-60.0,-67.0,-69.0,-67.0,-60.0,-77.0,-85.0,-77.0,-84.0,9.0,15.0,10.0,24.0,1
5052,CC:2F:71:3F:1F:24,9268289,9650101270,6051316,9243771525,3216973,406329745,80,1403589,845669810,1395036,844642716,8553,1027094,1350210,619,6056016,610178,80,5950,86667.0,14444.0,-69.0,-64.0,-70.0,-69.0,-68.0,-63.0,-70.0,-69.0,-77.0,-85.0,-77.0,-84.0,8.0,21.0,7.0,15.0,1
5053,F8:59:71:5A:E0:3D,3379961,647809556,162986,241479689,3216975,406329867,0,161198,199780669,156374,199204259,4824,576410,138730,16,165700,2902,0,541,144444.0,43333.0,-67.0,-74.0,-66.0,-70.0,-67.0,-73.0,-66.0,-70.0,-77.0,-85.0,-77.0,-84.0,10.0,11.0,11.0,14.0,1
5054,CC:2F:71:3E:C5:1F,3228393,407726518,11418,1396651,3216975,406329867,6,48729,4080901,40266,3078113,8463,1002788,12038,34,16382,186,6,827,130000.0,39000.0,-68.0,-70.0,-68.0,-60.0,-67.0,-69.0,-67.0,-60.0,-77.0,-85.0,-77.0,-84.0,9.0,15.0,9.0,24.0,1
5055,CC:2F:71:3F:1F:24,9269436,9651865580,6052461,9245535713,3216975,406329867,80,1403867,845793170,1395313,844765958,8554,1027212,1350488,619,6057179,610217,80,5950,86667.0,14444.0,-68.0,-64.0,-70.0,-68.0,-68.0,-64.0,-70.0,-68.0,-77.0,-85.0,-77.0,-84.0,9.0,21.0,7.0,16.0,1
5056,F8:59:71:5A:E0:3D,3380031,647908124,163049,241577591,3216982,406330533,0,161261,199877689,156437,199301279,4824,576410,138793,16,165763,2902,0,541,144444.0,43333.0,-67.0,-73.0,-65.0,-70.0,-66.0,-73.0,-65.0,-70.0,-77.0,-85.0,-77.0,-84.0,10.0,12.0,12.0,14.0,1
5057,CC:2F:71:3E:C5:1F,3228400,407727184,11418,1396651,3216982,406330533,6,48729,4080901,40266,3078113,8463,1002788,12038,34,16382,186,6,827,130000.0,39000.0,-68.0,-70.0,-68.0,-60.0,-67.0,-69.0,-67.0,-60.0,-77.0,-85.0,-77.0,-84.0,9.0,15.0,9.0,24.0,1
5058,CC:2F:71:3F:1F:24,9270439,9653380977,6053454,9247050182,3216985,406330795,80,1404149,845920178,1395595,844892966,8554,1027212,1350768,619,6058173,610267,80,5950,104000.0,26000.0,-69.0,-63.0,-70.0,-68.0,-69.0,-63.0,-70.0,-68.0,-77.0,-85.0,-77.0,-84.0,8.0,22.0,7.0,16.0,1
5059,F8:59:71:5A:E0:3D,3380098,648007842,163113,241677047,3216985,406330795,0,161324,199974709,156500,199398299,4824,576410,138856,16,165827,2905,0,541,144444.0,43333.0,-67.0,-73.0,-66.0,-70.0,-67.0,-73.0,-65.0,-70.0,-77.0,-85.0,-77.0,-84.0,10.0,12.0,11.0,14.0,1
5060,CC:2F:71:3E:C5:1F,3228403,407727446,11418,1396651,3216985,406330795,6,48729,4080901,40266,3078113,8463,1002788,12038,34,16382,186,6,827,130000.0,39000.0,-68.0,-70.0,-68.0,-60.0,-67.0,-69.0,-67.0,-60.0,-77.0,-85.0,-77.0,-84.0,9.0,15.0,9.0,24.0,1
5061,CC:2F:71:3F:1F:24,9271424,9654892699,6054439,9248561904,3216985,406330795,80,1404409,846041266,1395855,845014054,8554,1027212,1351028,619,6059136,610496,80,5950,86667.0,14444.0,-69.0,-63.0,-71.0,-68.0,-68.0,-63.0,-70.0,-68.0,-77.0,-85.0,-77.0,-84.0,8.0,22.0,6.0,16.0,1
5062,F8:59:71:5A:E0:3D,3380163,648105946,163176,241774949,3216987,406330997,0,161388,200073269,156564,199496859,4824,576410,138920,16,165890,2905,0,541,144444.0,43333.0,-67.0,-73.0,-64.0,-70.0,-66.0,-72.0,-65.0,-70.0,-77.0,-85.0,-77.0,-84.0,10.0,12.0,13.0,14.0,1
5063,CC:2F:71:3E:C5:1F,3228408,407727984,11418,1396651,3216990,406331333,6,48729,4080901,40266,3078113,8463,1002788,12038,34,16382,186,6,827,130000.0,39000.0,-68.0,-70.0,-68.0,-60.0,-67.0,-69.0,-67.0,-60.0,-77.0,-85.0,-77.0,-84.0,9.0,15.0,9.0,24.0,1
5064,CC:2F:71:3F:1F:24,9272306,9656231514,6055314,9249900053,3216992,406331461,80,1404658,846168289,1396104,845141077,8554,1027212,1351277,619,6060033,610645,80,5952,65000.0,14444.0,-68.0,-63.0,-69.0,-70.0,-68.0,-63.0,-69.0,-70.0,-77.0,-85.0,-77.0,-84.0,9.0,22.0,8.0,14.0,1
5065,F8:59:71:5A:E0:3D,3380238,648212284,163244,241880621,3216994,406331663,0,161456,200178031,156632,199601621,4824,576410,138988,16,165958,2905,0,541,144444.0,43333.0,-67.0,-73.0,-65.0,-71.0,-67.0,-73.0,-65.0,-70.0,-77.0,-85.0,-77.0,-84.0,10.0,12.0,12.0,13.0,1
5066,CC:2F:71:3E:C5:1F,3228412,407728314,11418,1396651,3216994,406331663,6,48729,4080901,40266,3078113,8463,1002788,12038,34,16382,186,6,827,130000.0,39000.0,-68.0,-70.0,-68.0,-60.0,-67.0,-69.0,-67.0,-60.0,-77.0,-85.0,-77.0,-84.0,9.0,15.0,9.0,24.0,1
5067,CC:2F:71:3F:1F:24,9273373,9657871462,6056379,9251539799,3216994,406331663,80,1404908,846289593,1396354,845262381,8554,1027212,1351527,619,6061081,610650,80,5952,86667.0,14444.0,-69.0,-63.0,-70.0,-69.0,-68.0,-63.0,-70.0,-69.0,-77.0,-85.0,-77.0,-84.0,8.0,22.0,7.0,15.0,1
5068,F8:59:71:5A:E0:3D,3380302,648311740,163308,241980077,3216994,406331663,0,161520,200276591,156696,199700181,4824,576410,139052,16,166022,2906,0,541,144444.0,43333.0,-66.0,-73.0,-65.0,-71.0,-66.0,-72.0,-65.0,-70.0,-77.0,-85.0,-77.0,-84.0,11.0,12.0,12.0,13.0,1
5069,CC:2F:71:3E:C5:1F,3228413,407728382,11418,1396651,3216995,406331731,6,48729,4080901,40266,3078113,8463,1002788,12038,34,16382,186,6,827,130000.0,39000.0,-68.0,-70.0,-68.0,-60.0,-67.0,-69.0,-67.0,-60.0,-77.0,-85.0,-77.0,-84.0,9.0,15.0,9.0,24.0,1
5070,CC:2F:71:3F:1F:24,9274223,9659165974,6057225,9252833907,3216998,406332067,80,1405163,846410311,1396609,845383099,8554,1027212,1351782,619,6061944,610656,80,5952,86667.0,14444.0,-70.0,-64.0,-70.0,-70.0,-70.0,-64.0,-70.0,-69.0,-77.0,-85.0,-77.0,-84.0,7.0,21.0,7.0,14.0,1
5071,F8:59:71:5A:E0:3D,3380374,648410510,163371,242077979,3217003,406332531,0,161583,200373611,156759,199797201,4824,576410,139115,16,166085,2907,0,541,144444.0,43333.0,-67.0,-73.0,-65.0,-70.0,-66.0,-73.0,-65.0,-70.0,-77.0,-85.0,-77.0,-84.0,10.0,12.0,12.0,14.0,1
5072,CC:2F:71:3E:C5:1F,3228421,407729182,11418,1396651,3217003,406332531,6,48729,4080901,40266,3078113,8463,1002788,12038,34,16382,186,6,827,130000.0,39000.0,-68.0,-70.0,-68.0,-60.0,-67.0,-69.0,-67.0,-60.0,-77.0,-85.0,-77.0,-84.0,9.0,15.0,9.0,24.0,1
5073,CC:2F:71:3F:1F:24,9275417,9660982841,6058414,9254650310,3217003,406332531,80,1405417,846533347,1396863,845506135,8554,1027212,1352036,619,6063133,610794,80,5952,115556.0,28889.0,-69.0,-63.0,-71.0,-68.0,-69.0,-63.0,-70.0,-68.0,-77.0,-85.0,-77.0,-84.0,8.0,22.0,6.0,16.0,1
5074,F8:59:71:5A:E0:3D,3380438,648509966,163435,242177435,3217003,406332531,0,161648,200473725,156824,199897315,4824,576410,139179,16,166149,2907,0,541,144444.0,43333.0,-67.0,-73.0,-66.0,-71.0,-66.0,-73.0,-65.0,-71.0,-77.0,-85.0,-77.0,-84.0,10.0,12.0,11.0,13.0,1
5075,CC:2F:71:3E:C5:1F,3228421,407729182,11418,1396651,3217003,406332531,6,48729,4080901,40266,3078113,8463,1002788,12038,34,16382,186,6,827,130000.0,39000.0,-68.0,-70.0,-68.0,-60.0,-67.0,-69.0,-67.0,-60.0,-77.0,-85.0,-77.0,-84.0,9.0,15.0,9.0,24.0,1
5076,CC:2F:71:3F:1F:24,9276693,9662956049,6059690,9256623518,3217003,406332531,80,1405667,846653327,1397113,845626115,8554,1027212,1352286,619,6064409,610888,80,5952,115556.0,28889.0,-69.0,-63.0,-71.0,-68.0,-69.0,-63.0,-70.0,-68.0,-77.0,-85.0,-77.0,-84.0,8.0,22.0,6.0,16.0,1
5077,F8:59:71:5A:E0:3D,3380509,648608676,163498,242275337,3217011,406333339,0,161711,200570745,156887,199994335,4824,576410,139242,16,166212,2908,0,541,144444.0,43333.0,-66.0,-73.0,-65.0,-71.0,-66.0,-73.0,-65.0,-70.0,-77.0,-85.0,-77.0,-84.0,11.0,12.0,12.0,13.0,1
5078,CC:2F:71:3E:C5:1F,3228429,407729990,11418,1396651,3217011,406333339,6,48729,4080901,40266,3078113,8463,1002788,12038,34,16382,186,6,827,130000.0,39000.0,-68.0,-70.0,-68.0,-60.0,-67.0,-69.0,-67.0,-60.0,-77.0,-85.0,-77.0,-84.0,9.0,15.0,9.0,24.0,1
5079,CC:2F:71:3F:1F:24,9277927,9664849941,6060916,9258516602,3217011,406333339,80,1405930,846774787,1397376,845747575,8554,1027212,1352549,619,6065635,610937,80,5952,115556.0,28889.0,-70.0,-63.0,-71.0,-67.0,-69.0,-63.0,-70.0,-67.0,-77.0,-85.0,-77.0,-84.0,7.0,22.0,6.0,17.0,1
5080,F8:59:71:5A:E0:3D,3380574,648706743,163561,242373071,3217013,406333672,0,161774,200667765,156950,200091355,4824,576410,139305,16,166275,2909,0,541,144444.0,43333.0,-66.0,-73.0,-66.0,-71.0,-66.0,-72.0,-65.0,-70.0,-77.0,-85.0,-77.0,-84.0,11.0,12.0,11.0,13.0,1
5081,CC:2F:71:3E:C5:1F,3228431,407730323,11418,1396651,3217013,406333672,6,48729,4080901,40266,3078113,8463,1002788,12038,34,16382,186,6,827,130000.0,39000.0,-68.0,-70.0,-68.0,-60.0,-67.0,-69.0,-67.0,-60.0,-77.0,-85.0,-77.0,-84.0,9.0,15.0,9.0,24.0,1
5082,CC:2F:71:3F:1F:24,9278802,9666185932,6061789,9259852260,3217013,406333672,80,1406190,846895803,1397636,845868591,8554,1027212,1352809,619,6066508,611032,80,5952,130000.0,43333.0,-69.0,-63.0,-71.0,-67.0,-70.0,-63.0,-71.0,-67.0,-77.0,-85.0,-77.0,-84.0,8.0,22.0,6.0,17.0,1
5083,F8:59:71:5A:E0:3D,3380645,648805453,163624,242470973,3217021,406334480,0,161836,200763245,157012,200186835,4824,576410,139367,16,166338,2909,0,541,144444.0,43333.0,-66.0,-73.0,-65.0,-70.0,-66.0,-72.0,-64.0,-70.0,-77.0,-85.0,-77.0,-84.0,11.0,12.0,12.0,14.0,1
5084,CC:2F:71:3E:C5:1F,3228439,407731131,11418,1396651,3217021,406334480,6,48729,4080901,40266,3078113,8463,1002788,12038,34,16382,186,6,827,130000.0,39000.0,-68.0,-70.0,-68.0,-60.0,-67.0,-69.0,-67.0,-60.0,-77.0,-85.0,-77.0,-84.0,9.0,15.0,9.0,24.0,1
5085,CC:2F:71:3F:1F:24,9279890,9667840965,6062869,9261506485,3217021,406334480,80,1406420,847013914,1397866,845986702,8554,1027212,1353039,619,6067588,611080,80,5952,130000.0,43333.0,-70.0,-63.0,-71.0,-67.0,-69.0,-63.0,-71.0,-67.0,-77.0,-85.0,-77.0,-84.0,7.0,22.0,6.0,17.0,1
5086,F8:59:71:5A:E0:3D,3380712,648908079,163690,242573537,3217022,406334542,0,161904,200866543,157079,200290015,4825,576528,139435,16,166404,2910,0,541,144444.0,43333.0,-66.0,-72.0,-66.0,-71.0,-66.0,-72.0,-65.0,-70.0,-77.0,-85.0,-77.0,-84.0,11.0,13.0,11.0,13.0,1
5087,CC:2F:71:3E:C5:1F,3228440,407731193,11418,1396651,3217022,406334542,6,48729,4080901,40266,3078113,8463,1002788,12038,34,16382,186,6,827,130000.0,39000.0,-68.0,-70.0,-68.0,-60.0,-67.0,-69.0,-67.0,-60.0,-77.0,-85.0,-77.0,-84.0,9.0,15.0,9.0,24.0,1
5088,CC:2F:71:3F:1F:24,9280844,9669304021,6063822,9262969479,3217022,406334542,80,1406642,847134786,1398088,846107574,8554,1027212,1353261,619,6068531,611418,80,5953,130000.0,43333.0,-70.0,-63.0,-71.0,-68.0,-69.0,-63.0,-70.0,-67.0,-77.0,-85.0,-77.0,-84.0,7.0,22.0,6.0,16.0,1
5089,F8:59:71:5A:E0:3D,3380785,649011309,163756,242676101,3217029,406335208,0,161969,200966671,157144,200390143,4825,576528,139500,16,166470,2912,0,542,144444.0,43333.0,-66.0,-73.0,-66.0,-71.0,-66.0,-72.0,-65.0,-70.0,-77.0,-85.0,-77.0,-84.0,11.0,12.0,11.0,13.0,1
5090,CC:2F:71:3E:C5:1F,3228449,407732061,11418,1396651,3217031,406335410,6,48729,4080901,40266,3078113,8463,1002788,12038,34,16382,186,6,827,130000.0,39000.0,-68.0,-70.0,-68.0,-60.0,-67.0,-69.0,-67.0,-60.0,-77.0,-85.0,-77.0,-84.0,9.0,15.0,9.0,24.0,1
5091,CC:2F:71:3F:1F:24,9281843,9670826917,6064812,9264491507,3217031,406335410,80,1406879,847260518,1398325,846233306,8554,1027212,1353497,619,6069531,611666,80,5953,130000.0,43333.0,-69.0,-63.0,-71.0,-67.0,-69.0,-63.0,-70.0,-67.0,-77.0,-85.0,-77.0,-84.0,8.0,22.0,6.0,17.0,1
5092,F8:59:71:5A:E0:3D,3380851,649109475,163819,242774003,3217032,406335472,0,162032,201063691,157207,200487163,4825,576528,139563,16,166533,2912,0,542,144444.0,43333.0,-66.0,-73.0,-65.0,-71.0,-66.0,-73.0,-64.0,-70.0,-77.0,-85.0,-77.0,-84.0,11.0,12.0,12.0,13.0,1
5093,CC:2F:71:3E:C5:1F,3228450,407732123,11418,1396651,3217032,406335472,6,48731,4081089,40267,3078183,8464,1002906,12039,34,16382,186,6,827,130000.0,39000.0,-68.0,-69.0,-68.0,-60.0,-67.0,-68.0,-67.0,-60.0,-77.0,-85.0,-77.0,-84.0,9.0,16.0,9.0,24.0,1
5094,CC:2F:71:3F:1F:24,9283121,9672801765,6066089,9266466293,3217032,406335472,80,1407102,847375822,1398548,846348610,8554,1027212,1353720,619,6070808,611936,80,5953,130000.0,43333.0,-71.0,-63.0,-71.0,-67.0,-70.0,-63.0,-71.0,-67.0,-77.0,-85.0,-77.0,-84.0,6.0,22.0,6.0,17.0,1
5095,F8:59:71:5A:E0:3D,3380922,649211091,163884,242875013,3217038,406336078,0,162097,201163791,157272,200587263,4825,576528,139628,16,166598,2912,0,542,144444.0,43333.0,-66.0,-73.0,-65.0,-70.0,-66.0,-72.0,-65.0,-70.0,-77.0,-85.0,-77.0,-84.0,11.0,12.0,12.0,14.0,1
5096,CC:2F:71:3E:C5:1F,3228456,407732729,11418,1396651,3217038,406336078,6,48731,4081089,40267,3078183,8464,1002906,12039,34,16382,186,6,827,130000.0,39000.0,-68.0,-69.0,-68.0,-60.0,-67.0,-68.0,-67.0,-60.0,-77.0,-85.0,-77.0,-84.0,9.0,16.0,9.0,24.0,1
5097,CC:2F:71:3F:1F:24,9284753,9675317553,6067713,9268981273,3217040,406336280,80,1407370,847499855,1398816,846472643,8554,1027212,1353988,619,6072419,612024,80,5953,130000.0,43333.0,-70.0,-63.0,-71.0,-67.0,-69.0,-63.0,-71.0,-67.0,-77.0,-85.0,-77.0,-84.0,7.0,22.0,6.0,17.0,1
5098,F8:59:71:5A:E0:3D,3380987,649307701,163946,242971361,3217041,406336340,0,162160,201260811,157335,200684283,4825,576528,139691,16,166660,2912,0,542,144444.0,43333.0,-66.0,-73.0,-65.0,-71.0,-66.0,-72.0,-64.0,-70.0,-77.0,-85.0,-77.0,-84.0,11.0,12.0,12.0,13.0,1
5099,CC:2F:71:3E:C5:1F,3228459,407732991,11418,1396651,3217041,406336340,6,48731,4081089,40267,3078183,8464,1002906,12039,34,16382,186,6,827,130000.0,39000.0,-68.0,-69.0,-68.0,-60.0,-67.0,-68.0,-67.0,-60.0,-77.0,-85.0,-77.0,-84.0,9.0,16.0,9.0,24.0,1
5100,CC:2F:71:3F:1F:24,9285589,9676595171,6068548,9270258831,3217041,406336340,80,1407622,847618677,1399068,846591465,8554,1027212,1354240,619,6073267,612100,80,5953,130000.0,43333.0,-70.0,-63.0,-71.0,-67.0,-70.0,-63.0,-71.0,-67.0,-77.0,-85.0,-77.0,-84.0,7.0,22.0,6.0,17.0,1
5101,F8:59:71:5A:E0:3D,3381052,649405805,164009,243069263,3217043,406336542,0,162223,201357845,157398,200781317,4825,576528,139753,16,166723,2912,0,542,144444.0,43333.0,-67.0,-72.0,-65.0,-71.0,-66.0,-72.0,-65.0,-70.0,-77.0,-85.0,-77.0,-84.0,10.0,13.0,12.0,13.0,1
5102,CC:2F:71:3E:C5:1F,3228461,407733193,11418,1396651,3217043,406336542,6,48731,4081089,40267,3078183,8464,1002906,12039,34,16382,186,6,827,130000.0,39000.0,-68.0,-69.0,-68.0,-60.0,-67.0,-68.0,-67.0,-60.0,-77.0,-85.0,-77.0,-84.0,9.0,16.0,9.0,24.0,1
5103,CC:2F:71:3F:1F:24,9286351,9677749483,6069306,9271412739,3217045,406336744,80,1407845,847735531,1399291,846708319,8554,1027212,1354463,619,6074025,612333,80,5953,115556.0,26000.0,-70.0,-63.0,-71.0,-67.0,-70.0,-63.0,-71.0,-67.0,-77.0,-85.0,-77.0,-84.0,7.0,22.0,6.0,17.0,1
5104,F8:59:71:5A:E0:3D,3381120,649502759,164071,243165611,3217049,406337148,0,162286,201454865,157461,200878337,4825,576528,139816,16,166785,2912,0,542,144444.0,43333.0,-67.0,-73.0,-65.0,-71.0,-66.0,-72.0,-65.0,-70.0,-77.0,-85.0,-77.0,-84.0,10.0,12.0,12.0,13.0,1
5105,CC:2F:71:3E:C5:1F,3228467,407733799,11418,1396651,3217049,406337148,6,48731,4081089,40267,3078183,8464,1002906,12039,34,16382,186,6,827,130000.0,39000.0,-68.0,-69.0,-68.0,-60.0,-67.0,-68.0,-67.0,-60.0,-77.0,-85.0,-77.0,-84.0,9.0,16.0,9.0,24.0,1
5106,CC:2F:71:3F:1F:24,9287193,9679032099,6070144,9272694951,3217049,406337148,80,1408091,847854959,1399537,846827747,8554,1027212,1354709,619,6074863,612340,80,5953,115556.0,28889.0,-69.0,-63.0,-71.0,-68.0,-70.0,-63.0,-70.0,-68.0,-77.0,-85.0,-77.0,-84.0,8.0,22.0,6.0,16.0,1
5107,F8:59:71:5A:E0:3D,3381185,649600837,164135,243263629,3217050,406337208,0,162350,201551991,157525,200975463,4825,576528,139880,16,166849,2912,0,542,144444.0,43333.0,-67.0,-73.0,-65.0,-71.0,-67.0,-72.0,-64.0,-70.0,-77.0,-85.0,-77.0,-84.0,10.0,12.0,12.0,13.0,1
5108,CC:2F:71:3E:C5:1F,3228470,407734061,11418,1396651,3217052,406337410,6,48731,4081089,40267,3078183,8464,1002906,12039,34,16382,186,6,827,130000.0,39000.0,-68.0,-69.0,-68.0,-60.0,-67.0,-68.0,-67.0,-60.0,-77.0,-85.0,-77.0,-84.0,9.0,16.0,9.0,24.0,1
5109,CC:2F:71:3F:1F:24,9288410,9680905047,6071358,9274567637,3217052,406337410,80,1408337,847974533,1399783,846947321,8554,1027212,1354955,619,6076077,612385,80,5953,115556.0,28889.0,-70.0,-63.0,-72.0,-67.0,-70.0,-63.0,-71.0,-67.0,-77.0,-85.0,-77.0,-84.0,7.0,22.0,5.0,17.0,1
5110,F8:59:71:5A:E0:3D,3381257,649701101,164199,243363085,3217058,406338016,0,162413,201649011,157588,201072483,4825,576528,139943,16,166913,2914,0,542,144444.0,43333.0,-67.0,-73.0,-65.0,-71.0,-66.0,-73.0,-65.0,-71.0,-77.0,-85.0,-77.0,-84.0,10.0,12.0,12.0,13.0,1
5111,CC:2F:71:3E:C5:1F,3228476,407734667,11418,1396651,3217058,406338016,6,48731,4081089,40267,3078183,8464,1002906,12039,34,16382,186,6,827,130000.0,39000.0,-68.0,-69.0,-68.0,-60.0,-67.0,-68.0,-67.0,-60.0,-77.0,-85.0,-77.0,-84.0,9.0,16.0,9.0,24.0,1
5112,CC:2F:71:3F:1F:24,9289767,9682984985,6072709,9276646969,3217058,406338016,80,1408576,848096720,1400022,847069508,8554,1027212,1355194,619,6077428,612720,80,5954,130000.0,43333.0,-69.0,-63.0,-71.0,-67.0,-69.0,-63.0,-70.0,-67.0,-77.0,-85.0,-77.0,-84.0,8.0,22.0,6.0,17.0,1
5113,F8:59:71:5A:E0:3D,3381322,649802111,164264,243464095,3217058,406338016,0,162478,201749111,157653,201172583,4825,576528,140008,16,166977,2914,0,542,144444.0,43333.0,-67.0,-72.0,-65.0,-71.0,-67.0,-72.0,-65.0,-70.0,-77.0,-85.0,-77.0,-84.0,10.0,13.0,12.0,13.0,1
5114,CC:2F:71:3E:C5:1F,3228476,407734667,11418,1396651,3217058,406338016,6,48731,4081089,40267,3078183,8464,1002906,12039,34,16382,186,6,827,130000.0,39000.0,-68.0,-69.0,-68.0,-60.0,-67.0,-68.0,-67.0,-60.0,-77.0,-85.0,-77.0,-84.0,9.0,16.0,9.0,24.0,1
5115,CC:2F:71:3F:1F:24,9291305,9685365957,6074244,9279027679,3217061,406338278,80,1408842,848218536,1400288,847191324,8554,1027212,1355458,619,6078962,612827,80,5954,130000.0,43333.0,-70.0,-63.0,-70.0,-68.0,-69.0,-63.0,-70.0,-67.0,-77.0,-85.0,-77.0,-84.0,7.0,22.0,7.0,16.0,1
5116,F8:59:71:5A:E0:3D,3381393,649899327,164326,243560443,3217067,406338884,0,162541,201846131,157716,201269603,4825,576528,140071,16,167040,2914,0,542,144444.0,43333.0,-67.0,-73.0,-65.0,-70.0,-67.0,-72.0,-65.0,-70.0,-77.0,-85.0,-77.0,-84.0,10.0,12.0,12.0,14.0,1
5117,CC:2F:71:3E:C5:1F,3228485,407735535,11418,1396651,3217067,406338884,6,48731,4081089,40267,3078183,8464,1002906,12039,34,16382,186,6,827,130000.0,39000.0,-68.0,-69.0,-68.0,-60.0,-67.0,-68.0,-67.0,-60.0,-77.0,-85.0,-77.0,-84.0,9.0,16.0,9.0,24.0,1
5118,CC:2F:71:3F:1F:24,9292421,9687077855,6075354,9280738971,3217067,406338884,80,1409079,848338404,1400525,847311192,8554,1027212,1355695,619,6080073,612979,80,5954,130000.0,39000.0,-70.0,-64.0,-71.0,-69.0,-69.0,-64.0,-70.0,-68.0,-77.0,-85.0,-77.0,-84.0,7.0,21.0,6.0,15.0,1
5119,F8:59:71:5A:E0:3D,3381457,649998783,164390,243659899,3217067,406338884,0,162605,201944691,157780,201368163,4825,576528,140135,16,167104,2914,0,542,144444.0,43333.0,-68.0,-73.0,-65.0,-70.0,-67.0,-72.0,-65.0,-70.0,-77.0,-85.0,-77.0,-84.0,9.0,12.0,12.0,14.0,1
5120,CC:2F:71:3E:C5:1F,3228485,407735535,11418,1396651,3217067,406338884,6,48731,4081089,40267,3078183,8464,1002906,12039,34,16382,186,6,827,130000.0,39000.0,-68.0,-69.0,-68.0,-60.0,-67.0,-68.0,-67.0,-60.0,-77.0,-85.0,-77.0,-84.0,9.0,16.0,9.0,24.0,1
5121,CC:2F:71:3F:1F:24,9293568,9688846637,6076501,9282507753,3217067,406338884,80,1409327,848459556,1400773,847432344,8554,1027212,1355943,619,6081220,613171,80,5955,86667.0,14444.0,-70.0,-64.0,-71.0,-69.0,-69.0,-64.0,-70.0,-69.0,-77.0,-85.0,-77.0,-84.0,7.0,21.0,6.0,15.0,1
5122,F8:59:71:5A:E0:3D,3381531,650099380,164454,243759355,3217077,406340025,0,162669,202043251,157844,201466723,4825,576528,140199,16,167168,2914,0,542,144444.0,43333.0,-67.0,-73.0,-65.0,-71.0,-67.0,-72.0,-65.0,-70.0,-77.0,-85.0,-77.0,-84.0,10.0,12.0,12.0,13.0,1
5123,CC:2F:71:3E:C5:1F,3228495,407736676,11418,1396651,3217077,406340025,6,48731,4081089,40267,3078183,8464,1002906,12039,34,16382,186,6,827,130000.0,39000.0,-68.0,-69.0,-68.0,-60.0,-67.0,-68.0,-67.0,-60.0,-77.0,-85.0,-77.0,-84.0,9.0,16.0,9.0,24.0,1
5124,CC:2F:71:3F:1F:24,9294808,9690738739,6077731,9284398714,3217077,406340025,80,1409594,848583325,1401040,847556113,8554,1027212,1356206,619,6082450,613200,80,5955,86667.0,14444.0,-68.0,-64.0,-70.0,-69.0,-68.0,-64.0,-70.0,-69.0,-77.0,-85.0,-77.0,-84.0,9.0,21.0,7.0,15.0,1
5125,F8:59:71:5A:E0:3D,3381598,650203498,164521,243863473,3217077,406340025,0,162737,202147985,157912,201571457,4825,576528,140266,16,167235,2915,0,542,144444.0,43333.0,-67.0,-73.0,-65.0,-71.0,-67.0,-73.0,-65.0,-70.0,-77.0,-85.0,-77.0,-84.0,10.0,12.0,12.0,13.0,1
5126,CC:2F:71:3E:C5:1F,3228495,407736676,11418,1396651,3217077,406340025,6,48731,4081089,40267,3078183,8464,1002906,12039,34,16382,186,6,827,130000.0,39000.0,-68.0,-69.0,-68.0,-60.0,-67.0,-68.0,-67.0,-60.0,-77.0,-85.0,-77.0,-84.0,9.0,16.0,9.0,24.0,1
5127,CC:2F:71:3F:1F:24,9296789,9693821749,6079712,9287481724,3217077,406340025,80,1410001,848727317,1401447,847700105,8554,1027212,1356609,619,6084405,613407,80,5955,86667.0,14444.0,-69.0,-64.0,-70.0,-67.0,-68.0,-64.0,-70.0,-67.0,-77.0,-85.0,-77.0,-84.0,8.0,21.0,7.0,17.0,1
5128,F8:59:71:5A:E0:3D,3381670,650303762,164585,243962929,3217085,406340833,0,162801,202246545,157976,201670017,4825,576528,140330,16,167299,2915,0,542,144444.0,43333.0,-67.0,-73.0,-66.0,-70.0,-67.0,-73.0,-65.0,-69.0,-77.0,-85.0,-77.0,-84.0,10.0,12.0,11.0,14.0,1
5129,CC:2F:71:3E:C5:1F,3228503,407737484,11418,1396651,3217085,406340833,6,48731,4081089,40267,3078183,8464,1002906,12039,34,16382,186,6,827,130000.0,39000.0,-68.0,-69.0,-68.0,-60.0,-67.0,-68.0,-67.0,-60.0,-77.0,-85.0,-77.0,-84.0,9.0,16.0,9.0,24.0,1
5130,CC:2F:71:3F:1F:24,9298196,9695989019,6081111,9289648186,3217085,406340833,80,1410307,848855335,1401753,847828123,8554,1027212,1356915,619,6085826,613473,80,5955,86667.0,14444.0,-69.0,-64.0,-72.0,-67.0,-68.0,-64.0,-71.0,-67.0,-77.0,-85.0,-77.0,-84.0,8.0,21.0,5.0,17.0,1
5131,F8:59:71:5A:E0:3D,3381735,650403278,164649,244062385,3217086,406340893,0,162865,202345105,158040,201768577,4825,576528,140394,16,167363,2915,0,542,144444.0,43333.0,-67.0,-73.0,-66.0,-70.0,-67.0,-72.0,-65.0,-69.0,-77.0,-85.0,-77.0,-84.0,10.0,12.0,11.0,14.0,1
5132,CC:2F:71:3E:C5:1F,3228504,407737544,11418,1396651,3217086,406340893,6,48731,4081089,40267,3078183,8464,1002906,12039,34,16382,186,6,827,130000.0,39000.0,-68.0,-69.0,-68.0,-60.0,-67.0,-68.0,-67.0,-60.0,-77.0,-85.0,-77.0,-84.0,9.0,16.0,9.0,24.0,1
5133,CC:2F:71:3F:1F:24,9299219,9697560891,6082133,9291219998,3217086,406340893,80,1410577,848977529,1402023,847950317,8554,1027212,1357185,619,6086852,613485,80,5956,86667.0,14444.0,-69.0,-64.0,-71.0,-67.0,-68.0,-64.0,-70.0,-67.0,-77.0,-85.0,-77.0,-84.0,8.0,21.0,6.0,17.0,1
5134,F8:59:71:5A:E0:3D,3381802,650501584,164712,244160287,3217090,406341297,0,162927,202440585,158102,201864057,4825,576528,140456,16,167426,2915,0,542,144444.0,43333.0,-67.0,-73.0,-65.0,-70.0,-66.0,-73.0,-65.0,-69.0,-77.0,-84.0,-77.0,-84.0,10.0,11.0,12.0,14.0,1
5135,CC:2F:71:3E:C5:1F,3228510,407738150,11418,1396651,3217092,406341499,6,48731,4081089,40267,3078183,8464,1002906,12039,34,16382,186,6,827,130000.0,39000.0,-68.0,-69.0,-68.0,-60.0,-67.0,-68.0,-67.0,-60.0,-77.0,-84.0,-77.0,-84.0,9.0,15.0,9.0,24.0,1
5136,CC:2F:71:3F:1F:24,9300501,9699521454,6083407,9293179753,3217094,406341701,80,1410871,849104534,1402317,848077322,8554,1027212,1357479,619,6088126,613565,80,5956,115556.0,28889.0,-69.0,-64.0,-72.0,-67.0,-69.0,-64.0,-71.0,-67.0,-77.0,-84.0,-77.0,-84.0,8.0,20.0,5.0,17.0,1
5137,F8:59:71:5A:E0:3D,3381876,650606590,164780,244264521,3217096,406342069,0,162995,202545305,158170,201968777,4825,576528,140524,16,167494,2915,0,542,144444.0,43333.0,-67.0,-73.0,-65.0,-71.0,-67.0,-73.0,-65.0,-70.0,-77.0,-84.0,-77.0,-84.0,10.0,11.0,12.0,13.0,1
5138,CC:2F:71:3E:C5:1F,3228515,407738836,11419,1396767,3217096,406342069,6,48733,4081229,40269,3078323,8464,1002906,12039,34,16383,186,6,827,130000.0,39000.0,-69.0,-69.0,-67.0,-60.0,-67.0,-69.0,-67.0,-60.0,-77.0,-84.0,-77.0,-84.0,8.0,15.0,10.0,24.0,1
5139,CC:2F:71:3F:1F:24,9301547,9701126728,6084451,9294784659,3217096,406342069,80,1411146,849231640,1402592,848204428,8554,1027212,1357751,619,6089154,613713,80,5956,115556.0,28889.0,-69.0,-63.0,-70.0,-66.0,-68.0,-63.0,-69.0,-66.0,-77.0,-84.0,-77.0,-84.0,8.0,21.0,7.0,18.0,1
5140,F8:59:71:5A:E0:3D,3381942,650704754,164843,244362423,3217099,406342331,0,163057,202640785,158232,202064257,4825,576528,140586,16,167556,2915,0,542,144444.0,43333.0,-67.0,-72.0,-65.0,-71.0,-67.0,-72.0,-65.0,-70.0,-77.0,-84.0,-77.0,-84.0,10.0,12.0,12.0,13.0,1
5141,CC:2F:71:3E:C5:1F,3228518,407739098,11419,1396767,3217099,406342331,6,48733,4081229,40269,3078323,8464,1002906,12039,34,16383,186,6,827,130000.0,39000.0,-69.0,-69.0,-67.0,-60.0,-67.0,-69.0,-67.0,-60.0,-77.0,-84.0,-77.0,-84.0,8.0,15.0,10.0,24.0,1
5142,CC:2F:71:3F:1F:24,9302530,9702626394,6085427,9296283659,3217103,406342735,80,1411383,849351496,1402829,848324284,8554,1027212,1357988,619,6090146,613838,80,5956,130000.0,39000.0,-70.0,-64.0,-72.0,-69.0,-69.0,-64.0,-71.0,-69.0,-77.0,-84.0,-77.0,-84.0,7.0,20.0,5.0,15.0,1
5143,F8:59:71:5A:E0:3D,3382012,650804816,164907,244461879,3217105,406342937,0,163122,202740885,158297,202164357,4825,576528,140651,16,167621,2917,0,542,144444.0,43333.0,-68.0,-74.0,-66.0,-71.0,-67.0,-73.0,-65.0,-70.0,-77.0,-84.0,-77.0,-84.0,9.0,10.0,11.0,13.0,1
5144,CC:2F:71:3E:C5:1F,3228524,407739704,11419,1396767,3217105,406342937,6,48733,4081229,40269,3078323,8464,1002906,12039,34,16383,186,6,827,130000.0,39000.0,-69.0,-69.0,-67.0,-60.0,-67.0,-69.0,-67.0,-60.0,-77.0,-84.0,-77.0,-84.0,8.0,15.0,10.0,24.0,1
5145,CC:2F:71:3F:1F:24,9303540,9704173324,6086435,9297830387,3217105,406342937,80,1411633,849472752,1403079,848445540,8554,1027212,1358238,619,6091154,614049,80,5956,86667.0,14444.0,-68.0,-63.0,-71.0,-68.0,-68.0,-63.0,-69.0,-68.0,-77.0,-84.0,-77.0,-84.0,9.0,21.0,6.0,16.0,1
5146,F8:59:71:5A:E0:3D,3382078,650904418,164971,244561279,3217107,406343139,0,163186,202839445,158361,202262917,4825,576528,140715,16,167685,2917,0,542,130000.0,39000.0,-67.0,-72.0,-65.0,-70.0,-66.0,-72.0,-64.0,-70.0,-77.0,-84.0,-77.0,-84.0,10.0,12.0,12.0,14.0,1
5147,CC:2F:71:3E:C5:1F,3228526,407739906,11419,1396767,3217107,406343139,6,48733,4081229,40269,3078323,8464,1002906,12039,34,16383,186,6,827,130000.0,39000.0,-69.0,-69.0,-67.0,-60.0,-67.0,-69.0,-67.0,-60.0,-77.0,-84.0,-77.0,-84.0,8.0,15.0,10.0,24.0,1
5148,CC:2F:71:3F:1F:24,9304790,9706091530,6087683,9299748391,3217107,406343139,80,1411916,849596987,1403362,848569775,8554,1027212,1358521,619,6092376,614071,80,5956,130000.0,39000.0,-68.0,-64.0,-69.0,-68.0,-68.0,-64.0,-69.0,-67.0,-77.0,-84.0,-77.0,-84.0,9.0,20.0,8.0,16.0,1
5149,F8:59:71:5A:E0:3D,3382151,651007536,165037,244663731,3217114,406343805,0,163252,202941085,158427,202364557,4825,576528,140781,16,167751,2918,0,542,144444.0,43333.0,-67.0,-72.0,-65.0,-70.0,-66.0,-72.0,-65.0,-69.0,-77.0,-84.0,-77.0,-84.0,10.0,12.0,12.0,14.0,1
5150,CC:2F:71:3E:C5:1F,3228533,407740572,11419,1396767,3217114,406343805,6,48733,4081229,40269,3078323,8464,1002906,12039,34,16383,186,6,827,130000.0,39000.0,-69.0,-69.0,-67.0,-60.0,-67.0,-69.0,-67.0,-60.0,-77.0,-84.0,-77.0,-84.0,8.0,15.0,10.0,24.0,1
5151,CC:2F:71:3F:1F:24,9306378,9708544746,6089263,9302200879,3217115,406343867,80,1412207,849725993,1403653,848698781,8554,1027212,1358812,619,6093982,614419,80,5956,115556.0,28889.0,-69.0,-63.0,-71.0,-68.0,-68.0,-63.0,-71.0,-68.0,-77.0,-84.0,-77.0,-84.0,8.0,21.0,6.0,16.0,1
5152,F8:59:71:5A:E0:3D,3382222,651113472,165105,244769403,3217117,406344069,0,163319,203044265,158494,202467737,4825,576528,140848,16,167819,2918,0,542,144444.0,43333.0,-67.0,-73.0,-65.0,-70.0,-66.0,-73.0,-65.0,-70.0,-77.0,-84.0,-77.0,-84.0,10.0,11.0,12.0,14.0,1
5153,CC:2F:71:3E:C5:1F,3228536,407740836,11419,1396767,3217117,406344069,6,48735,4081417,40270,3078393,8465,1003024,12040,34,16383,186,6,827,130000.0,39000.0,-69.0,-71.0,-66.0,-61.0,-67.0,-69.0,-67.0,-60.0,-77.0,-84.0,-77.0,-84.0,8.0,13.0,11.0,23.0,1
5154,CC:2F:71:3F:1F:24,9308116,9711243500,6090999,9304899431,3217117,406344069,80,1412533,849866097,1403979,848838885,8554,1027212,1359137,619,6095718,615020,80,5956,86667.0,14444.0,-69.0,-63.0,-70.0,-67.0,-69.0,-63.0,-70.0,-67.0,-77.0,-84.0,-77.0,-84.0,8.0,21.0,7.0,17.0,1
5155,F8:59:71:5A:E0:3D,3382293,651215088,165170,244870413,3217123,406344675,0,163384,203144365,158559,202567837,4825,576528,140913,16,167884,2918,0,542,144444.0,43333.0,-67.0,-73.0,-66.0,-71.0,-66.0,-72.0,-65.0,-70.0,-77.0,-84.0,-77.0,-84.0,10.0,11.0,11.0,13.0,1
5156,CC:2F:71:3E:C5:1F,3228542,407741442,11419,1396767,3217123,406344675,6,48735,4081417,40270,3078393,8465,1003024,12040,34,16383,186,6,827,130000.0,39000.0,-69.0,-71.0,-66.0,-61.0,-67.0,-69.0,-67.0,-60.0,-77.0,-84.0,-77.0,-84.0,8.0,13.0,11.0,23.0,1
5157,CC:2F:71:3F:1F:24,9309530,9713421812,6092406,9307077077,3217124,406344735,80,1412856,849996191,1404302,848968979,8554,1027212,1359460,619,6097123,615059,80,5956,65000.0,14444.0,-70.0,-65.0,-69.0,-68.0,-70.0,-65.0,-69.0,-67.0,-77.0,-84.0,-77.0,-84.0,7.0,19.0,8.0,16.0,1
5158,F8:59:71:5A:E0:3D,3382385,651328878,165237,244973093,3217148,406355785,0,163451,203246111,158626,202669583,4825,576528,140980,16,167951,2918,0,542,144444.0,43333.0,-67.0,-73.0,-65.0,-70.0,-67.0,-73.0,-65.0,-70.0,-77.0,-84.0,-77.0,-84.0,10.0,11.0,12.0,14.0,1
5159,CC:2F:71:3E:C5:1F,3228567,407752552,11419,1396767,3217148,406355785,6,48735,4081417,40270,3078393,8465,1003024,12040,34,16383,186,6,827,130000.0,39000.0,-69.0,-71.0,-66.0,-61.0,-67.0,-69.0,-67.0,-60.0,-77.0,-84.0,-77.0,-84.0,8.0,13.0,11.0,23.0,1
5160,CC:2F:71:3F:1F:24,9310296,9714555748,6093148,9308199963,3217148,406355785,80,1413067,850116466,1404513,849089254,8554,1027212,1359671,619,6097862,615187,80,5956,115556.0,28889.0,-70.0,-64.0,-69.0,-69.0,-69.0,-63.0,-69.0,-69.0,-77.0,-84.0,-77.0,-84.0,7.0,20.0,8.0,15.0,1
5161,F8:59:71:5A:E0:3D,3382456,651430494,165302,245074103,3217154,406356391,0,163517,203347751,158692,202771223,4825,576528,141046,16,168016,2918,0,542,144444.0,43333.0,-67.0,-72.0,-65.0,-71.0,-66.0,-72.0,-65.0,-70.0,-77.0,-84.0,-77.0,-84.0,10.0,12.0,12.0,13.0,1
5162,CC:2F:71:3E:C5:1F,3228573,407753158,11419,1396767,3217154,406356391,6,48735,4081417,40270,3078393,8465,1003024,12040,34,16383,186,6,827,130000.0,39000.0,-69.0,-71.0,-66.0,-61.0,-67.0,-69.0,-67.0,-60.0,-77.0,-84.0,-77.0,-84.0,8.0,13.0,11.0,23.0,1
5163,CC:2F:71:3F:1F:24,9310976,9715573577,6093822,9309217186,3217154,406356391,80,1413303,850236242,1404749,849209030,8554,1027212,1359907,619,6098541,615282,80,5956,115556.0,28889.0,-70.0,-64.0,-70.0,-70.0,-69.0,-64.0,-70.0,-70.0,-77.0,-84.0,-77.0,-84.0,7.0,20.0,7.0,14.0,1
5164,F8:59:71:5A:E0:3D,3382522,651528871,165365,245172005,3217157,406356866,0,163579,203443231,158754,202866703,4825,576528,141108,16,168079,2919,0,542,144444.0,43333.0,-67.0,-73.0,-65.0,-70.0,-66.0,-72.0,-65.0,-70.0,-77.0,-84.0,-77.0,-84.0,10.0,11.0,12.0,14.0,1
5165,CC:2F:71:3E:C5:1F,3228577,407753693,11419,1396767,3217158,406356926,6,48735,4081417,40270,3078393,8465,1003024,12040,34,16383,186,6,827,130000.0,39000.0,-69.0,-71.0,-66.0,-61.0,-67.0,-69.0,-67.0,-60.0,-77.0,-84.0,-77.0,-84.0,8.0,13.0,11.0,23.0,1
5166,CC:2F:71:3F:1F:24,9311872,9716940752,6094714,9310583826,3217158,406356926,80,1413542,850354846,1404988,849327634,8554,1027212,1360146,619,6099433,615403,80,5956,86667.0,14444.0,-69.0,-64.0,-70.0,-71.0,-69.0,-64.0,-70.0,-70.0,-77.0,-84.0,-77.0,-84.0,8.0,20.0,7.0,13.0,1
5167,F8:59:71:5A:E0:3D,3382595,651632101,165431,245274569,3217164,406357532,0,163645,203544871,158820,202968343,4825,576528,141174,16,168145,2919,0,542,144444.0,43333.0,-67.0,-72.0,-65.0,-70.0,-67.0,-72.0,-64.0,-70.0,-77.0,-84.0,-77.0,-84.0,10.0,12.0,12.0,14.0,1
5168,CC:2F:71:3E:C5:1F,3228583,407754299,11419,1396767,3217164,406357532,6,48735,4081417,40270,3078393,8465,1003024,12040,34,16383,186,6,827,130000.0,39000.0,-69.0,-71.0,-66.0,-61.0,-67.0,-69.0,-67.0,-60.0,-77.0,-84.0,-77.0,-84.0,8.0,13.0,11.0,23.0,1
5169,CC:2F:71:3F:1F:24,9312825,9718393076,6095661,9312035544,3217164,406357532,80,1413804,850480576,1405250,849453364,8554,1027212,1360405,619,6100369,615592,80,5956,86667.0,14444.0,-69.0,-64.0,-70.0,-70.0,-69.0,-64.0,-69.0,-70.0,-77.0,-84.0,-77.0,-84.0,8.0,20.0,7.0,14.0,1
5170,F8:59:71:5A:E0:3D,3382660,651732228,165496,245374696,3217164,406357532,0,163710,203643581,158885,203067053,4825,576528,141239,16,168209,2919,0,542,144444.0,43333.0,-67.0,-73.0,-66.0,-71.0,-67.0,-72.0,-65.0,-70.0,-77.0,-84.0,-77.0,-84.0,10.0,11.0,11.0,13.0,1
5171,CC:2F:71:3E:C5:1F,3228583,407754299,11419,1396767,3217164,406357532,6,48735,4081417,40270,3078393,8465,1003024,12040,34,16383,186,6,827,130000.0,39000.0,-69.0,-71.0,-66.0,-61.0,-67.0,-69.0,-67.0,-60.0,-77.0,-84.0,-77.0,-84.0,8.0,13.0,11.0,23.0,1
5172,CC:2F:71:3F:1F:24,9314081,9720321432,6096914,9313963636,3217167,406357796,80,1414117,850609187,1405563,849581975,8554,1027212,1360718,619,6101617,615625,80,5956,65000.0,13000.0,-70.0,-64.0,-68.0,-69.0,-69.0,-64.0,-69.0,-69.0,-77.0,-84.0,-77.0,-84.0,7.0,20.0,9.0,15.0,1
5173,F8:59:71:5A:E0:3D,3382732,651829506,165558,245471044,3217174,406358462,0,163774,203740719,158948,203164073,4826,576646,141303,16,168272,2919,0,542,144444.0,43333.0,-67.0,-71.0,-65.0,-71.0,-67.0,-73.0,-64.0,-70.0,-77.0,-84.0,-77.0,-84.0,10.0,13.0,12.0,13.0,1
5174,CC:2F:71:3E:C5:1F,3228593,407755229,11419,1396767,3217174,406358462,6,48735,4081417,40270,3078393,8465,1003024,12040,34,16383,186,6,827,130000.0,39000.0,-69.0,-71.0,-66.0,-61.0,-67.0,-69.0,-67.0,-60.0,-77.0,-84.0,-77.0,-84.0,8.0,13.0,11.0,23.0,1
5175,CC:2F:71:3F:1F:24,9315136,9721925863,6097962,9315567401,3217174,406358462,80,1414390,850733807,1405836,849706595,8554,1027212,1360991,619,6102681,615634,80,5956,86667.0,14444.0,-70.0,-63.0,-70.0,-69.0,-69.0,-63.0,-69.0,-69.0,-77.0,-84.0,-77.0,-84.0,7.0,21.0,7.0,15.0,1
5176,F8:59:71:5A:E0:3D,3382798,651930578,165623,245572054,3217175,406358524,0,163839,203840819,159013,203264173,4826,576646,141368,16,168337,2921,0,542,144444.0,43333.0,-67.0,-73.0,-65.0,-71.0,-67.0,-73.0,-64.0,-71.0,-77.0,-84.0,-77.0,-84.0,10.0,11.0,12.0,13.0,1
5177,CC:2F:71:3E:C5:1F,3228594,407755291,11419,1396767,3217175,406358524,6,48735,4081417,40270,3078393,8465,1003024,12040,34,16383,186,6,827,130000.0,39000.0,-69.0,-71.0,-66.0,-61.0,-67.0,-69.0,-67.0,-60.0,-77.0,-84.0,-77.0,-84.0,8.0,13.0,11.0,23.0,1
5178,CC:2F:71:3F:1F:24,9316028,9723289539,6098853,9316931015,3217175,406358524,80,1414659,850855917,1406104,849828587,8555,1027330,1361260,619,6103572,615668,80,5956,115556.0,28889.0,-68.0,-63.0,-70.0,-69.0,-68.0,-63.0,-69.0,-69.0,-77.0,-84.0,-77.0,-84.0,9.0,21.0,7.0,15.0,1
5179,F8:59:71:5A:E0:3D,3382865,652028884,165686,245669956,3217179,406358928,0,163902,203937839,159076,203361193,4826,576646,141431,16,168400,2921,0,542,144444.0,43333.0,-67.0,-74.0,-65.0,-71.0,-67.0,-73.0,-64.0,-70.0,-77.0,-84.0,-77.0,-84.0,10.0,10.0,12.0,13.0,1
5180,CC:2F:71:3E:C5:1F,3228602,407756099,11419,1396767,3217183,406359332,6,48735,4081417,40270,3078393,8465,1003024,12040,34,16383,186,6,827,130000.0,39000.0,-69.0,-71.0,-66.0,-61.0,-67.0,-69.0,-67.0,-60.0,-77.0,-84.0,-77.0,-84.0,8.0,13.0,11.0,23.0,1
5181,CC:2F:71:3F:1F:24,9317258,9725178271,6100075,9318818939,3217183,406359332,80,1414957,850985919,1406402,849958589,8555,1027330,1361558,619,6104794,615887,80,5958,115556.0,28889.0,-69.0,-63.0,-69.0,-69.0,-69.0,-63.0,-69.0,-69.0,-77.0,-84.0,-77.0,-84.0,8.0,21.0,8.0,15.0,1
5182,F8:59:71:5A:E0:3D,3382937,652133466,165753,245774074,3217184,406359392,0,163968,204039479,159142,203462833,4826,576646,141497,16,168467,2922,0,542,144444.0,43333.0,-67.0,-73.0,-64.0,-71.0,-66.0,-73.0,-64.0,-70.0,-77.0,-84.0,-77.0,-84.0,10.0,11.0,13.0,13.0,1
5183,CC:2F:71:3E:C5:1F,3228603,407756159,11419,1396767,3217184,406359392,6,48735,4081417,40270,3078393,8465,1003024,12040,34,16383,186,6,827,130000.0,39000.0,-69.0,-71.0,-66.0,-61.0,-67.0,-69.0,-67.0,-60.0,-77.0,-84.0,-77.0,-84.0,8.0,13.0,11.0,23.0,1
5184,CC:2F:71:3F:1F:24,9318838,9727628673,6101654,9321269281,3217184,406359392,80,1415321,851121921,1406766,850094591,8555,1027330,1361922,619,6106357,616261,80,5958,65000.0,13000.0,-69.0,-63.0,-70.0,-69.0,-68.0,-63.0,-69.0,-69.0,-77.0,-84.0,-77.0,-84.0,8.0,21.0,7.0,15.0,1
5185,F8:59:71:5A:E0:3D,3383003,652233124,165817,245873530,3217186,406359594,0,164033,204139579,159207,203562933,4826,576646,141562,16,168531,2922,0,542,144444.0,43333.0,-67.0,-73.0,-65.0,-71.0,-67.0,-73.0,-65.0,-70.0,-77.0,-84.0,-77.0,-84.0,10.0,11.0,12.0,13.0,1
5186,CC:2F:71:3E:C5:1F,3228605,407756361,11419,1396767,3217186,406359594,6,48735,4081417,40270,3078393,8465,1003024,12040,34,16383,186,6,827,130000.0,39000.0,-69.0,-71.0,-66.0,-61.0,-67.0,-69.0,-67.0,-60.0,-77.0,-84.0,-77.0,-84.0,8.0,13.0,11.0,23.0,1
5187,CC:2F:71:3F:1F:24,9320428,9730083116,6103240,9323723320,3217188,406359796,80,1415654,851253540,1407099,850226210,8555,1027330,1362252,619,6107959,616280,80,5958,86667.0,14444.0,-68.0,-63.0,-69.0,-69.0,-67.0,-63.0,-68.0,-68.0,-77.0,-84.0,-77.0,-84.0,9.0,21.0,8.0,15.0,1
5188,F8:59:71:5A:E0:3D,3383074,652334740,165882,245974540,3217192,406360200,0,164097,204238139,159271,203661493,4826,576646,141626,16,168596,2922,0,542,144444.0,43333.0,-67.0,-73.0,-65.0,-71.0,-66.0,-73.0,-64.0,-71.0,-77.0,-84.0,-77.0,-84.0,10.0,11.0,12.0,13.0,1
5189,CC:2F:71:3E:C5:1F,3228611,407756967,11419,1396767,3217192,406360200,6,48735,4081417,40270,3078393,8465,1003024,12040,34,16383,186,6,827,130000.0,39000.0,-69.0,-71.0,-66.0,-61.0,-67.0,-69.0,-67.0,-60.0,-77.0,-84.0,-77.0,-84.0,8.0,13.0,11.0,23.0,1
5190,CC:2F:71:3F:1F:24,9321434,9731623548,6104242,9325263348,3217192,406360200,80,1415917,851377800,1407362,850350470,8555,1027330,1362515,619,6108961,616369,80,5958,86667.0,14444.0,-69.0,-63.0,-70.0,-69.0,-69.0,-63.0,-69.0,-69.0,-77.0,-84.0,-77.0,-84.0,8.0,21.0,7.0,15.0,1
5191,F8:59:71:5A:E0:3D,3383142,652434574,165947,246074112,3217195,406360462,0,164163,204338345,159337,203761699,4826,576646,141692,16,168661,2922,0,542,144444.0,43333.0,-67.0,-73.0,-64.0,-71.0,-66.0,-73.0,-64.0,-70.0,-77.0,-84.0,-77.0,-84.0,10.0,11.0,13.0,13.0,1
5192,CC:2F:71:3E:C5:1F,3228614,407757229,11419,1396767,3217195,406360462,6,48735,4081417,40270,3078393,8465,1003024,12040,34,16383,186,6,827,130000.0,39000.0,-69.0,-71.0,-66.0,-61.0,-67.0,-69.0,-67.0,-60.0,-77.0,-84.0,-77.0,-84.0,8.0,13.0,11.0,23.0,1
5193,CC:2F:71:3F:1F:24,9322330,9732992188,6105135,9326631726,3217195,406360462,80,1416148,851495604,1407593,850468274,8555,1027330,1362746,619,6109840,616380,80,5959,65000.0,13000.0,-69.0,-63.0,-69.0,-69.0,-69.0,-63.0,-69.0,-69.0,-77.0,-84.0,-77.0,-84.0,8.0,21.0,8.0,15.0,1
5194,F8:59:71:5A:E0:3D,3383213,652534752,166012,246173684,3217201,406361068,0,164228,204437011,159402,203860365,4826,576646,141757,16,168726,2924,0,542,144444.0,43333.0,-66.0,-73.0,-64.0,-71.0,-66.0,-73.0,-64.0,-71.0,-77.0,-85.0,-77.0,-84.0,11.0,12.0,13.0,13.0,1
5195,CC:2F:71:3E:C5:1F,3228620,407757835,11419,1396767,3217201,406361068,6,48735,4081417,40270,3078393,8465,1003024,12040,34,16383,186,6,827,130000.0,39000.0,-69.0,-71.0,-66.0,-61.0,-67.0,-69.0,-67.0,-60.0,-77.0,-85.0,-77.0,-84.0,8.0,14.0,11.0,23.0,1
5196,CC:2F:71:3F:1F:24,9323219,9734343712,6106018,9327982644,3217201,406361068,80,1416399,851617108,1407844,850589778,8555,1027330,1362997,619,6110737,616380,80,5959,86667.0,14444.0,-70.0,-63.0,-69.0,-69.0,-70.0,-63.0,-69.0,-69.0,-77.0,-85.0,-77.0,-84.0,7.0,22.0,8.0,15.0,1
5197,F8:59:71:5A:E0:3D,3383281,652637518,166078,246276248,3217203,406361270,0,164295,204540205,159469,203963559,4826,576646,141823,16,168792,2924,0,542,144444.0,43333.0,-66.0,-73.0,-64.0,-71.0,-66.0,-72.0,-64.0,-70.0,-77.0,-85.0,-77.0,-84.0,11.0,12.0,13.0,13.0,1
5198,CC:2F:71:3E:C5:1F,3228622,407758037,11419,1396767,3217203,406361270,6,48735,4081417,40270,3078393,8465,1003024,12040,34,16383,186,6,827,130000.0,39000.0,-69.0,-71.0,-66.0,-61.0,-67.0,-69.0,-67.0,-60.0,-77.0,-85.0,-77.0,-84.0,8.0,14.0,11.0,23.0,1
5199,CC:2F:71:3F:1F:24,9324225,9735877922,6107021,9329516592,3217204,406361330,80,1416650,851747827,1408095,850720497,8555,1027330,1363248,619,6111740,616492,80,5959,104000.0,26000.0,-70.0,-63.0,-71.0,-69.0,-69.0,-63.0,-69.0,-69.0,-77.0,-85.0,-77.0,-84.0,7.0,22.0,6.0,15.0,1
5200,F8:59:71:5A:E0:3D,3383354,652740748,166144,246378812,3217210,406361936,0,164362,204643399,159536,204066753,4826,576646,141889,16,168858,2925,0,542,144444.0,43333.0,-67.0,-71.0,-64.0,-71.0,-66.0,-72.0,-64.0,-71.0,-77.0,-85.0,-77.0,-84.0,10.0,14.0,13.0,13.0,1
5201,CC:2F:71:3E:C5:1F,3228629,407758703,11419,1396767,3217210,406361936,6,48735,4081417,40270,3078393,8465,1003024,12040,34,16383,186,6,827,130000.0,39000.0,-69.0,-71.0,-66.0,-61.0,-67.0,-69.0,-67.0,-60.0,-77.0,-85.0,-77.0,-84.0,8.0,14.0,11.0,23.0,1
5202,CC:2F:71:3F:1F:24,9325175,9737326528,6107965,9330964592,3217210,406361936,80,1416861,851861771,1408306,850834441,8555,1027330,1363459,619,6112684,616588,80,5959,115556.0,28889.0,-70.0,-63.0,-68.0,-68.0,-69.0,-63.0,-69.0,-68.0,-77.0,-85.0,-77.0,-84.0,7.0,22.0,9.0,16.0,1
5203,F8:59:71:5A:E0:3D,3383419,652838852,166207,246476714,3217212,406362138,0,164425,204740419,159599,204163773,4826,576646,141952,16,168921,2926,0,542,144444.0,43333.0,-67.0,-73.0,-65.0,-71.0,-67.0,-73.0,-64.0,-70.0,-77.0,-85.0,-77.0,-84.0,10.0,12.0,12.0,13.0,1
5204,CC:2F:71:3E:C5:1F,3228631,407758905,11419,1396767,3217212,406362138,6,48735,4081417,40270,3078393,8465,1003024,12040,34,16383,186,6,827,130000.0,39000.0,-69.0,-71.0,-66.0,-61.0,-67.0,-69.0,-67.0,-60.0,-77.0,-85.0,-77.0,-84.0,8.0,14.0,11.0,23.0,1
5205,CC:2F:71:3F:1F:24,9326312,9739076216,6109100,9332714078,3217212,406362138,80,1417084,851978587,1408529,850951257,8555,1027330,1363682,619,6113819,616673,80,5959,115556.0,28889.0,-70.0,-63.0,-69.0,-69.0,-69.0,-63.0,-69.0,-69.0,-77.0,-85.0,-77.0,-84.0,7.0,22.0,8.0,15.0,1
5206,F8:59:71:5A:E0:3D,3383490,652939187,166271,246576170,3217219,406363017,0,164489,204838979,159663,204262333,4826,576646,142016,16,168985,2927,0,542,144444.0,43333.0,-66.0,-73.0,-65.0,-70.0,-66.0,-73.0,-64.0,-70.0,-77.0,-85.0,-77.0,-84.0,11.0,12.0,12.0,14.0,1
5207,CC:2F:71:3E:C5:1F,3228639,407759844,11419,1396767,3217220,406363077,6,48735,4081417,40270,3078393,8465,1003024,12040,34,16383,186,6,827,130000.0,39000.0,-69.0,-71.0,-66.0,-61.0,-67.0,-69.0,-67.0,-60.0,-77.0,-85.0,-77.0,-84.0,8.0,14.0,11.0,23.0,1
5208,CC:2F:71:3F:1F:24,9327310,9740598535,6110090,9334235458,3217220,406363077,80,1417321,852099771,1408766,851072441,8555,1027330,1363919,619,6114809,616864,80,5959,130000.0,43333.0,-69.0,-64.0,-68.0,-70.0,-69.0,-64.0,-67.0,-70.0,-77.0,-85.0,-77.0,-84.0,8.0,21.0,9.0,14.0,1
5209,F8:59:71:5A:E0:3D,3383559,653042013,166337,246678734,3217222,406363279,0,164554,204939079,159728,204362433,4826,576646,142081,16,169051,2927,0,542,144444.0,43333.0,-67.0,-72.0,-66.0,-71.0,-66.0,-72.0,-65.0,-71.0,-77.0,-85.0,-77.0,-84.0,10.0,13.0,11.0,13.0,1
5210,CC:2F:71:3E:C5:1F,3228641,407760046,11419,1396767,3217222,406363279,6,48735,4081417,40270,3078393,8465,1003024,12040,34,16383,186,6,827,130000.0,39000.0,-69.0,-71.0,-66.0,-61.0,-67.0,-69.0,-67.0,-60.0,-77.0,-85.0,-77.0,-84.0,8.0,14.0,11.0,23.0,1
5211,CC:2F:71:3F:1F:24,9328638,9742648701,6111416,9336285422,3217222,406363279,80,1417610,852228557,1409055,851201227,8555,1027330,1364208,619,6116135,617195,80,5959,86667.0,14444.0,-68.0,-64.0,-69.0,-70.0,-67.0,-64.0,-68.0,-70.0,-77.0,-85.0,-77.0,-84.0,9.0,21.0,8.0,14.0,1
5212,F8:59:71:5A:E0:3D,3383630,653143629,166402,246779744,3217228,406363885,0,164619,205039179,159793,204462533,4826,576646,142146,16,169116,2929,0,542,144444.0,43333.0,-67.0,-73.0,-65.0,-70.0,-66.0,-73.0,-65.0,-70.0,-77.0,-85.0,-77.0,-84.0,10.0,12.0,12.0,14.0,1
5213,CC:2F:71:3E:C5:1F,3228647,407760652,11419,1396767,3217228,406363885,6,48735,4081417,40270,3078393,8465,1003024,12040,34,16383,186,6,827,130000.0,39000.0,-69.0,-71.0,-66.0,-61.0,-67.0,-69.0,-67.0,-60.0,-77.0,-85.0,-77.0,-84.0,8.0,14.0,11.0,23.0,1
5214,CC:2F:71:3F:1F:24,9330112,9744918648,6112884,9338554763,3217228,406363885,80,1417955,852361993,1409400,851334663,8555,1027330,1364551,619,6117603,617211,80,5959,86667.0,14444.0,-69.0,-64.0,-72.0,-68.0,-69.0,-64.0,-71.0,-68.0,-77.0,-85.0,-77.0,-84.0,8.0,21.0,5.0,16.0,1
5215,F8:59:71:5A:E0:3D,3383696,653241625,166465,246877478,3217231,406364147,0,164683,205137739,159857,204561093,4826,576646,142210,16,169179,2929,0,542,144444.0,43333.0,-66.0,-74.0,-65.0,-71.0,-66.0,-74.0,-65.0,-70.0,-77.0,-85.0,-77.0,-84.0,11.0,11.0,12.0,13.0,1
5216,CC:2F:71:3E:C5:1F,3228650,407760914,11419,1396767,3217231,406364147,6,48735,4081417,40270,3078393,8465,1003024,12040,34,16383,186,6,827,130000.0,39000.0,-69.0,-71.0,-66.0,-61.0,-67.0,-69.0,-67.0,-60.0,-77.0,-85.0,-77.0,-84.0,8.0,14.0,11.0,23.0,1
5217,CC:2F:71:3F:1F:24,9331620,9747253200,6114389,9340889053,3217231,406364147,80,1418250,852487197,1409695,851459867,8555,1027330,1364846,619,6119095,617402,80,5959,115556.0,28889.0,-69.0,-64.0,-69.0,-67.0,-69.0,-64.0,-69.0,-67.0,-77.0,-85.0,-77.0,-84.0,8.0,21.0,8.0,17.0,1
5218,F8:59:71:5A:E0:3D,3383763,653339931,166528,246975380,3217235,406364551,0,164746,205234759,159920,204658113,4826,576646,142273,16,169242,2929,0,542,144444.0,43333.0,-67.0,-73.0,-65.0,-71.0,-67.0,-72.0,-65.0,-71.0,-77.0,-84.0,-77.0,-84.0,10.0,11.0,12.0,13.0,1
5219,CC:2F:71:3E:C5:1F,3228654,407761318,11419,1396767,3217235,406364551,6,48735,4081417,40270,3078393,8465,1003024,12040,34,16383,186,6,827,130000.0,39000.0,-69.0,-71.0,-66.0,-61.0,-67.0,-69.0,-67.0,-60.0,-77.0,-84.0,-77.0,-84.0,8.0,13.0,11.0,23.0,1
5220,CC:2F:71:3F:1F:24,9332931,9749270800,6115694,9342906047,3217237,406364753,80,1418532,852612287,1409977,851584957,8555,1027330,1365128,619,6120400,617645,80,5959,86667.0,14444.0,-70.0,-64.0,-70.0,-69.0,-69.0,-64.0,-70.0,-69.0,-77.0,-84.0,-77.0,-84.0,7.0,20.0,7.0,15.0,1
5221,F8:59:71:5A:E0:3D,3383830,653439705,166593,247074952,3217237,406364753,0,164810,205333347,159984,204756701,4826,576646,142337,16,169307,2929,0,543,144444.0,43333.0,-67.0,-74.0,-65.0,-71.0,-67.0,-74.0,-65.0,-70.0,-77.0,-84.0,-77.0,-84.0,10.0,10.0,12.0,13.0,1
5222,CC:2F:71:3E:C5:1F,3228659,407761838,11420,1396883,3217239,406364955,6,48737,4081557,40272,3078533,8465,1003024,12040,34,16384,186,6,827,130000.0,39000.0,-67.0,-70.0,-68.0,-60.0,-67.0,-69.0,-67.0,-60.0,-77.0,-84.0,-77.0,-84.0,10.0,14.0,9.0,24.0,1
5223,CC:2F:71:3F:1F:24,9334314,9751406270,6117075,9345041315,3217239,406364955,80,1418854,852743555,1410299,851716225,8555,1027330,1365450,619,6121794,617661,80,5959,86667.0,14444.0,-70.0,-63.0,-69.0,-68.0,-69.0,-63.0,-69.0,-68.0,-77.0,-84.0,-77.0,-84.0,7.0,21.0,8.0,16.0,1
5224,F8:59:71:5A:E0:3D,3383899,653542531,166659,247177516,3217240,406365015,0,164876,205434987,160050,204858341,4826,576646,142403,16,169373,2929,0,543,144444.0,43333.0,-67.0,-74.0,-64.0,-71.0,-66.0,-74.0,-64.0,-70.0,-77.0,-84.0,-77.0,-84.0,10.0,10.0,13.0,13.0,1
5225,CC:2F:71:3E:C5:1F,3228662,407762100,11420,1396883,3217242,406365217,6,48737,4081557,40272,3078533,8465,1003024,12040,34,16384,186,6,827,130000.0,39000.0,-67.0,-70.0,-68.0,-60.0,-67.0,-69.0,-67.0,-60.0,-77.0,-84.0,-77.0,-84.0,10.0,14.0,9.0,24.0,1
5226,CC:2F:71:3F:1F:24,9335482,9753193337,6118238,9346827918,3217244,406365419,80,1419139,852871061,1410584,851843731,8555,1027330,1365735,619,6122922,617671,80,5959,86667.0,14444.0,-70.0,-63.0,-71.0,-68.0,-70.0,-63.0,-70.0,-68.0,-77.0,-84.0,-77.0,-84.0,7.0,21.0,6.0,16.0,1
5227,F8:59:71:5A:E0:3D,3383971,653644209,166724,247278526,3217247,406365683,0,164941,205535115,160115,204958469,4826,576646,142468,16,169438,2930,0,543,144444.0,43333.0,-66.0,-75.0,-65.0,-71.0,-65.0,-74.0,-64.0,-71.0,-77.0,-84.0,-77.0,-84.0,11.0,9.0,12.0,13.0,1
5228,CC:2F:71:3E:C5:1F,3228667,407762566,11420,1396883,3217247,406365683,6,48739,4081745,40273,3078603,8466,1003142,12041,34,16384,186,6,827,130000.0,39000.0,-68.0,-71.0,-67.0,-60.0,-67.0,-69.0,-66.0,-60.0,-77.0,-84.0,-77.0,-84.0,9.0,13.0,10.0,24.0,1
5229,CC:2F:71:3F:1F:24,9336872,9755336653,6119623,9348970768,3217249,406365885,80,1419423,852997849,1410868,851970519,8555,1027330,1366019,619,6124301,617834,80,5959,130000.0,39000.0,-71.0,-63.0,-70.0,-68.0,-70.0,-63.0,-70.0,-67.0,-77.0,-84.0,-77.0,-84.0,6.0,21.0,7.0,16.0,1
5230,F8:59:71:5A:E0:3D,3384042,653747486,166790,247381090,3217252,406366396,0,165007,205635333,160180,205058569,4827,576764,142534,16,169504,2930,0,543,144444.0,43333.0,-66.0,-75.0,-65.0,-71.0,-66.0,-75.0,-65.0,-71.0,-77.0,-85.0,-77.0,-84.0,11.0,10.0,12.0,13.0,1
5231,CC:2F:71:3E:C5:1F,3228672,407763279,11420,1396883,3217252,406366396,6,48739,4081745,40273,3078603,8466,1003142,12041,34,16384,186,6,827,130000.0,39000.0,-68.0,-71.0,-67.0,-60.0,-67.0,-69.0,-66.0,-60.0,-77.0,-85.0,-77.0,-84.0,9.0,14.0,10.0,24.0,1
5232,CC:2F:71:3F:1F:24,9338189,9757367278,6120935,9351000680,3217254,406366598,80,1419695,853123225,1411140,852095895,8555,1027330,1366291,619,6125653,617961,80,5959,130000.0,43333.0,-70.0,-63.0,-70.0,-67.0,-70.0,-63.0,-70.0,-67.0,-77.0,-85.0,-77.0,-84.0,7.0,22.0,7.0,17.0,1
5233,F8:59:71:5A:E0:3D,3384114,653846503,166853,247478992,3217261,406367511,0,165071,205733893,160244,205157129,4827,576764,142598,16,169567,2932,0,543,144444.0,43333.0,-66.0,-75.0,-64.0,-71.0,-65.0,-74.0,-64.0,-71.0,-77.0,-85.0,-77.0,-84.0,11.0,10.0,13.0,13.0,1
5234,CC:2F:71:3E:C5:1F,3228685,407765107,11424,1397596,3217261,406367511,6,48746,4082702,40280,3079560,8466,1003142,12047,34,16388,186,6,827,130000.0,39000.0,-68.0,-70.0,-67.0,-60.0,-67.0,-69.0,-67.0,-60.0,-77.0,-85.0,-77.0,-84.0,9.0,15.0,10.0,24.0,1
5235,CC:2F:71:3F:1F:24,9339304,9759075095,6122043,9352707584,3217261,406367511,80,1419946,853243213,1411391,852215883,8555,1027330,1366542,619,6126762,618002,80,5959,130000.0,43333.0,-70.0,-64.0,-70.0,-67.0,-69.0,-64.0,-70.0,-67.0,-77.0,-85.0,-77.0,-84.0,7.0,21.0,7.0,17.0,1
5236,F8:59:71:5A:E0:3D,3384180,653946161,166917,247578448,3217263,406367713,0,165135,205832453,160308,205255689,4827,576764,142662,16,169631,2933,0,543,144444.0,43333.0,-66.0,-75.0,-65.0,-71.0,-66.0,-74.0,-65.0,-71.0,-77.0,-85.0,-77.0,-84.0,11.0,10.0,12.0,13.0,1
5237,CC:2F:71:3E:C5:1F,3228687,407765309,11424,1397596,3217263,406367713,6,48746,4082702,40280,3079560,8466,1003142,12047,34,16388,186,6,827,130000.0,39000.0,-68.0,-70.0,-67.0,-60.0,-67.0,-69.0,-67.0,-60.0,-77.0,-85.0,-77.0,-84.0,9.0,15.0,10.0,24.0,1
5238,CC:2F:71:3F:1F:24,9340740,9761288632,6123476,9354920694,3217264,406367938,80,1420213,853366960,1411658,852339630,8555,1027330,1366809,619,6128195,618115,80,5959,130000.0,43333.0,-70.0,-64.0,-71.0,-68.0,-70.0,-63.0,-70.0,-67.0,-77.0,-85.0,-77.0,-84.0,7.0,21.0,6.0,16.0,1
5239,F8:59:71:5A:E0:3D,3384252,654046672,166981,247677904,3217271,406368768,0,165198,205929473,160371,205352709,4827,576764,142725,16,169695,2934,0,543,144444.0,43333.0,-66.0,-74.0,-64.0,-70.0,-66.0,-73.0,-64.0,-70.0,-77.0,-85.0,-77.0,-85.0,11.0,11.0,13.0,15.0,1
5240,CC:2F:71:3E:C5:1F,3228695,407766364,11424,1397596,3217271,406368768,6,48746,4082702,40280,3079560,8466,1003142,12047,34,16388,186,6,827,130000.0,39000.0,-68.0,-70.0,-67.0,-60.0,-67.0,-69.0,-67.0,-60.0,-77.0,-85.0,-77.0,-85.0,9.0,15.0,10.0,25.0,1
5241,CC:2F:71:3F:1F:24,9342370,9763809036,6125099,9357440268,3217271,406368768,80,1420475,853488320,1411920,852460990,8555,1027330,1367071,619,6129799,618154,80,5959,130000.0,43333.0,-70.0,-64.0,-71.0,-67.0,-69.0,-64.0,-70.0,-67.0,-77.0,-85.0,-77.0,-85.0,7.0,21.0,6.0,18.0,1
5242,F8:59:71:5A:E0:3D,3384319,654143731,167043,247774252,3217276,406369479,0,165261,206026493,160434,205449729,4827,576764,142788,16,169757,2935,0,543,144444.0,43333.0,-67.0,-75.0,-65.0,-70.0,-66.0,-73.0,-65.0,-70.0,-77.0,-85.0,-77.0,-85.0,10.0,10.0,12.0,15.0,1
5243,CC:2F:71:3E:C5:1F,3228700,407767075,11424,1397596,3217276,406369479,6,48746,4082702,40280,3079560,8466,1003142,12047,34,16388,186,6,827,130000.0,39000.0,-68.0,-70.0,-67.0,-60.0,-67.0,-69.0,-67.0,-60.0,-77.0,-85.0,-77.0,-85.0,9.0,15.0,10.0,25.0,1
5244,CC:2F:71:3F:1F:24,9344123,9766526547,6126847,9360157068,3217276,406369479,80,1420782,853615188,1412227,852587858,8555,1027330,1367373,619,6131526,618220,80,5960,130000.0,43333.0,-69.0,-65.0,-70.0,-68.0,-69.0,-65.0,-70.0,-68.0,-77.0,-85.0,-77.0,-85.0,8.0,20.0,7.0,17.0,1
5245,F8:59:71:5A:E0:3D,3384387,654243591,167107,247873708,3217280,406369883,0,165325,206125053,160498,205548289,4827,576764,142852,16,169821,2936,0,543,144444.0,43333.0,-66.0,-74.0,-65.0,-70.0,-66.0,-74.0,-64.0,-70.0,-77.0,-85.0,-77.0,-85.0,11.0,11.0,12.0,15.0,1
5246,CC:2F:71:3E:C5:1F,3228706,407767681,11424,1397596,3217282,406370085,6,48746,4082702,40280,3079560,8466,1003142,12047,34,16388,186,6,827,130000.0,39000.0,-68.0,-70.0,-67.0,-60.0,-67.0,-69.0,-67.0,-60.0,-77.0,-85.0,-77.0,-85.0,9.0,15.0,10.0,25.0,1
5247,CC:2F:71:3F:1F:24,9345444,9768558843,6128161,9362188696,3217283,406370147,80,1421068,853743582,1412512,852716134,8556,1027448,1367659,619,6132880,618286,80,5960,130000.0,43333.0,-70.0,-66.0,-69.0,-67.0,-69.0,-65.0,-69.0,-67.0,-77.0,-85.0,-77.0,-85.0,7.0,19.0,8.0,18.0,1
5248,F8:59:71:5A:E0:3D,3384458,654345340,167172,247974718,3217286,406370622,0,165390,206225153,160563,205648389,4827,576764,142917,16,169886,2936,0,543,144444.0,43333.0,-65.0,-74.0,-65.0,-70.0,-65.0,-73.0,-64.0,-70.0,-77.0,-85.0,-77.0,-85.0,12.0,11.0,12.0,15.0,1
5249,CC:2F:71:3E:C5:1F,3228711,407768278,11424,1397596,3217287,406370682,6,48746,4082702,40280,3079560,8466,1003142,12047,34,16388,186,6,827,130000.0,39000.0,-68.0,-70.0,-67.0,-60.0,-67.0,-69.0,-67.0,-60.0,-77.0,-85.0,-77.0,-85.0,9.0,15.0,10.0,25.0,1
5250,CC:2F:71:3F:1F:24,9347195,9771267028,6129908,9364896346,3217287,406370682,80,1421377,853870853,1412821,852843405,8556,1027448,1367968,619,6134625,618303,80,5960,130000.0,43333.0,-69.0,-66.0,-70.0,-68.0,-69.0,-66.0,-70.0,-68.0,-77.0,-85.0,-77.0,-85.0,8.0,19.0,7.0,17.0,1
5251,F8:59:71:5A:E0:3D,3384528,654446814,167237,248075728,3217291,406371086,0,165456,206326807,160629,205750043,4827,576764,142982,16,169951,2936,0,543,144444.0,43333.0,-66.0,-73.0,-65.0,-70.0,-66.0,-73.0,-64.0,-70.0,-77.0,-85.0,-77.0,-85.0,11.0,12.0,12.0,15.0,1
5252,CC:2F:71:3E:C5:1F,3228715,407768682,11424,1397596,3217291,406371086,6,48746,4082702,40280,3079560,8466,1003142,12047,34,16388,186,6,827,130000.0,39000.0,-68.0,-70.0,-67.0,-60.0,-67.0,-69.0,-67.0,-60.0,-77.0,-85.0,-77.0,-85.0,9.0,15.0,10.0,25.0,1
5253,CC:2F:71:3F:1F:24,9348669,9773543794,6131376,9367172506,3217293,406371288,80,1421655,853998267,1413099,852970819,8556,1027448,1368245,619,6136095,618357,80,5960,130000.0,43333.0,-69.0,-66.0,-71.0,-68.0,-69.0,-66.0,-70.0,-68.0,-77.0,-85.0,-77.0,-85.0,8.0,19.0,6.0,17.0,1
5254,F8:59:71:5A:E0:3D,3384597,654548228,167302,248176738,3217295,406371490,0,165521,206426907,160694,205850143,4827,576764,143047,16,170016,2936,0,543,144444.0,43333.0,-66.0,-74.0,-65.0,-70.0,-65.0,-73.0,-64.0,-70.0,-77.0,-85.0,-77.0,-85.0,11.0,11.0,12.0,15.0,1
5255,CC:2F:71:3E:C5:1F,3228721,407769318,11426,1397828,3217295,406371490,6,48748,4082914,40282,3079772,8466,1003142,12049,34,16390,186,6,827,130000.0,39000.0,-68.0,-70.0,-68.0,-60.0,-67.0,-69.0,-67.0,-60.0,-77.0,-85.0,-77.0,-85.0,9.0,15.0,9.0,25.0,1
5256,CC:2F:71:3F:1F:24,9349911,9775460404,6132616,9369088914,3217295,406371490,80,1421942,854125383,1413386,853097935,8556,1027448,1368532,619,6137335,618392,80,5960,130000.0,39000.0,-69.0,-65.0,-70.0,-67.0,-69.0,-65.0,-69.0,-67.0,-77.0,-85.0,-77.0,-85.0,8.0,20.0,7.0,18.0,1
5257,F8:59:71:5A:E0:3D,3384667,654649702,167367,248277748,3217300,406371954,0,165585,206525467,160758,205948703,4827,576764,143111,16,170081,2936,0,543,144444.0,43333.0,-66.0,-74.0,-65.0,-70.0,-66.0,-73.0,-64.0,-69.0,-77.0,-85.0,-77.0,-85.0,11.0,11.0,12.0,15.0,1
5258,CC:2F:71:3E:C5:1F,3228726,407769782,11426,1397828,3217300,406371954,6,48749,4082984,40283,3079842,8466,1003142,12049,34,16390,186,6,827,130000.0,39000.0,-68.0,-70.0,-68.0,-60.0,-67.0,-69.0,-67.0,-60.0,-77.0,-85.0,-77.0,-85.0,9.0,15.0,9.0,25.0,1
5259,CC:2F:71:3F:1F:24,9351051,9777210250,6133751,9370838296,3217300,406371954,80,1422204,854249463,1413648,853222015,8556,1027448,1368793,619,6138470,618418,80,5960,130000.0,43333.0,-70.0,-65.0,-70.0,-68.0,-69.0,-65.0,-70.0,-67.0,-77.0,-85.0,-77.0,-85.0,7.0,20.0,7.0,17.0,1
5260,F8:59:71:5A:E0:3D,3384735,654749562,167431,248377204,3217304,406372358,0,165650,206625609,160823,206048845,4827,576764,143176,16,170145,2937,0,543,144444.0,43333.0,-66.0,-74.0,-65.0,-71.0,-65.0,-73.0,-64.0,-70.0,-77.0,-85.0,-77.0,-85.0,11.0,11.0,12.0,14.0,1
5261,CC:2F:71:3E:C5:1F,3228730,407770186,11426,1397828,3217304,406372358,6,48749,4082984,40283,3079842,8466,1003142,12049,34,16390,186,6,827,130000.0,39000.0,-68.0,-70.0,-68.0,-60.0,-67.0,-69.0,-67.0,-60.0,-77.0,-85.0,-77.0,-85.0,9.0,15.0,9.0,25.0,1
5262,CC:2F:71:3F:1F:24,9352350,9779212012,6135046,9372839654,3217304,406372358,80,1422449,854371653,1413893,853344205,8556,1027448,1369038,619,6139765,618592,80,5960,130000.0,43333.0,-70.0,-65.0,-70.0,-69.0,-69.0,-64.0,-69.0,-68.0,-77.0,-85.0,-77.0,-85.0,7.0,20.0,7.0,16.0,1
5263,F8:59:71:5A:E0:3D,3384808,654857358,167500,248484430,3217308,406372928,0,165719,206731869,160892,206155105,4827,576764,143245,16,170214,2938,0,543,144444.0,43333.0,-67.0,-74.0,-65.0,-71.0,-66.0,-72.0,-65.0,-70.0,-77.0,-85.0,-77.0,-85.0,10.0,11.0,12.0,14.0,1
5264,CC:2F:71:3E:C5:1F,3228736,407770958,11426,1397828,3217310,406373130,6,48749,4082984,40283,3079842,8466,1003142,12049,34,16390,186,6,827,130000.0,39000.0,-68.0,-70.0,-68.0,-60.0,-67.0,-69.0,-67.0,-60.0,-77.0,-85.0,-77.0,-85.0,9.0,15.0,9.0,25.0,1
5265,CC:2F:71:3F:1F:24,9353347,9780726514,6136037,9374353384,3217310,406373130,80,1422683,854503230,1414127,853475782,8556,1027448,1369272,619,6140755,618932,80,5961,115556.0,26000.0,-68.0,-64.0,-71.0,-70.0,-68.0,-64.0,-69.0,-70.0,-77.0,-85.0,-77.0,-85.0,9.0,21.0,6.0,15.0,1
5266,F8:59:71:5A:E0:3D,3384883,654963696,167568,248590102,3217315,406373594,0,165787,206836603,160960,206259839,4827,576764,143312,16,170282,2938,0,543,144444.0,43333.0,-67.0,-74.0,-65.0,-71.0,-66.0,-73.0,-65.0,-70.0,-77.0,-85.0,-77.0,-85.0,10.0,11.0,12.0,14.0,1
5267,CC:2F:71:3E:C5:1F,3228741,407771422,11426,1397828,3217315,406373594,6,48749,4082984,40283,3079842,8466,1003142,12049,34,16390,186,6,827,130000.0,39000.0,-68.0,-70.0,-68.0,-60.0,-67.0,-69.0,-67.0,-60.0,-77.0,-85.0,-77.0,-85.0,9.0,15.0,9.0,25.0,1
5268,CC:2F:71:3F:1F:24,9354350,9782259718,6137035,9375886124,3217315,406373594,80,1422903,854621018,1414347,853593570,8556,1027448,1369492,619,6141752,619018,80,5961,130000.0,43333.0,-70.0,-64.0,-69.0,-71.0,-70.0,-64.0,-69.0,-70.0,-77.0,-85.0,-77.0,-85.0,7.0,21.0,8.0,14.0,1
5269,F8:59:71:5A:E0:3D,3384945,655060044,167630,248686450,3217315,406373594,0,165850,206933623,161023,206356859,4827,576764,143375,16,170344,2939,0,543,144444.0,43333.0,-67.0,-74.0,-64.0,-71.0,-66.0,-73.0,-64.0,-70.0,-77.0,-85.0,-77.0,-85.0,10.0,11.0,13.0,14.0,1
5270,CC:2F:71:3E:C5:1F,3228743,407771624,11426,1397828,3217317,406373796,6,48749,4082984,40283,3079842,8466,1003142,12049,34,16390,186,6,827,130000.0,39000.0,-68.0,-70.0,-68.0,-60.0,-67.0,-69.0,-67.0,-60.0,-77.0,-85.0,-77.0,-85.0,9.0,15.0,9.0,25.0,1
5271,CC:2F:71:3F:1F:24,9355225,9783597274,6137908,9377223478,3217317,406373796,80,1423142,854738198,1414586,853710750,8556,1027448,1369731,619,6142627,619062,80,5961,130000.0,43333.0,-70.0,-64.0,-70.0,-71.0,-70.0,-64.0,-69.0,-71.0,-77.0,-85.0,-77.0,-85.0,7.0,21.0,7.0,14.0,1
5272,F8:59:71:5A:E0:3D,3385016,655158754,167693,248784352,3217323,406374402,0,165912,207029103,161085,206452339,4827,576764,143437,16,170407,2941,0,543,144444.0,43333.0,-66.0,-74.0,-65.0,-71.0,-66.0,-73.0,-64.0,-70.0,-77.0,-85.0,-77.0,-85.0,11.0,11.0,12.0,14.0,1
5273,CC:2F:71:3E:C5:1F,3228749,407772230,11426,1397828,3217323,406374402,6,48749,4082984,40283,3079842,8466,1003142,12049,34,16390,186,6,827,130000.0,39000.0,-68.0,-70.0,-68.0,-60.0,-67.0,-69.0,-67.0,-60.0,-77.0,-85.0,-77.0,-85.0,9.0,15.0,9.0,25.0,1
5274,CC:2F:71:3F:1F:24,9356448,9785476538,6139125,9379102136,3217323,406374402,80,1423402,854857794,1414846,853830346,8556,1027448,1369991,619,6143803,619137,80,5961,130000.0,39000.0,-70.0,-64.0,-69.0,-71.0,-70.0,-64.0,-69.0,-70.0,-77.0,-85.0,-77.0,-85.0,7.0,21.0,8.0,14.0,1
5275,F8:59:71:5A:E0:3D,3385080,655256716,167756,248882254,3217324,406374462,0,165977,207129217,161150,206552453,4827,576764,143501,16,170470,2941,0,543,144444.0,43333.0,-66.0,-73.0,-65.0,-71.0,-66.0,-73.0,-65.0,-70.0,-77.0,-85.0,-77.0,-85.0,11.0,12.0,12.0,14.0,1
5276,CC:2F:71:3E:C5:1F,3228750,407772290,11426,1397828,3217324,406374462,6,48749,4082984,40283,3079842,8466,1003142,12049,34,16390,186,6,827,130000.0,39000.0,-68.0,-70.0,-68.0,-60.0,-67.0,-69.0,-67.0,-60.0,-77.0,-85.0,-77.0,-85.0,9.0,15.0,9.0,25.0,1
5277,CC:2F:71:3F:1F:24,9358304,9788354480,6140980,9381980018,3217324,406374462,80,1423723,854989335,1415167,853961887,8556,1027448,1370308,619,6145682,619190,80,5961,130000.0,43333.0,-70.0,-65.0,-69.0,-71.0,-70.0,-64.0,-69.0,-71.0,-77.0,-85.0,-77.0,-85.0,7.0,20.0,8.0,14.0,1
5278,F8:59:71:5A:E0:3D,3385151,655358332,167821,248983264,3217330,406375068,0,166041,207227777,161214,206651013,4827,576764,143565,16,170535,2943,0,543,144444.0,43333.0,-66.0,-74.0,-66.0,-71.0,-66.0,-73.0,-65.0,-70.0,-77.0,-85.0,-77.0,-85.0,11.0,11.0,11.0,14.0,1
5279,CC:2F:71:3E:C5:1F,3228758,407773098,11426,1397828,3217332,406375270,6,48749,4082984,40283,3079842,8466,1003142,12049,34,16390,186,6,827,130000.0,39000.0,-68.0,-70.0,-68.0,-60.0,-67.0,-69.0,-67.0,-60.0,-77.0,-85.0,-77.0,-85.0,9.0,15.0,9.0,25.0,1
5280,CC:2F:71:3F:1F:24,9359915,9790843230,6142583,9384467960,3217332,406375270,80,1423990,855114347,1415434,854086899,8556,1027448,1370574,619,6147289,619195,80,5961,130000.0,43333.0,-69.0,-64.0,-69.0,-72.0,-70.0,-64.0,-69.0,-71.0,-77.0,-85.0,-77.0,-85.0,8.0,21.0,8.0,13.0,1
5281,F8:59:71:5A:E0:3D,3385217,655457934,167885,249082664,3217332,406375270,0,166106,207327877,161279,206751113,4827,576764,143630,16,170599,2944,0,543,130000.0,39000.0,-66.0,-74.0,-65.0,-71.0,-66.0,-73.0,-65.0,-70.0,-77.0,-85.0,-77.0,-85.0,11.0,11.0,12.0,14.0,1
5282,CC:2F:71:3E:C5:1F,3228758,407773098,11426,1397828,3217332,406375270,6,48749,4082984,40283,3079842,8466,1003142,12049,34,16390,186,6,827,130000.0,39000.0,-68.0,-70.0,-68.0,-60.0,-67.0,-69.0,-67.0,-60.0,-77.0,-85.0,-77.0,-85.0,9.0,15.0,9.0,25.0,1
5283,CC:2F:71:3F:1F:24,9360846,9792273452,6143514,9385898182,3217332,406375270,80,1424217,855233107,1415661,854205659,8556,1027448,1370801,619,6148233,619243,80,5961,130000.0,43333.0,-70.0,-65.0,-69.0,-71.0,-70.0,-65.0,-68.0,-71.0,-77.0,-85.0,-77.0,-85.0,7.0,20.0,8.0,14.0,1
5284,F8:59:71:5A:E0:3D,3385289,655559498,167950,249183562,3217339,406375936,0,166170,207426437,161343,206849673,4827,576764,143694,16,170664,2945,0,543,144444.0,43333.0,-67.0,-74.0,-65.0,-71.0,-66.0,-73.0,-64.0,-71.0,-77.0,-85.0,-77.0,-85.0,10.0,11.0,12.0,14.0,1
5285,CC:2F:71:3E:C5:1F,3228765,407773764,11426,1397828,3217339,406375936,6,48749,4082984,40283,3079842,8466,1003142,12049,34,16390,186,6,827,130000.0,39000.0,-68.0,-70.0,-68.0,-60.0,-67.0,-69.0,-67.0,-60.0,-77.0,-85.0,-77.0,-85.0,9.0,15.0,9.0,25.0,1
5286,CC:2F:71:3F:1F:24,9361911,9793899048,6144570,9387522910,3217341,406376138,80,1424477,855355615,1415921,854328167,8556,1027448,1371061,619,6149279,619320,80,5961,130000.0,43333.0,-70.0,-64.0,-70.0,-71.0,-70.0,-64.0,-69.0,-71.0,-77.0,-85.0,-77.0,-85.0,7.0,21.0,7.0,14.0,1
5287,F8:59:71:5A:E0:3D,3385355,655656290,168013,249280026,3217342,406376264,0,166234,207523563,161407,206946799,4827,576764,143758,16,170727,2945,0,543,144444.0,43333.0,-66.0,-73.0,-65.0,-71.0,-66.0,-73.0,-65.0,-70.0,-77.0,-85.0,-77.0,-85.0,11.0,12.0,12.0,14.0,1
5288,CC:2F:71:3E:C5:1F,3228768,407774092,11426,1397828,3217342,406376264,6,48749,4082984,40283,3079842,8466,1003142,12049,34,16390,186,6,827,130000.0,39000.0,-68.0,-70.0,-68.0,-60.0,-67.0,-69.0,-67.0,-60.0,-77.0,-85.0,-77.0,-85.0,9.0,15.0,9.0,25.0,1
5289,CC:2F:71:3F:1F:24,9362924,9795445636,6145582,9389069372,3217342,406376264,80,1424724,855475950,1416168,854448502,8556,1027448,1371307,619,6150301,619346,80,5962,130000.0,43333.0,-70.0,-64.0,-70.0,-71.0,-70.0,-64.0,-69.0,-71.0,-77.0,-85.0,-77.0,-85.0,7.0,21.0,7.0,14.0,1
5290,F8:59:71:5A:E0:3D,3385424,655754825,168076,249377816,3217348,406377009,0,166297,207620583,161470,207043819,4827,576764,143821,16,170790,2951,0,543,144444.0,43333.0,-66.0,-73.0,-65.0,-71.0,-66.0,-73.0,-65.0,-71.0,-77.0,-85.0,-77.0,-85.0,11.0,12.0,12.0,14.0,1
5291,CC:2F:71:3E:C5:1F,3228775,407774971,11426,1397828,3217349,406377143,6,48749,4082984,40283,3079842,8466,1003142,12049,34,16390,186,6,827,130000.0,39000.0,-68.0,-70.0,-68.0,-60.0,-67.0,-69.0,-67.0,-60.0,-77.0,-85.0,-77.0,-85.0,9.0,15.0,9.0,25.0,1
5292,CC:2F:71:3F:1F:24,9363975,9797050437,6146625,9390673234,3217350,406377203,80,1424994,855598280,1416438,854570832,8556,1027448,1371577,619,6151344,619379,80,5962,130000.0,43333.0,-70.0,-65.0,-68.0,-71.0,-70.0,-64.0,-68.0,-71.0,-77.0,-85.0,-77.0,-85.0,7.0,20.0,9.0,14.0,1
5293,F8:59:71:5A:E0:3D,3385491,655853123,168139,249475718,3217352,406377405,0,166359,207716063,161532,207139299,4827,576764,143883,16,170853,2952,0,543,144444.0,43333.0,-67.0,-73.0,-65.0,-71.0,-66.0,-73.0,-65.0,-70.0,-77.0,-85.0,-77.0,-85.0,10.0,12.0,12.0,14.0,1
5294,CC:2F:71:3E:C5:1F,3228778,407775233,11426,1397828,3217352,406377405,6,48749,4082984,40283,3079842,8466,1003142,12049,34,16390,186,6,827,130000.0,39000.0,-68.0,-70.0,-68.0,-60.0,-67.0,-69.0,-67.0,-60.0,-77.0,-85.0,-77.0,-84.0,9.0,15.0,9.0,24.0,1
5295,CC:2F:71:3F:1F:24,9364831,9798356507,6147479,9391979102,3217352,406377405,80,1425187,855711720,1416631,854684272,8556,1027448,1371770,619,6152198,619471,80,5962,130000.0,43333.0,-70.0,-65.0,-69.0,-71.0,-70.0,-65.0,-68.0,-70.0,-77.0,-85.0,-77.0,-84.0,7.0,20.0,8.0,13.0,1
5296,F8:59:71:5A:E0:3D,3385556,655951227,168202,249573620,3217354,406377607,0,166423,207814623,161596,207237859,4827,576764,143947,16,170916,2952,0,543,144444.0,43333.0,-66.0,-73.0,-65.0,-71.0,-66.0,-73.0,-64.0,-71.0,-77.0,-85.0,-77.0,-84.0,11.0,12.0,12.0,13.0,1
5297,CC:2F:71:3E:C5:1F,3228782,407775637,11426,1397828,3217356,406377809,6,48749,4082984,40283,3079842,8466,1003142,12049,34,16390,186,6,827,130000.0,39000.0,-68.0,-70.0,-68.0,-60.0,-67.0,-69.0,-67.0,-60.0,-77.0,-85.0,-77.0,-84.0,9.0,15.0,9.0,24.0,1
5298,CC:2F:71:3F:1F:24,9365497,9799360003,6148141,9392982194,3217356,406377809,80,1425377,855824664,1416821,854797216,8556,1027448,1371960,619,6152860,619518,80,5962,130000.0,43333.0,-70.0,-64.0,-70.0,-71.0,-70.0,-64.0,-69.0,-71.0,-77.0,-85.0,-77.0,-84.0,7.0,21.0,7.0,13.0,1
5299,F8:59:71:5A:E0:3D,3385625,656049735,168265,249671522,3217360,406378213,0,166486,207911643,161659,207334879,4827,576764,144010,16,170979,2953,0,543,144444.0,43333.0,-67.0,-73.0,-65.0,-71.0,-66.0,-73.0,-64.0,-70.0,-77.0,-85.0,-77.0,-84.0,10.0,12.0,12.0,13.0,1
5300,CC:2F:71:3E:C5:1F,3228787,407776101,11426,1397828,3217361,406378273,6,48749,4082984,40283,3079842,8466,1003142,12049,34,16390,186,6,827,130000.0,39000.0,-68.0,-70.0,-68.0,-60.0,-67.0,-69.0,-67.0,-60.0,-77.0,-85.0,-77.0,-84.0,9.0,15.0,9.0,24.0,1
5301,CC:2F:71:3F:1F:24,9366567,9800990774,6149206,9394612501,3217361,406378273,80,1425608,855942811,1417052,854915363,8556,1027448,1372191,619,6153925,619590,80,5962,130000.0,43333.0,-70.0,-65.0,-68.0,-71.0,-70.0,-65.0,-68.0,-71.0,-77.0,-85.0,-77.0,-84.0,7.0,20.0,9.0,13.0,1
5302,F8:59:71:5A:E0:3D,3385692,656152359,168331,249774086,3217361,406378273,0,166551,208011743,161724,207434979,4827,576764,144075,16,171045,2953,0,543,144444.0,43333.0,-66.0,-73.0,-65.0,-71.0,-66.0,-72.0,-64.0,-70.0,-77.0,-85.0,-77.0,-84.0,11.0,12.0,12.0,13.0,1
5303,CC:2F:71:3E:C5:1F,3228789,407776303,11426,1397828,3217363,406378475,6,48749,4082984,40283,3079842,8466,1003142,12049,34,16390,186,6,827,130000.0,39000.0,-68.0,-70.0,-68.0,-60.0,-67.0,-69.0,-67.0,-60.0,-77.0,-85.0,-77.0,-84.0,9.0,15.0,9.0,24.0,1
5304,CC:2F:71:3F:1F:24,9367982,9803181994,6150619,9396803519,3217363,406378475,80,1425852,856064875,1417296,855037427,8556,1027448,1372431,619,6155324,619628,80,5962,130000.0,43333.0,-70.0,-65.0,-69.0,-71.0,-70.0,-65.0,-68.0,-71.0,-77.0,-85.0,-77.0,-84.0,7.0,20.0,8.0,13.0,1
5305,F8:59:71:5A:E0:3D,3385766,656254293,168397,249875212,3217369,406379081,0,166616,208111843,161789,207535079,4827,576764,144140,16,171111,2953,0,543,144444.0,43333.0,-66.0,-73.0,-65.0,-70.0,-66.0,-73.0,-64.0,-70.0,-77.0,-85.0,-77.0,-84.0,11.0,12.0,12.0,14.0,1
5306,CC:2F:71:3E:C5:1F,3228796,407777025,11427,1397944,3217369,406379081,6,48751,4083124,40285,3079982,8466,1003142,12049,34,16391,186,6,827,130000.0,39000.0,-68.0,-71.0,-67.0,-61.0,-67.0,-69.0,-67.0,-60.0,-77.0,-85.0,-77.0,-84.0,9.0,14.0,10.0,23.0,1
5307,CC:2F:71:3F:1F:24,9368836,9804478890,6151467,9398099809,3217369,406379081,80,1426045,856185585,1417489,855158137,8556,1027448,1372618,619,6156186,619656,80,5962,130000.0,43333.0,-71.0,-65.0,-70.0,-71.0,-70.0,-64.0,-69.0,-71.0,-77.0,-85.0,-77.0,-84.0,6.0,20.0,7.0,13.0,1
5308,F8:59:71:5A:E0:3D,3385834,656358471,168464,249979330,3217370,406379141,0,166684,208216563,161857,207639799,4827,576764,144208,16,171178,2953,0,543,144444.0,43333.0,-67.0,-73.0,-65.0,-71.0,-66.0,-73.0,-65.0,-70.0,-77.0,-85.0,-77.0,-84.0,10.0,12.0,12.0,13.0,1
5309,CC:2F:71:3E:C5:1F,3228799,407777287,11427,1397944,3217372,406379343,6,48751,4083124,40285,3079982,8466,1003142,12049,34,16391,186,6,827,130000.0,39000.0,-68.0,-71.0,-67.0,-61.0,-67.0,-69.0,-67.0,-60.0,-77.0,-85.0,-77.0,-84.0,9.0,14.0,10.0,23.0,1
5310,CC:2F:71:3F:1F:24,9369681,9805767588,6152309,9399388245,3217372,406379343,80,1426224,856305853,1417668,855278405,8556,1027448,1372797,619,6157028,619682,80,5962,130000.0,43333.0,-70.0,-64.0,-69.0,-71.0,-69.0,-64.0,-68.0,-71.0,-77.0,-85.0,-77.0,-84.0,7.0,21.0,8.0,13.0,1
5311,F8:59:71:5A:E0:3D,3385910,656464951,168532,250085002,3217378,406379949,0,166751,208319743,161924,207742979,4827,576764,144275,16,171246,2953,0,543,144444.0,43333.0,-66.0,-73.0,-64.0,-70.0,-66.0,-73.0,-64.0,-70.0,-77.0,-85.0,-77.0,-84.0,11.0,12.0,13.0,14.0,1
5312,CC:2F:71:3E:C5:1F,3228805,407777893,11427,1397944,3217378,406379949,6,48751,4083124,40285,3079982,8466,1003142,12049,34,16391,186,6,827,130000.0,39000.0,-68.0,-71.0,-67.0,-61.0,-67.0,-69.0,-67.0,-60.0,-77.0,-85.0,-77.0,-84.0,9.0,14.0,10.0,23.0,1
5313,CC:2F:71:3F:1F:24,9370539,9807066096,6153161,9400686147,3217378,406379949,80,1426402,856425078,1417846,855397630,8556,1027448,1372975,619,6157880,619693,80,5962,130000.0,43333.0,-70.0,-64.0,-69.0,-71.0,-70.0,-64.0,-68.0,-71.0,-77.0,-85.0,-77.0,-84.0,7.0,21.0,8.0,13.0,1
5314,F8:59:71:5A:E0:3D,3385976,656567515,168598,250187566,3217378,406379949,0,166818,208422923,161991,207846159,4827,576764,144342,16,171312,2954,0,543,144444.0,43333.0,-67.0,-74.0,-65.0,-71.0,-66.0,-72.0,-65.0,-70.0,-77.0,-85.0,-77.0,-84.0,10.0,11.0,12.0,13.0,1
5315,CC:2F:71:3E:C5:1F,3228805,407777893,11427,1397944,3217378,406379949,6,48751,4083124,40285,3079982,8466,1003142,12049,34,16391,186,6,827,130000.0,39000.0,-68.0,-71.0,-67.0,-61.0,-67.0,-69.0,-67.0,-60.0,-77.0,-85.0,-77.0,-84.0,9.0,14.0,10.0,23.0,1
5316,CC:2F:71:3F:1F:24,9371578,9808663836,6154200,9402283887,3217378,406379949,80,1426584,856537134,1418028,855509686,8556,1027448,1373157,619,6158919,619756,80,5962,130000.0,43333.0,-70.0,-65.0,-69.0,-71.0,-70.0,-64.0,-69.0,-71.0,-77.0,-85.0,-77.0,-84.0,7.0,20.0,8.0,13.0,1
5317,F8:59:71:5A:E0:3D,3386048,656666285,168661,250285468,3217387,406380817,0,166881,208519943,162054,207943179,4827,576764,144405,16,171375,2954,0,543,144444.0,43333.0,-66.0,-73.0,-65.0,-71.0,-66.0,-73.0,-65.0,-70.0,-77.0,-85.0,-77.0,-84.0,11.0,12.0,12.0,13.0,1
5318,CC:2F:71:3E:C5:1F,3228814,407778761,11427,1397944,3217387,406380817,6,48751,4083124,40285,3079982,8466,1003142,12049,34,16391,186,6,827,130000.0,39000.0,-68.0,-71.0,-67.0,-61.0,-67.0,-69.0,-67.0,-60.0,-77.0,-85.0,-77.0,-84.0,9.0,14.0,10.0,23.0,1
5319,CC:2F:71:3F:1F:24,9372991,9810837151,6155604,9404456334,3217387,406380817,80,1426822,856655771,1418266,855628323,8556,1027448,1373395,619,6160323,619859,80,5963,130000.0,43333.0,-70.0,-65.0,-69.0,-71.0,-70.0,-65.0,-69.0,-71.0,-77.0,-85.0,-77.0,-84.0,7.0,20.0,8.0,13.0,1
5320,F8:59:71:5A:E0:3D,3386111,656764187,168724,250383370,3217387,406380817,0,166945,208618573,162118,208041809,4827,576764,144468,16,171438,2954,0,543,144444.0,43333.0,-66.0,-74.0,-65.0,-71.0,-66.0,-73.0,-64.0,-71.0,-77.0,-85.0,-77.0,-84.0,11.0,11.0,12.0,13.0,1
5321,CC:2F:71:3E:C5:1F,3228814,407778761,11427,1397944,3217387,406380817,6,48751,4083124,40285,3079982,8466,1003142,12049,34,16391,186,6,827,130000.0,39000.0,-68.0,-71.0,-67.0,-61.0,-67.0,-69.0,-67.0,-60.0,-77.0,-85.0,-77.0,-84.0,9.0,14.0,10.0,23.0,1
5322,CC:2F:71:3F:1F:24,9374043,9812455439,6156656,9406074622,3217387,406380817,80,1427068,856775199,1418512,855747751,8556,1027448,1373641,619,6161375,619917,80,5963,130000.0,43333.0,-70.0,-65.0,-69.0,-71.0,-70.0,-64.0,-68.0,-71.0,-77.0,-85.0,-77.0,-84.0,7.0,20.0,8.0,13.0,1
5323,F8:59:71:5A:E0:3D,3386183,656864451,168788,250482826,3217395,406381625,0,167008,208715593,162181,208138829,4827,576764,144531,16,171502,2955,0,543,144444.0,43333.0,-67.0,-74.0,-65.0,-71.0,-66.0,-73.0,-65.0,-71.0,-77.0,-85.0,-77.0,-84.0,10.0,11.0,12.0,13.0,1
5324,CC:2F:71:3E:C5:1F,3228822,407779569,11427,1397944,3217395,406381625,6,48751,4083124,40285,3079982,8466,1003142,12049,34,16391,186,6,827,130000.0,39000.0,-68.0,-71.0,-67.0,-61.0,-67.0,-69.0,-67.0,-60.0,-77.0,-85.0,-77.0,-84.0,9.0,14.0,10.0,23.0,1
5325,CC:2F:71:3F:1F:24,9375225,9814267275,6157830,9407885650,3217395,406381625,80,1427278,856891977,1418722,855864529,8556,1027448,1373851,619,6162515,620037,80,5965,130000.0,43333.0,-70.0,-65.0,-68.0,-71.0,-70.0,-64.0,-68.0,-71.0,-77.0,-85.0,-77.0,-84.0,7.0,20.0,9.0,13.0,1
5326,F8:59:71:5A:E0:3D,3386248,656963967,168852,250582282,3217396,406381685,0,167073,208815693,162246,208238929,4827,576764,144596,16,171566,2955,0,543,144444.0,43333.0,-66.0,-73.0,-65.0,-71.0,-66.0,-73.0,-65.0,-70.0,-77.0,-85.0,-77.0,-84.0,11.0,12.0,12.0,13.0,1
5327,CC:2F:71:3E:C5:1F,3228823,407779629,11427,1397944,3217396,406381685,6,48751,4083124,40285,3079982,8466,1003142,12049,34,16391,186,6,827,130000.0,39000.0,-68.0,-71.0,-67.0,-61.0,-67.0,-69.0,-67.0,-60.0,-77.0,-85.0,-77.0,-84.0,9.0,14.0,10.0,23.0,1
5328,CC:2F:71:3F:1F:24,9376989,9816983550,6159593,9410601865,3217396,406381685,80,1427604,857028959,1419048,856001511,8556,1027448,1374177,619,6164312,620095,80,5965,130000.0,43333.0,-70.0,-65.0,-68.0,-71.0,-70.0,-64.0,-68.0,-70.0,-77.0,-85.0,-77.0,-84.0,7.0,20.0,9.0,13.0,1
5329,F8:59:71:5A:E0:3D,3386327,657075109,168923,250692616,3217404,406382493,0,167143,208923493,162316,208346729,4827,576764,144666,16,171637,2957,0,543,144444.0,43333.0,-67.0,-73.0,-66.0,-71.0,-66.0,-73.0,-65.0,-70.0,-77.0,-85.0,-77.0,-84.0,10.0,12.0,11.0,13.0,1
5330,CC:2F:71:3E:C5:1F,3228831,407780437,11427,1397944,3217404,406382493,6,48751,4083124,40285,3079982,8466,1003142,12049,34,16391,186,6,827,130000.0,39000.0,-68.0,-71.0,-67.0,-61.0,-67.0,-69.0,-67.0,-60.0,-77.0,-85.0,-77.0,-84.0,9.0,14.0,10.0,23.0,1
5331,CC:2F:71:3F:1F:24,9378273,9818957470,6160869,9412574977,3217404,406382493,80,1427837,857152847,1419281,856125399,8556,1027448,1374410,619,6165567,620209,80,5965,130000.0,43333.0,-72.0,-65.0,-69.0,-71.0,-70.0,-65.0,-68.0,-71.0,-77.0,-85.0,-77.0,-84.0,5.0,20.0,8.0,13.0,1
5332,F8:59:71:5A:E0:3D,3386391,657173284,168986,250790518,3217405,406382766,0,167206,209020513,162379,208443749,4827,576764,144729,16,171700,2957,0,543,144444.0,43333.0,-67.0,-73.0,-65.0,-71.0,-66.0,-73.0,-65.0,-71.0,-77.0,-85.0,-77.0,-84.0,10.0,12.0,12.0,13.0,1
5333,CC:2F:71:3E:C5:1F,3228832,407780710,11427,1397944,3217405,406382766,6,48751,4083124,40285,3079982,8466,1003142,12049,34,16391,186,6,827,130000.0,39000.0,-68.0,-71.0,-67.0,-61.0,-67.0,-69.0,-67.0,-60.0,-77.0,-85.0,-77.0,-84.0,9.0,14.0,10.0,23.0,1
5334,CC:2F:71:3F:1F:24,9379267,9820481635,6161861,9414098809,3217406,406382826,80,1428092,857273339,1419536,856245891,8556,1027448,1374665,619,6166580,620227,80,5965,130000.0,43333.0,-70.0,-65.0,-69.0,-72.0,-70.0,-65.0,-68.0,-71.0,-77.0,-85.0,-77.0,-84.0,7.0,20.0,8.0,12.0,1
5335,F8:59:71:5A:E0:3D,3386457,657271448,169049,250888420,3217408,406383028,0,167269,209117533,162442,208540769,4827,576764,144792,16,171762,2957,0,543,144444.0,43333.0,-67.0,-74.0,-65.0,-71.0,-66.0,-73.0,-65.0,-71.0,-77.0,-85.0,-77.0,-84.0,10.0,11.0,12.0,13.0,1
5336,CC:2F:71:3E:C5:1F,3228837,407781174,11427,1397944,3217410,406383230,6,48751,4083124,40285,3079982,8466,1003142,12049,34,16391,186,6,827,130000.0,39000.0,-68.0,-71.0,-67.0,-61.0,-67.0,-69.0,-67.0,-60.0,-77.0,-85.0,-77.0,-84.0,9.0,14.0,10.0,23.0,1
5337,CC:2F:71:3F:1F:24,9380694,9822681309,6163281,9416297809,3217413,406383500,80,1428351,857395663,1419795,856368215,8556,1027448,1374924,619,6167966,620308,80,5965,130000.0,39000.0,-71.0,-65.0,-70.0,-71.0,-70.0,-64.0,-68.0,-71.0,-77.0,-85.0,-77.0,-84.0,6.0,20.0,7.0,13.0,1
5338,F8:59:71:5A:E0:3D,3386527,657371510,169113,250987876,3217414,406383634,0,167334,209217633,162507,208640869,4827,576764,144857,16,171827,2958,0,543,144444.0,43333.0,-67.0,-71.0,-64.0,-71.0,-66.0,-72.0,-64.0,-71.0,-77.0,-85.0,-77.0,-84.0,10.0,14.0,13.0,13.0,1
5339,CC:2F:71:3E:C5:1F,3228841,407781578,11427,1397944,3217414,406383634,6,48751,4083124,40285,3079982,8466,1003142,12049,34,16391,186,6,827,130000.0,39000.0,-68.0,-71.0,-67.0,-61.0,-67.0,-69.0,-67.0,-60.0,-77.0,-85.0,-77.0,-84.0,9.0,14.0,10.0,23.0,1
5340,CC:2F:71:3F:1F:24,9381650,9824137589,6164236,9417753955,3217414,406383634,80,1428588,857514738,1420032,856487290,8556,1027448,1375161,619,6168955,620336,80,5965,130000.0,43333.0,-70.0,-65.0,-69.0,-71.0,-70.0,-64.0,-68.0,-71.0,-77.0,-85.0,-77.0,-84.0,7.0,20.0,8.0,13.0,1
5341,F8:59:71:5A:E0:3D,3386596,657471352,169177,251087332,3217419,406384020,0,167398,209314771,162570,208737889,4828,576882,144921,16,171891,2958,0,543,144444.0,43333.0,-66.0,-73.0,-65.0,-71.0,-66.0,-73.0,-65.0,-70.0,-77.0,-85.0,-77.0,-84.0,11.0,12.0,12.0,13.0,1
5342,CC:2F:71:3E:C5:1F,3228846,407781964,11427,1397944,3217419,406384020,6,48751,4083124,40285,3079982,8466,1003142,12049,34,16391,186,6,827,130000.0,39000.0,-68.0,-71.0,-67.0,-61.0,-67.0,-69.0,-67.0,-60.0,-77.0,-85.0,-77.0,-84.0,9.0,14.0,10.0,23.0,1
5343,CC:2F:71:3F:1F:24,9382629,9825633403,6165210,9419249383,3217419,406384020,80,1428852,857637718,1420295,856610152,8557,1027566,1375424,619,6169929,620378,80,5965,130000.0,43333.0,-70.0,-64.0,-69.0,-71.0,-70.0,-64.0,-68.0,-71.0,-77.0,-85.0,-77.0,-84.0,7.0,21.0,8.0,13.0,1
5344,F8:59:71:5A:E0:3D,3386666,657569922,169240,251185234,3217426,406384688,0,167461,209411791,162633,208834909,4828,576882,144984,16,171954,2958,0,543,144444.0,43333.0,-67.0,-74.0,-65.0,-71.0,-66.0,-73.0,-65.0,-71.0,-77.0,-85.0,-77.0,-84.0,10.0,11.0,12.0,13.0,1
5345,CC:2F:71:3E:C5:1F,3228853,407782632,11427,1397944,3217426,406384688,6,48753,4083312,40286,3080052,8467,1003260,12050,34,16391,186,6,828,130000.0,39000.0,-68.0,-70.0,-67.0,-60.0,-68.0,-70.0,-67.0,-61.0,-77.0,-85.0,-77.0,-84.0,9.0,15.0,10.0,24.0,1
5346,CC:2F:71:3F:1F:24,9383574,9827072355,6166148,9420687667,3217426,406384688,80,1429066,857752040,1420509,856724474,8557,1027566,1375638,619,6170847,620469,80,5966,117000.0,39000.0,-70.0,-64.0,-69.0,-71.0,-70.0,-64.0,-68.0,-71.0,-77.0,-85.0,-77.0,-84.0,7.0,21.0,8.0,13.0,1
5347,F8:59:71:5A:E0:3D,3386728,657666270,169302,251281582,3217426,406384688,0,167524,209508811,162696,208931929,4828,576882,145047,16,172016,2958,0,543,144444.0,43333.0,-66.0,-73.0,-65.0,-70.0,-66.0,-73.0,-64.0,-70.0,-77.0,-85.0,-77.0,-84.0,11.0,12.0,12.0,14.0,1
5348,CC:2F:71:3E:C5:1F,3228853,407782632,11427,1397944,3217426,406384688,6,48753,4083312,40286,3080052,8467,1003260,12050,34,16391,186,6,828,130000.0,39000.0,-68.0,-70.0,-67.0,-60.0,-68.0,-70.0,-67.0,-61.0,-77.0,-85.0,-77.0,-84.0,9.0,15.0,10.0,24.0,1
5349,CC:2F:71:3F:1F:24,9384862,9829061633,6167434,9422676743,3217428,406384890,80,1429322,857874108,1420765,856846542,8557,1027566,1375894,619,6172152,620497,80,5966,130000.0,43333.0,-70.0,-64.0,-69.0,-71.0,-69.0,-64.0,-68.0,-71.0,-77.0,-85.0,-77.0,-84.0,7.0,21.0,8.0,13.0,1
5350,F8:59:71:5A:E0:3D,3386809,657769336,169366,251380870,3217443,406388466,0,167588,209607371,162760,209030489,4828,576882,145111,16,172080,2960,0,543,144444.0,43333.0,-66.0,-74.0,-65.0,-71.0,-66.0,-73.0,-64.0,-71.0,-77.0,-85.0,-77.0,-84.0,11.0,11.0,12.0,13.0,1
5351,CC:2F:71:3E:C5:1F,3228870,407786410,11427,1397944,3217443,406388466,6,48753,4083312,40286,3080052,8467,1003260,12050,34,16391,186,6,828,130000.0,39000.0,-68.0,-70.0,-67.0,-60.0,-68.0,-70.0,-67.0,-61.0,-77.0,-85.0,-77.0,-84.0,9.0,15.0,10.0,24.0,1
5352,CC:2F:71:3F:1F:24,9386234,9831158911,6168791,9424770445,3217443,406388466,80,1429600,857997802,1421043,856970236,8557,1027566,1376172,619,6173510,620598,80,5966,130000.0,43333.0,-70.0,-65.0,-68.0,-71.0,-70.0,-65.0,-68.0,-71.0,-77.0,-85.0,-77.0,-84.0,7.0,20.0,9.0,13.0,1
5353,F8:59:71:5A:E0:3D,3386873,657868792,169430,251480326,3217443,406388466,0,167651,209704391,162823,209127509,4828,576882,145174,16,172144,2961,0,543,144444.0,43333.0,-66.0,-73.0,-65.0,-71.0,-66.0,-73.0,-65.0,-71.0,-77.0,-85.0,-77.0,-84.0,11.0,12.0,12.0,13.0,1
5354,CC:2F:71:3E:C5:1F,3228870,407786410,11427,1397944,3217443,406388466,6,48753,4083312,40286,3080052,8467,1003260,12050,34,16391,186,6,828,130000.0,39000.0,-68.0,-70.0,-67.0,-60.0,-68.0,-70.0,-67.0,-61.0,-77.0,-85.0,-77.0,-84.0,9.0,15.0,10.0,24.0,1
5355,CC:2F:71:3F:1F:24,9387556,9833204683,6170113,9426816217,3217443,406388466,80,1429895,858122944,1421338,857095378,8557,1027566,1376467,619,6174826,620694,80,5966,130000.0,43333.0,-69.0,-65.0,-68.0,-71.0,-69.0,-65.0,-68.0,-71.0,-77.0,-85.0,-77.0,-84.0,8.0,20.0,9.0,13.0,1
5356,F8:59:71:5A:E0:3D,3386944,657966064,169493,251576790,3217451,406389274,0,167714,209799977,162886,209223095,4828,576882,145237,16,172207,2961,0,543,144444.0,43333.0,-67.0,-73.0,-65.0,-71.0,-66.0,-73.0,-65.0,-71.0,-77.0,-85.0,-77.0,-84.0,10.0,12.0,12.0,13.0,1
5357,CC:2F:71:3E:C5:1F,3228878,407787218,11427,1397944,3217451,406389274,6,48753,4083312,40286,3080052,8467,1003260,12050,34,16391,186,6,828,130000.0,39000.0,-68.0,-70.0,-67.0,-60.0,-68.0,-70.0,-67.0,-61.0,-77.0,-85.0,-77.0,-84.0,9.0,15.0,10.0,24.0,1
5358,CC:2F:71:3F:1F:24,9388739,9835018107,6171288,9428628833,3217451,406389274,80,1430150,858243382,1421593,857215816,8557,1027566,1376722,619,6176007,620717,80,5966,130000.0,43333.0,-69.0,-64.0,-68.0,-71.0,-70.0,-64.0,-68.0,-71.0,-77.0,-85.0,-77.0,-84.0,8.0,21.0,9.0,13.0,1
5359,F8:59:71:5A:E0:3D,3387007,658062472,169555,251673138,3217452,406389334,0,167777,209896997,162949,209320115,4828,576882,145300,16,172269,2961,0,543,144444.0,43333.0,-67.0,-74.0,-65.0,-71.0,-66.0,-73.0,-65.0,-70.0,-77.0,-85.0,-77.0,-84.0,10.0,11.0,12.0,13.0,1
5360,CC:2F:71:3E:C5:1F,3228879,407787278,11427,1397944,3217452,406389334,6,48753,4083312,40286,3080052,8467,1003260,12050,34,16391,186,6,828,130000.0,39000.0,-68.0,-70.0,-67.0,-60.0,-68.0,-70.0,-67.0,-61.0,-77.0,-85.0,-77.0,-84.0,9.0,15.0,10.0,24.0,1
5361,CC:2F:71:3F:1F:24,9389832,9836701247,6172380,9430311913,3217452,406389334,80,1430366,858359334,1421809,857331768,8557,1027566,1376938,619,6177099,620810,80,5966,130000.0,43333.0,-70.0,-65.0,-69.0,-71.0,-70.0,-64.0,-68.0,-71.0,-77.0,-85.0,-77.0,-84.0,7.0,20.0,8.0,13.0,1
5362,F8:59:71:5A:E0:3D,3387077,658162534,169619,251772594,3217458,406389940,0,167841,209995557,163013,209418675,4828,576882,145364,16,172333,2962,0,543,144444.0,43333.0,-67.0,-73.0,-65.0,-71.0,-66.0,-73.0,-65.0,-71.0,-77.0,-85.0,-77.0,-84.0,10.0,12.0,12.0,13.0,1
5363,CC:2F:71:3E:C5:1F,3228885,407787884,11427,1397944,3217458,406389940,6,48753,4083312,40286,3080052,8467,1003260,12050,34,16391,186,6,828,130000.0,39000.0,-68.0,-70.0,-67.0,-60.0,-68.0,-70.0,-67.0,-61.0,-77.0,-85.0,-77.0,-84.0,9.0,15.0,10.0,24.0,1
5364,CC:2F:71:3F:1F:24,9391153,9838733649,6173693,9432343507,3217460,406390142,80,1430596,858477104,1422039,857449538,8557,1027566,1377168,619,6178401,621108,80,5966,130000.0,43333.0,-71.0,-65.0,-68.0,-71.0,-70.0,-65.0,-68.0,-71.0,-77.0,-85.0,-77.0,-84.0,6.0,20.0,9.0,13.0,1
5365,F8:59:71:5A:E0:3D,3387142,658260638,169682,251870496,3217460,406390142,0,167904,210092577,163076,209515695,4828,576882,145427,16,172396,2963,0,543,144444.0,43333.0,-66.0,-73.0,-65.0,-70.0,-66.0,-73.0,-64.0,-70.0,-77.0,-85.0,-77.0,-84.0,11.0,12.0,12.0,14.0,1
5366,CC:2F:71:3E:C5:1F,3228887,407788086,11427,1397944,3217460,406390142,6,48753,4083312,40286,3080052,8467,1003260,12050,34,16391,186,6,828,130000.0,39000.0,-68.0,-70.0,-67.0,-60.0,-68.0,-70.0,-67.0,-61.0,-77.0,-85.0,-77.0,-84.0,9.0,15.0,10.0,24.0,1
5367,CC:2F:71:3F:1F:24,9392658,9841059287,6175198,9434669145,3217460,406390142,80,1430872,858602087,1422315,857574521,8557,1027566,1377444,619,6179917,621193,80,5966,117000.0,39000.0,-70.0,-65.0,-69.0,-71.0,-70.0,-65.0,-69.0,-71.0,-77.0,-85.0,-77.0,-84.0,7.0,20.0,8.0,13.0,1
5368,F8:59:71:5A:E0:3D,3387211,658360558,169746,251969952,3217465,406390606,0,167968,210191137,163140,209614255,4828,576882,145491,16,172460,2964,0,543,144444.0,43333.0,-66.0,-72.0,-65.0,-70.0,-66.0,-72.0,-65.0,-70.0,-77.0,-85.0,-77.0,-84.0,11.0,13.0,12.0,14.0,1
5369,CC:2F:71:3E:C5:1F,3228892,407788550,11427,1397944,3217465,406390606,6,48753,4083312,40286,3080052,8467,1003260,12050,34,16391,186,6,828,130000.0,39000.0,-68.0,-70.0,-67.0,-60.0,-68.0,-70.0,-67.0,-61.0,-77.0,-85.0,-77.0,-84.0,9.0,15.0,10.0,24.0,1
5370,CC:2F:71:3F:1F:24,9394042,9843195469,6176577,9436804863,3217465,406390606,80,1431118,858723051,1422561,857695485,8557,1027566,1377688,619,6181296,621278,80,5966,117000.0,39000.0,-70.0,-65.0,-69.0,-71.0,-70.0,-65.0,-68.0,-71.0,-77.0,-85.0,-77.0,-84.0,7.0,20.0,8.0,13.0,1
5371,F8:59:71:5A:E0:3D,3387278,658458864,169809,252067854,3217469,406391010,0,168031,210288157,163203,209711275,4828,576882,145554,16,172523,2965,0,543,144444.0,43333.0,-67.0,-73.0,-65.0,-71.0,-66.0,-72.0,-65.0,-71.0,-77.0,-85.0,-77.0,-84.0,10.0,12.0,12.0,13.0,1
5372,CC:2F:71:3E:C5:1F,3228896,407788954,11427,1397944,3217469,406391010,6,48753,4083312,40286,3080052,8467,1003260,12050,34,16391,186,6,828,130000.0,39000.0,-68.0,-70.0,-67.0,-60.0,-68.0,-70.0,-67.0,-61.0,-77.0,-85.0,-77.0,-84.0,9.0,15.0,10.0,24.0,1
5373,CC:2F:71:3F:1F:24,9395675,9845724779,6178206,9439333769,3217469,406391010,80,1431391,858845539,1422834,857817973,8557,1027566,1377961,619,6182925,621322,80,5966,130000.0,43333.0,-70.0,-65.0,-69.0,-71.0,-70.0,-65.0,-68.0,-70.0,-77.0,-85.0,-77.0,-84.0,7.0,20.0,8.0,13.0,1
5374,F8:59:71:5A:E0:3D,3387348,658560551,169874,252168864,3217474,406391687,0,168096,210388257,163268,209811375,4828,576882,145619,16,172588,2965,0,543,144444.0,43333.0,-67.0,-73.0,-65.0,-71.0,-66.0,-73.0,-65.0,-71.0,-77.0,-85.0,-77.0,-84.0,10.0,12.0,12.0,13.0,1
5375,CC:2F:71:3E:C5:1F,3228901,407789631,11427,1397944,3217474,406391687,6,48753,4083312,40286,3080052,8467,1003260,12050,34,16391,186,6,828,130000.0,39000.0,-68.0,-70.0,-67.0,-60.0,-68.0,-70.0,-67.0,-61.0,-77.0,-85.0,-77.0,-84.0,9.0,15.0,10.0,24.0,1
5376,CC:2F:71:3F:1F:24,9397014,9847790268,6179540,9441398581,3217474,406391687,80,1431660,858970675,1423103,857943109,8557,1027566,1378230,619,6184259,621421,80,5966,130000.0,43333.0,-70.0,-65.0,-69.0,-71.0,-70.0,-65.0,-69.0,-71.0,-77.0,-85.0,-77.0,-84.0,7.0,20.0,8.0,13.0,1
5377,F8:59:71:5A:E0:3D,3387420,658665133,169941,252272982,3217479,406392151,0,168162,210489897,163334,209913015,4828,576882,145685,16,172655,2965,0,543,144444.0,43333.0,-67.0,-73.0,-64.0,-71.0,-66.0,-72.0,-65.0,-70.0,-77.0,-85.0,-77.0,-84.0,10.0,12.0,13.0,13.0,1
5378,CC:2F:71:3E:C5:1F,3228906,407790095,11427,1397944,3217479,406392151,6,48753,4083312,40286,3080052,8467,1003260,12050,34,16391,186,6,828,130000.0,39000.0,-68.0,-70.0,-67.0,-60.0,-68.0,-70.0,-67.0,-61.0,-77.0,-85.0,-77.0,-84.0,9.0,15.0,10.0,24.0,1
5379,CC:2F:71:3F:1F:24,9398601,9850239388,6181122,9443847237,3217479,406392151,80,1431927,859097439,1423370,858069873,8557,1027566,1378497,619,6185791,621487,80,5967,130000.0,43333.0,-70.0,-65.0,-68.0,-71.0,-70.0,-64.0,-68.0,-70.0,-77.0,-85.0,-77.0,-84.0,7.0,20.0,9.0,13.0,1
5380,F8:59:71:5A:E0:3D,3387485,658763237,170004,252370884,3217481,406392353,0,168226,210588457,163398,210011575,4828,576882,145749,16,172718,2966,0,543,144444.0,43333.0,-66.0,-71.0,-65.0,-71.0,-66.0,-72.0,-65.0,-70.0,-77.0,-85.0,-77.0,-84.0,11.0,14.0,12.0,13.0,1
5381,CC:2F:71:3E:C5:1F,3228910,407790499,11427,1397944,3217483,406392555,6,48753,4083312,40286,3080052,8467,1003260,12050,34,16391,186,6,828,130000.0,39000.0,-68.0,-70.0,-67.0,-60.0,-68.0,-70.0,-67.0,-61.0,-77.0,-85.0,-77.0,-84.0,9.0,15.0,10.0,24.0,1
5382,CC:2F:71:3F:1F:24,9400187,9852694620,6182704,9446302065,3217483,406392555,80,1432181,859219379,1423624,858191813,8557,1027566,1378747,619,6187415,621529,80,5967,130000.0,43333.0,-70.0,-65.0,-69.0,-71.0,-69.0,-64.0,-69.0,-71.0,-77.0,-85.0,-77.0,-84.0,7.0,20.0,8.0,13.0,1
5383,F8:59:71:5A:E0:3D,3387555,658861823,170067,252468786,3217488,406393037,0,168289,210685477,163461,210108595,4828,576882,145812,16,172781,2966,0,543,144444.0,43333.0,-66.0,-73.0,-65.0,-71.0,-66.0,-73.0,-64.0,-71.0,-77.0,-85.0,-77.0,-84.0,11.0,12.0,12.0,13.0,1
5384,CC:2F:71:3E:C5:1F,3228915,407790981,11427,1397944,3217488,406393037,6,48753,4083312,40286,3080052,8467,1003260,12050,34,16391,186,6,828,130000.0,39000.0,-68.0,-70.0,-67.0,-60.0,-68.0,-70.0,-67.0,-61.0,-77.0,-85.0,-77.0,-84.0,9.0,15.0,10.0,24.0,1
5385,CC:2F:71:3F:1F:24,9401437,9854616450,6183948,9448223353,3217489,406393097,80,1432441,859339119,1423884,858311553,8557,1027566,1379007,619,6188667,621581,80,5969,130000.0,43333.0,-70.0,-64.0,-69.0,-71.0,-70.0,-64.0,-68.0,-71.0,-77.0,-85.0,-77.0,-84.0,7.0,21.0,8.0,13.0,1
5386,F8:59:71:5A:E0:3D,3387619,658959785,170130,252566688,3217489,406393097,0,168352,210782497,163524,210205615,4828,576882,145875,16,172844,2969,0,543,144444.0,43333.0,-67.0,-72.0,-65.0,-71.0,-66.0,-72.0,-65.0,-70.0,-77.0,-85.0,-77.0,-84.0,10.0,13.0,12.0,13.0,1
5387,CC:2F:71:3E:C5:1F,3228916,407791041,11427,1397944,3217489,406393097,6,48753,4083312,40286,3080052,8467,1003260,12050,34,16391,186,6,828,130000.0,39000.0,-68.0,-70.0,-67.0,-60.0,-68.0,-70.0,-67.0,-61.0,-77.0,-85.0,-77.0,-84.0,9.0,15.0,10.0,24.0,1
5388,CC:2F:71:3F:1F:24,9402386,9856070922,6184895,9449677623,3217491,406393299,80,1432650,859454259,1424093,858426693,8557,1027566,1379216,619,6189614,621613,80,5969,130000.0,43333.0,-71.0,-65.0,-69.0,-71.0,-69.0,-64.0,-68.0,-71.0,-77.0,-85.0,-77.0,-84.0,6.0,20.0,8.0,13.0,1
5389,F8:59:71:5A:E0:3D,3387691,659058611,170194,252664706,3217497,406393905,0,168415,210879545,163587,210302663,4828,576882,145938,16,172908,2970,0,544,144444.0,43333.0,-67.0,-73.0,-65.0,-71.0,-66.0,-73.0,-65.0,-71.0,-77.0,-85.0,-77.0,-84.0,10.0,12.0,12.0,13.0,1
5390,CC:2F:71:3E:C5:1F,3228925,407791965,11428,1398060,3217497,406393905,6,48754,4083382,40287,3080122,8467,1003260,12050,34,16392,186,6,828,130000.0,39000.0,-67.0,-70.0,-68.0,-61.0,-68.0,-70.0,-68.0,-61.0,-77.0,-85.0,-77.0,-84.0,10.0,15.0,9.0,23.0,1
5391,CC:2F:71:3F:1F:24,9403758,9858176582,6186259,9451782309,3217499,406394273,80,1432911,859577330,1424354,858549764,8557,1027566,1379477,619,6190978,621713,80,5969,130000.0,43333.0,-69.0,-64.0,-69.0,-71.0,-69.0,-64.0,-69.0,-71.0,-77.0,-85.0,-77.0,-84.0,8.0,21.0,8.0,13.0,1
5392,F8:59:71:5A:E0:3D,3387759,659158557,170258,252764162,3217501,406394395,0,168478,210976565,163650,210399683,4828,576882,146001,16,172972,2970,0,544,144444.0,43333.0,-66.0,-73.0,-65.0,-71.0,-66.0,-72.0,-64.0,-70.0,-77.0,-85.0,-77.0,-84.0,11.0,12.0,12.0,13.0,1
5393,CC:2F:71:3E:C5:1F,3228929,407792455,11428,1398060,3217501,406394395,6,48757,4083640,40289,3080262,8468,1003378,12051,34,16392,186,6,828,130000.0,39000.0,-68.0,-70.0,-67.0,-60.0,-68.0,-70.0,-67.0,-61.0,-77.0,-85.0,-77.0,-84.0,9.0,15.0,10.0,24.0,1
5394,CC:2F:71:3F:1F:24,9405129,9860296442,6187628,9453902047,3217501,406394395,80,1433180,859697984,1424623,858670418,8557,1027566,1379746,619,6192347,621844,80,5969,130000.0,43333.0,-69.0,-64.0,-70.0,-71.0,-69.0,-64.0,-69.0,-71.0,-77.0,-85.0,-77.0,-84.0,8.0,21.0,7.0,13.0,1
5395,F8:59:71:5A:E0:3D,3387831,659260235,170323,252865172,3217508,406395063,0,168543,211076665,163715,210499783,4828,576882,146066,16,173037,2971,0,544,144444.0,43333.0,-67.0,-74.0,-66.0,-71.0,-66.0,-74.0,-66.0,-70.0,-77.0,-85.0,-77.0,-84.0,10.0,11.0,11.0,13.0,1
5396,CC:2F:71:3E:C5:1F,3228938,407793325,11428,1398060,3217510,406395265,6,48757,4083640,40289,3080262,8468,1003378,12051,34,16392,186,6,828,130000.0,39000.0,-68.0,-70.0,-67.0,-60.0,-68.0,-70.0,-67.0,-61.0,-77.0,-85.0,-77.0,-84.0,9.0,15.0,10.0,24.0,1
5397,CC:2F:71:3F:1F:24,9406701,9862719958,6189191,9456324693,3217510,406395265,80,1433467,859829410,1424909,858801726,8558,1027684,1380033,619,6193905,622257,80,5970,86667.0,14444.0,-70.0,-64.0,-70.0,-70.0,-70.0,-63.0,-70.0,-70.0,-77.0,-85.0,-77.0,-84.0,7.0,21.0,7.0,14.0,1
5398,F8:59:71:5A:E0:3D,3387899,659363001,170389,252967736,3217510,406395265,0,168609,211178305,163781,210601423,4828,576882,146132,16,173103,2972,0,544,144444.0,43333.0,-66.0,-73.0,-65.0,-71.0,-65.0,-73.0,-64.0,-70.0,-77.0,-85.0,-77.0,-84.0,11.0,12.0,12.0,13.0,1
5399,CC:2F:71:3E:C5:1F,3228938,407793325,11428,1398060,3217510,406395265,6,48757,4083640,40289,3080262,8468,1003378,12051,34,16392,186,6,828,130000.0,39000.0,-68.0,-70.0,-67.0,-60.0,-68.0,-70.0,-67.0,-61.0,-77.0,-85.0,-77.0,-84.0,9.0,15.0,10.0,24.0,1
5400,CC:2F:71:3F:1F:24,9408094,9864875536,6190584,9458480271,3217510,406395265,80,1433801,859960610,1425243,858932926,8558,1027684,1380367,619,6195301,622272,80,5970,65000.0,14444.0,-67.0,-63.0,-70.0,-68.0,-67.0,-63.0,-71.0,-68.0,-77.0,-85.0,-77.0,-84.0,10.0,22.0,7.0,16.0,1
5401,F8:59:71:5A:E0:3D,3387967,659461367,170452,253065638,3217515,406395729,0,168673,211276865,163845,210699983,4828,576882,146196,16,173166,2973,0,544,144444.0,43333.0,-67.0,-74.0,-64.0,-70.0,-67.0,-73.0,-64.0,-70.0,-77.0,-85.0,-77.0,-84.0,10.0,11.0,13.0,14.0,1
5402,CC:2F:71:3E:C5:1F,3228943,407793789,11428,1398060,3217515,406395729,6,48757,4083640,40289,3080262,8468,1003378,12051,34,16392,186,6,828,130000.0,39000.0,-68.0,-70.0,-67.0,-60.0,-68.0,-70.0,-67.0,-61.0,-77.0,-85.0,-77.0,-84.0,9.0,15.0,10.0,24.0,1
5403,CC:2F:71:3F:1F:24,9409234,9866621884,6191717,9460225953,3217517,406395931,80,1434042,860079716,1425484,859052032,8558,1027684,1380608,619,6196426,622307,80,5971,130000.0,43333.0,-70.0,-63.0,-72.0,-71.0,-69.0,-63.0,-70.0,-70.0,-77.0,-85.0,-77.0,-84.0,7.0,22.0,5.0,13.0,1
5404,F8:59:71:5A:E0:3D,3388034,659559673,170515,253163540,3217519,406396133,0,168736,211373885,163908,210797003,4828,576882,146259,16,173229,2974,0,544,144444.0,43333.0,-67.0,-74.0,-64.0,-71.0,-67.0,-73.0,-64.0,-70.0,-77.0,-85.0,-77.0,-84.0,10.0,11.0,13.0,13.0,1
5405,CC:2F:71:3E:C5:1F,3228947,407794193,11428,1398060,3217519,406396133,6,48757,4083640,40289,3080262,8468,1003378,12051,34,16392,186,6,828,130000.0,39000.0,-68.0,-70.0,-67.0,-60.0,-68.0,-70.0,-67.0,-61.0,-77.0,-85.0,-77.0,-84.0,9.0,15.0,10.0,24.0,1
5406,CC:2F:71:3F:1F:24,9410457,9868496178,6192938,9462100045,3217519,406396133,80,1434307,860203345,1425749,859175661,8558,1027684,1380873,619,6197657,622583,80,5971,86667.0,14444.0,-68.0,-63.0,-71.0,-68.0,-67.0,-63.0,-70.0,-68.0,-77.0,-85.0,-77.0,-84.0,9.0,22.0,6.0,16.0,1
5407,F8:59:71:5A:E0:3D,3388101,659657979,170578,253261442,3217523,406396537,0,168800,211472459,163972,210895577,4828,576882,146322,16,173292,2974,0,544,144444.0,43333.0,-66.0,-74.0,-65.0,-70.0,-66.0,-73.0,-65.0,-70.0,-77.0,-85.0,-77.0,-84.0,11.0,11.0,12.0,14.0,1
5408,CC:2F:71:3E:C5:1F,3228951,407794597,11428,1398060,3217523,406396537,6,48757,4083640,40289,3080262,8468,1003378,12051,34,16392,186,6,828,130000.0,39000.0,-68.0,-70.0,-67.0,-60.0,-68.0,-70.0,-67.0,-61.0,-77.0,-85.0,-77.0,-84.0,9.0,15.0,10.0,24.0,1
5409,CC:2F:71:3F:1F:24,9411615,9870275154,6194092,9463878617,3217523,406396537,80,1434598,860326611,1426040,859298927,8558,1027684,1381161,619,6198788,622584,80,5971,86667.0,14444.0,-70.0,-64.0,-70.0,-68.0,-70.0,-64.0,-69.0,-68.0,-77.0,-85.0,-77.0,-84.0,7.0,21.0,7.0,16.0,1
5410,F8:59:71:5A:E0:3D,3388183,659766431,170644,253364006,3217539,406402425,0,168865,211572559,164037,210995677,4828,576882,146387,16,173357,2974,0,544,144444.0,43333.0,-67.0,-74.0,-67.0,-71.0,-67.0,-74.0,-66.0,-71.0,-77.0,-85.0,-77.0,-84.0,10.0,11.0,10.0,13.0,1
5411,CC:2F:71:3E:C5:1F,3228967,407800485,11428,1398060,3217539,406402425,6,48757,4083640,40289,3080262,8468,1003378,12051,34,16392,186,6,828,130000.0,39000.0,-68.0,-70.0,-67.0,-60.0,-68.0,-70.0,-67.0,-61.0,-77.0,-85.0,-77.0,-84.0,9.0,15.0,10.0,24.0,1
5412,CC:2F:71:3F:1F:24,9412691,9871912722,6195152,9465510297,3217539,406402425,80,1434859,860456319,1426301,859428635,8558,1027684,1381422,619,6199871,622627,80,5971,86667.0,14444.0,-70.0,-64.0,-72.0,-68.0,-69.0,-63.0,-71.0,-68.0,-77.0,-85.0,-77.0,-84.0,7.0,21.0,5.0,16.0,1
5413,F8:59:71:5A:E0:3D,3388264,659874823,170710,253466570,3217554,406408253,0,168931,211674199,164103,211097317,4828,576882,146453,16,173423,2974,0,544,144444.0,43333.0,-66.0,-74.0,-65.0,-70.0,-66.0,-74.0,-64.0,-70.0,-77.0,-85.0,-77.0,-84.0,11.0,11.0,12.0,14.0,1
5414,CC:2F:71:3E:C5:1F,3228982,407806313,11428,1398060,3217554,406408253,6,48757,4083640,40289,3080262,8468,1003378,12051,34,16392,186,6,828,130000.0,39000.0,-68.0,-70.0,-67.0,-60.0,-68.0,-70.0,-67.0,-61.0,-77.0,-85.0,-77.0,-84.0,9.0,15.0,10.0,24.0,1
5415,CC:2F:71:3F:1F:24,9413577,9873250940,6196023,9466842687,3217554,406408253,80,1435091,860574173,1426533,859546489,8558,1027684,1381653,619,6200742,622767,80,5971,115556.0,28889.0,-70.0,-64.0,-72.0,-69.0,-69.0,-63.0,-71.0,-69.0,-77.0,-85.0,-77.0,-84.0,7.0,21.0,5.0,15.0,1
5416,F8:59:71:5A:E0:3D,3388331,659973129,170773,253564472,3217558,406408657,0,168994,211771219,164166,211194337,4828,576882,146516,16,173487,2975,0,544,144444.0,43333.0,-66.0,-74.0,-65.0,-70.0,-66.0,-73.0,-65.0,-70.0,-77.0,-85.0,-77.0,-84.0,11.0,11.0,12.0,14.0,1
5417,CC:2F:71:3E:C5:1F,3228987,407806990,11428,1398060,3217559,406408930,6,48757,4083640,40289,3080262,8468,1003378,12051,34,16392,186,6,828,130000.0,39000.0,-68.0,-70.0,-67.0,-60.0,-68.0,-70.0,-67.0,-61.0,-77.0,-85.0,-77.0,-84.0,9.0,15.0,10.0,24.0,1
5418,CC:2F:71:3F:1F:24,9414926,9875324711,6197367,9468915781,3217559,406408930,80,1435343,860697971,1426785,859670287,8558,1027684,1381904,619,6202086,622816,80,5973,115556.0,28889.0,-70.0,-64.0,-71.0,-69.0,-70.0,-64.0,-70.0,-69.0,-77.0,-85.0,-77.0,-84.0,7.0,21.0,6.0,15.0,1
5419,F8:59:71:5A:E0:3D,3388403,660076262,170839,253666868,3217564,406409394,0,169061,211874399,164233,211297517,4828,576882,146583,16,173553,2977,0,544,144444.0,43333.0,-66.0,-74.0,-66.0,-70.0,-66.0,-73.0,-65.0,-70.0,-77.0,-85.0,-77.0,-84.0,11.0,11.0,11.0,14.0,1
5420,CC:2F:71:3E:C5:1F,3228992,407807454,11428,1398060,3217564,406409394,6,48757,4083640,40289,3080262,8468,1003378,12051,34,16392,186,6,828,130000.0,39000.0,-68.0,-70.0,-67.0,-60.0,-68.0,-70.0,-67.0,-61.0,-77.0,-85.0,-77.0,-84.0,9.0,15.0,10.0,24.0,1
5421,CC:2F:71:3F:1F:24,9416087,9877109223,6198523,9470699829,3217564,406409394,80,1435582,860819633,1427024,859791949,8558,1027684,1382143,619,6203224,622875,80,5975,115556.0,28889.0,-69.0,-64.0,-71.0,-69.0,-69.0,-64.0,-70.0,-69.0,-77.0,-85.0,-77.0,-84.0,8.0,21.0,6.0,15.0,1
5422,F8:59:71:5A:E0:3D,3388472,660177676,170904,253767878,3217568,406409798,0,169125,211972959,164297,211396077,4828,576882,146647,16,173618,2977,0,544,144444.0,43333.0,-67.0,-72.0,-66.0,-71.0,-67.0,-72.0,-66.0,-71.0,-77.0,-85.0,-77.0,-84.0,10.0,13.0,11.0,13.0,1
5423,CC:2F:71:3E:C5:1F,3228996,407807858,11428,1398060,3217568,406409798,6,48757,4083640,40289,3080262,8468,1003378,12051,34,16392,186,6,828,130000.0,39000.0,-68.0,-70.0,-67.0,-60.0,-68.0,-70.0,-67.0,-61.0,-77.0,-85.0,-77.0,-84.0,9.0,15.0,10.0,24.0,1
5424,CC:2F:71:3F:1F:24,9417704,9879614125,6200136,9473204327,3217568,406409798,80,1435867,860946605,1427309,859918921,8558,1027684,1382426,619,6204855,623363,80,5975,115556.0,28889.0,-71.0,-64.0,-73.0,-66.0,-70.0,-64.0,-71.0,-66.0,-77.0,-85.0,-77.0,-84.0,6.0,21.0,4.0,18.0,1
5425,F8:59:71:5A:E0:3D,3388537,660275780,170967,253865780,3217570,406410000,0,169189,212071519,164361,211494637,4828,576882,146711,16,173681,2977,0,544,144444.0,43333.0,-66.0,-72.0,-66.0,-70.0,-66.0,-72.0,-65.0,-70.0,-77.0,-85.0,-77.0,-84.0,11.0,13.0,11.0,14.0,1
5426,CC:2F:71:3E:C5:1F,3229000,407808262,11428,1398060,3217572,406410202,6,48757,4083640,40289,3080262,8468,1003378,12051,34,16392,186,6,828,130000.0,39000.0,-68.0,-70.0,-67.0,-60.0,-68.0,-70.0,-67.0,-61.0,-77.0,-85.0,-77.0,-84.0,9.0,15.0,10.0,24.0,1
5427,CC:2F:71:3F:1F:24,9419314,9882107253,6201742,9475697051,3217572,406410202,80,1436186,861073149,1427628,860045465,8558,1027684,1382745,619,6206450,623374,80,5975,115556.0,28889.0,-69.0,-63.0,-70.0,-68.0,-69.0,-63.0,-70.0,-68.0,-77.0,-85.0,-77.0,-84.0,8.0,22.0,7.0,16.0,1
5428,F8:59:71:5A:E0:3D,3388606,660374280,171030,253963682,3217576,406410598,0,169253,212170093,164425,211593211,4828,576882,146774,16,173744,2977,0,544,144444.0,43333.0,-66.0,-73.0,-65.0,-70.0,-66.0,-72.0,-64.0,-69.0,-77.0,-85.0,-77.0,-84.0,11.0,12.0,12.0,14.0,1
5429,CC:2F:71:3E:C5:1F,3229005,407808726,11428,1398060,3217577,406410666,6,48757,4083640,40289,3080262,8468,1003378,12051,34,16392,186,6,828,130000.0,39000.0,-68.0,-70.0,-67.0,-60.0,-68.0,-70.0,-67.0,-61.0,-77.0,-85.0,-77.0,-84.0,9.0,15.0,10.0,24.0,1
5430,CC:2F:71:3F:1F:24,9420389,9883746861,6202812,9477336195,3217577,406410666,80,1436412,861190821,1427854,860163137,8558,1027684,1382971,619,6207531,623626,80,5975,115556.0,28889.0,-69.0,-63.0,-71.0,-68.0,-69.0,-63.0,-70.0,-68.0,-77.0,-85.0,-77.0,-84.0,8.0,22.0,6.0,16.0,1
5431,F8:59:71:5A:E0:3D,3388671,660472312,171093,254061584,3217578,406410728,0,169316,212265691,164487,211688691,4829,577000,146837,16,173807,2978,0,544,144444.0,43333.0,-66.0,-73.0,-65.0,-70.0,-65.0,-72.0,-65.0,-70.0,-77.0,-85.0,-77.0,-84.0,11.0,12.0,12.0,14.0,1
5432,CC:2F:71:3E:C5:1F,3229006,407808788,11428,1398060,3217578,406410728,6,48757,4083640,40289,3080262,8468,1003378,12051,34,16392,186,6,828,130000.0,39000.0,-68.0,-70.0,-67.0,-60.0,-68.0,-70.0,-67.0,-61.0,-77.0,-85.0,-77.0,-84.0,9.0,15.0,10.0,24.0,1
5433,CC:2F:71:3F:1F:24,9421244,9885050037,6203664,9478639107,3217580,406410930,80,1436610,861303209,1428052,860275525,8558,1027684,1383169,619,6208383,623626,80,5975,115556.0,28889.0,-69.0,-63.0,-70.0,-68.0,-69.0,-63.0,-70.0,-68.0,-77.0,-85.0,-77.0,-84.0,8.0,22.0,7.0,16.0,1
5434,F8:59:71:5A:E0:3D,3388739,660569266,171155,254157932,3217584,406411334,0,169378,212361171,164549,211784171,4829,577000,146899,16,173869,2979,0,544,144444.0,43333.0,-67.0,-72.0,-65.0,-69.0,-67.0,-72.0,-65.0,-69.0,-77.0,-85.0,-77.0,-85.0,10.0,13.0,12.0,16.0,1
5435,CC:2F:71:3E:C5:1F,3229012,407809394,11428,1398060,3217584,406411334,6,48757,4083640,40289,3080262,8468,1003378,12051,34,16392,186,6,828,130000.0,39000.0,-68.0,-70.0,-67.0,-60.0,-68.0,-70.0,-67.0,-61.0,-77.0,-85.0,-77.0,-85.0,9.0,15.0,10.0,25.0,1
5436,CC:2F:71:3F:1F:24,9422279,9886635447,6204695,9480224113,3217584,406411334,80,1436823,861418897,1428265,860391213,8558,1027684,1383382,619,6209394,623704,80,5975,130000.0,43333.0,-70.0,-63.0,-72.0,-66.0,-69.0,-63.0,-70.0,-65.0,-77.0,-85.0,-77.0,-85.0,7.0,22.0,5.0,19.0,1
5437,F8:59:71:5A:E0:3D,3388805,660667430,171218,254255834,3217587,406411596,0,169441,212458191,164612,211881191,4829,577000,146962,16,173932,2979,0,544,144444.0,43333.0,-66.0,-72.0,-64.0,-70.0,-66.0,-71.0,-64.0,-70.0,-77.0,-85.0,-77.0,-85.0,11.0,13.0,13.0,15.0,1
5438,CC:2F:71:3E:C5:1F,3229015,407809656,11428,1398060,3217587,406411596,6,48757,4083640,40289,3080262,8468,1003378,12051,34,16392,186,6,828,130000.0,39000.0,-68.0,-70.0,-67.0,-60.0,-68.0,-70.0,-67.0,-61.0,-77.0,-85.0,-77.0,-85.0,9.0,15.0,10.0,25.0,1
5439,CC:2F:71:3F:1F:24,9423039,9887788487,6205452,9481376891,3217587,406411596,80,1437038,861534917,1428480,860507233,8558,1027684,1383597,619,6210171,623827,80,5975,130000.0,43333.0,-70.0,-64.0,-71.0,-69.0,-70.0,-63.0,-71.0,-69.0,-77.0,-85.0,-77.0,-85.0,7.0,21.0,6.0,16.0,1
5440,F8:59:71:5A:E0:3D,3388872,660765736,171281,254353736,3217591,406412000,0,169504,212555211,164675,211978211,4829,577000,147025,16,173995,2979,0,544,144444.0,43333.0,-67.0,-74.0,-64.0,-70.0,-66.0,-73.0,-64.0,-70.0,-77.0,-85.0,-77.0,-85.0,10.0,11.0,13.0,15.0,1
5441,CC:2F:71:3E:C5:1F,3229019,407810060,11428,1398060,3217591,406412000,6,48757,4083640,40289,3080262,8468,1003378,12051,34,16392,186,6,828,130000.0,39000.0,-68.0,-70.0,-67.0,-60.0,-68.0,-70.0,-67.0,-61.0,-77.0,-85.0,-77.0,-85.0,9.0,15.0,10.0,25.0,1
5442,CC:2F:71:3F:1F:24,9423951,9889172623,6206360,9482760623,3217591,406412000,80,1437290,861654178,1428732,860626494,8558,1027684,1383849,619,6211073,623858,80,5977,130000.0,43333.0,-69.0,-63.0,-72.0,-68.0,-68.0,-62.0,-71.0,-67.0,-77.0,-85.0,-77.0,-85.0,8.0,22.0,5.0,17.0,1
5443,F8:59:71:5A:E0:3D,3388938,660862488,171343,254450084,3217595,406412404,0,169566,212650691,164737,212073691,4829,577000,147087,16,174057,2979,0,544,144444.0,43333.0,-67.0,-72.0,-64.0,-70.0,-66.0,-72.0,-64.0,-69.0,-77.0,-85.0,-77.0,-85.0,10.0,13.0,13.0,15.0,1
5444,CC:2F:71:3E:C5:1F,3229024,407810524,11428,1398060,3217596,406412464,6,48757,4083640,40289,3080262,8468,1003378,12051,34,16392,186,6,828,130000.0,39000.0,-68.0,-70.0,-67.0,-60.0,-68.0,-70.0,-67.0,-61.0,-77.0,-85.0,-77.0,-85.0,9.0,15.0,10.0,25.0,1
5445,CC:2F:71:3F:1F:24,9424939,9890682549,6207343,9484270085,3217596,406412464,80,1437505,861768632,1428947,860740948,8558,1027684,1384064,619,6212062,623861,80,5977,144444.0,43333.0,-69.0,-63.0,-72.0,-68.0,-69.0,-63.0,-71.0,-68.0,-77.0,-85.0,-77.0,-85.0,8.0,22.0,5.0,17.0,1
5446,F8:59:71:5A:E0:3D,3389005,660959188,171405,254546320,3217600,406412868,0,169628,212746171,164799,212169171,4829,577000,147149,16,174119,2984,0,544,144444.0,43333.0,-67.0,-73.0,-64.0,-70.0,-66.0,-72.0,-63.0,-70.0,-77.0,-85.0,-77.0,-85.0,10.0,12.0,13.0,15.0,1
5447,CC:2F:71:3E:C5:1F,3229028,407810928,11428,1398060,3217600,406412868,6,48757,4083640,40289,3080262,8468,1003378,12051,34,16392,186,6,828,130000.0,39000.0,-68.0,-70.0,-67.0,-60.0,-68.0,-70.0,-67.0,-61.0,-77.0,-85.0,-77.0,-85.0,9.0,15.0,10.0,25.0,1
5448,CC:2F:71:3F:1F:24,9426256,9892713347,6208656,9486300479,3217600,406412868,80,1437735,861886180,1429177,860858496,8558,1027684,1384294,619,6213375,623918,80,5977,144444.0,43333.0,-68.0,-63.0,-70.0,-66.0,-68.0,-63.0,-70.0,-66.0,-77.0,-85.0,-77.0,-85.0,9.0,22.0,7.0,19.0,1
5449,F8:59:71:5A:E0:3D,3389072,661057494,171468,254644222,3217604,406413272,0,169692,212844745,164863,212267745,4829,577000,147212,16,174182,2984,0,544,144444.0,43333.0,-65.0,-73.0,-64.0,-70.0,-66.0,-73.0,-64.0,-69.0,-77.0,-85.0,-77.0,-85.0,12.0,12.0,13.0,15.0,1
5450,CC:2F:71:3E:C5:1F,3229032,407811332,11428,1398060,3217604,406413272,6,48757,4083640,40289,3080262,8468,1003378,12051,34,16392,186,6,828,130000.0,39000.0,-68.0,-70.0,-67.0,-60.0,-68.0,-70.0,-67.0,-61.0,-77.0,-85.0,-77.0,-85.0,9.0,15.0,10.0,25.0,1
5451,CC:2F:71:3F:1F:24,9427556,9894717023,6209952,9488303751,3217604,406413272,80,1438029,862014044,1429471,860986360,8558,1027684,1384588,619,6214671,624178,80,5977,104000.0,26000.0,-70.0,-63.0,-71.0,-69.0,-69.0,-63.0,-70.0,-68.0,-77.0,-85.0,-77.0,-85.0,7.0,22.0,6.0,16.0,1
5452,F8:59:71:5A:E0:3D,3389142,661158968,171533,254745232,3217609,406413736,0,169757,212944845,164928,212367845,4829,577000,147277,16,174247,2986,0,544,144444.0,43333.0,-66.0,-73.0,-65.0,-70.0,-66.0,-72.0,-65.0,-70.0,-77.0,-85.0,-77.0,-85.0,11.0,12.0,12.0,15.0,1
5453,CC:2F:71:3E:C5:1F,3229037,407811796,11428,1398060,3217609,406413736,6,48757,4083640,40289,3080262,8468,1003378,12051,34,16392,186,6,828,130000.0,39000.0,-68.0,-70.0,-67.0,-60.0,-68.0,-70.0,-67.0,-61.0,-77.0,-85.0,-77.0,-85.0,9.0,15.0,10.0,25.0,1
5454,CC:2F:71:3F:1F:24,9428722,9896509361,6211113,9490095625,3217609,406413736,80,1438301,862138170,1429743,861110486,8558,1027684,1384854,619,6215824,624208,80,5978,115556.0,28889.0,-71.0,-63.0,-69.0,-68.0,-71.0,-63.0,-69.0,-68.0,-77.0,-85.0,-77.0,-85.0,6.0,22.0,8.0,17.0,1
5455,F8:59:71:5A:E0:3D,3389208,661255720,171595,254841580,3217613,406414140,0,169819,213040325,164990,212463325,4829,577000,147339,16,174308,2986,0,544,144444.0,43333.0,-66.0,-73.0,-65.0,-71.0,-66.0,-72.0,-65.0,-70.0,-77.0,-85.0,-77.0,-85.0,11.0,12.0,12.0,14.0,1
5456,CC:2F:71:3E:C5:1F,3229041,407812200,11428,1398060,3217613,406414140,6,48757,4083640,40289,3080262,8468,1003378,12051,34,16392,186,6,828,130000.0,39000.0,-68.0,-70.0,-67.0,-60.0,-68.0,-70.0,-67.0,-61.0,-77.0,-85.0,-77.0,-85.0,9.0,15.0,10.0,25.0,1
5457,CC:2F:71:3F:1F:24,9429716,9898022703,6212103,9491608563,3217613,406414140,80,1438543,862257687,1429985,861230003,8558,1027684,1385095,619,6216822,624248,80,5978,130000.0,43333.0,-68.0,-64.0,-72.0,-67.0,-68.0,-64.0,-72.0,-67.0,-77.0,-85.0,-77.0,-85.0,9.0,21.0,5.0,18.0,1
5458,F8:59:71:5A:E0:3D,3389276,661358486,171661,254944144,3217615,406414342,0,169885,213141965,165056,212564965,4829,577000,147405,16,174375,2987,0,544,144444.0,43333.0,-67.0,-74.0,-64.0,-70.0,-66.0,-73.0,-64.0,-70.0,-77.0,-85.0,-77.0,-85.0,10.0,11.0,13.0,15.0,1
5459,CC:2F:71:3E:C5:1F,3229043,407812402,11428,1398060,3217615,406414342,6,48757,4083640,40289,3080262,8468,1003378,12051,34,16392,186,6,828,130000.0,39000.0,-68.0,-70.0,-67.0,-60.0,-68.0,-70.0,-67.0,-61.0,-77.0,-85.0,-77.0,-85.0,9.0,15.0,10.0,25.0,1
5460,CC:2F:71:3F:1F:24,9430699,9899528803,6213084,9493114461,3217615,406414342,80,1438803,862384423,1430245,861356739,8558,1027684,1385355,619,6217784,624413,80,5978,115556.0,28889.0,-68.0,-64.0,-71.0,-68.0,-67.0,-64.0,-70.0,-68.0,-77.0,-85.0,-77.0,-85.0,9.0,21.0,6.0,17.0,1
5461,F8:59:71:5A:E0:3D,3389347,661457327,171724,255042046,3217623,406415281,0,169948,213238985,165119,212661985,4829,577000,147468,16,174438,2987,0,544,144444.0,43333.0,-67.0,-73.0,-65.0,-71.0,-66.0,-73.0,-64.0,-71.0,-77.0,-85.0,-77.0,-85.0,10.0,12.0,12.0,14.0,1
5462,CC:2F:71:3E:C5:1F,3229051,407813341,11428,1398060,3217623,406415281,6,48757,4083640,40289,3080262,8468,1003378,12051,34,16392,186,6,828,130000.0,39000.0,-68.0,-70.0,-67.0,-60.0,-68.0,-70.0,-67.0,-61.0,-77.0,-85.0,-77.0,-85.0,9.0,15.0,10.0,25.0,1
5463,CC:2F:71:3F:1F:24,9431737,9901114986,6214114,9494699705,3217623,406415281,80,1439052,862504225,1430494,861476541,8558,1027684,1385604,619,6218833,624476,80,5978,115556.0,28889.0,-68.0,-64.0,-69.0,-68.0,-68.0,-64.0,-69.0,-68.0,-77.0,-85.0,-77.0,-85.0,9.0,21.0,8.0,17.0,1
5464,F8:59:71:5A:E0:3D,3389412,661555431,171787,255139948,3217625,406415483,0,170012,213337545,165183,212760545,4829,577000,147532,16,174501,2987,0,544,144444.0,43333.0,-67.0,-73.0,-64.0,-71.0,-67.0,-73.0,-64.0,-70.0,-77.0,-85.0,-77.0,-85.0,10.0,12.0,13.0,14.0,1
5465,CC:2F:71:3E:C5:1F,3229053,407813543,11428,1398060,3217625,406415483,6,48757,4083640,40289,3080262,8468,1003378,12051,34,16392,186,6,828,130000.0,39000.0,-68.0,-70.0,-67.0,-60.0,-68.0,-70.0,-67.0,-61.0,-77.0,-85.0,-77.0,-85.0,9.0,15.0,10.0,25.0,1
5466,CC:2F:71:3F:1F:24,9433170,9903332962,6215545,9496917479,3217625,406415483,80,1439319,862626071,1430761,861598387,8558,1027684,1385871,619,6220241,624643,80,5978,115556.0,28889.0,-69.0,-63.0,-71.0,-68.0,-69.0,-63.0,-70.0,-68.0,-77.0,-85.0,-77.0,-85.0,8.0,22.0,6.0,17.0,1
5467,F8:59:71:5A:E0:3D,3389477,661653535,171850,255237850,3217627,406415685,0,170074,213433025,165245,212856025,4829,577000,147594,16,174564,2988,0,544,144444.0,43333.0,-67.0,-73.0,-64.0,-71.0,-67.0,-73.0,-64.0,-70.0,-77.0,-85.0,-77.0,-85.0,10.0,12.0,13.0,14.0,1
5468,CC:2F:71:3E:C5:1F,3229057,407813947,11428,1398060,3217629,406415887,6,48757,4083640,40289,3080262,8468,1003378,12051,34,16392,186,6,828,130000.0,39000.0,-68.0,-70.0,-67.0,-60.0,-68.0,-70.0,-67.0,-61.0,-77.0,-85.0,-77.0,-85.0,9.0,15.0,10.0,25.0,1
5469,CC:2F:71:3F:1F:24,9434780,9905815566,6217149,9499399477,3217631,406416089,80,1439606,862752110,1431048,861724426,8558,1027684,1386158,619,6221820,624673,80,5978,115556.0,28889.0,-69.0,-63.0,-69.0,-69.0,-69.0,-63.0,-70.0,-68.0,-77.0,-85.0,-77.0,-85.0,8.0,22.0,8.0,16.0,1
5470,F8:59:71:5A:E0:3D,3389547,661753571,171915,255337422,3217632,406416149,0,170141,213534785,165312,212957785,4829,577000,147660,16,174629,2988,0,544,144444.0,43333.0,-67.0,-73.0,-64.0,-71.0,-67.0,-73.0,-63.0,-70.0,-77.0,-85.0,-77.0,-85.0,10.0,12.0,13.0,14.0,1
5471,CC:2F:71:3E:C5:1F,3229062,407814411,11428,1398060,3217634,406416351,6,48757,4083640,40289,3080262,8468,1003378,12051,34,16392,186,6,828,130000.0,39000.0,-68.0,-70.0,-67.0,-60.0,-68.0,-70.0,-67.0,-61.0,-77.0,-85.0,-77.0,-85.0,9.0,15.0,10.0,25.0,1
5472,CC:2F:71:3F:1F:24,9436128,9907894920,6218494,9501478569,3217634,406416351,80,1439888,862874328,1431330,861846644,8558,1027684,1386440,619,6223195,624794,80,5978,115556.0,28889.0,-69.0,-64.0,-71.0,-68.0,-69.0,-64.0,-70.0,-68.0,-77.0,-85.0,-77.0,-85.0,8.0,21.0,6.0,17.0,1
5473,F8:59:71:5A:E0:3D,3389615,661853431,171979,255436878,3217636,406416553,0,170205,213633387,165376,213056387,4829,577000,147723,16,174693,2990,0,545,144444.0,43333.0,-67.0,-73.0,-65.0,-71.0,-67.0,-72.0,-65.0,-71.0,-77.0,-85.0,-77.0,-85.0,10.0,12.0,12.0,14.0,1
5474,CC:2F:71:3E:C5:1F,3229064,407814613,11428,1398060,3217636,406416553,6,48757,4083640,40289,3080262,8468,1003378,12051,34,16392,186,6,828,130000.0,39000.0,-68.0,-70.0,-67.0,-60.0,-68.0,-70.0,-67.0,-61.0,-77.0,-85.0,-77.0,-85.0,9.0,15.0,10.0,25.0,1
5475,CC:2F:71:3F:1F:24,9437623,9910209484,6219987,9503792931,3217636,406416553,80,1440161,862999760,1431603,861972076,8558,1027684,1386713,619,6224706,624886,80,5978,115556.0,28889.0,-69.0,-64.0,-70.0,-68.0,-68.0,-64.0,-69.0,-68.0,-77.0,-85.0,-77.0,-85.0,8.0,21.0,7.0,17.0,1
5476,F8:59:71:5A:E0:3D,3389684,661951915,172043,255534896,3217641,406417019,0,170270,213732065,165440,213154947,4830,577118,147788,16,174757,2991,0,545,144444.0,43333.0,-67.0,-73.0,-65.0,-71.0,-67.0,-73.0,-65.0,-71.0,-77.0,-85.0,-77.0,-85.0,10.0,12.0,12.0,14.0,1
5477,CC:2F:71:3E:C5:1F,3229070,407815195,11429,1398176,3217641,406417019,6,48759,4083780,40291,3080402,8468,1003378,12051,34,16393,186,6,828,130000.0,39000.0,-69.0,-72.0,-67.0,-60.0,-68.0,-71.0,-67.0,-61.0,-77.0,-85.0,-77.0,-85.0,8.0,13.0,10.0,25.0,1
5478,CC:2F:71:3F:1F:24,9439409,9912972744,6221766,9506555523,3217643,406417221,80,1440482,863135016,1431924,862107332,8558,1027684,1387034,619,6226477,624985,80,5979,130000.0,39000.0,-69.0,-64.0,-70.0,-69.0,-69.0,-64.0,-70.0,-69.0,-77.0,-85.0,-77.0,-85.0,8.0,21.0,7.0,16.0,1
5479,F8:59:71:5A:E0:3D,3389758,662058113,172111,255640568,3217647,406417545,0,170338,213836785,165508,213259667,4830,577118,147856,16,174825,2998,0,545,144444.0,43333.0,-67.0,-74.0,-66.0,-70.0,-67.0,-73.0,-65.0,-70.0,-77.0,-85.0,-77.0,-85.0,10.0,11.0,11.0,15.0,1
5480,CC:2F:71:3E:C5:1F,3229076,407815721,11429,1398176,3217647,406417545,6,48761,4083968,40292,3080472,8469,1003496,12052,34,16393,186,6,829,130000.0,39000.0,-67.0,-70.0,-67.0,-60.0,-68.0,-71.0,-67.0,-61.0,-77.0,-85.0,-77.0,-85.0,10.0,15.0,10.0,25.0,1
5481,CC:2F:71:3F:1F:24,9440844,9915181870,6223197,9508764325,3217647,406417545,80,1440755,863266818,1432197,862239134,8558,1027684,1387306,619,6227916,625296,80,5980,104000.0,26000.0,-69.0,-63.0,-72.0,-67.0,-69.0,-63.0,-72.0,-67.0,-77.0,-85.0,-77.0,-85.0,8.0,22.0,5.0,18.0,1
5482,F8:59:71:5A:E0:3D,3389835,662171959,172184,255754010,3217651,406417949,0,170411,213949205,165581,213372087,4830,577118,147929,16,174898,2998,0,545,144444.0,43333.0,-67.0,-73.0,-65.0,-70.0,-66.0,-72.0,-64.0,-70.0,-77.0,-85.0,-77.0,-85.0,10.0,12.0,12.0,15.0,1
5483,CC:2F:71:3E:C5:1F,3229082,407816327,11429,1398176,3217653,406418151,6,48761,4083968,40292,3080472,8469,1003496,12052,34,16393,186,6,829,130000.0,39000.0,-67.0,-70.0,-67.0,-60.0,-68.0,-71.0,-67.0,-61.0,-77.0,-85.0,-77.0,-85.0,10.0,15.0,10.0,25.0,1
5484,CC:2F:71:3F:1F:24,9442146,9917186220,6224493,9510768069,3217653,406418151,80,1441031,863402984,1432473,862375300,8558,1027684,1387582,619,6229212,625561,80,5981,86667.0,14444.0,-73.0,-62.0,-70.0,-68.0,-71.0,-63.0,-70.0,-68.0,-77.0,-85.0,-77.0,-85.0,4.0,23.0,7.0,17.0,1
5485,F8:59:71:5A:E0:3D,3389907,662277923,172252,255859570,3217655,406418353,0,170478,214052385,165648,213475267,4830,577118,147996,16,174966,2999,0,545,144444.0,39000.0,-67.0,-72.0,-66.0,-70.0,-66.0,-71.0,-65.0,-69.0,-77.0,-85.0,-77.0,-84.0,10.0,13.0,11.0,14.0,1
5486,CC:2F:71:3E:C5:1F,3229085,407816589,11429,1398176,3217656,406418413,6,48761,4083968,40292,3080472,8469,1003496,12052,34,16393,186,6,829,130000.0,39000.0,-67.0,-70.0,-67.0,-60.0,-68.0,-71.0,-67.0,-61.0,-77.0,-85.0,-77.0,-84.0,10.0,15.0,10.0,24.0,1
5487,CC:2F:71:3F:1F:24,9443296,9918955456,6225640,9512537043,3217656,406418413,80,1441316,863527090,1432758,862499406,8558,1027684,1387865,619,6230339,625597,80,5982,86667.0,14444.0,-68.0,-63.0,-71.0,-66.0,-69.0,-63.0,-71.0,-66.0,-77.0,-85.0,-77.0,-84.0,9.0,22.0,6.0,18.0,1
5488,F8:59:71:5A:E0:3D,3389973,662373125,172313,255954308,3217660,406418817,0,170540,214147865,165710,213570747,4830,577118,148058,16,175027,3001,0,545,144444.0,43333.0,-65.0,-72.0,-65.0,-71.0,-66.0,-72.0,-65.0,-70.0,-77.0,-85.0,-77.0,-84.0,12.0,13.0,12.0,13.0,1
5489,CC:2F:71:3E:C5:1F,3229089,407816993,11429,1398176,3217660,406418817,6,48761,4083968,40292,3080472,8469,1003496,12052,34,16393,186,6,829,130000.0,39000.0,-67.0,-70.0,-67.0,-60.0,-68.0,-71.0,-67.0,-61.0,-77.0,-85.0,-77.0,-84.0,10.0,15.0,10.0,24.0,1
5490,CC:2F:71:3F:1F:24,9444089,9920158542,6226429,9513739725,3217660,406418817,80,1441550,863643862,1432992,862616178,8558,1027684,1388099,619,6231148,625602,80,5983,78000.0,13000.0,-66.0,-66.0,-69.0,-65.0,-66.0,-66.0,-69.0,-65.0,-77.0,-85.0,-77.0,-84.0,11.0,19.0,8.0,19.0,1
5491,F8:59:71:5A:E0:3D,3390040,662471431,172376,256052210,3217664,406419221,0,170603,214244885,165773,213667767,4830,577118,148121,16,175090,3002,0,545,144444.0,43333.0,-68.0,-73.0,-64.0,-69.0,-67.0,-73.0,-64.0,-69.0,-77.0,-85.0,-77.0,-84.0,9.0,12.0,13.0,15.0,1
5492,CC:2F:71:3E:C5:1F,3229093,407817397,11429,1398176,3217664,406419221,6,48761,4083968,40292,3080472,8469,1003496,12052,34,16393,186,6,829,130000.0,39000.0,-67.0,-70.0,-67.0,-60.0,-68.0,-71.0,-67.0,-61.0,-77.0,-85.0,-77.0,-84.0,10.0,15.0,10.0,24.0,1
5493,CC:2F:71:3F:1F:24,9445101,9921702175,6227437,9515282954,3217664,406419221,80,1441813,863767179,1433255,862739495,8558,1027684,1388362,619,6232156,625746,80,5983,104000.0,26000.0,-73.0,-64.0,-70.0,-68.0,-72.0,-64.0,-70.0,-68.0,-77.0,-85.0,-77.0,-84.0,4.0,21.0,7.0,16.0,1
5494,F8:59:71:5A:E0:3D,3390109,662571351,172440,256151666,3217669,406419685,0,170666,214341905,165836,213764787,4830,577118,148184,16,175154,3002,0,545,144444.0,43333.0,-63.0,-73.0,-67.0,-73.0,-64.0,-73.0,-66.0,-73.0,-77.0,-85.0,-77.0,-84.0,14.0,12.0,10.0,11.0,1
5495,CC:2F:71:3E:C5:1F,3229098,407817861,11429,1398176,3217669,406419685,6,48761,4083968,40292,3080472,8469,1003496,12052,34,16393,186,6,829,130000.0,39000.0,-67.0,-70.0,-67.0,-60.0,-68.0,-71.0,-67.0,-61.0,-77.0,-85.0,-77.0,-84.0,10.0,15.0,10.0,24.0,1
5496,CC:2F:71:3F:1F:24,9446494,9923851967,6228825,9517432282,3217669,406419685,80,1442117,863893269,1433559,862865585,8558,1027684,1388666,619,6233544,625930,80,5983,130000.0,43333.0,-67.0,-65.0,-70.0,-66.0,-67.0,-65.0,-69.0,-66.0,-77.0,-85.0,-77.0,-84.0,10.0,20.0,7.0,18.0,1
5497,F8:59:71:5A:E0:3D,3390174,662669455,172503,256249568,3217671,406419887,0,170730,214440465,165900,213863347,4830,577118,148248,16,175217,3011,0,545,144444.0,43333.0,-66.0,-73.0,-68.0,-70.0,-66.0,-72.0,-67.0,-70.0,-77.0,-85.0,-77.0,-84.0,11.0,12.0,9.0,14.0,1
5498,CC:2F:71:3E:C5:1F,3229100,407818063,11429,1398176,3217671,406419887,6,48761,4083968,40292,3080472,8469,1003496,12052,34,16393,186,6,829,130000.0,39000.0,-67.0,-70.0,-67.0,-60.0,-68.0,-71.0,-67.0,-61.0,-77.0,-85.0,-77.0,-84.0,10.0,15.0,10.0,24.0,1
5499,CC:2F:71:3F:1F:24,9448147,9926414117,6230474,9519994028,3217673,406420089,80,1442398,864016825,1433840,862989141,8558,1027684,1388946,619,6235193,626081,80,5983,115556.0,28889.0,-69.0,-63.0,-71.0,-65.0,-70.0,-63.0,-69.0,-65.0,-77.0,-85.0,-77.0,-84.0,8.0,22.0,6.0,19.0,1
5500,F8:59:71:5A:E0:3D,3390243,662767963,172566,256347470,3217677,406420493,0,170792,214535945,165962,213958827,4830,577118,148310,16,175279,3011,0,545,144444.0,43333.0,-66.0,-72.0,-64.0,-69.0,-66.0,-72.0,-65.0,-69.0,-77.0,-85.0,-77.0,-84.0,11.0,13.0,13.0,15.0,1
5501,CC:2F:71:3E:C5:1F,3229106,407818669,11429,1398176,3217677,406420493,6,48761,4083968,40292,3080472,8469,1003496,12052,34,16393,186,6,829,130000.0,39000.0,-67.0,-70.0,-67.0,-60.0,-68.0,-71.0,-67.0,-61.0,-77.0,-85.0,-77.0,-84.0,10.0,15.0,10.0,24.0,1
5502,CC:2F:71:3F:1F:24,9449492,9928489019,6231815,9522068526,3217677,406420493,80,1442678,864140403,1434120,863112719,8558,1027684,1389226,619,6236510,626211,80,5983,115556.0,28889.0,-72.0,-65.0,-71.0,-67.0,-71.0,-64.0,-70.0,-67.0,-77.0,-85.0,-77.0,-84.0,5.0,20.0,6.0,17.0,1
5503,F8:59:71:5A:E0:3D,3390311,662867954,172630,256446926,3217681,406421028,0,170857,214636045,166027,214058927,4830,577118,148375,16,175344,3011,0,545,144444.0,43333.0,-66.0,-72.0,-65.0,-70.0,-66.0,-72.0,-64.0,-69.0,-77.0,-85.0,-77.0,-84.0,11.0,13.0,12.0,14.0,1
5504,CC:2F:71:3E:C5:1F,3229110,407819204,11429,1398176,3217681,406421028,6,48761,4083968,40292,3080472,8469,1003496,12052,34,16393,186,6,829,130000.0,39000.0,-67.0,-70.0,-67.0,-60.0,-68.0,-71.0,-67.0,-61.0,-77.0,-85.0,-77.0,-84.0,10.0,15.0,10.0,24.0,1
5505,CC:2F:71:3F:1F:24,9450760,9930441674,6233079,9524020646,3217681,406421028,80,1442958,864271071,1434400,863243387,8558,1027684,1389506,619,6237780,627038,80,5983,104000.0,26000.0,-70.0,-64.0,-71.0,-67.0,-69.0,-64.0,-71.0,-67.0,-77.0,-85.0,-77.0,-84.0,7.0,21.0,6.0,17.0,1
5506,F8:59:71:5A:E0:3D,3390384,662975584,172699,256554152,3217685,406421432,0,170926,214742319,166096,214165201,4830,577118,148443,16,175413,3013,0,545,144444.0,43333.0,-67.0,-73.0,-65.0,-70.0,-67.0,-72.0,-65.0,-69.0,-77.0,-85.0,-77.0,-84.0,10.0,12.0,12.0,14.0,1
5507,CC:2F:71:3E:C5:1F,3229116,407819810,11429,1398176,3217687,406421634,6,48761,4083968,40292,3080472,8469,1003496,12052,34,16393,186,6,829,130000.0,39000.0,-67.0,-70.0,-67.0,-60.0,-68.0,-71.0,-67.0,-61.0,-77.0,-85.0,-77.0,-84.0,10.0,15.0,10.0,24.0,1
5508,CC:2F:71:3F:1F:24,9451822,9932060844,6234135,9525639210,3217687,406421634,80,1443205,864394162,1434647,863366478,8558,1027684,1389753,619,6238854,627239,80,5983,115556.0,28889.0,-68.0,-64.0,-71.0,-68.0,-68.0,-64.0,-71.0,-67.0,-77.0,-85.0,-77.0,-84.0,9.0,21.0,6.0,16.0,1
5509,F8:59:71:5A:E0:3D,3390452,663075444,172763,256653608,3217689,406421836,0,170991,214842419,166161,214265301,4830,577118,148508,16,175477,3013,0,545,144444.0,43333.0,-67.0,-73.0,-65.0,-70.0,-66.0,-73.0,-65.0,-69.0,-77.0,-85.0,-77.0,-84.0,10.0,12.0,12.0,14.0,1
5510,CC:2F:71:3E:C5:1F,3229118,407820012,11429,1398176,3217689,406421836,6,48761,4083968,40292,3080472,8469,1003496,12052,34,16393,186,6,829,130000.0,39000.0,-67.0,-70.0,-67.0,-60.0,-68.0,-71.0,-67.0,-61.0,-77.0,-85.0,-77.0,-84.0,10.0,15.0,10.0,24.0,1
5511,CC:2F:71:3F:1F:24,9452893,9933706360,6235204,9527284524,3217689,406421836,80,1443440,864512372,1434882,863484688,8558,1027684,1389988,619,6239902,627347,80,5984,115556.0,28889.0,-68.0,-64.0,-71.0,-67.0,-68.0,-64.0,-71.0,-67.0,-77.0,-85.0,-77.0,-84.0,9.0,21.0,6.0,17.0,1
5512,F8:59:71:5A:E0:3D,3390521,663175364,172827,256753064,3217694,406422300,0,171054,214939467,166224,214362349,4830,577118,148571,16,175541,3015,0,546,144444.0,43333.0,-65.0,-72.0,-66.0,-69.0,-66.0,-73.0,-65.0,-69.0,-77.0,-85.0,-77.0,-84.0,12.0,13.0,11.0,15.0,1
5513,CC:2F:71:3E:C5:1F,3229123,407820476,11429,1398176,3217694,406422300,6,48761,4083968,40292,3080472,8469,1003496,12052,34,16393,186,6,829,130000.0,39000.0,-67.0,-70.0,-67.0,-60.0,-68.0,-71.0,-67.0,-61.0,-77.0,-85.0,-77.0,-84.0,10.0,15.0,10.0,24.0,1
5514,CC:2F:71:3F:1F:24,9453734,9934982598,6236038,9528560096,3217696,406422502,80,1443645,864635640,1435087,863607956,8558,1027684,1390193,619,6240751,627493,80,5984,115556.0,28889.0,-68.0,-64.0,-70.0,-67.0,-68.0,-64.0,-71.0,-67.0,-77.0,-85.0,-77.0,-84.0,9.0,21.0,7.0,17.0,1
5515,F8:59:71:5A:E0:3D,3390598,663287718,172899,256864952,3217699,406422766,0,171124,215047267,166294,214470149,4830,577118,148641,16,175613,3016,0,546,144444.0,43333.0,-66.0,-72.0,-66.0,-70.0,-66.0,-72.0,-65.0,-70.0,-77.0,-85.0,-77.0,-84.0,11.0,13.0,11.0,14.0,1
5516,CC:2F:71:3E:C5:1F,3229128,407820942,11429,1398176,3217699,406422766,6,48761,4083968,40292,3080472,8469,1003496,12052,34,16393,186,6,829,130000.0,39000.0,-67.0,-70.0,-67.0,-60.0,-68.0,-71.0,-67.0,-61.0,-77.0,-85.0,-77.0,-84.0,10.0,15.0,10.0,24.0,1
5517,CC:2F:71:3F:1F:24,9454560,9936231742,6236857,9529808406,3217703,406423336,80,1443905,864779668,1435346,863751866,8559,1027802,1390452,619,6241576,627636,80,5984,115556.0,26000.0,-68.0,-64.0,-71.0,-67.0,-68.0,-64.0,-70.0,-66.0,-77.0,-85.0,-77.0,-84.0,9.0,21.0,6.0,17.0,1
5518,F8:59:71:5A:E0:3D,3390678,663403486,172973,256979948,3217705,406423538,0,171201,215165875,166371,214588757,4830,577118,148718,16,175687,3019,0,546,144444.0,43333.0,-67.0,-73.0,-65.0,-70.0,-66.0,-73.0,-65.0,-70.0,-77.0,-85.0,-77.0,-84.0,10.0,12.0,12.0,14.0,1
5519,CC:2F:71:3E:C5:1F,3229135,407821774,11429,1398176,3217706,406423598,6,48761,4083968,40292,3080472,8469,1003496,12052,34,16393,186,6,829,130000.0,39000.0,-67.0,-70.0,-67.0,-60.0,-68.0,-71.0,-67.0,-61.0,-77.0,-85.0,-77.0,-84.0,10.0,15.0,10.0,24.0,1
5520,CC:2F:71:3F:1F:24,9455242,9937250758,6237534,9530826958,3217708,406423800,80,1444129,864898411,1435570,863870609,8559,1027802,1390676,619,6242237,627941,80,5984,86667.0,13000.0,-68.0,-64.0,-71.0,-66.0,-67.0,-64.0,-71.0,-66.0,-77.0,-85.0,-77.0,-84.0,9.0,21.0,6.0,18.0,1
5521,F8:59:71:5A:E0:3D,3390746,663501852,173036,257077850,3217710,406424002,0,171264,215262895,166434,214685777,4830,577118,148781,16,175750,3019,0,546,144444.0,43333.0,-66.0,-73.0,-65.0,-70.0,-66.0,-73.0,-65.0,-69.0,-77.0,-85.0,-77.0,-84.0,11.0,12.0,12.0,14.0,1
5522,CC:2F:71:3E:C5:1F,3229139,407822178,11429,1398176,3217710,406424002,6,48761,4083968,40292,3080472,8469,1003496,12052,34,16393,186,6,829,130000.0,39000.0,-67.0,-70.0,-67.0,-60.0,-68.0,-71.0,-67.0,-61.0,-77.0,-85.0,-77.0,-84.0,10.0,15.0,10.0,24.0,1
5523,CC:2F:71:3F:1F:24,9456184,9938693344,6238474,9532269342,3217710,406424002,80,1444357,865014255,1435798,863986453,8559,1027802,1390904,619,6243193,627942,80,5984,86667.0,14444.0,-69.0,-64.0,-71.0,-67.0,-69.0,-64.0,-71.0,-67.0,-77.0,-85.0,-77.0,-84.0,8.0,21.0,6.0,17.0,1
5524,F8:59:71:5A:E0:3D,3390814,663601712,173100,257177306,3217714,406424406,0,171328,215361525,166498,214784407,4830,577118,148845,16,175814,3019,0,546,144444.0,43333.0,-67.0,-73.0,-65.0,-70.0,-66.0,-72.0,-65.0,-70.0,-77.0,-85.0,-77.0,-84.0,10.0,12.0,12.0,14.0,1
5525,CC:2F:71:3E:C5:1F,3229143,407822582,11429,1398176,3217714,406424406,6,48761,4083968,40292,3080472,8469,1003496,12052,34,16393,186,6,829,130000.0,39000.0,-67.0,-70.0,-67.0,-60.0,-68.0,-71.0,-67.0,-61.0,-77.0,-85.0,-77.0,-84.0,10.0,15.0,10.0,24.0,1
5526,CC:2F:71:3F:1F:24,9457620,9940912132,6239906,9534487726,3217714,406424406,80,1444690,865151059,1436131,864123257,8559,1027802,1391237,619,6244620,627976,80,5984,86667.0,14444.0,-68.0,-64.0,-71.0,-67.0,-68.0,-64.0,-71.0,-67.0,-77.0,-85.0,-77.0,-84.0,9.0,21.0,6.0,17.0,1
5527,F8:59:71:5A:E0:3D,3390897,663720490,173176,257295410,3217721,406425080,0,171400,215472461,166570,214895343,4830,577118,148917,16,175890,3020,0,546,144444.0,43333.0,-66.0,-72.0,-65.0,-70.0,-66.0,-72.0,-65.0,-70.0,-77.0,-85.0,-77.0,-84.0,11.0,13.0,12.0,14.0,1
5528,CC:2F:71:3E:C5:1F,3229150,407823256,11429,1398176,3217721,406425080,6,48761,4083968,40292,3080472,8469,1003496,12052,34,16393,186,6,829,130000.0,39000.0,-67.0,-70.0,-67.0,-60.0,-68.0,-71.0,-67.0,-61.0,-77.0,-85.0,-77.0,-84.0,10.0,15.0,10.0,24.0,1
5529,CC:2F:71:3F:1F:24,9458541,9942312594,6240820,9535887514,3217721,406425080,80,1444906,865283119,1436347,864255317,8559,1027802,1391453,619,6245539,628181,80,5984,117000.0,39000.0,-69.0,-64.0,-71.0,-67.0,-68.0,-64.0,-70.0,-67.0,-77.0,-85.0,-77.0,-84.0,8.0,21.0,6.0,17.0,1
5530,F8:59:71:5A:E0:3D,3390966,663821904,173241,257396420,3217725,406425484,0,171469,215578721,166639,215001603,4830,577118,148986,16,175955,3022,0,546,144444.0,43333.0,-66.0,-73.0,-65.0,-70.0,-66.0,-73.0,-65.0,-70.0,-77.0,-85.0,-77.0,-84.0,11.0,12.0,12.0,14.0,1
5531,CC:2F:71:3E:C5:1F,3229154,407823660,11429,1398176,3217725,406425484,6,48761,4083968,40292,3080472,8469,1003496,12052,34,16393,186,6,829,130000.0,39000.0,-67.0,-70.0,-67.0,-60.0,-68.0,-71.0,-67.0,-61.0,-77.0,-85.0,-77.0,-84.0,10.0,15.0,10.0,24.0,1
5532,CC:2F:71:3F:1F:24,9459755,9944173120,6242030,9537747636,3217725,406425484,80,1445165,865407286,1436606,864379484,8559,1027802,1391712,619,6246749,628270,80,5984,115556.0,28889.0,-68.0,-64.0,-71.0,-67.0,-68.0,-64.0,-70.0,-67.0,-77.0,-85.0,-77.0,-84.0,9.0,21.0,6.0,17.0,1
5533,F8:59:71:5A:E0:3D,3391035,663923318,173306,257497430,3217729,406425888,0,171533,215677281,166703,215100163,4830,577118,149050,16,176020,3022,0,546,144444.0,43333.0,-66.0,-72.0,-65.0,-70.0,-66.0,-72.0,-65.0,-70.0,-77.0,-85.0,-77.0,-84.0,11.0,13.0,12.0,14.0,1
5534,CC:2F:71:3E:C5:1F,3229158,407824064,11429,1398176,3217729,406425888,6,48761,4083968,40292,3080472,8469,1003496,12052,34,16393,186,6,829,130000.0,39000.0,-67.0,-70.0,-67.0,-60.0,-68.0,-71.0,-67.0,-61.0,-77.0,-85.0,-77.0,-84.0,10.0,15.0,10.0,24.0,1
5535,CC:2F:71:3F:1F:24,9461595,9947030588,6243866,9540604700,3217729,406425888,80,1445455,865531870,1436896,864504068,8559,1027802,1392002,619,6248557,628273,80,5984,115556.0,28889.0,-68.0,-64.0,-71.0,-67.0,-68.0,-64.0,-71.0,-67.0,-77.0,-85.0,-77.0,-84.0,9.0,21.0,6.0,17.0,1
5536,F8:59:71:5A:E0:3D,3391102,664023036,173370,257596886,3217732,406426150,0,171595,215772761,166765,215195643,4830,577118,149112,16,176084,3022,0,546,144444.0,43333.0,-67.0,-73.0,-65.0,-70.0,-66.0,-72.0,-64.0,-70.0,-77.0,-85.0,-77.0,-84.0,10.0,12.0,12.0,14.0,1
5537,CC:2F:71:3E:C5:1F,3229163,407824528,11429,1398176,3217734,406426352,6,48761,4083968,40292,3080472,8469,1003496,12052,34,16393,186,6,829,130000.0,39000.0,-67.0,-70.0,-67.0,-60.0,-68.0,-71.0,-67.0,-61.0,-77.0,-85.0,-77.0,-84.0,10.0,15.0,10.0,24.0,1
5538,CC:2F:71:3F:1F:24,9463160,9949454377,6245426,9543028025,3217734,406426352,80,1445729,865658990,1437170,864631188,8559,1027802,1392276,619,6250145,628335,80,5984,115556.0,28889.0,-69.0,-64.0,-70.0,-66.0,-68.0,-64.0,-70.0,-66.0,-77.0,-85.0,-77.0,-84.0,8.0,21.0,7.0,18.0,1
5539,F8:59:71:5A:E0:3D,3391173,664124652,173435,257697896,3217738,406426756,0,171663,215877523,166833,215300405,4830,577118,149180,16,176149,3022,0,546,144444.0,43333.0,-67.0,-73.0,-65.0,-70.0,-67.0,-72.0,-65.0,-70.0,-77.0,-85.0,-77.0,-84.0,10.0,12.0,12.0,14.0,1
5540,CC:2F:71:3E:C5:1F,3229167,407824932,11429,1398176,3217738,406426756,6,48761,4083968,40292,3080472,8469,1003496,12052,34,16393,186,6,829,130000.0,39000.0,-67.0,-70.0,-67.0,-60.0,-68.0,-71.0,-67.0,-61.0,-77.0,-85.0,-77.0,-84.0,10.0,15.0,10.0,24.0,1
5541,CC:2F:71:3F:1F:24,9464766,9951941145,6247028,9545514389,3217738,406426756,80,1446003,865781642,1437444,864753840,8559,1027802,1392550,619,6251730,628336,80,5984,115556.0,28889.0,-68.0,-64.0,-70.0,-67.0,-68.0,-64.0,-71.0,-67.0,-77.0,-85.0,-77.0,-84.0,9.0,21.0,7.0,17.0,1
5542,F8:59:71:5A:E0:3D,3391240,664223155,173498,257795798,3217742,406427357,0,171726,215974543,166896,215397425,4830,577118,149243,16,176212,3023,0,546,144444.0,43333.0,-67.0,-73.0,-65.0,-70.0,-66.0,-72.0,-65.0,-70.0,-77.0,-85.0,-77.0,-84.0,10.0,12.0,12.0,14.0,1
5543,CC:2F:71:3E:C5:1F,3229171,407825533,11429,1398176,3217742,406427357,6,48761,4083968,40292,3080472,8469,1003496,12052,34,16393,186,6,829,130000.0,39000.0,-67.0,-70.0,-67.0,-60.0,-68.0,-71.0,-67.0,-61.0,-77.0,-85.0,-77.0,-84.0,10.0,15.0,10.0,24.0,1
5544,CC:2F:71:3F:1F:24,9466388,9954444082,6248644,9548016523,3217744,406427559,80,1446303,865907881,1437744,864880079,8559,1027802,1392850,619,6253351,628419,80,5984,117000.0,39000.0,-69.0,-64.0,-71.0,-67.0,-68.0,-64.0,-71.0,-67.0,-77.0,-85.0,-77.0,-84.0,8.0,21.0,6.0,17.0,1
5545,F8:59:71:5A:E0:3D,3391312,664324831,173563,257896808,3217749,406428023,0,171791,216074643,166961,215497525,4830,577118,149308,16,176277,3023,0,546,144444.0,43333.0,-67.0,-73.0,-65.0,-70.0,-66.0,-72.0,-65.0,-70.0,-77.0,-85.0,-77.0,-84.0,10.0,12.0,12.0,14.0,1
5546,CC:2F:71:3E:C5:1F,3229178,407826199,11429,1398176,3217749,406428023,6,48761,4083968,40292,3080472,8469,1003496,12052,34,16393,186,6,829,130000.0,39000.0,-67.0,-70.0,-67.0,-60.0,-68.0,-71.0,-67.0,-61.0,-77.0,-85.0,-77.0,-84.0,10.0,15.0,10.0,24.0,1
5547,CC:2F:71:3F:1F:24,9467646,9956380772,6249897,9549952749,3217749,406428023,80,1446575,866036141,1438016,865008339,8559,1027802,1393122,619,6254616,628830,80,5984,130000.0,43333.0,-69.0,-64.0,-72.0,-67.0,-69.0,-64.0,-71.0,-67.0,-77.0,-85.0,-77.0,-84.0,8.0,21.0,5.0,17.0,1
5548,F8:59:71:5A:E0:3D,3391382,664429678,173631,258001453,3217751,406428225,0,171860,216178097,167030,215600979,4830,577118,149377,16,176345,3025,0,546,144444.0,43333.0,-66.0,-72.0,-65.0,-70.0,-66.0,-72.0,-65.0,-70.0,-77.0,-85.0,-77.0,-84.0,11.0,13.0,12.0,14.0,1
5549,CC:2F:71:3E:C5:1F,3229180,407826401,11429,1398176,3217751,406428225,6,48761,4083968,40292,3080472,8469,1003496,12052,34,16393,186,6,829,130000.0,39000.0,-67.0,-70.0,-67.0,-60.0,-68.0,-71.0,-67.0,-61.0,-77.0,-85.0,-77.0,-84.0,10.0,15.0,10.0,24.0,1
5550,CC:2F:71:3F:1F:24,9468908,9958329062,6251157,9551900837,3217751,406428225,80,1446817,866160865,1438258,865133063,8559,1027802,1393364,619,6255876,628996,80,5984,130000.0,43333.0,-69.0,-64.0,-70.0,-67.0,-68.0,-64.0,-70.0,-66.0,-77.0,-85.0,-77.0,-84.0,8.0,21.0,7.0,17.0,1
5551,F8:59:71:5A:E0:3D,3391458,664533509,173701,258104678,3217757,406428831,0,171929,216278748,167099,215701630,4830,577118,149446,16,176415,3027,0,546,130000.0,39000.0,-67.0,-73.0,-66.0,-70.0,-66.0,-72.0,-65.0,-70.0,-77.0,-85.0,-77.0,-84.0,10.0,12.0,11.0,14.0,1
5552,CC:2F:71:3E:C5:1F,3229187,407827067,11429,1398176,3217758,406428891,6,48761,4083968,40292,3080472,8469,1003496,12052,34,16393,186,6,829,130000.0,39000.0,-67.0,-70.0,-67.0,-60.0,-68.0,-71.0,-67.0,-61.0,-77.0,-85.0,-77.0,-84.0,10.0,15.0,10.0,24.0,1
5553,CC:2F:71:3F:1F:24,9470148,9960235082,6252390,9553806191,3217758,406428891,80,1447061,866280389,1438502,865252587,8559,1027802,1393608,619,6257101,629354,80,5984,130000.0,43333.0,-69.0,-64.0,-71.0,-67.0,-68.0,-64.0,-71.0,-67.0,-77.0,-85.0,-77.0,-84.0,8.0,21.0,6.0,17.0,1
5554,F8:59:71:5A:E0:3D,3391526,664633231,173766,258204138,3217760,406429093,0,171994,216377414,167164,215800296,4830,577118,149511,16,176480,3027,0,546,144444.0,43333.0,-67.0,-73.0,-65.0,-70.0,-66.0,-72.0,-65.0,-70.0,-77.0,-85.0,-77.0,-84.0,10.0,12.0,12.0,14.0,1
5555,CC:2F:71:3E:C5:1F,3229189,407827269,11429,1398176,3217760,406429093,6,48761,4083968,40292,3080472,8469,1003496,12052,34,16393,186,6,829,130000.0,39000.0,-67.0,-70.0,-67.0,-60.0,-68.0,-71.0,-67.0,-61.0,-77.0,-85.0,-77.0,-84.0,10.0,15.0,10.0,24.0,1
5556,CC:2F:71:3F:1F:24,9471523,9962351758,6253763,9555922665,3217760,406429093,80,1447323,866405148,1438764,865377346,8559,1027802,1393870,619,6258482,629561,80,5984,115556.0,28889.0,-69.0,-64.0,-71.0,-67.0,-68.0,-64.0,-71.0,-67.0,-77.0,-85.0,-77.0,-84.0,8.0,21.0,6.0,17.0,1
5557,F8:59:71:5A:E0:3D,3391596,664734761,173832,258305264,3217764,406429497,0,172059,216477514,167229,215900396,4830,577118,149576,16,176546,3027,0,546,144444.0,43333.0,-67.0,-73.0,-65.0,-70.0,-67.0,-72.0,-64.0,-69.0,-77.0,-85.0,-77.0,-84.0,10.0,12.0,12.0,14.0,1
5558,CC:2F:71:3E:C5:1F,3229196,407827991,11430,1398292,3217766,406429699,6,48763,4084108,40294,3080612,8469,1003496,12052,34,16394,186,6,829,144444.0,39000.0,-69.0,-70.0,-66.0,-60.0,-68.0,-71.0,-67.0,-61.0,-77.0,-85.0,-77.0,-84.0,8.0,15.0,11.0,24.0,1
5559,CC:2F:71:3F:1F:24,9473218,9964974504,6255452,9558544805,3217766,406429699,80,1447607,866533392,1439048,865505590,8559,1027802,1394154,619,6260171,629603,80,5984,115556.0,28889.0,-69.0,-64.0,-71.0,-67.0,-68.0,-64.0,-71.0,-67.0,-77.0,-85.0,-77.0,-84.0,8.0,21.0,6.0,17.0,1
5560,F8:59:71:5A:E0:3D,3391668,664840755,173900,258410936,3217768,406429819,0,172125,216579154,167295,216002036,4830,577118,149642,16,176614,3027,0,546,144444.0,43333.0,-66.0,-72.0,-66.0,-70.0,-66.0,-72.0,-65.0,-70.0,-77.0,-85.0,-77.0,-84.0,11.0,13.0,11.0,14.0,1
5561,CC:2F:71:3E:C5:1F,3229200,407828313,11430,1398292,3217770,406430021,6,48763,4084108,40294,3080612,8469,1003496,12052,34,16394,186,6,829,144444.0,39000.0,-69.0,-70.0,-66.0,-60.0,-68.0,-71.0,-67.0,-61.0,-77.0,-85.0,-77.0,-84.0,8.0,15.0,11.0,24.0,1
5562,CC:2F:71:3F:1F:24,9474611,9967124932,6256841,9560694911,3217770,406430021,80,1447862,866660122,1439303,865632320,8559,1027802,1394409,619,6261560,629622,80,5984,115556.0,28889.0,-68.0,-64.0,-70.0,-67.0,-68.0,-64.0,-71.0,-67.0,-77.0,-85.0,-77.0,-84.0,9.0,21.0,7.0,17.0,1
5563,F8:59:71:5A:E0:3D,3391735,664939061,173963,258508838,3217772,406430223,0,172191,216680794,167361,216103676,4830,577118,149708,16,176677,3027,0,546,144444.0,43333.0,-66.0,-73.0,-65.0,-69.0,-66.0,-73.0,-65.0,-70.0,-77.0,-85.0,-77.0,-84.0,11.0,12.0,12.0,15.0,1
5564,CC:2F:71:3E:C5:1F,3229204,407828717,11430,1398292,3217774,406430425,6,48763,4084108,40294,3080612,8469,1003496,12052,34,16394,186,6,829,144444.0,39000.0,-69.0,-70.0,-66.0,-60.0,-68.0,-71.0,-67.0,-61.0,-77.0,-85.0,-77.0,-84.0,8.0,15.0,11.0,24.0,1
5565,CC:2F:71:3F:1F:24,9475968,9969217320,6258192,9562786693,3217776,406430627,80,1448088,866778686,1439529,865750884,8559,1027802,1394635,619,6262911,629648,80,5984,115556.0,28889.0,-68.0,-64.0,-70.0,-67.0,-68.0,-64.0,-70.0,-67.0,-77.0,-85.0,-77.0,-84.0,9.0,21.0,7.0,17.0,1
5566,F8:59:71:5A:E0:3D,3391804,665038981,174027,258608294,3217777,406430687,0,172255,216779354,167425,216202236,4830,577118,149772,16,176741,3027,0,546,144444.0,43333.0,-67.0,-73.0,-65.0,-70.0,-66.0,-72.0,-65.0,-70.0,-77.0,-85.0,-77.0,-84.0,10.0,12.0,12.0,14.0,1
5567,CC:2F:71:3E:C5:1F,3229207,407828979,11430,1398292,3217777,406430687,6,48763,4084108,40294,3080612,8469,1003496,12052,34,16394,186,6,829,144444.0,39000.0,-69.0,-70.0,-66.0,-60.0,-68.0,-71.0,-67.0,-61.0,-77.0,-85.0,-77.0,-84.0,8.0,15.0,11.0,24.0,1
5568,CC:2F:71:3F:1F:24,9477401,9971429434,6259624,9564998747,3217777,406430687,80,1448376,866902347,1439817,865874545,8559,1027802,1394923,619,6264343,629659,80,5984,115556.0,28889.0,-68.0,-64.0,-71.0,-67.0,-69.0,-64.0,-71.0,-67.0,-77.0,-85.0,-77.0,-84.0,9.0,21.0,6.0,17.0,1
5569,F8:59:71:5A:E0:3D,3391874,665138961,174091,258707750,3217783,406431211,0,172318,216876402,167488,216299284,4830,577118,149835,16,176805,3027,0,547,144444.0,43333.0,-67.0,-73.0,-65.0,-70.0,-66.0,-72.0,-65.0,-69.0,-77.0,-85.0,-77.0,-84.0,10.0,12.0,12.0,14.0,1
5570,CC:2F:71:3E:C5:1F,3229213,407829503,11430,1398292,3217783,406431211,6,48763,4084108,40294,3080612,8469,1003496,12052,34,16394,186,6,829,144444.0,39000.0,-69.0,-70.0,-66.0,-60.0,-68.0,-71.0,-67.0,-61.0,-77.0,-85.0,-77.0,-84.0,8.0,15.0,11.0,24.0,1
5571,CC:2F:71:3F:1F:24,9478824,9973624976,6261041,9567193765,3217783,406431211,80,1448644,867027283,1440085,865999481,8559,1027802,1395191,619,6265759,630010,80,5985,130000.0,43333.0,-68.0,-64.0,-70.0,-67.0,-68.0,-64.0,-70.0,-67.0,-77.0,-85.0,-77.0,-84.0,9.0,21.0,7.0,17.0,1
5572,F8:59:71:5A:E0:3D,3391944,665240491,174157,258808876,3217787,406431615,0,172384,216976608,167554,216399490,4830,577118,149901,16,176870,3027,0,547,144444.0,43333.0,-66.0,-72.0,-65.0,-70.0,-66.0,-72.0,-65.0,-69.0,-77.0,-85.0,-77.0,-84.0,11.0,13.0,12.0,14.0,1
5573,CC:2F:71:3E:C5:1F,3229217,407829907,11430,1398292,3217787,406431615,6,48763,4084108,40294,3080612,8469,1003496,12052,34,16394,186,6,829,144444.0,39000.0,-69.0,-70.0,-66.0,-60.0,-68.0,-71.0,-67.0,-61.0,-77.0,-85.0,-77.0,-84.0,8.0,15.0,11.0,24.0,1
5574,CC:2F:71:3F:1F:24,9480337,9975965077,6262550,9569533462,3217787,406431615,80,1448906,867150234,1440347,866122432,8559,1027802,1395453,619,6267269,630311,80,5985,130000.0,43333.0,-69.0,-64.0,-71.0,-67.0,-68.0,-64.0,-71.0,-67.0,-77.0,-85.0,-77.0,-84.0,8.0,21.0,6.0,17.0,1
5575,F8:59:71:5A:E0:3D,3392010,665337243,174219,258905224,3217791,406432019,0,172447,217073628,167617,216496510,4830,577118,149964,16,176933,3028,0,547,144444.0,43333.0,-66.0,-72.0,-65.0,-70.0,-66.0,-72.0,-65.0,-69.0,-77.0,-85.0,-77.0,-84.0,11.0,13.0,12.0,14.0,1
5576,CC:2F:71:3E:C5:1F,3229221,407830311,11430,1398292,3217791,406432019,6,48763,4084108,40294,3080612,8469,1003496,12052,34,16394,186,6,829,144444.0,39000.0,-69.0,-70.0,-66.0,-60.0,-68.0,-71.0,-67.0,-61.0,-77.0,-85.0,-77.0,-84.0,8.0,15.0,11.0,24.0,1
5577,CC:2F:71:3F:1F:24,9481484,9977727567,6263693,9571295548,3217791,406432019,80,1449162,867272250,1440603,866244448,8559,1027802,1395709,619,6268412,630653,80,5985,130000.0,43333.0,-68.0,-64.0,-72.0,-67.0,-68.0,-64.0,-71.0,-67.0,-77.0,-85.0,-77.0,-84.0,9.0,21.0,5.0,17.0,1
5578,F8:59:71:5A:E0:3D,3392081,665440271,174285,259007788,3217796,406432483,0,172512,217173728,167682,216596610,4830,577118,150029,16,176999,3030,0,547,144444.0,43333.0,-66.0,-73.0,-65.0,-70.0,-66.0,-73.0,-65.0,-70.0,-77.0,-85.0,-77.0,-84.0,11.0,12.0,12.0,14.0,1
5579,CC:2F:71:3E:C5:1F,3229226,407830775,11430,1398292,3217796,406432483,6,48763,4084108,40294,3080612,8469,1003496,12052,34,16394,186,6,829,144444.0,39000.0,-69.0,-70.0,-66.0,-60.0,-68.0,-71.0,-67.0,-61.0,-77.0,-85.0,-77.0,-84.0,8.0,15.0,11.0,24.0,1
5580,CC:2F:71:3F:1F:24,9482810,9979770617,6265014,9573338134,3217796,406432483,80,1449424,867397948,1440865,866370146,8559,1027802,1395971,619,6269733,631045,80,5985,117000.0,39000.0,-69.0,-64.0,-71.0,-67.0,-68.0,-64.0,-70.0,-67.0,-77.0,-85.0,-77.0,-84.0,8.0,21.0,6.0,17.0,1
5581,F8:59:71:5A:E0:3D,3392150,665541685,174350,259108798,3217800,406432887,0,172577,217273828,167747,216696710,4830,577118,150094,16,177063,3030,0,547,144444.0,43333.0,-67.0,-73.0,-65.0,-70.0,-67.0,-72.0,-65.0,-70.0,-77.0,-85.0,-77.0,-84.0,10.0,12.0,12.0,14.0,1
5582,CC:2F:71:3E:C5:1F,3229230,407831179,11430,1398292,3217800,406432887,6,48763,4084108,40294,3080612,8469,1003496,12052,34,16394,186,6,829,144444.0,39000.0,-69.0,-70.0,-66.0,-60.0,-68.0,-71.0,-67.0,-61.0,-77.0,-85.0,-77.0,-84.0,8.0,15.0,11.0,24.0,1
5583,CC:2F:71:3F:1F:24,9484235,9981954223,6266435,9575521336,3217800,406432887,80,1449702,867523624,1441143,866495822,8559,1027802,1396249,619,6271153,631354,80,5985,130000.0,43333.0,-69.0,-64.0,-71.0,-67.0,-68.0,-64.0,-70.0,-67.0,-77.0,-85.0,-77.0,-84.0,8.0,21.0,6.0,17.0,1
5584,F8:59:71:5A:E0:3D,3392222,665644988,174416,259211362,3217806,406433626,0,172644,217377008,167814,216799890,4830,577118,150161,16,177130,3030,0,547,144444.0,43333.0,-66.0,-72.0,-66.0,-70.0,-66.0,-72.0,-65.0,-70.0,-77.0,-85.0,-77.0,-84.0,11.0,13.0,11.0,14.0,1
5585,CC:2F:71:3E:C5:1F,3229237,407831980,11430,1398292,3217807,406433688,6,48763,4084108,40294,3080612,8469,1003496,12052,34,16394,186,6,829,144444.0,39000.0,-69.0,-70.0,-66.0,-60.0,-68.0,-71.0,-67.0,-61.0,-77.0,-85.0,-77.0,-84.0,8.0,15.0,11.0,24.0,1
5586,CC:2F:71:3F:1F:24,9486086,9984824440,6268279,9578390752,3217807,406433688,80,1450003,867659536,1441443,866631616,8560,1027920,1396550,619,6272998,632207,80,5985,104000.0,26000.0,-69.0,-64.0,-71.0,-67.0,-68.0,-64.0,-70.0,-67.0,-77.0,-85.0,-77.0,-84.0,8.0,21.0,6.0,17.0,1
5587,F8:59:71:5A:E0:3D,3392296,665751186,174484,259317034,3217812,406434152,0,172713,217481874,167882,216904638,4831,577236,150230,16,177198,3030,0,547,144444.0,43333.0,-66.0,-72.0,-65.0,-69.0,-66.0,-72.0,-65.0,-69.0,-77.0,-85.0,-77.0,-84.0,11.0,13.0,12.0,15.0,1
5588,CC:2F:71:3E:C5:1F,3229242,407832444,11430,1398292,3217812,406434152,6,48763,4084108,40294,3080612,8469,1003496,12052,34,16394,186,6,829,144444.0,39000.0,-69.0,-70.0,-66.0,-60.0,-68.0,-71.0,-67.0,-61.0,-77.0,-85.0,-77.0,-84.0,8.0,15.0,11.0,24.0,1
5589,CC:2F:71:3F:1F:24,9487926,9987680326,6270114,9581246174,3217812,406434152,80,1450317,867788790,1441757,866760870,8560,1027920,1396864,619,6274833,632232,80,5986,115556.0,28889.0,-70.0,-64.0,-71.0,-67.0,-69.0,-64.0,-71.0,-67.0,-77.0,-85.0,-77.0,-84.0,7.0,21.0,6.0,17.0,1
5590,F8:59:71:5A:E0:3D,3392365,665851108,174548,259416490,3217817,406434618,0,172776,217578894,167945,217001658,4831,577236,150293,16,177262,3031,0,547,144444.0,43333.0,-67.0,-73.0,-65.0,-70.0,-66.0,-72.0,-65.0,-70.0,-77.0,-85.0,-77.0,-84.0,10.0,12.0,12.0,14.0,1
5591,CC:2F:71:3E:C5:1F,3229247,407832910,11430,1398292,3217817,406434618,6,48765,4084296,40295,3080682,8470,1003614,12053,34,16394,186,6,829,144444.0,39000.0,-68.0,-70.0,-67.0,-60.0,-68.0,-71.0,-67.0,-61.0,-77.0,-85.0,-77.0,-84.0,9.0,15.0,10.0,24.0,1
5592,CC:2F:71:3F:1F:24,9489825,9990627932,6272008,9584193314,3217817,406434618,80,1450616,867917210,1442056,866889290,8560,1027920,1397163,619,6276699,632239,80,5986,115556.0,28889.0,-69.0,-64.0,-71.0,-67.0,-69.0,-64.0,-70.0,-67.0,-77.0,-85.0,-77.0,-84.0,8.0,21.0,6.0,17.0,1
5593,F8:59:71:5A:E0:3D,3392433,665952380,174613,259517500,3217820,406434880,0,172841,217678994,168010,217101758,4831,577236,150358,16,177327,3031,0,547,144444.0,43333.0,-67.0,-73.0,-65.0,-70.0,-66.0,-72.0,-65.0,-70.0,-77.0,-85.0,-77.0,-84.0,10.0,12.0,12.0,14.0,1
5594,CC:2F:71:3E:C5:1F,3229252,407833374,11430,1398292,3217822,406435082,6,48765,4084296,40295,3080682,8470,1003614,12053,34,16394,186,6,829,144444.0,39000.0,-68.0,-70.0,-67.0,-60.0,-68.0,-71.0,-67.0,-61.0,-77.0,-85.0,-77.0,-84.0,9.0,15.0,10.0,24.0,1
5595,CC:2F:71:3F:1F:24,9490985,9992402768,6273163,9585967686,3217822,406435082,80,1450876,868041809,1442316,867013889,8560,1027920,1397422,619,6277882,632458,80,5986,117000.0,39000.0,-69.0,-64.0,-70.0,-67.0,-68.0,-64.0,-70.0,-67.0,-77.0,-85.0,-77.0,-84.0,8.0,21.0,7.0,17.0,1
5596,F8:59:71:5A:E0:3D,3392504,666053996,174678,259618510,3217826,406435486,0,172906,217779094,168075,217201858,4831,577236,150423,16,177392,3032,0,547,144444.0,43333.0,-66.0,-72.0,-65.0,-70.0,-66.0,-72.0,-64.0,-70.0,-77.0,-85.0,-77.0,-84.0,11.0,13.0,12.0,14.0,1
5597,CC:2F:71:3E:C5:1F,3229256,407833778,11430,1398292,3217826,406435486,6,48765,4084296,40295,3080682,8470,1003614,12053,34,16394,186,6,829,144444.0,39000.0,-68.0,-70.0,-67.0,-60.0,-68.0,-71.0,-67.0,-61.0,-77.0,-85.0,-77.0,-84.0,9.0,15.0,10.0,24.0,1
5598,CC:2F:71:3F:1F:24,9492096,9994109538,6274270,9587674052,3217826,406435486,80,1451118,868162249,1442558,867134329,8560,1027920,1397663,619,6278976,632784,80,5986,130000.0,43333.0,-69.0,-64.0,-71.0,-67.0,-68.0,-64.0,-71.0,-67.0,-77.0,-85.0,-77.0,-84.0,8.0,21.0,6.0,17.0,1
5599,F8:59:71:5A:E0:3D,3392570,666153654,174742,259717966,3217828,406435688,0,172970,217877654,168139,217300418,4831,577236,150487,16,177456,3032,0,547,144444.0,43333.0,-67.0,-73.0,-65.0,-70.0,-67.0,-73.0,-65.0,-70.0,-77.0,-85.0,-77.0,-84.0,10.0,12.0,12.0,14.0,1
5600,CC:2F:71:3E:C5:1F,3229258,407833980,11430,1398292,3217828,406435688,6,48765,4084296,40295,3080682,8470,1003614,12053,34,16394,186,6,829,144444.0,39000.0,-68.0,-70.0,-67.0,-60.0,-68.0,-71.0,-67.0,-61.0,-77.0,-85.0,-77.0,-84.0,9.0,15.0,10.0,24.0,1
5601,CC:2F:71:3F:1F:24,9493774,9996712900,6275946,9590277212,3217828,406435688,80,1451418,868290753,1442858,867262833,8560,1027920,1397963,619,6280665,633141,80,5986,130000.0,43333.0,-69.0,-64.0,-71.0,-67.0,-68.0,-64.0,-70.0,-67.0,-77.0,-85.0,-77.0,-84.0,8.0,21.0,6.0,17.0,1
5602,F8:59:71:5A:E0:3D,3392641,666253776,174806,259817422,3217835,406436354,0,173034,217976214,168203,217398978,4831,577236,150551,16,177519,3032,0,547,144444.0,43333.0,-67.0,-73.0,-65.0,-70.0,-67.0,-73.0,-65.0,-70.0,-77.0,-85.0,-77.0,-84.0,10.0,12.0,12.0,14.0,1
5603,CC:2F:71:3E:C5:1F,3229265,407834646,11430,1398292,3217835,406436354,6,48765,4084296,40295,3080682,8470,1003614,12053,34,16394,186,6,829,144444.0,39000.0,-68.0,-70.0,-67.0,-60.0,-68.0,-71.0,-67.0,-61.0,-77.0,-85.0,-77.0,-84.0,9.0,15.0,10.0,24.0,1
5604,CC:2F:71:3F:1F:24,9495034,9998650464,6277199,9592214110,3217835,406436354,80,1451679,868419149,1443119,867391229,8560,1027920,1398224,619,6281918,633476,80,5986,130000.0,43333.0,-69.0,-64.0,-71.0,-67.0,-69.0,-64.0,-71.0,-67.0,-77.0,-85.0,-77.0,-84.0,8.0,21.0,6.0,17.0,1
5605,F8:59:71:5A:E0:3D,3392709,666359448,174874,259923094,3217835,406436354,0,173103,218082474,168272,217505238,4831,577236,150620,16,177588,3034,0,547,144444.0,43333.0,-67.0,-73.0,-65.0,-70.0,-66.0,-72.0,-65.0,-70.0,-77.0,-85.0,-77.0,-84.0,10.0,12.0,12.0,14.0,1
5606,CC:2F:71:3E:C5:1F,3229267,407834848,11430,1398292,3217837,406436556,6,48765,4084296,40295,3080682,8470,1003614,12053,34,16394,186,6,829,144444.0,39000.0,-68.0,-70.0,-67.0,-60.0,-68.0,-71.0,-67.0,-61.0,-77.0,-85.0,-77.0,-84.0,9.0,15.0,10.0,24.0,1
5607,CC:2F:71:3F:1F:24,9495608,9999504190,6277771,9593067634,3217837,406436556,80,1451845,868529812,1443285,867501892,8560,1027920,1398390,619,6282490,633571,80,5986,130000.0,43333.0,-68.0,-64.0,-71.0,-67.0,-68.0,-64.0,-71.0,-67.0,-77.0,-85.0,-77.0,-84.0,9.0,21.0,6.0,17.0,1
5608,F8:59:71:5A:E0:3D,3392778,666457956,174937,260020996,3217841,406436960,0,173166,218179494,168335,217602258,4831,577236,150683,16,177651,3034,0,547,144444.0,43333.0,-67.0,-73.0,-65.0,-70.0,-66.0,-72.0,-65.0,-70.0,-77.0,-85.0,-77.0,-84.0,10.0,12.0,12.0,14.0,1
5609,CC:2F:71:3E:C5:1F,3229271,407835252,11430,1398292,3217841,406436960,6,48765,4084296,40295,3080682,8470,1003614,12053,34,16394,186,6,829,144444.0,39000.0,-68.0,-70.0,-67.0,-60.0,-68.0,-71.0,-67.0,-61.0,-77.0,-85.0,-77.0,-84.0,9.0,15.0,10.0,24.0,1
5610,CC:2F:71:3F:1F:24,9496392,10000692360,6278549,9594255198,3217843,406437162,80,1452058,868646856,1443498,867618936,8560,1027920,1398603,619,6283268,633681,80,5986,130000.0,43333.0,-69.0,-64.0,-72.0,-67.0,-68.0,-64.0,-70.0,-66.0,-77.0,-85.0,-77.0,-84.0,8.0,21.0,5.0,17.0,1
5611,F8:59:71:5A:E0:3D,3392844,666556120,175000,260118898,3217844,406437222,0,173229,218276514,168398,217699278,4831,577236,150746,16,177714,3034,0,547,144444.0,43333.0,-67.0,-73.0,-65.0,-70.0,-66.0,-73.0,-65.0,-70.0,-77.0,-85.0,-77.0,-84.0,10.0,12.0,12.0,14.0,1
5612,CC:2F:71:3E:C5:1F,3229274,407835514,11430,1398292,3217844,406437222,6,48765,4084296,40295,3080682,8470,1003614,12053,34,16394,186,6,829,144444.0,39000.0,-68.0,-70.0,-67.0,-60.0,-68.0,-71.0,-67.0,-61.0,-77.0,-85.0,-77.0,-84.0,9.0,15.0,10.0,24.0,1
5613,CC:2F:71:3F:1F:24,9497592,10002542226,6279748,9596105004,3217844,406437222,80,1452308,868766780,1443748,867738860,8560,1027920,1398853,619,6284449,633977,80,5987,130000.0,43333.0,-69.0,-64.0,-71.0,-67.0,-68.0,-64.0,-70.0,-67.0,-77.0,-85.0,-77.0,-84.0,8.0,21.0,6.0,17.0,1
5614,F8:59:71:5A:E0:3D,3392915,666657736,175065,260219908,3217850,406437828,0,173293,218375074,168462,217797838,4831,577236,150810,16,177778,3034,0,547,144444.0,43333.0,-67.0,-73.0,-66.0,-70.0,-66.0,-72.0,-65.0,-69.0,-77.0,-85.0,-77.0,-84.0,10.0,12.0,11.0,14.0,1
5615,CC:2F:71:3E:C5:1F,3229280,407836120,11430,1398292,3217850,406437828,6,48765,4084296,40295,3080682,8470,1003614,12053,34,16394,186,6,829,144444.0,39000.0,-68.0,-70.0,-67.0,-60.0,-68.0,-71.0,-67.0,-61.0,-77.0,-85.0,-77.0,-84.0,9.0,15.0,10.0,24.0,1
5616,CC:2F:71:3F:1F:24,9498871,10004507040,6281019,9598069010,3217852,406438030,80,1452571,868901108,1444011,867873188,8560,1027920,1399116,619,6285738,634234,80,5987,130000.0,43333.0,-69.0,-64.0,-71.0,-67.0,-68.0,-64.0,-71.0,-67.0,-77.0,-85.0,-77.0,-84.0,8.0,21.0,6.0,17.0,1
5617,F8:59:71:5A:E0:3D,3392988,666768272,175136,260330242,3217852,406438030,0,173364,218484414,168533,217907178,4831,577236,150881,16,177850,3036,0,547,144444.0,43333.0,-66.0,-73.0,-65.0,-70.0,-66.0,-72.0,-65.0,-70.0,-77.0,-85.0,-77.0,-84.0,11.0,12.0,12.0,14.0,1
5618,CC:2F:71:3E:C5:1F,3229282,407836322,11430,1398292,3217852,406438030,6,48765,4084296,40295,3080682,8470,1003614,12053,34,16394,186,6,829,144444.0,39000.0,-68.0,-70.0,-67.0,-60.0,-68.0,-71.0,-67.0,-61.0,-77.0,-85.0,-77.0,-84.0,9.0,15.0,10.0,24.0,1
5619,CC:2F:71:3F:1F:24,9500112,10006414638,6282260,9599976608,3217852,406438030,80,1452815,869020819,1444255,867992899,8560,1027920,1399360,619,6286979,634573,80,5987,130000.0,39000.0,-68.0,-64.0,-71.0,-67.0,-68.0,-64.0,-70.0,-67.0,-77.0,-85.0,-77.0,-84.0,9.0,21.0,6.0,17.0,1
5620,F8:59:71:5A:E0:3D,3393059,666868226,175200,260429530,3217859,406438696,0,173429,218584514,168598,218007278,4831,577236,150946,16,177914,3036,0,547,144444.0,43333.0,-67.0,-73.0,-65.0,-70.0,-67.0,-73.0,-65.0,-70.0,-77.0,-85.0,-77.0,-84.0,10.0,12.0,12.0,14.0,1
5621,CC:2F:71:3E:C5:1F,3229289,407836988,11430,1398292,3217859,406438696,6,48765,4084296,40295,3080682,8470,1003614,12053,34,16394,186,6,829,144444.0,39000.0,-68.0,-70.0,-67.0,-60.0,-68.0,-71.0,-67.0,-61.0,-77.0,-85.0,-77.0,-84.0,9.0,15.0,10.0,24.0,1
5622,CC:2F:71:3F:1F:24,9501149,10008000108,6283290,9601561412,3217859,406438696,80,1453034,869139879,1444474,868111959,8560,1027920,1399579,619,6288009,634776,80,5987,130000.0,43333.0,-69.0,-64.0,-72.0,-67.0,-68.0,-64.0,-71.0,-67.0,-77.0,-85.0,-77.0,-84.0,8.0,21.0,5.0,17.0,1
5623,F8:59:71:5A:E0:3D,3393125,666967884,175264,260528986,3217861,406438898,0,173493,218683074,168662,218105838,4831,577236,151010,16,177978,3037,0,547,144444.0,43333.0,-67.0,-73.0,-65.0,-70.0,-67.0,-72.0,-65.0,-69.0,-77.0,-85.0,-77.0,-85.0,10.0,12.0,12.0,15.0,1
5624,CC:2F:71:3E:C5:1F,3229291,407837190,11430,1398292,3217861,406438898,6,48765,4084296,40295,3080682,8470,1003614,12053,34,16394,186,6,829,144444.0,39000.0,-68.0,-70.0,-67.0,-60.0,-68.0,-71.0,-67.0,-61.0,-77.0,-85.0,-77.0,-85.0,9.0,15.0,10.0,25.0,1
5625,CC:2F:71:3F:1F:24,9502411,10009947046,6284550,9603508148,3217861,406438898,80,1453293,869262239,1444733,868234319,8560,1027920,1399838,619,6289269,635028,80,5987,130000.0,43333.0,-68.0,-64.0,-70.0,-67.0,-68.0,-64.0,-70.0,-67.0,-77.0,-85.0,-77.0,-85.0,9.0,21.0,7.0,18.0,1
5626,F8:59:71:5A:E0:3D,3393195,667069571,175329,260629996,3217866,406439575,0,173557,218781634,168726,218204398,4831,577236,151074,16,178042,3037,0,547,144444.0,43333.0,-67.0,-73.0,-65.0,-70.0,-66.0,-72.0,-64.0,-70.0,-77.0,-85.0,-77.0,-85.0,10.0,12.0,12.0,15.0,1
5627,CC:2F:71:3E:C5:1F,3229298,407838069,11430,1398292,3217868,406439777,6,48765,4084296,40295,3080682,8470,1003614,12053,34,16394,186,6,829,144444.0,39000.0,-68.0,-70.0,-67.0,-60.0,-68.0,-71.0,-67.0,-61.0,-77.0,-85.0,-77.0,-85.0,9.0,15.0,10.0,25.0,1
5628,CC:2F:71:3F:1F:24,9503690,10011911831,6285821,9605471994,3217869,406439837,80,1453541,869383423,1444981,868355503,8560,1027920,1400086,619,6290540,635421,80,5987,130000.0,43333.0,-69.0,-64.0,-71.0,-67.0,-68.0,-64.0,-71.0,-67.0,-77.0,-85.0,-77.0,-85.0,8.0,21.0,6.0,18.0,1
5629,F8:59:71:5A:E0:3D,3393265,667171045,175394,260731006,3217871,406440039,0,173623,218883274,168792,218306038,4831,577236,151140,16,178108,3037,0,547,144444.0,43333.0,-66.0,-73.0,-65.0,-70.0,-66.0,-72.0,-65.0,-69.0,-77.0,-85.0,-77.0,-85.0,11.0,12.0,12.0,15.0,1
5630,CC:2F:71:3E:C5:1F,3229301,407838331,11430,1398292,3217871,406440039,6,48765,4084296,40295,3080682,8470,1003614,12053,34,16394,186,6,829,144444.0,39000.0,-68.0,-70.0,-67.0,-60.0,-68.0,-71.0,-67.0,-61.0,-77.0,-85.0,-77.0,-85.0,9.0,15.0,10.0,25.0,1
5631,CC:2F:71:3F:1F:24,9504638,10013357233,6286767,9606917194,3217871,406440039,80,1453763,869503468,1445203,868475548,8560,1027920,1400307,619,6291482,635650,80,5987,130000.0,43333.0,-69.0,-64.0,-71.0,-67.0,-68.0,-64.0,-70.0,-67.0,-77.0,-85.0,-77.0,-85.0,8.0,21.0,6.0,18.0,1
5632,F8:59:71:5A:E0:3D,3393332,667268468,175457,260828025,3217875,406440443,0,173686,218978904,168855,218401668,4831,577236,151203,16,178171,3037,0,547,144444.0,43333.0,-67.0,-73.0,-65.0,-70.0,-66.0,-73.0,-65.0,-70.0,-77.0,-85.0,-77.0,-85.0,10.0,12.0,12.0,15.0,1
5633,CC:2F:71:3E:C5:1F,3229305,407838735,11430,1398292,3217875,406440443,6,48765,4084296,40295,3080682,8470,1003614,12053,34,16394,186,6,829,144444.0,39000.0,-68.0,-70.0,-67.0,-60.0,-68.0,-71.0,-67.0,-61.0,-77.0,-85.0,-77.0,-85.0,9.0,15.0,10.0,25.0,1
5634,CC:2F:71:3F:1F:24,9505559,10014764343,6287684,9608323900,3217875,406440443,80,1453993,869620840,1445433,868592920,8560,1027920,1400535,619,6292402,635769,80,5987,130000.0,43333.0,-69.0,-64.0,-71.0,-67.0,-68.0,-64.0,-71.0,-67.0,-77.0,-85.0,-77.0,-85.0,8.0,21.0,6.0,18.0,1
5635,F8:59:71:5A:E0:3D,3393399,667366662,175520,260925815,3217879,406440847,0,173749,219075924,168918,218498688,4831,577236,151266,16,178234,3037,0,547,144444.0,43333.0,-67.0,-73.0,-65.0,-71.0,-66.0,-72.0,-65.0,-70.0,-77.0,-85.0,-77.0,-85.0,10.0,12.0,12.0,14.0,1
5636,CC:2F:71:3E:C5:1F,3229310,407839199,11430,1398292,3217880,406440907,6,48765,4084296,40295,3080682,8470,1003614,12053,34,16394,186,6,829,144444.0,39000.0,-68.0,-70.0,-67.0,-60.0,-68.0,-71.0,-67.0,-61.0,-77.0,-85.0,-77.0,-85.0,9.0,15.0,10.0,25.0,1
5637,CC:2F:71:3F:1F:24,9506800,10016675119,6288920,9610234212,3217880,406440907,80,1454224,869738496,1445664,868710576,8560,1027920,1400766,619,6293639,635929,80,5987,130000.0,43333.0,-68.0,-64.0,-71.0,-67.0,-68.0,-64.0,-71.0,-67.0,-77.0,-85.0,-77.0,-85.0,9.0,21.0,6.0,18.0,1
5638,F8:59:71:5A:E0:3D,3393466,667466380,175584,261025271,3217882,406441109,0,173813,219174484,168982,218597248,4831,577236,151330,16,178298,3037,0,547,144444.0,43333.0,-67.0,-73.0,-65.0,-70.0,-66.0,-73.0,-65.0,-70.0,-77.0,-85.0,-77.0,-85.0,10.0,12.0,12.0,15.0,1
5639,CC:2F:71:3E:C5:1F,3229312,407839401,11430,1398292,3217882,406441109,6,48765,4084296,40295,3080682,8470,1003614,12053,34,16394,186,6,829,144444.0,39000.0,-68.0,-70.0,-67.0,-60.0,-68.0,-71.0,-67.0,-61.0,-77.0,-85.0,-77.0,-85.0,9.0,15.0,10.0,25.0,1
5640,CC:2F:71:3F:1F:24,9508073,10018637677,6290189,9612196366,3217884,406441311,80,1454465,869864740,1445905,868836820,8560,1027920,1401006,619,6294908,636199,80,5987,117000.0,39000.0,-69.0,-64.0,-71.0,-67.0,-68.0,-64.0,-71.0,-67.0,-77.0,-85.0,-77.0,-85.0,8.0,21.0,6.0,18.0,1
5641,F8:59:71:5A:E0:3D,3393543,667573142,175653,261131059,3217890,406442083,0,173880,219277664,169049,218700428,4831,577236,151397,16,178367,3037,0,547,144444.0,43333.0,-67.0,-73.0,-65.0,-70.0,-66.0,-72.0,-64.0,-69.0,-77.0,-85.0,-77.0,-85.0,10.0,12.0,12.0,15.0,1
5642,CC:2F:71:3E:C5:1F,3229321,407840435,11431,1398352,3217890,406442083,6,48767,4084436,40297,3080822,8470,1003614,12053,34,16395,186,6,829,144444.0,39000.0,-69.0,-71.0,-67.0,-60.0,-68.0,-71.0,-67.0,-61.0,-77.0,-85.0,-77.0,-85.0,8.0,14.0,10.0,25.0,1
5643,CC:2F:71:3F:1F:24,9509176,10020327821,6291286,9613885738,3217890,406442083,80,1454710,869985416,1446150,868957496,8560,1027920,1401251,619,6296005,636315,80,5987,130000.0,43333.0,-69.0,-64.0,-70.0,-67.0,-68.0,-64.0,-70.0,-67.0,-77.0,-85.0,-77.0,-85.0,8.0,21.0,7.0,18.0,1
5644,F8:59:71:5A:E0:3D,3393610,667672860,175717,261230515,3217893,406442345,0,173945,219377778,169114,218800542,4831,577236,151461,16,178431,3037,0,547,144444.0,43333.0,-66.0,-73.0,-66.0,-70.0,-66.0,-72.0,-65.0,-70.0,-77.0,-85.0,-77.0,-85.0,11.0,12.0,11.0,15.0,1
5645,CC:2F:71:3E:C5:1F,3229324,407840697,11431,1398352,3217893,406442345,6,48767,4084436,40297,3080822,8470,1003614,12053,34,16395,186,6,829,144444.0,39000.0,-69.0,-71.0,-67.0,-60.0,-68.0,-71.0,-67.0,-61.0,-77.0,-85.0,-77.0,-85.0,8.0,14.0,10.0,25.0,1
5646,CC:2F:71:3F:1F:24,9510596,10022513569,6292703,9616071224,3217893,406442345,80,1454941,870103551,1446381,869075631,8560,1027920,1401482,619,6297401,636594,80,5987,130000.0,43333.0,-69.0,-64.0,-71.0,-67.0,-68.0,-64.0,-71.0,-67.0,-77.0,-85.0,-77.0,-85.0,8.0,21.0,6.0,18.0,1
5647,F8:59:71:5A:E0:3D,3393680,667772922,175781,261329971,3217899,406442951,0,174010,219477892,169179,218900656,4831,577236,151525,16,178495,3037,0,547,144444.0,43333.0,-67.0,-73.0,-65.0,-70.0,-67.0,-73.0,-65.0,-70.0,-77.0,-85.0,-77.0,-85.0,10.0,12.0,12.0,15.0,1
5648,CC:2F:71:3E:C5:1F,3229330,407841303,11431,1398352,3217899,406442951,6,48767,4084436,40297,3080822,8470,1003614,12053,34,16395,186,6,829,144444.0,39000.0,-69.0,-71.0,-67.0,-60.0,-68.0,-71.0,-67.0,-61.0,-77.0,-85.0,-77.0,-85.0,8.0,14.0,10.0,25.0,1
5649,CC:2F:71:3F:1F:24,9512251,10025074505,6294352,9618631554,3217899,406442951,80,1455257,870233971,1446697,869206051,8560,1027920,1401798,619,6299055,636839,80,5987,130000.0,43333.0,-68.0,-64.0,-71.0,-67.0,-68.0,-64.0,-70.0,-67.0,-77.0,-85.0,-77.0,-85.0,9.0,21.0,6.0,18.0,1
5650,F8:59:71:5A:E0:3D,3393746,667872556,175846,261429543,3217900,406443013,0,174076,219578098,169245,219000862,4831,577236,151591,16,178560,3037,0,547,144444.0,43333.0,-67.0,-72.0,-65.0,-70.0,-66.0,-72.0,-65.0,-70.0,-77.0,-85.0,-77.0,-85.0,10.0,13.0,12.0,15.0,1
5651,CC:2F:71:3E:C5:1F,3229331,407841365,11431,1398352,3217900,406443013,6,48769,4084624,40298,3080892,8471,1003732,12054,34,16395,186,6,829,144444.0,39000.0,-68.0,-71.0,-67.0,-60.0,-68.0,-70.0,-66.0,-60.0,-77.0,-85.0,-77.0,-85.0,9.0,14.0,10.0,25.0,1
5652,CC:2F:71:3F:1F:24,9513584,10027131641,6295684,9620688628,3217900,406443013,80,1455497,870355481,1446937,869327561,8560,1027920,1402038,619,6300391,637205,80,5987,130000.0,43333.0,-69.0,-64.0,-71.0,-67.0,-68.0,-64.0,-70.0,-67.0,-77.0,-85.0,-77.0,-85.0,8.0,21.0,6.0,18.0,1
5653,F8:59:71:5A:E0:3D,3393822,667976050,175912,261532107,3217910,406443943,0,174143,219679856,169311,219102502,4832,577354,151658,16,178626,3038,0,547,144444.0,43333.0,-67.0,-73.0,-65.0,-70.0,-67.0,-72.0,-65.0,-70.0,-77.0,-85.0,-77.0,-85.0,10.0,12.0,12.0,15.0,1
5654,CC:2F:71:3E:C5:1F,3229341,407842295,11431,1398352,3217910,406443943,6,48769,4084624,40298,3080892,8471,1003732,12054,34,16395,186,6,829,144444.0,39000.0,-68.0,-71.0,-67.0,-60.0,-68.0,-70.0,-66.0,-60.0,-77.0,-85.0,-77.0,-85.0,9.0,14.0,10.0,25.0,1
5655,CC:2F:71:3F:1F:24,9515059,10029402701,6297149,9622958758,3217910,406443943,80,1455759,870484259,1447199,869456339,8560,1027920,1402299,619,6301868,637418,80,5987,130000.0,43333.0,-69.0,-64.0,-72.0,-67.0,-68.0,-64.0,-71.0,-67.0,-77.0,-85.0,-77.0,-85.0,8.0,21.0,5.0,18.0,1
5656,F8:59:71:5A:E0:3D,3393887,668077060,175977,261633117,3217910,406443943,0,174207,219778416,169375,219201062,4832,577354,151722,16,178691,3038,0,547,144444.0,43333.0,-67.0,-73.0,-65.0,-70.0,-66.0,-72.0,-65.0,-70.0,-77.0,-85.0,-77.0,-85.0,10.0,12.0,12.0,15.0,1
5657,CC:2F:71:3E:C5:1F,3229341,407842295,11431,1398352,3217910,406443943,6,48769,4084624,40298,3080892,8471,1003732,12054,34,16395,186,6,829,144444.0,39000.0,-68.0,-71.0,-67.0,-60.0,-68.0,-70.0,-66.0,-60.0,-77.0,-85.0,-77.0,-85.0,9.0,14.0,10.0,25.0,1
5658,CC:2F:71:3F:1F:24,9516125,10031032507,6298215,9624588564,3217910,406443943,80,1456030,870607102,1447470,869579182,8560,1027920,1402570,619,6302911,637593,80,5987,130000.0,39000.0,-68.0,-64.0,-71.0,-67.0,-68.0,-64.0,-71.0,-67.0,-77.0,-85.0,-77.0,-85.0,9.0,21.0,6.0,18.0,1
5659,F8:59:71:5A:E0:3D,3393956,668175568,176040,261731019,3217916,406444549,0,174273,219880056,169441,219302702,4832,577354,151788,16,178754,3038,0,547,144444.0,43333.0,-67.0,-72.0,-65.0,-70.0,-67.0,-72.0,-65.0,-70.0,-77.0,-85.0,-77.0,-85.0,10.0,13.0,12.0,15.0,1
5660,CC:2F:71:3E:C5:1F,3229347,407842901,11431,1398352,3217916,406444549,6,48769,4084624,40298,3080892,8471,1003732,12054,34,16395,186,6,829,144444.0,39000.0,-68.0,-71.0,-67.0,-60.0,-68.0,-70.0,-66.0,-60.0,-77.0,-85.0,-77.0,-85.0,9.0,14.0,10.0,25.0,1
5661,CC:2F:71:3F:1F:24,9517612,10033325033,6299694,9626880282,3217918,406444751,80,1456317,870737012,1447757,869709092,8560,1027920,1402857,619,6304413,637894,80,5987,130000.0,43333.0,-69.0,-64.0,-70.0,-67.0,-68.0,-64.0,-70.0,-67.0,-77.0,-85.0,-77.0,-85.0,8.0,21.0,7.0,18.0,1
5662,F8:59:71:5A:E0:3D,3394038,668286926,176108,261836691,3217930,406450235,0,174338,219980184,169506,219402830,4832,577354,151853,16,178822,3038,0,547,144444.0,43333.0,-67.0,-73.0,-65.0,-69.0,-66.0,-72.0,-65.0,-70.0,-77.0,-85.0,-77.0,-85.0,10.0,12.0,12.0,16.0,1
5663,CC:2F:71:3E:C5:1F,3229372,407854011,11431,1398352,3217941,406455659,6,48769,4084624,40298,3080892,8471,1003732,12054,34,16395,186,6,829,144444.0,39000.0,-68.0,-71.0,-67.0,-60.0,-68.0,-70.0,-66.0,-60.0,-77.0,-85.0,-77.0,-85.0,9.0,14.0,10.0,25.0,1
5664,CC:2F:71:3F:1F:24,9518949,10035369169,6301008,9628913510,3217941,406455659,80,1456615,870872508,1448055,869844588,8560,1027920,1403155,619,6305727,638151,80,5987,130000.0,43333.0,-68.0,-64.0,-71.0,-67.0,-68.0,-64.0,-70.0,-67.0,-77.0,-85.0,-77.0,-85.0,9.0,21.0,6.0,18.0,1
5665,F8:59:71:5A:E0:3D,3394124,668400182,176177,261943917,3217947,406456265,0,174407,220086444,169575,219509090,4832,577354,151922,16,178891,3038,0,547,144444.0,43333.0,-67.0,-73.0,-65.0,-70.0,-66.0,-73.0,-65.0,-70.0,-77.0,-85.0,-77.0,-85.0,10.0,12.0,12.0,15.0,1
5666,CC:2F:71:3E:C5:1F,3229378,407854617,11431,1398352,3217947,406456265,6,48769,4084624,40298,3080892,8471,1003732,12054,34,16395,186,6,829,144444.0,39000.0,-68.0,-71.0,-67.0,-60.0,-68.0,-70.0,-66.0,-60.0,-77.0,-85.0,-77.0,-85.0,9.0,14.0,10.0,25.0,1
5667,CC:2F:71:3F:1F:24,9519986,10036951747,6302037,9630495280,3217949,406456467,80,1456828,870988084,1448268,869960164,8560,1027920,1403368,619,6306756,638372,80,5987,130000.0,43333.0,-68.0,-64.0,-71.0,-67.0,-69.0,-64.0,-71.0,-67.0,-77.0,-85.0,-77.0,-85.0,9.0,21.0,6.0,18.0,1
5668,F8:59:71:5A:E0:3D,3394190,668498559,176240,262041819,3217950,406456740,0,174471,220185004,169639,219607650,4832,577354,151986,16,178954,3039,0,547,144444.0,43333.0,-66.0,-73.0,-65.0,-70.0,-66.0,-72.0,-65.0,-70.0,-77.0,-85.0,-77.0,-85.0,11.0,12.0,12.0,15.0,1
5669,CC:2F:71:3E:C5:1F,3229381,407855092,11431,1398352,3217950,406456740,6,48769,4084624,40298,3080892,8471,1003732,12054,34,16395,186,6,829,144444.0,39000.0,-68.0,-71.0,-67.0,-60.0,-68.0,-70.0,-66.0,-60.0,-77.0,-85.0,-77.0,-85.0,9.0,14.0,10.0,25.0,1
5670,CC:2F:71:3F:1F:24,9521330,10039020616,6303379,9632563816,3217951,406456800,80,1457094,871110263,1448534,870082343,8560,1027920,1403634,619,6308097,638576,80,5987,130000.0,43333.0,-68.0,-64.0,-71.0,-67.0,-68.0,-64.0,-70.0,-67.0,-77.0,-85.0,-77.0,-85.0,9.0,21.0,6.0,18.0,1
5671,F8:59:71:5A:E0:3D,3394261,668597189,176303,262139721,3217958,406457468,0,174533,220280484,169701,219703130,4832,577354,152048,16,179017,3039,0,547,144444.0,43333.0,-67.0,-73.0,-65.0,-70.0,-66.0,-72.0,-65.0,-70.0,-77.0,-85.0,-77.0,-85.0,10.0,12.0,12.0,15.0,1
5672,CC:2F:71:3E:C5:1F,3229389,407855820,11431,1398352,3217958,406457468,6,48769,4084624,40298,3080892,8471,1003732,12054,34,16395,186,6,829,144444.0,39000.0,-68.0,-71.0,-67.0,-60.0,-68.0,-70.0,-66.0,-60.0,-77.0,-85.0,-77.0,-85.0,9.0,14.0,10.0,25.0,1
5673,CC:2F:71:3F:1F:24,9523030,10041652742,6305072,9635195274,3217958,406457468,80,1457405,871238621,1448844,870210583,8561,1028038,1403945,619,6309791,638809,80,5987,130000.0,43333.0,-68.0,-64.0,-70.0,-67.0,-68.0,-64.0,-70.0,-66.0,-77.0,-85.0,-77.0,-85.0,9.0,21.0,7.0,18.0,1
5674,F8:59:71:5A:E0:3D,3394327,668696735,176367,262239065,3217960,406457670,0,174598,220380584,169766,219803230,4832,577354,152113,16,179081,3039,0,547,144444.0,43333.0,-66.0,-73.0,-66.0,-70.0,-66.0,-72.0,-65.0,-69.0,-77.0,-85.0,-77.0,-85.0,11.0,12.0,11.0,15.0,1
5675,CC:2F:71:3E:C5:1F,3229391,407856022,11431,1398352,3217960,406457670,6,48769,4084624,40298,3080892,8471,1003732,12054,34,16395,186,6,829,144444.0,39000.0,-68.0,-71.0,-67.0,-60.0,-68.0,-70.0,-66.0,-60.0,-77.0,-85.0,-77.0,-85.0,9.0,14.0,10.0,25.0,1
5676,CC:2F:71:3F:1F:24,9524309,10043626258,6306349,9637168588,3217960,406457670,80,1457655,871360105,1449094,870332067,8561,1028038,1404195,619,6311068,639245,80,5987,130000.0,43333.0,-69.0,-64.0,-71.0,-67.0,-69.0,-64.0,-70.0,-67.0,-77.0,-85.0,-77.0,-85.0,8.0,21.0,6.0,18.0,1
5677,F8:59:71:5A:E0:3D,3394402,668803073,176435,262344737,3217967,406458336,0,174666,220485304,169834,219907950,4832,577354,152181,16,179149,3040,0,547,144444.0,43333.0,-67.0,-73.0,-65.0,-70.0,-66.0,-72.0,-65.0,-69.0,-77.0,-85.0,-77.0,-85.0,10.0,12.0,12.0,15.0,1
5678,CC:2F:71:3E:C5:1F,3229398,407856688,11431,1398352,3217967,406458336,6,48769,4084624,40298,3080892,8471,1003732,12054,34,16395,186,6,829,144444.0,39000.0,-68.0,-71.0,-67.0,-60.0,-68.0,-70.0,-66.0,-60.0,-77.0,-85.0,-77.0,-85.0,9.0,14.0,10.0,25.0,1
5679,CC:2F:71:3F:1F:24,9525516,10045480332,6307549,9639021996,3217967,406458336,80,1457864,871481011,1449303,870452973,8561,1028038,1404404,619,6312268,639529,80,5987,130000.0,43333.0,-69.0,-64.0,-71.0,-67.0,-68.0,-64.0,-71.0,-67.0,-77.0,-85.0,-77.0,-85.0,8.0,21.0,6.0,18.0,1
5680,F8:59:71:5A:E0:3D,3394467,668901177,176498,262442639,3217969,406458538,0,174728,220580784,169896,220003430,4832,577354,152243,16,179211,3040,0,547,144444.0,43333.0,-66.0,-72.0,-66.0,-69.0,-66.0,-72.0,-65.0,-69.0,-77.0,-85.0,-77.0,-85.0,11.0,13.0,11.0,16.0,1
5681,CC:2F:71:3E:C5:1F,3229400,407856890,11431,1398352,3217969,406458538,6,48769,4084624,40298,3080892,8471,1003732,12054,34,16395,186,6,829,144444.0,39000.0,-68.0,-71.0,-67.0,-60.0,-68.0,-70.0,-66.0,-60.0,-77.0,-85.0,-77.0,-85.0,9.0,14.0,10.0,25.0,1
5682,CC:2F:71:3F:1F:24,9526889,10047594744,6308920,9641136206,3217969,406458538,80,1458151,871605872,1449590,870577834,8561,1028038,1404691,619,6313638,639825,80,5987,117000.0,39000.0,-69.0,-64.0,-71.0,-67.0,-68.0,-64.0,-70.0,-67.0,-77.0,-85.0,-77.0,-85.0,8.0,21.0,6.0,18.0,1
5683,F8:59:71:5A:E0:3D,3394533,669000835,176562,262542095,3217971,406458740,0,174792,220679344,169960,220101990,4832,577354,152307,16,179275,3042,0,547,144444.0,43333.0,-67.0,-73.0,-65.0,-70.0,-66.0,-72.0,-65.0,-70.0,-77.0,-85.0,-77.0,-85.0,10.0,12.0,12.0,15.0,1
5684,CC:2F:71:3E:C5:1F,3229404,407857294,11431,1398352,3217973,406458942,6,48769,4084624,40298,3080892,8471,1003732,12054,34,16395,186,6,829,144444.0,39000.0,-68.0,-71.0,-67.0,-60.0,-68.0,-70.0,-66.0,-60.0,-77.0,-85.0,-77.0,-85.0,9.0,14.0,10.0,25.0,1
5685,CC:2F:71:3F:1F:24,9528261,10049711924,6310288,9643252982,3217973,406458942,80,1458426,871731542,1449865,870703504,8561,1028038,1404966,619,6315007,640081,80,5988,130000.0,43333.0,-69.0,-64.0,-71.0,-67.0,-68.0,-64.0,-71.0,-66.0,-77.0,-85.0,-77.0,-85.0,8.0,21.0,6.0,18.0,1
5686,F8:59:71:5A:E0:3D,3394605,669102343,176627,262642937,3217978,406459406,0,174857,220779444,170025,220202090,4832,577354,152372,16,179341,3044,0,547,144444.0,43333.0,-67.0,-73.0,-65.0,-70.0,-66.0,-72.0,-65.0,-70.0,-77.0,-85.0,-77.0,-85.0,10.0,12.0,12.0,15.0,1
5687,CC:2F:71:3E:C5:1F,3229409,407857758,11431,1398352,3217978,406459406,6,48769,4084624,40298,3080892,8471,1003732,12054,34,16395,186,6,829,144444.0,39000.0,-68.0,-71.0,-67.0,-60.0,-68.0,-70.0,-66.0,-60.0,-77.0,-85.0,-77.0,-85.0,9.0,14.0,10.0,25.0,1
5688,CC:2F:71:3F:1F:24,9529360,10051396928,6311382,9644937522,3217978,406459406,80,1458662,871851222,1450101,870823184,8561,1028038,1405202,619,6316101,640319,80,5988,130000.0,43333.0,-69.0,-64.0,-72.0,-67.0,-69.0,-64.0,-70.0,-67.0,-77.0,-85.0,-77.0,-85.0,8.0,21.0,5.0,18.0,1
5689,F8:59:71:5A:E0:3D,3394668,669200245,176690,262740839,3217978,406459406,0,174921,220878004,170089,220300650,4832,577354,152436,16,179404,3044,0,547,144444.0,43333.0,-66.0,-72.0,-66.0,-70.0,-66.0,-72.0,-65.0,-70.0,-77.0,-85.0,-77.0,-85.0,11.0,13.0,11.0,15.0,1
5690,CC:2F:71:3E:C5:1F,3229409,407857758,11431,1398352,3217978,406459406,6,48769,4084624,40298,3080892,8471,1003732,12054,34,16395,186,6,829,144444.0,39000.0,-68.0,-71.0,-67.0,-60.0,-68.0,-70.0,-66.0,-60.0,-77.0,-85.0,-77.0,-85.0,9.0,14.0,10.0,25.0,1
5691,CC:2F:71:3F:1F:24,9530330,10052879776,6312348,9646419966,3217982,406459810,80,1458913,871971294,1450352,870943256,8561,1028038,1405453,619,6317067,640546,80,5988,117000.0,39000.0,-69.0,-64.0,-72.0,-67.0,-68.0,-64.0,-71.0,-67.0,-77.0,-85.0,-77.0,-85.0,8.0,21.0,5.0,18.0,1
5692,F8:59:71:5A:E0:3D,3394742,669303617,176756,262843403,3217986,406460214,0,174986,220978104,170154,220400750,4832,577354,152501,16,179470,3044,0,547,144444.0,43333.0,-66.0,-73.0,-65.0,-70.0,-66.0,-72.0,-65.0,-69.0,-77.0,-85.0,-77.0,-85.0,11.0,12.0,12.0,15.0,1
5693,CC:2F:71:3E:C5:1F,3229417,407858566,11431,1398352,3217986,406460214,6,48769,4084624,40298,3080892,8471,1003732,12054,34,16395,186,6,829,144444.0,39000.0,-68.0,-71.0,-67.0,-60.0,-68.0,-70.0,-66.0,-60.0,-77.0,-85.0,-77.0,-85.0,9.0,14.0,10.0,25.0,1
5694,CC:2F:71:3F:1F:24,9531467,10054627574,6313481,9648167360,3217986,406460214,80,1459138,872091172,1450577,871063134,8561,1028038,1405677,619,6318179,640744,80,5988,130000.0,43333.0,-68.0,-64.0,-71.0,-67.0,-68.0,-64.0,-70.0,-67.0,-77.0,-85.0,-77.0,-85.0,9.0,21.0,6.0,18.0,1
5695,F8:59:71:5A:E0:3D,3394807,669403133,176820,262942859,3217987,406460274,0,175051,221078204,170219,220500850,4832,577354,152566,16,179534,3044,0,547,144444.0,43333.0,-67.0,-73.0,-65.0,-70.0,-66.0,-72.0,-65.0,-70.0,-77.0,-85.0,-77.0,-85.0,10.0,12.0,12.0,15.0,1
5696,CC:2F:71:3E:C5:1F,3229418,407858626,11431,1398352,3217987,406460274,6,48769,4084624,40298,3080892,8471,1003732,12054,34,16395,186,6,829,144444.0,39000.0,-68.0,-71.0,-67.0,-60.0,-68.0,-70.0,-66.0,-60.0,-77.0,-85.0,-77.0,-85.0,9.0,14.0,10.0,25.0,1
5697,CC:2F:71:3F:1F:24,9532432,10056097344,6314445,9649637070,3217987,406460274,80,1459365,872211926,1450804,871183888,8561,1028038,1405904,619,6319164,640990,80,5988,130000.0,43333.0,-68.0,-64.0,-70.0,-67.0,-68.0,-64.0,-70.0,-66.0,-77.0,-85.0,-77.0,-85.0,9.0,21.0,7.0,18.0,1
5698,F8:59:71:5A:E0:3D,3394877,669503195,176884,263042315,3217993,406460880,0,175115,221176764,170283,220599410,4832,577354,152630,16,179598,3045,0,547,144444.0,43333.0,-67.0,-73.0,-66.0,-70.0,-66.0,-73.0,-65.0,-70.0,-77.0,-85.0,-77.0,-85.0,10.0,12.0,11.0,15.0,1
5699,CC:2F:71:3E:C5:1F,3229426,407859434,11431,1398352,3217995,406461082,6,48769,4084624,40298,3080892,8471,1003732,12054,34,16395,186,6,829,144444.0,39000.0,-68.0,-71.0,-67.0,-60.0,-68.0,-70.0,-66.0,-60.0,-77.0,-85.0,-77.0,-85.0,9.0,14.0,10.0,25.0,1
5700,CC:2F:71:3F:1F:24,9533670,10057998548,6315675,9651537466,3217995,406461082,80,1459602,872331880,1451041,871303842,8561,1028038,1406141,619,6320380,641311,80,5988,130000.0,43333.0,-70.0,-64.0,-73.0,-67.0,-69.0,-64.0,-71.0,-67.0,-77.0,-85.0,-77.0,-85.0,7.0,21.0,4.0,18.0,1
5701,F8:59:71:5A:E0:3D,3394942,669601299,176947,263140217,3217995,406461082,0,175177,221272244,170345,220694890,4832,577354,152692,16,179661,3045,0,547,144444.0,43333.0,-66.0,-73.0,-65.0,-70.0,-66.0,-72.0,-65.0,-70.0,-77.0,-85.0,-77.0,-85.0,11.0,12.0,12.0,15.0,1
5702,CC:2F:71:3E:C5:1F,3229426,407859434,11431,1398352,3217995,406461082,6,48769,4084624,40298,3080892,8471,1003732,12054,34,16395,186,6,829,144444.0,39000.0,-68.0,-71.0,-67.0,-60.0,-68.0,-70.0,-66.0,-60.0,-77.0,-85.0,-77.0,-85.0,9.0,14.0,10.0,25.0,1
5703,CC:2F:71:3F:1F:24,9534821,10059773034,6316826,9653311952,3217995,406461082,80,1459870,872455266,1451309,871427228,8561,1028038,1406409,619,6321545,641521,80,5988,130000.0,43333.0,-69.0,-64.0,-72.0,-67.0,-69.0,-64.0,-71.0,-67.0,-77.0,-85.0,-77.0,-85.0,8.0,21.0,5.0,18.0,1
5704,F8:59:71:5A:E0:3D,3395015,669704529,177013,263242781,3218002,406461748,0,175245,221376964,170413,220799610,4832,577354,152760,16,179727,3045,0,547,144444.0,43333.0,-67.0,-72.0,-65.0,-70.0,-67.0,-72.0,-65.0,-70.0,-77.0,-85.0,-77.0,-85.0,10.0,13.0,12.0,15.0,1
5705,CC:2F:71:3E:C5:1F,3229433,407860100,11431,1398352,3218002,406461748,6,48769,4084624,40298,3080892,8471,1003732,12054,34,16395,186,6,829,144444.0,39000.0,-68.0,-71.0,-67.0,-60.0,-68.0,-70.0,-66.0,-60.0,-77.0,-85.0,-77.0,-85.0,9.0,14.0,10.0,25.0,1
5706,CC:2F:71:3F:1F:24,9536218,10061921182,6318214,9655459232,3218004,406461950,80,1460103,872580426,1451542,871552388,8561,1028038,1406642,619,6322901,641980,80,5988,130000.0,43333.0,-69.0,-64.0,-71.0,-67.0,-69.0,-64.0,-71.0,-67.0,-77.0,-85.0,-77.0,-85.0,8.0,21.0,6.0,18.0,1
5707,F8:59:71:5A:E0:3D,3395083,669807295,177079,263345345,3218004,406461950,0,175310,221477064,170478,220899710,4832,577354,152825,16,179793,3045,0,547,144444.0,43333.0,-67.0,-72.0,-66.0,-70.0,-66.0,-72.0,-65.0,-70.0,-78.0,-86.0,-78.0,-85.0,11.0,14.0,12.0,15.0,1
5708,CC:2F:71:3E:C5:1F,3229435,407860302,11431,1398352,3218004,406461950,6,48769,4084624,40298,3080892,8471,1003732,12054,34,16395,186,6,829,144444.0,39000.0,-68.0,-71.0,-67.0,-60.0,-68.0,-70.0,-66.0,-60.0,-78.0,-86.0,-78.0,-85.0,10.0,15.0,11.0,25.0,1
5709,CC:2F:71:3F:1F:24,9537492,10063883638,6319488,9657421688,3218004,406461950,80,1460355,872702523,1451794,871674485,8561,1028038,1406894,619,6324207,642296,80,5988,130000.0,43333.0,-68.0,-64.0,-71.0,-67.0,-68.0,-64.0,-70.0,-67.0,-78.0,-86.0,-78.0,-85.0,10.0,22.0,7.0,18.0,1
5710,F8:59:71:5A:E0:3D,3395154,669907630,177143,263444801,3218011,406462829,0,175374,221575624,170542,220998270,4832,577354,152889,16,179857,3045,0,547,144444.0,43333.0,-66.0,-73.0,-65.0,-70.0,-66.0,-72.0,-65.0,-70.0,-78.0,-86.0,-78.0,-85.0,12.0,13.0,13.0,15.0,1
5711,CC:2F:71:3E:C5:1F,3229442,407861181,11431,1398352,3218011,406462829,6,48769,4084624,40298,3080892,8471,1003732,12054,34,16395,186,6,829,144444.0,39000.0,-68.0,-71.0,-67.0,-60.0,-68.0,-70.0,-66.0,-60.0,-78.0,-86.0,-78.0,-85.0,10.0,15.0,11.0,25.0,1
5712,CC:2F:71:3F:1F:24,9538525,10065460483,6320513,9658997594,3218012,406462889,80,1460583,872819911,1452022,871791873,8561,1028038,1407122,619,6325232,642433,80,5988,130000.0,43333.0,-68.0,-64.0,-70.0,-67.0,-68.0,-64.0,-70.0,-67.0,-78.0,-86.0,-78.0,-85.0,10.0,22.0,8.0,18.0,1
5713,F8:59:71:5A:E0:3D,3395220,670005794,177206,263542703,3218014,406463091,0,175437,221672644,170605,221095290,4832,577354,152952,16,179920,3045,0,547,144444.0,43333.0,-67.0,-73.0,-66.0,-70.0,-66.0,-72.0,-65.0,-70.0,-78.0,-86.0,-78.0,-85.0,11.0,13.0,12.0,15.0,1
5714,CC:2F:71:3E:C5:1F,3229445,407861443,11431,1398352,3218014,406463091,6,48769,4084624,40298,3080892,8471,1003732,12054,34,16395,186,6,829,144444.0,39000.0,-68.0,-71.0,-67.0,-60.0,-68.0,-70.0,-66.0,-60.0,-78.0,-86.0,-78.0,-85.0,10.0,15.0,11.0,25.0,1
5715,CC:2F:71:3F:1F:24,9539806,10067437379,6321792,9660974288,3218014,406463091,80,1460814,872938963,1452253,871910925,8561,1028038,1407353,619,6326491,642676,80,5988,130000.0,43333.0,-69.0,-64.0,-72.0,-67.0,-68.0,-64.0,-71.0,-67.0,-78.0,-86.0,-78.0,-85.0,9.0,22.0,6.0,18.0,1
5716,F8:59:71:5A:E0:3D,3395287,670104100,177269,263640605,3218018,406463495,0,175500,221769664,170668,221192310,4832,577354,153015,16,179983,3046,0,547,144444.0,43333.0,-66.0,-72.0,-66.0,-70.0,-66.0,-72.0,-65.0,-70.0,-78.0,-86.0,-78.0,-85.0,12.0,14.0,12.0,15.0,1
5717,CC:2F:71:3E:C5:1F,3229449,407861847,11431,1398352,3218018,406463495,6,48769,4084624,40298,3080892,8471,1003732,12054,34,16395,186,6,829,144444.0,39000.0,-68.0,-71.0,-67.0,-60.0,-68.0,-70.0,-66.0,-60.0,-78.0,-86.0,-78.0,-85.0,10.0,15.0,11.0,25.0,1
5718,CC:2F:71:3F:1F:24,9541156,10069518967,6323137,9663055338,3218019,406463629,80,1461073,873058387,1452512,872030349,8561,1028038,1407610,619,6327856,643118,80,5988,130000.0,43333.0,-69.0,-64.0,-71.0,-67.0,-68.0,-64.0,-71.0,-67.0,-78.0,-86.0,-78.0,-85.0,9.0,22.0,7.0,18.0,1
5719,F8:59:71:5A:E0:3D,3395356,670204020,177333,263740061,3218023,406463959,0,175564,221868224,170732,221290870,4832,577354,153079,16,180047,3046,0,547,144444.0,43333.0,-66.0,-72.0,-65.0,-69.0,-66.0,-72.0,-65.0,-69.0,-78.0,-86.0,-78.0,-85.0,12.0,14.0,13.0,16.0,1
5720,CC:2F:71:3E:C5:1F,3229454,407862311,11431,1398352,3218023,406463959,6,48769,4084624,40298,3080892,8471,1003732,12054,34,16395,186,6,829,144444.0,39000.0,-68.0,-71.0,-67.0,-60.0,-68.0,-70.0,-66.0,-60.0,-78.0,-86.0,-78.0,-85.0,10.0,15.0,11.0,25.0,1
5721,CC:2F:71:3F:1F:24,9542728,10071944437,6324705,9665480478,3218023,406463959,80,1461337,873183380,1452776,872155342,8561,1028038,1407874,619,6329422,643523,80,5988,130000.0,43333.0,-69.0,-64.0,-71.0,-67.0,-68.0,-64.0,-70.0,-67.0,-78.0,-86.0,-78.0,-85.0,9.0,22.0,7.0,18.0,1
5722,F8:59:71:5A:E0:3D,3395424,670303880,177397,263839517,3218027,406464363,0,175627,221965244,170795,221387890,4832,577354,153142,16,180111,3047,0,547,144444.0,43333.0,-67.0,-73.0,-66.0,-70.0,-66.0,-72.0,-65.0,-70.0,-78.0,-86.0,-78.0,-85.0,11.0,13.0,12.0,15.0,1
5723,CC:2F:71:3E:C5:1F,3229458,407862715,11431,1398352,3218027,406464363,6,48769,4084624,40298,3080892,8471,1003732,12054,34,16395,186,6,829,144444.0,39000.0,-68.0,-71.0,-67.0,-60.0,-68.0,-70.0,-66.0,-60.0,-78.0,-86.0,-78.0,-85.0,10.0,15.0,11.0,25.0,1
5724,CC:2F:71:3F:1F:24,9544685,10074983427,6326658,9668519064,3218027,406464363,80,1461657,873321160,1453096,872293122,8561,1028038,1408192,619,6331377,644252,80,5988,117000.0,39000.0,-69.0,-64.0,-71.0,-67.0,-68.0,-64.0,-71.0,-67.0,-78.0,-86.0,-78.0,-85.0,9.0,22.0,7.0,18.0,1
5725,F8:59:71:5A:E0:3D,3395500,670414734,177469,263949967,3218031,406464767,0,175699,222076124,170867,221498770,4832,577354,153214,16,180183,3047,0,547,144444.0,43333.0,-67.0,-72.0,-65.0,-70.0,-66.0,-72.0,-65.0,-70.0,-78.0,-86.0,-78.0,-85.0,11.0,14.0,13.0,15.0,1
5726,CC:2F:71:3E:C5:1F,3229463,407863235,11432,1398468,3218031,406464767,6,48771,4084764,40300,3081032,8471,1003732,12054,34,16396,186,6,829,144444.0,39000.0,-68.0,-70.0,-67.0,-60.0,-68.0,-70.0,-67.0,-60.0,-78.0,-86.0,-78.0,-85.0,10.0,16.0,11.0,25.0,1
5727,CC:2F:71:3F:1F:24,9546025,10077047505,6327994,9670582738,3218031,406464767,80,1461915,873449312,1453354,872421274,8561,1028038,1408450,619,6332713,644637,80,5988,130000.0,43333.0,-68.0,-64.0,-70.0,-67.0,-68.0,-64.0,-70.0,-67.0,-78.0,-86.0,-78.0,-85.0,10.0,22.0,8.0,18.0,1
5728,F8:59:71:5A:E0:3D,3395571,670517762,177535,264052531,3218036,406465231,0,175765,222177834,170933,221600480,4832,577354,153280,16,180249,3047,0,547,144444.0,43333.0,-67.0,-73.0,-66.0,-70.0,-66.0,-72.0,-65.0,-70.0,-78.0,-86.0,-78.0,-85.0,11.0,13.0,12.0,15.0,1
5729,CC:2F:71:3E:C5:1F,3229468,407863699,11432,1398468,3218036,406465231,6,48771,4084764,40300,3081032,8471,1003732,12054,34,16396,186,6,829,144444.0,39000.0,-68.0,-70.0,-67.0,-60.0,-68.0,-70.0,-67.0,-60.0,-78.0,-86.0,-78.0,-85.0,10.0,16.0,11.0,25.0,1
5730,CC:2F:71:3F:1F:24,9546830,10078268849,6328794,9671803618,3218036,406465231,80,1462132,873563988,1453571,872535950,8561,1028038,1408667,619,6333511,644844,80,5988,130000.0,43333.0,-69.0,-64.0,-69.0,-67.0,-68.0,-64.0,-70.0,-67.0,-78.0,-86.0,-78.0,-85.0,9.0,22.0,9.0,18.0,1
5731,F8:59:71:5A:E0:3D,3395639,670616130,177598,264150433,3218041,406465697,0,175828,222274854,170996,221697500,4832,577354,153343,16,180312,3047,0,547,144444.0,43333.0,-66.0,-73.0,-65.0,-70.0,-66.0,-72.0,-65.0,-70.0,-78.0,-86.0,-78.0,-85.0,12.0,13.0,13.0,15.0,1
5732,CC:2F:71:3E:C5:1F,3229473,407864165,11432,1398468,3218041,406465697,6,48771,4084764,40300,3081032,8471,1003732,12054,34,16396,186,6,829,144444.0,39000.0,-68.0,-70.0,-67.0,-60.0,-68.0,-70.0,-67.0,-60.0,-78.0,-86.0,-78.0,-85.0,10.0,16.0,11.0,25.0,1
5733,CC:2F:71:3F:1F:24,9547401,10079113123,6329360,9672647426,3218041,406465697,80,1462314,873675049,1453752,872646893,8562,1028156,1408849,619,6334079,644905,80,5988,130000.0,43333.0,-68.0,-64.0,-71.0,-67.0,-68.0,-64.0,-71.0,-67.0,-78.0,-86.0,-78.0,-85.0,10.0,22.0,7.0,18.0,1
5734,F8:59:71:5A:E0:3D,3395712,670722515,177666,264256105,3218046,406466410,0,175896,222378152,171063,221800680,4833,577472,153411,16,180380,3047,0,547,144444.0,43333.0,-67.0,-73.0,-65.0,-70.0,-66.0,-72.0,-65.0,-70.0,-78.0,-86.0,-78.0,-85.0,11.0,13.0,13.0,15.0,1
5735,CC:2F:71:3E:C5:1F,3229480,407865080,11432,1398468,3218048,406466612,6,48771,4084764,40300,3081032,8471,1003732,12054,34,16396,186,6,829,144444.0,39000.0,-68.0,-70.0,-67.0,-60.0,-68.0,-70.0,-67.0,-60.0,-78.0,-86.0,-78.0,-85.0,10.0,16.0,11.0,25.0,1
5736,CC:2F:71:3F:1F:24,9548045,10080077440,6329997,9673610828,3218048,406466612,80,1462490,873796277,1453928,872768121,8562,1028156,1409025,619,6334716,645015,80,5988,130000.0,43333.0,-69.0,-64.0,-70.0,-67.0,-68.0,-64.0,-70.0,-67.0,-78.0,-86.0,-78.0,-85.0,9.0,22.0,8.0,18.0,1
5737,F8:59:71:5A:E0:3D,3395784,670824438,177731,264357115,3218053,406467323,0,175961,222478252,171128,221900780,4833,577472,153476,16,180445,3047,0,547,144444.0,43333.0,-67.0,-73.0,-65.0,-70.0,-66.0,-73.0,-65.0,-70.0,-78.0,-86.0,-78.0,-85.0,11.0,13.0,13.0,15.0,1
5738,CC:2F:71:3E:C5:1F,3229487,407865993,11432,1398468,3218055,406467525,6,48771,4084764,40300,3081032,8471,1003732,12054,34,16396,186,6,829,144444.0,39000.0,-68.0,-70.0,-67.0,-60.0,-68.0,-70.0,-67.0,-60.0,-78.0,-86.0,-78.0,-85.0,10.0,16.0,11.0,25.0,1
5739,CC:2F:71:3F:1F:24,9549095,10081683839,6331040,9675216314,3218055,406467525,80,1462719,873916569,1454157,872888413,8562,1028156,1409254,619,6335759,645287,80,5988,130000.0,43333.0,-69.0,-64.0,-71.0,-67.0,-68.0,-64.0,-71.0,-66.0,-78.0,-86.0,-78.0,-85.0,9.0,22.0,7.0,18.0,1
5740,F8:59:71:5A:E0:3D,3395853,670925852,177796,264458125,3218057,406467727,0,176028,222581446,171195,222003974,4833,577472,153542,16,180510,3047,0,547,144444.0,43333.0,-67.0,-73.0,-65.0,-70.0,-66.0,-72.0,-65.0,-70.0,-78.0,-86.0,-78.0,-85.0,11.0,13.0,13.0,15.0,1
5741,CC:2F:71:3E:C5:1F,3229489,407866195,11432,1398468,3218057,406467727,6,48771,4084764,40300,3081032,8471,1003732,12054,34,16396,186,6,829,144444.0,39000.0,-68.0,-70.0,-67.0,-60.0,-68.0,-70.0,-67.0,-60.0,-78.0,-86.0,-78.0,-85.0,10.0,16.0,11.0,25.0,1
5742,CC:2F:71:3F:1F:24,9550550,10083932152,6332490,9677463998,3218060,406468154,80,1462978,874043193,1454416,873015037,8562,1028156,1409513,619,6337209,645731,80,5989,117000.0,39000.0,-69.0,-64.0,-71.0,-67.0,-68.0,-64.0,-70.0,-67.0,-78.0,-86.0,-78.0,-85.0,9.0,22.0,7.0,18.0,1
5743,F8:59:71:5A:E0:3D,3395927,671032377,177864,264563797,3218063,406468580,0,176095,222684626,171262,222107154,4833,577472,153609,16,180577,3047,0,547,144444.0,43333.0,-66.0,-73.0,-66.0,-70.0,-66.0,-72.0,-65.0,-70.0,-78.0,-86.0,-78.0,-85.0,12.0,13.0,12.0,15.0,1
5744,CC:2F:71:3E:C5:1F,3229495,407867048,11432,1398468,3218063,406468580,6,48771,4084764,40300,3081032,8471,1003732,12054,34,16396,186,6,829,144444.0,39000.0,-68.0,-70.0,-67.0,-60.0,-68.0,-70.0,-67.0,-60.0,-78.0,-86.0,-78.0,-85.0,10.0,16.0,11.0,25.0,1
5745,CC:2F:71:3F:1F:24,9551734,10085743966,6333669,9679275184,3218065,406468782,80,1463240,874166416,1454678,873138260,8562,1028156,1409775,619,6338388,645964,80,5989,130000.0,43333.0,-68.0,-64.0,-70.0,-67.0,-68.0,-64.0,-70.0,-67.0,-78.0,-86.0,-78.0,-85.0,10.0,22.0,8.0,18.0,1
5746,F8:59:71:5A:E0:3D,3395994,671129436,177926,264660145,3218068,406469291,0,176157,222780120,171324,222202648,4833,577472,153670,16,180640,3047,0,547,144444.0,43333.0,-67.0,-73.0,-65.0,-70.0,-67.0,-73.0,-65.0,-69.0,-78.0,-86.0,-78.0,-85.0,11.0,13.0,13.0,15.0,1
5747,CC:2F:71:3E:C5:1F,3229502,407867961,11432,1398468,3218070,406469493,6,48771,4084764,40300,3081032,8471,1003732,12054,34,16396,186,6,829,144444.0,39000.0,-68.0,-70.0,-67.0,-60.0,-68.0,-70.0,-67.0,-60.0,-78.0,-86.0,-78.0,-85.0,10.0,16.0,11.0,25.0,1
5748,CC:2F:71:3F:1F:24,9552727,10087263645,6334657,9680794152,3218070,406469493,80,1463481,874286652,1454919,873258496,8562,1028156,1410016,619,6339376,646092,80,5989,130000.0,43333.0,-68.0,-64.0,-71.0,-67.0,-68.0,-63.0,-70.0,-66.0,-78.0,-86.0,-78.0,-85.0,10.0,22.0,7.0,18.0,1
5749,F8:59:71:5A:E0:3D,3396064,671229498,177990,264759601,3218074,406469897,0,176223,222881760,171390,222304288,4833,577472,153736,16,180704,3047,0,547,144444.0,43333.0,-67.0,-73.0,-65.0,-70.0,-66.0,-72.0,-65.0,-70.0,-78.0,-86.0,-78.0,-85.0,11.0,13.0,13.0,15.0,1
5750,CC:2F:71:3E:C5:1F,3229506,407868365,11432,1398468,3218074,406469897,6,48771,4084764,40300,3081032,8471,1003732,12054,34,16396,186,6,829,144444.0,39000.0,-68.0,-70.0,-67.0,-60.0,-68.0,-70.0,-67.0,-60.0,-78.0,-86.0,-78.0,-85.0,10.0,16.0,11.0,25.0,1
5751,CC:2F:71:3F:1F:24,9553751,10088831297,6335677,9682361400,3218074,406469897,80,1463727,874410580,1455165,873382424,8562,1028156,1410262,619,6340396,646289,80,5989,130000.0,43333.0,-69.0,-64.0,-71.0,-67.0,-68.0,-64.0,-70.0,-67.0,-78.0,-86.0,-78.0,-85.0,9.0,22.0,7.0,18.0,1
5752,F8:59:71:5A:E0:3D,3396134,671332597,178057,264862225,3218077,406470372,0,176290,222983534,171457,222406062,4833,577472,153803,16,180771,3048,0,547,130000.0,39000.0,-67.0,-73.0,-65.0,-70.0,-66.0,-73.0,-65.0,-70.0,-78.0,-86.0,-78.0,-85.0,11.0,13.0,13.0,15.0,1
5753,CC:2F:71:3E:C5:1F,3229510,407868900,11432,1398468,3218078,406470432,6,48771,4084764,40300,3081032,8471,1003732,12054,34,16396,186,6,829,144444.0,39000.0,-68.0,-70.0,-67.0,-60.0,-68.0,-70.0,-67.0,-60.0,-78.0,-86.0,-78.0,-85.0,10.0,16.0,11.0,25.0,1
5754,CC:2F:71:3F:1F:24,9554586,10090098526,6336506,9683627892,3218080,406470634,80,1463925,874525920,1455363,873497764,8562,1028156,1410460,619,6341225,646469,80,5989,130000.0,43333.0,-69.0,-64.0,-71.0,-67.0,-68.0,-64.0,-71.0,-67.0,-78.0,-86.0,-78.0,-85.0,9.0,22.0,7.0,18.0,1
5755,F8:59:71:5A:E0:3D,3396206,671432669,178121,264961569,3218085,406471100,0,176354,223082094,171521,222504622,4833,577472,153867,16,180835,3048,0,547,144444.0,43333.0,-67.0,-73.0,-65.0,-70.0,-66.0,-72.0,-65.0,-70.0,-78.0,-86.0,-78.0,-85.0,11.0,13.0,13.0,15.0,1
5756,CC:2F:71:3E:C5:1F,3229517,407869568,11432,1398468,3218085,406471100,6,48773,4084952,40301,3081102,8472,1003850,12055,34,16396,186,6,829,144444.0,39000.0,-68.0,-71.0,-67.0,-60.0,-68.0,-70.0,-67.0,-60.0,-78.0,-86.0,-78.0,-85.0,10.0,15.0,11.0,25.0,1
5757,CC:2F:71:3F:1F:24,9555597,10091643476,6337512,9685172376,3218085,406471100,80,1464133,874648144,1455571,873619988,8562,1028156,1410668,619,6342231,646764,80,5989,130000.0,43333.0,-69.0,-64.0,-71.0,-67.0,-68.0,-64.0,-70.0,-67.0,-78.0,-86.0,-78.0,-85.0,9.0,22.0,7.0,18.0,1
5758,F8:59:71:5A:E0:3D,3396276,671538543,178189,265067241,3218087,406471302,0,176421,223185344,171588,222607872,4833,577472,153934,16,180903,3049,0,547,144444.0,43333.0,-67.0,-73.0,-65.0,-70.0,-66.0,-72.0,-64.0,-70.0,-78.0,-86.0,-78.0,-85.0,11.0,13.0,13.0,15.0,1
5759,CC:2F:71:3E:C5:1F,3229519,407869770,11432,1398468,3218087,406471302,6,48773,4084952,40301,3081102,8472,1003850,12055,34,16396,186,6,829,144444.0,39000.0,-68.0,-71.0,-67.0,-60.0,-68.0,-70.0,-67.0,-60.0,-78.0,-86.0,-78.0,-85.0,10.0,15.0,11.0,25.0,1
5760,CC:2F:71:3F:1F:24,9556440,10092918930,6338353,9686447628,3218087,406471302,80,1464355,874765273,1455793,873737117,8562,1028156,1410890,619,6343072,646902,80,5989,130000.0,43333.0,-68.0,-64.0,-71.0,-67.0,-68.0,-64.0,-70.0,-67.0,-78.0,-86.0,-78.0,-85.0,10.0,22.0,7.0,18.0,1
5761,F8:59:71:5A:E0:3D,3396348,671640219,178254,265168251,3218094,406471968,0,176486,223285444,171653,222707972,4833,577472,153999,16,180968,3050,0,547,144444.0,43333.0,-67.0,-73.0,-65.0,-70.0,-66.0,-72.0,-65.0,-70.0,-78.0,-86.0,-78.0,-85.0,11.0,13.0,13.0,15.0,1
5762,CC:2F:71:3E:C5:1F,3229526,407870436,11432,1398468,3218094,406471968,6,48773,4084952,40301,3081102,8472,1003850,12055,34,16396,186,6,829,144444.0,39000.0,-68.0,-71.0,-67.0,-60.0,-68.0,-70.0,-67.0,-60.0,-78.0,-86.0,-78.0,-85.0,10.0,15.0,11.0,25.0,1
5763,CC:2F:71:3F:1F:24,9557588,10094678294,6339494,9688206326,3218094,406471968,80,1464609,874899945,1456047,873871789,8562,1028156,1411144,619,6344202,647171,80,5989,130000.0,39000.0,-68.0,-64.0,-70.0,-67.0,-68.0,-64.0,-70.0,-67.0,-78.0,-86.0,-78.0,-85.0,10.0,22.0,8.0,18.0,1
5764,F8:59:71:5A:E0:3D,3396429,671763187,178333,265291017,3218096,406472170,0,176566,223408686,171733,222831214,4833,577472,154079,16,181047,3056,0,547,144444.0,43333.0,-66.0,-73.0,-65.0,-70.0,-66.0,-72.0,-65.0,-70.0,-78.0,-86.0,-78.0,-85.0,12.0,13.0,13.0,15.0,1
5765,CC:2F:71:3E:C5:1F,3229530,407870840,11432,1398468,3218098,406472372,6,48773,4084952,40301,3081102,8472,1003850,12055,34,16396,186,6,829,144444.0,39000.0,-68.0,-71.0,-67.0,-60.0,-68.0,-70.0,-67.0,-60.0,-78.0,-86.0,-78.0,-85.0,10.0,15.0,11.0,25.0,1
5766,CC:2F:71:3F:1F:24,9558528,10096113698,6340430,9689641326,3218098,406472372,80,1464795,875033963,1456233,874005807,8562,1028156,1411330,619,6345113,647407,80,5990,130000.0,43333.0,-68.0,-64.0,-69.0,-67.0,-68.0,-64.0,-69.0,-67.0,-78.0,-86.0,-78.0,-85.0,10.0,22.0,9.0,18.0,1
5767,F8:59:71:5A:E0:3D,3396512,671880711,178408,265407567,3218104,406473144,0,176640,223522814,171807,222945342,4833,577472,154153,16,181121,3057,0,547,144444.0,43333.0,-66.0,-72.0,-66.0,-70.0,-66.0,-72.0,-65.0,-70.0,-78.0,-86.0,-78.0,-85.0,12.0,14.0,12.0,15.0,1
5768,CC:2F:71:3E:C5:1F,3229536,407871612,11432,1398468,3218104,406473144,6,48773,4084952,40301,3081102,8472,1003850,12055,34,16396,186,6,829,144444.0,39000.0,-68.0,-71.0,-67.0,-60.0,-68.0,-70.0,-67.0,-60.0,-78.0,-86.0,-78.0,-85.0,10.0,15.0,11.0,25.0,1
5769,CC:2F:71:3F:1F:24,9559437,10097492059,6341333,9691018915,3218104,406473144,80,1464971,875157107,1456409,874128951,8562,1028156,1411506,619,6346052,647761,80,5990,130000.0,43333.0,-69.0,-64.0,-70.0,-67.0,-68.0,-64.0,-70.0,-67.0,-78.0,-86.0,-78.0,-85.0,9.0,22.0,8.0,18.0,1
5770,F8:59:71:5A:E0:3D,3396583,671983739,178474,265510131,3218109,406473608,0,176707,223625994,171874,223048522,4833,577472,154220,16,181188,3057,0,547,144444.0,43333.0,-67.0,-73.0,-64.0,-70.0,-66.0,-72.0,-65.0,-70.0,-78.0,-86.0,-78.0,-85.0,11.0,13.0,14.0,15.0,1
5771,CC:2F:71:3E:C5:1F,3229541,407872076,11432,1398468,3218109,406473608,6,48773,4084952,40301,3081102,8472,1003850,12055,34,16396,186,6,829,144444.0,39000.0,-68.0,-71.0,-67.0,-60.0,-68.0,-70.0,-67.0,-60.0,-78.0,-86.0,-78.0,-85.0,10.0,15.0,11.0,25.0,1
5772,CC:2F:71:3F:1F:24,9560680,10099404543,6342571,9692930935,3218109,406473608,80,1465235,875281547,1456673,874253391,8562,1028156,1411768,619,6347265,647925,80,5990,130000.0,43333.0,-69.0,-64.0,-71.0,-67.0,-69.0,-64.0,-70.0,-66.0,-78.0,-86.0,-78.0,-85.0,9.0,22.0,7.0,18.0,1
5773,F8:59:71:5A:E0:3D,3396652,672085153,178539,265611141,3218113,406474012,0,176771,223724554,171938,223147082,4833,577472,154284,16,181253,3057,0,547,144444.0,43333.0,-66.0,-72.0,-66.0,-70.0,-66.0,-72.0,-65.0,-70.0,-78.0,-86.0,-78.0,-85.0,12.0,14.0,12.0,15.0,1
5774,CC:2F:71:3E:C5:1F,3229545,407872480,11432,1398468,3218113,406474012,6,48773,4084952,40301,3081102,8472,1003850,12055,34,16396,186,6,829,144444.0,39000.0,-68.0,-71.0,-67.0,-60.0,-68.0,-70.0,-67.0,-60.0,-78.0,-86.0,-78.0,-85.0,10.0,15.0,11.0,25.0,1
5775,CC:2F:71:3F:1F:24,9562007,10101452049,6343894,9694978037,3218113,406474012,80,1465526,875407643,1456964,874379487,8562,1028156,1412059,619,6348611,648169,80,5990,130000.0,43333.0,-69.0,-64.0,-71.0,-67.0,-68.0,-64.0,-70.0,-67.0,-78.0,-86.0,-78.0,-85.0,9.0,22.0,7.0,18.0,1
5776,F8:59:71:5A:E0:3D,3396717,672183257,178602,265709043,3218115,406474214,0,176834,223821574,172001,223244102,4833,577472,154347,16,181316,3057,0,547,144444.0,43333.0,-66.0,-73.0,-65.0,-70.0,-66.0,-72.0,-65.0,-70.0,-78.0,-86.0,-78.0,-85.0,12.0,13.0,13.0,15.0,1
5777,CC:2F:71:3E:C5:1F,3229548,407872742,11432,1398468,3218116,406474274,6,48773,4084952,40301,3081102,8472,1003850,12055,34,16396,186,6,829,144444.0,39000.0,-68.0,-71.0,-67.0,-60.0,-68.0,-70.0,-67.0,-60.0,-78.0,-86.0,-78.0,-85.0,10.0,15.0,11.0,25.0,1
5778,CC:2F:71:3F:1F:24,9563049,10103047107,6344931,9696572631,3218118,406474476,80,1465750,875527403,1457188,874499247,8562,1028156,1412283,619,6349650,648407,80,5990,117000.0,39000.0,-69.0,-64.0,-71.0,-67.0,-68.0,-64.0,-70.0,-66.0,-78.0,-86.0,-78.0,-85.0,9.0,22.0,7.0,18.0,1
5779,F8:59:71:5A:E0:3D,3396788,672284865,178667,265810053,3218121,406474812,0,176899,223921674,172066,223344202,4833,577472,154412,16,181381,3057,0,547,144444.0,43333.0,-67.0,-72.0,-65.0,-70.0,-66.0,-72.0,-64.0,-69.0,-78.0,-86.0,-78.0,-85.0,11.0,14.0,13.0,15.0,1
5780,CC:2F:71:3E:C5:1F,3229554,407873348,11432,1398468,3218122,406474880,6,48773,4084952,40301,3081102,8472,1003850,12055,34,16396,186,6,829,144444.0,39000.0,-68.0,-71.0,-67.0,-60.0,-68.0,-70.0,-67.0,-60.0,-78.0,-86.0,-78.0,-85.0,10.0,15.0,11.0,25.0,1
5781,CC:2F:71:3F:1F:24,9564121,10104691159,6345999,9698216279,3218122,406474880,80,1466006,875647919,1457444,874619763,8562,1028156,1412539,619,6350718,648534,80,5990,130000.0,43333.0,-69.0,-64.0,-71.0,-67.0,-69.0,-64.0,-71.0,-67.0,-78.0,-86.0,-78.0,-85.0,9.0,22.0,7.0,18.0,1
5782,F8:59:71:5A:E0:3D,3396855,672384591,178731,265909509,3218124,406475082,0,176963,224020234,172130,223442762,4833,577472,154476,16,181445,3057,0,547,144444.0,43333.0,-66.0,-72.0,-65.0,-69.0,-66.0,-72.0,-65.0,-69.0,-78.0,-86.0,-78.0,-85.0,12.0,14.0,13.0,16.0,1
5783,CC:2F:71:3E:C5:1F,3229556,407873550,11432,1398468,3218124,406475082,6,48773,4084952,40301,3081102,8472,1003850,12055,34,16396,186,6,829,144444.0,39000.0,-68.0,-71.0,-67.0,-60.0,-68.0,-70.0,-67.0,-60.0,-78.0,-86.0,-78.0,-85.0,10.0,15.0,11.0,25.0,1
5784,CC:2F:71:3F:1F:24,9565189,10106325793,6347065,9699850711,3218124,406475082,80,1466256,875771308,1457694,874743152,8562,1028156,1412789,619,6351784,648699,80,5990,130000.0,43333.0,-69.0,-64.0,-72.0,-67.0,-68.0,-64.0,-71.0,-67.0,-78.0,-86.0,-78.0,-85.0,9.0,22.0,6.0,18.0,1
5785,F8:59:71:5A:E0:3D,3396927,672487189,178796,266010519,3218131,406476670,0,177029,224121874,172196,223544402,4833,577472,154542,16,181510,3058,0,547,144444.0,43333.0,-67.0,-73.0,-65.0,-70.0,-66.0,-72.0,-64.0,-69.0,-78.0,-86.0,-78.0,-85.0,11.0,13.0,13.0,15.0,1
5786,CC:2F:71:3E:C5:1F,3229563,407875138,11432,1398468,3218131,406476670,6,48773,4084952,40301,3081102,8472,1003850,12055,34,16396,186,6,829,144444.0,39000.0,-68.0,-71.0,-67.0,-60.0,-68.0,-70.0,-67.0,-60.0,-78.0,-86.0,-78.0,-85.0,10.0,15.0,11.0,25.0,1
5787,CC:2F:71:3F:1F:24,9566321,10108057477,6348188,9701580605,3218133,406476872,80,1466484,875894382,1457922,874866226,8562,1028156,1413017,619,6352907,649043,80,5990,117000.0,39000.0,-69.0,-64.0,-70.0,-67.0,-68.0,-64.0,-70.0,-66.0,-78.0,-86.0,-78.0,-85.0,9.0,22.0,8.0,18.0,1
5788,F8:59:71:5A:E0:3D,3396999,672593265,178864,266116191,3218135,406477074,0,177097,224226594,172264,223649122,4833,577472,154610,16,181578,3059,0,547,144444.0,43333.0,-66.0,-72.0,-65.0,-69.0,-66.0,-72.0,-65.0,-69.0,-78.0,-86.0,-78.0,-85.0,12.0,14.0,13.0,16.0,1
5789,CC:2F:71:3E:C5:1F,3229567,407875542,11432,1398468,3218135,406477074,6,48773,4084952,40301,3081102,8472,1003850,12055,34,16396,186,6,829,144444.0,39000.0,-68.0,-71.0,-67.0,-60.0,-68.0,-70.0,-67.0,-60.0,-78.0,-86.0,-78.0,-85.0,10.0,15.0,11.0,25.0,1
5790,CC:2F:71:3F:1F:24,9567554,10109959941,6349419,9703482867,3218135,406477074,80,1466717,876015144,1458155,874986988,8562,1028156,1413250,619,6354102,649274,80,5990,130000.0,43333.0,-70.0,-64.0,-71.0,-67.0,-69.0,-64.0,-70.0,-67.0,-78.0,-86.0,-78.0,-85.0,8.0,22.0,7.0,18.0,1
5791,F8:59:71:5A:E0:3D,3397073,672699037,178931,266220309,3218142,406478728,0,177163,224328234,172330,223750762,4833,577472,154676,16,181645,3062,0,547,144444.0,43333.0,-67.0,-72.0,-65.0,-70.0,-66.0,-72.0,-65.0,-69.0,-78.0,-86.0,-78.0,-85.0,11.0,14.0,13.0,15.0,1
5792,CC:2F:71:3E:C5:1F,3229574,407877196,11432,1398468,3218142,406478728,6,48773,4084952,40301,3081102,8472,1003850,12055,34,16396,186,6,829,144444.0,39000.0,-68.0,-71.0,-67.0,-60.0,-68.0,-70.0,-67.0,-60.0,-78.0,-86.0,-78.0,-85.0,10.0,15.0,11.0,25.0,1
5793,CC:2F:71:3F:1F:24,9568768,10111824601,6350626,9705345873,3218142,406478728,80,1466971,876141284,1458409,875113128,8562,1028156,1413504,619,6355339,649422,80,5990,130000.0,43333.0,-68.0,-64.0,-71.0,-67.0,-68.0,-64.0,-70.0,-67.0,-78.0,-86.0,-78.0,-85.0,10.0,22.0,7.0,18.0,1
5794,F8:59:71:5A:E0:3D,3397143,672799230,178995,266319765,3218148,406479465,0,177227,224426794,172394,223849322,4833,577472,154740,16,181709,3062,0,547,144444.0,43333.0,-67.0,-73.0,-65.0,-70.0,-66.0,-72.0,-65.0,-69.0,-78.0,-86.0,-78.0,-85.0,11.0,13.0,13.0,15.0,1
5795,CC:2F:71:3E:C5:1F,3229580,407877933,11432,1398468,3218148,406479465,6,48773,4084952,40301,3081102,8472,1003850,12055,34,16396,186,6,829,144444.0,39000.0,-68.0,-71.0,-67.0,-60.0,-68.0,-70.0,-67.0,-60.0,-78.0,-86.0,-78.0,-85.0,10.0,15.0,11.0,25.0,1
5796,CC:2F:71:3F:1F:24,9570286,10114163358,6352138,9707683893,3218148,406479465,80,1467245,876264448,1458683,875236292,8562,1028156,1413778,619,6356842,649957,80,5990,130000.0,43333.0,-69.0,-64.0,-71.0,-67.0,-68.0,-64.0,-70.0,-67.0,-78.0,-86.0,-78.0,-85.0,9.0,22.0,7.0,18.0,1
5797,F8:59:71:5A:E0:3D,3397210,672898458,179058,266417667,3218152,406480791,0,177290,224523814,172457,223946342,4833,577472,154803,16,181772,3063,0,547,144444.0,43333.0,-67.0,-72.0,-65.0,-70.0,-66.0,-72.0,-65.0,-70.0,-78.0,-86.0,-78.0,-85.0,11.0,14.0,13.0,15.0,1
5798,CC:2F:71:3E:C5:1F,3229586,407879461,11432,1398468,3218154,406480993,6,48773,4084952,40301,3081102,8472,1003850,12055,34,16396,186,6,829,144444.0,39000.0,-68.0,-71.0,-67.0,-60.0,-68.0,-70.0,-67.0,-60.0,-78.0,-86.0,-78.0,-85.0,10.0,15.0,11.0,25.0,1
5799,CC:2F:71:3F:1F:24,9571644,10116256774,6353490,9709775781,3218154,406480993,80,1467489,876385152,1458927,875356996,8562,1028156,1414022,619,6358187,650289,80,5990,130000.0,43333.0,-70.0,-64.0,-72.0,-67.0,-69.0,-64.0,-71.0,-66.0,-78.0,-86.0,-78.0,-85.0,8.0,22.0,6.0,18.0,1
5800,F8:59:71:5A:E0:3D,3397280,673001426,179124,266520231,3218156,406481195,0,177356,224625454,172523,224047982,4833,577472,154869,16,181838,3063,0,547,144444.0,43333.0,-67.0,-73.0,-65.0,-70.0,-66.0,-72.0,-65.0,-70.0,-78.0,-86.0,-78.0,-85.0,11.0,13.0,13.0,15.0,1
5801,CC:2F:71:3E:C5:1F,3229590,407879865,11432,1398468,3218158,406481397,6,48773,4084952,40301,3081102,8472,1003850,12055,34,16396,186,6,829,144444.0,39000.0,-68.0,-71.0,-67.0,-60.0,-68.0,-70.0,-67.0,-60.0,-78.0,-86.0,-78.0,-85.0,10.0,15.0,11.0,25.0,1
5802,CC:2F:71:3F:1F:24,9573067,10118454520,6354909,9711973123,3218158,406481397,80,1467729,876508286,1459167,875480130,8562,1028156,1414261,619,6359613,651144,80,5992,130000.0,43333.0,-69.0,-64.0,-71.0,-67.0,-68.0,-64.0,-70.0,-67.0,-78.0,-86.0,-78.0,-85.0,9.0,22.0,7.0,18.0,1
5803,F8:59:71:5A:E0:3D,3397348,673099792,179187,266618133,3218161,406481659,0,177420,224724014,172587,224146542,4833,577472,154933,16,181901,3064,0,547,144444.0,43333.0,-66.0,-73.0,-66.0,-70.0,-66.0,-73.0,-65.0,-70.0,-78.0,-86.0,-78.0,-85.0,12.0,13.0,12.0,15.0,1
5804,CC:2F:71:3E:C5:1F,3229593,407880127,11432,1398468,3218161,406481659,6,48773,4084952,40301,3081102,8472,1003850,12055,34,16396,186,6,829,144444.0,39000.0,-68.0,-71.0,-67.0,-60.0,-68.0,-70.0,-67.0,-60.0,-78.0,-86.0,-78.0,-85.0,10.0,15.0,11.0,25.0,1
5805,CC:2F:71:3F:1F:24,9574653,10120908178,6356490,9714426317,3218163,406481861,80,1468037,876637924,1459475,875609768,8562,1028156,1414569,619,6361209,651452,80,5993,115556.0,28889.0,-69.0,-64.0,-71.0,-67.0,-68.0,-64.0,-71.0,-67.0,-78.0,-86.0,-78.0,-85.0,9.0,22.0,7.0,18.0,1
5806,F8:59:71:5A:E0:3D,3397416,673199652,179251,266717589,3218165,406482063,0,177483,224821034,172650,224243562,4833,577472,154996,16,181965,3064,0,547,144444.0,43333.0,-67.0,-73.0,-65.0,-70.0,-66.0,-73.0,-65.0,-69.0,-78.0,-86.0,-78.0,-85.0,11.0,13.0,13.0,15.0,1
5807,CC:2F:71:3E:C5:1F,3229597,407880531,11432,1398468,3218165,406482063,6,48773,4084952,40301,3081102,8472,1003850,12055,34,16396,186,6,829,144444.0,39000.0,-68.0,-71.0,-67.0,-60.0,-68.0,-70.0,-67.0,-60.0,-78.0,-86.0,-78.0,-85.0,10.0,15.0,11.0,25.0,1
5808,CC:2F:71:3F:1F:24,9576225,10123329388,6358058,9716847123,3218167,406482265,80,1468341,876766022,1459779,875737866,8562,1028156,1414871,619,6362777,651475,80,5993,115556.0,28889.0,-70.0,-64.0,-74.0,-67.0,-69.0,-63.0,-72.0,-66.0,-78.0,-86.0,-78.0,-85.0,8.0,22.0,4.0,18.0,1
5809,F8:59:71:5A:E0:3D,3397486,673301182,179317,266818715,3218169,406482467,0,177548,224921134,172715,224343662,4833,577472,155061,16,182031,3064,0,547,144444.0,43333.0,-67.0,-74.0,-66.0,-70.0,-66.0,-73.0,-65.0,-70.0,-78.0,-86.0,-78.0,-85.0,11.0,12.0,12.0,15.0,1
5810,CC:2F:71:3E:C5:1F,3229602,407881051,11433,1398584,3218169,406482467,6,48775,4085092,40303,3081242,8472,1003850,12055,34,16397,186,6,829,144444.0,39000.0,-68.0,-71.0,-67.0,-60.0,-68.0,-70.0,-67.0,-60.0,-78.0,-86.0,-78.0,-85.0,10.0,15.0,11.0,25.0,1
5811,CC:2F:71:3F:1F:24,9577613,10125474708,6359443,9718992181,3218170,406482527,80,1468654,876896194,1460092,875868038,8562,1028156,1415184,619,6364142,651810,80,5993,115556.0,26000.0,-68.0,-64.0,-71.0,-67.0,-68.0,-64.0,-71.0,-66.0,-78.0,-86.0,-78.0,-85.0,10.0,22.0,7.0,18.0,1
5812,F8:59:71:5A:E0:3D,3397561,673407442,179385,266924387,3218176,406483055,0,177617,225027394,172784,224449922,4833,577472,155130,16,182099,3067,0,547,144444.0,43333.0,-67.0,-73.0,-65.0,-70.0,-66.0,-73.0,-65.0,-70.0,-78.0,-86.0,-78.0,-85.0,11.0,13.0,13.0,15.0,1
5813,CC:2F:71:3E:C5:1F,3229609,407881639,11433,1398584,3218176,406483055,6,48777,4085280,40304,3081312,8473,1003968,12056,34,16397,186,6,829,144444.0,39000.0,-68.0,-70.0,-67.0,-60.0,-67.0,-70.0,-67.0,-60.0,-78.0,-86.0,-78.0,-85.0,10.0,16.0,11.0,25.0,1
5814,CC:2F:71:3F:1F:24,9578685,10127112176,6360509,9720629121,3218176,406483055,80,1468907,877023556,1460344,875995282,8563,1028274,1415437,619,6365228,651925,80,5993,86667.0,14444.0,-68.0,-64.0,-70.0,-67.0,-68.0,-64.0,-70.0,-66.0,-78.0,-86.0,-78.0,-85.0,10.0,22.0,8.0,18.0,1
5815,F8:59:71:5A:E0:3D,3397630,673508744,179450,267025285,3218180,406483459,0,177682,225127494,172849,224550022,4833,577472,155195,16,182165,3078,0,547,144444.0,43333.0,-67.0,-74.0,-65.0,-70.0,-66.0,-73.0,-65.0,-70.0,-78.0,-86.0,-78.0,-86.0,11.0,12.0,13.0,16.0,1
5816,CC:2F:71:3E:C5:1F,3229613,407882043,11433,1398584,3218180,406483459,6,48777,4085280,40304,3081312,8473,1003968,12056,34,16397,186,6,829,144444.0,39000.0,-68.0,-70.0,-67.0,-60.0,-67.0,-70.0,-67.0,-60.0,-78.0,-86.0,-78.0,-86.0,10.0,16.0,11.0,26.0,1
5817,CC:2F:71:3F:1F:24,9579911,10128996704,6361731,9722513245,3218180,406483459,80,1469190,877148898,1460627,876120624,8563,1028274,1415720,619,6366450,652212,80,5993,86667.0,14444.0,-69.0,-64.0,-71.0,-67.0,-68.0,-64.0,-71.0,-66.0,-78.0,-86.0,-78.0,-86.0,9.0,22.0,7.0,19.0,1
5818,F8:59:71:5A:E0:3D,3397704,673616378,179519,267132455,3218185,406483923,0,177751,225233782,172918,224656310,4833,577472,155264,16,182234,3079,0,547,130000.0,39000.0,-67.0,-72.0,-65.0,-70.0,-67.0,-72.0,-64.0,-69.0,-78.0,-86.0,-78.0,-86.0,11.0,14.0,13.0,16.0,1
5819,CC:2F:71:3E:C5:1F,3229618,407882507,11433,1398584,3218185,406483923,6,48777,4085280,40304,3081312,8473,1003968,12056,34,16397,186,6,829,144444.0,39000.0,-68.0,-70.0,-67.0,-60.0,-67.0,-70.0,-67.0,-60.0,-78.0,-86.0,-78.0,-86.0,10.0,16.0,11.0,26.0,1
5820,CC:2F:71:3F:1F:24,9581309,10131144917,6363124,9724660994,3218185,406483923,80,1469496,877284587,1460933,876256313,8563,1028274,1416026,619,6367842,652273,80,5993,86667.0,14444.0,-68.0,-64.0,-70.0,-68.0,-68.0,-64.0,-70.0,-67.0,-78.0,-86.0,-78.0,-86.0,10.0,22.0,8.0,18.0,1
5821,F8:59:71:5A:E0:3D,3397774,673719234,179585,267234907,3218189,406484327,0,177816,225333882,172983,224756410,4833,577472,155329,16,182300,3079,0,547,144444.0,43333.0,-66.0,-72.0,-64.0,-69.0,-66.0,-72.0,-65.0,-70.0,-78.0,-86.0,-78.0,-86.0,12.0,14.0,14.0,17.0,1
5822,CC:2F:71:3E:C5:1F,3229622,407882911,11433,1398584,3218189,406484327,6,48777,4085280,40304,3081312,8473,1003968,12056,34,16397,186,6,829,144444.0,39000.0,-68.0,-70.0,-67.0,-60.0,-67.0,-70.0,-67.0,-60.0,-78.0,-86.0,-78.0,-86.0,10.0,16.0,11.0,26.0,1
5823,CC:2F:71:3F:1F:24,9582782,10133420827,6364593,9726936500,3218189,406484327,80,1469839,877418207,1461276,876389933,8563,1028274,1416369,619,6369312,652282,80,5993,115556.0,26000.0,-73.0,-65.0,-70.0,-67.0,-73.0,-64.0,-69.0,-66.0,-78.0,-86.0,-78.0,-86.0,5.0,21.0,8.0,19.0,1
5824,F8:59:71:5A:E0:3D,3397841,673817540,179648,267332809,3218193,406484731,0,177880,225432442,173047,224854970,4833,577472,155393,16,182363,3079,0,547,144444.0,43333.0,-66.0,-74.0,-65.0,-70.0,-66.0,-74.0,-64.0,-69.0,-78.0,-86.0,-78.0,-86.0,12.0,12.0,13.0,16.0,1
5825,CC:2F:71:3E:C5:1F,3229626,407883315,11433,1398584,3218193,406484731,6,48777,4085280,40304,3081312,8473,1003968,12056,34,16397,186,6,829,144444.0,39000.0,-68.0,-70.0,-67.0,-60.0,-67.0,-70.0,-67.0,-60.0,-78.0,-86.0,-78.0,-86.0,10.0,16.0,11.0,26.0,1
5826,CC:2F:71:3F:1F:24,9583687,10134800769,6365494,9728316038,3218193,406484731,80,1470089,877538247,1461526,876509973,8563,1028274,1416619,619,6370213,652407,80,5993,115556.0,26000.0,-69.0,-64.0,-73.0,-68.0,-69.0,-64.0,-72.0,-68.0,-78.0,-86.0,-78.0,-86.0,9.0,22.0,5.0,18.0,1
5827,F8:59:71:5A:E0:3D,3397911,673917576,179713,267432381,3218198,406485195,0,177944,225529568,173111,224952096,4833,577472,155457,16,182428,3079,0,547,144444.0,43333.0,-66.0,-71.0,-68.0,-70.0,-67.0,-70.0,-67.0,-69.0,-78.0,-86.0,-78.0,-86.0,12.0,15.0,10.0,16.0,1
5828,CC:2F:71:3E:C5:1F,3229631,407883779,11433,1398584,3218198,406485195,6,48777,4085280,40304,3081312,8473,1003968,12056,34,16397,186,6,829,144444.0,39000.0,-68.0,-70.0,-67.0,-60.0,-67.0,-70.0,-67.0,-60.0,-78.0,-86.0,-78.0,-86.0,10.0,16.0,11.0,26.0,1
5829,CC:2F:71:3F:1F:24,9584586,10136167359,6366388,9729682164,3218198,406485195,80,1470307,877655793,1461744,876627519,8563,1028274,1416837,619,6371107,652560,80,5993,115556.0,28889.0,-70.0,-64.0,-69.0,-66.0,-70.0,-63.0,-67.0,-66.0,-78.0,-86.0,-78.0,-86.0,8.0,22.0,9.0,20.0,1
5830,F8:59:71:5A:E0:3D,3397976,674015680,179776,267530283,3218200,406485397,0,178007,225626588,173174,225049116,4833,577472,155520,16,182491,3087,0,547,144444.0,43333.0,-67.0,-73.0,-64.0,-71.0,-68.0,-73.0,-64.0,-72.0,-78.0,-86.0,-78.0,-86.0,11.0,13.0,14.0,15.0,1
5831,CC:2F:71:3E:C5:1F,3229633,407883981,11433,1398584,3218200,406485397,6,48777,4085280,40304,3081312,8473,1003968,12056,34,16397,186,6,829,144444.0,39000.0,-68.0,-70.0,-67.0,-60.0,-67.0,-70.0,-67.0,-60.0,-78.0,-86.0,-78.0,-86.0,10.0,16.0,11.0,26.0,1
5832,CC:2F:71:3F:1F:24,9586005,10138363267,6367805,9731877870,3218200,406485397,80,1470620,877781509,1462057,876753235,8563,1028274,1417150,619,6372514,652693,80,5993,115556.0,28889.0,-72.0,-64.0,-71.0,-69.0,-72.0,-64.0,-71.0,-69.0,-78.0,-86.0,-78.0,-86.0,6.0,22.0,7.0,17.0,1
5833,F8:59:71:5A:E0:3D,3398043,674113986,179839,267628185,3218204,406485801,0,178070,225723608,173237,225146136,4833,577472,155583,16,182553,3089,0,547,144444.0,43333.0,-65.0,-72.0,-65.0,-71.0,-65.0,-73.0,-64.0,-71.0,-78.0,-86.0,-78.0,-86.0,13.0,14.0,13.0,15.0,1
5834,CC:2F:71:3E:C5:1F,3229639,407884587,11433,1398584,3218206,406486003,6,48777,4085280,40304,3081312,8473,1003968,12056,34,16397,186,6,829,144444.0,39000.0,-68.0,-70.0,-67.0,-60.0,-67.0,-70.0,-67.0,-60.0,-78.0,-86.0,-78.0,-86.0,10.0,16.0,11.0,26.0,1
5835,CC:2F:71:3F:1F:24,9587369,10140444567,6369163,9733958564,3218206,406486003,80,1470941,877913684,1462378,876885410,8563,1028274,1417471,619,6373882,653091,80,5993,86667.0,13000.0,-66.0,-65.0,-70.0,-67.0,-65.0,-65.0,-70.0,-66.0,-78.0,-86.0,-78.0,-86.0,12.0,21.0,8.0,19.0,1
5836,F8:59:71:5A:E0:3D,3398113,674214179,179903,267727641,3218210,406486538,0,178135,225823708,173302,225246236,4833,577472,155648,16,182618,3089,0,547,144444.0,43333.0,-66.0,-71.0,-65.0,-70.0,-66.0,-72.0,-64.0,-70.0,-78.0,-86.0,-78.0,-86.0,12.0,15.0,13.0,16.0,1
5837,CC:2F:71:3E:C5:1F,3229643,407885122,11433,1398584,3218210,406486538,6,48777,4085280,40304,3081312,8473,1003968,12056,34,16397,186,6,829,144444.0,39000.0,-68.0,-70.0,-67.0,-60.0,-67.0,-70.0,-67.0,-60.0,-78.0,-86.0,-78.0,-86.0,10.0,16.0,11.0,26.0,1
5838,CC:2F:71:3F:1F:24,9589109,10143141774,6370899,9736655236,3218210,406486538,80,1471279,878048136,1462716,877019862,8563,1028274,1417805,619,6375618,653240,80,5993,130000.0,39000.0,-68.0,-65.0,-68.0,-65.0,-67.0,-65.0,-68.0,-65.0,-78.0,-86.0,-78.0,-86.0,10.0,21.0,10.0,21.0,1
5839,F8:59:71:5A:E0:3D,3398180,674315391,179968,267828651,3218212,406486740,0,178199,225922268,173366,225344796,4833,577472,155712,16,182683,3091,0,547,144444.0,43333.0,-68.0,-73.0,-65.0,-71.0,-66.0,-72.0,-65.0,-71.0,-78.0,-86.0,-78.0,-86.0,10.0,13.0,13.0,15.0,1
5840,CC:2F:71:3E:C5:1F,3229647,407885526,11433,1398584,3218214,406486942,6,48777,4085280,40304,3081312,8473,1003968,12056,34,16397,186,6,829,144444.0,39000.0,-68.0,-70.0,-67.0,-60.0,-67.0,-70.0,-67.0,-60.0,-78.0,-86.0,-78.0,-86.0,10.0,16.0,11.0,26.0,1
5841,CC:2F:71:3F:1F:24,9590410,10145145434,6372194,9738658290,3218216,406487144,80,1471543,878171136,1462980,877142862,8563,1028274,1418069,619,6376913,653481,80,5993,115556.0,28889.0,-69.0,-63.0,-71.0,-68.0,-69.0,-62.0,-70.0,-68.0,-78.0,-86.0,-78.0,-86.0,9.0,23.0,7.0,18.0,1
5842,F8:59:71:5A:E0:3D,3398248,674415251,180032,267928107,3218216,406487144,0,178264,226022368,173431,225444896,4833,577472,155777,16,182746,3092,0,547,144444.0,43333.0,-67.0,-70.0,-65.0,-70.0,-67.0,-72.0,-64.0,-70.0,-78.0,-86.0,-78.0,-86.0,11.0,16.0,13.0,16.0,1
5843,CC:2F:71:3E:C5:1F,3229649,407885728,11433,1398584,3218216,406487144,6,48777,4085280,40304,3081312,8473,1003968,12056,34,16397,186,6,829,144444.0,39000.0,-68.0,-70.0,-67.0,-60.0,-67.0,-70.0,-67.0,-60.0,-78.0,-86.0,-78.0,-86.0,10.0,16.0,11.0,26.0,1
5844,CC:2F:71:3F:1F:24,9591573,10146937646,6373355,9740450300,3218218,406487346,80,1471792,878289428,1463229,877261154,8563,1028274,1418318,619,6378062,653543,80,5993,115556.0,28889.0,-70.0,-63.0,-70.0,-68.0,-69.0,-63.0,-70.0,-68.0,-78.0,-86.0,-78.0,-86.0,8.0,23.0,8.0,18.0,1
5845,F8:59:71:5A:E0:3D,3398316,674512125,180094,268024455,3218222,406487670,0,178327,226118008,173493,225540418,4834,577590,155840,16,182809,3092,0,548,144444.0,43333.0,-66.0,-73.0,-66.0,-70.0,-66.0,-73.0,-65.0,-70.0,-78.0,-86.0,-78.0,-86.0,12.0,13.0,12.0,16.0,1
5846,CC:2F:71:3E:C5:1F,3229655,407886254,11433,1398584,3218222,406487670,6,48777,4085280,40304,3081312,8473,1003968,12056,34,16397,186,6,829,144444.0,39000.0,-68.0,-70.0,-67.0,-60.0,-67.0,-70.0,-67.0,-60.0,-78.0,-86.0,-78.0,-86.0,10.0,16.0,11.0,26.0,1
5847,CC:2F:71:3F:1F:24,9593024,10149171804,6374802,9742684134,3218222,406487670,80,1472059,878414653,1463496,877386379,8563,1028274,1418582,619,6379513,653682,80,5993,130000.0,43333.0,-68.0,-62.0,-71.0,-68.0,-68.0,-62.0,-70.0,-68.0,-78.0,-86.0,-78.0,-86.0,10.0,24.0,7.0,18.0,1
5848,F8:59:71:5A:E0:3D,3398383,674610431,180157,268122357,3218226,406488074,0,178389,226213488,173555,225635898,4834,577590,155902,16,182872,3092,0,548,144444.0,43333.0,-67.0,-73.0,-65.0,-71.0,-66.0,-73.0,-65.0,-70.0,-78.0,-86.0,-78.0,-86.0,11.0,13.0,13.0,15.0,1
5849,CC:2F:71:3E:C5:1F,3229659,407886658,11433,1398584,3218226,406488074,6,48777,4085280,40304,3081312,8473,1003968,12056,34,16397,186,6,829,144444.0,39000.0,-68.0,-70.0,-67.0,-60.0,-67.0,-70.0,-67.0,-60.0,-78.0,-86.0,-78.0,-86.0,10.0,16.0,11.0,26.0,1
5850,CC:2F:71:3F:1F:24,9594532,10151503512,6376306,9745015438,3218226,406488074,80,1472330,878542927,1463767,877514653,8563,1028274,1418853,619,6381000,653931,80,5994,86667.0,13000.0,-70.0,-64.0,-70.0,-68.0,-70.0,-64.0,-69.0,-68.0,-78.0,-86.0,-78.0,-86.0,8.0,22.0,8.0,18.0,1
5851,F8:59:71:5A:E0:3D,3398454,674714953,180224,268226475,3218230,406488478,0,178457,226318208,173623,225740618,4834,577590,155970,16,182939,3092,0,548,144444.0,43333.0,-67.0,-73.0,-67.0,-69.0,-67.0,-72.0,-66.0,-69.0,-78.0,-86.0,-78.0,-86.0,11.0,13.0,11.0,17.0,1
5852,CC:2F:71:3E:C5:1F,3229663,407887062,11433,1398584,3218230,406488478,6,48777,4085280,40304,3081312,8473,1003968,12056,34,16397,186,6,829,144444.0,39000.0,-68.0,-70.0,-67.0,-60.0,-67.0,-70.0,-67.0,-60.0,-78.0,-86.0,-78.0,-86.0,10.0,16.0,11.0,26.0,1
5853,CC:2F:71:3F:1F:24,9595738,10153356602,6377507,9746868064,3218231,406488538,80,1472597,878666489,1464034,877638215,8563,1028274,1419115,619,6382211,654003,80,5994,86667.0,14444.0,-71.0,-64.0,-70.0,-68.0,-70.0,-64.0,-70.0,-68.0,-78.0,-86.0,-78.0,-86.0,7.0,22.0,8.0,18.0,1
5854,F8:59:71:5A:E0:3D,3398522,674813319,180287,268324377,3218235,406488942,0,178520,226415228,173686,225837638,4834,577590,156033,16,183002,3092,0,548,144444.0,43333.0,-67.0,-72.0,-65.0,-70.0,-67.0,-71.0,-65.0,-70.0,-78.0,-86.0,-78.0,-86.0,11.0,14.0,13.0,16.0,1
5855,CC:2F:71:3E:C5:1F,3229668,407887526,11433,1398584,3218235,406488942,6,48777,4085280,40304,3081312,8473,1003968,12056,34,16397,186,6,829,144444.0,39000.0,-68.0,-70.0,-67.0,-60.0,-67.0,-70.0,-67.0,-60.0,-78.0,-86.0,-78.0,-86.0,10.0,16.0,11.0,26.0,1
5856,CC:2F:71:3F:1F:24,9597399,10155930600,6379164,9749441658,3218235,406488942,80,1472943,878800473,1464380,877772199,8563,1028274,1419461,619,6383862,654033,80,5994,86667.0,14444.0,-68.0,-63.0,-70.0,-67.0,-68.0,-63.0,-69.0,-67.0,-78.0,-86.0,-78.0,-86.0,10.0,23.0,8.0,19.0,1
5857,F8:59:71:5A:E0:3D,3398591,674914733,180352,268425387,3218239,406489346,0,178585,226515328,173751,225937738,4834,577590,156098,16,183067,3094,0,548,144444.0,43333.0,-66.0,-73.0,-66.0,-70.0,-66.0,-72.0,-66.0,-70.0,-78.0,-86.0,-78.0,-86.0,12.0,13.0,12.0,16.0,1
5858,CC:2F:71:3E:C5:1F,3229672,407887930,11433,1398584,3218239,406489346,6,48777,4085280,40304,3081312,8473,1003968,12056,34,16397,186,6,829,144444.0,39000.0,-68.0,-70.0,-67.0,-60.0,-67.0,-70.0,-67.0,-60.0,-78.0,-86.0,-78.0,-86.0,10.0,16.0,11.0,26.0,1
5859,CC:2F:71:3F:1F:24,9599316,10158898236,6381077,9752408890,3218239,406489346,80,1473262,878930527,1464699,877902253,8563,1028274,1419780,619,6385796,654196,80,5994,130000.0,43333.0,-68.0,-64.0,-69.0,-68.0,-67.0,-64.0,-69.0,-67.0,-78.0,-86.0,-78.0,-86.0,10.0,22.0,9.0,18.0,1
5860,F8:59:71:5A:E0:3D,3398659,675013099,180415,268523289,3218244,406489810,0,178648,226612348,173814,226034758,4834,577590,156161,16,183130,3095,0,548,144444.0,43333.0,-67.0,-73.0,-66.0,-71.0,-66.0,-73.0,-66.0,-70.0,-78.0,-86.0,-78.0,-86.0,11.0,13.0,12.0,15.0,1
5861,CC:2F:71:3E:C5:1F,3229677,407888394,11433,1398584,3218244,406489810,6,48777,4085280,40304,3081312,8473,1003968,12056,34,16397,186,6,829,144444.0,39000.0,-68.0,-70.0,-67.0,-60.0,-67.0,-70.0,-67.0,-60.0,-78.0,-86.0,-78.0,-86.0,10.0,16.0,11.0,26.0,1
5862,CC:2F:71:3F:1F:24,9600590,10160859662,6382346,9754369852,3218244,406489810,80,1473472,879044401,1464909,878016127,8563,1028274,1419990,619,6387048,654223,80,5994,130000.0,43333.0,-68.0,-64.0,-70.0,-68.0,-67.0,-64.0,-70.0,-68.0,-78.0,-86.0,-78.0,-86.0,10.0,22.0,8.0,18.0,1
5863,F8:59:71:5A:E0:3D,3398726,675112891,180479,268622745,3218247,406490146,0,178712,226710908,173878,226133318,4834,577590,156225,16,183194,3095,0,548,144444.0,43333.0,-66.0,-73.0,-66.0,-70.0,-66.0,-72.0,-65.0,-70.0,-78.0,-86.0,-78.0,-86.0,12.0,13.0,12.0,16.0,1
5864,CC:2F:71:3E:C5:1F,3229681,407888798,11433,1398584,3218248,406490214,6,48777,4085280,40304,3081312,8473,1003968,12056,34,16397,186,6,829,144444.0,39000.0,-68.0,-70.0,-67.0,-60.0,-67.0,-70.0,-67.0,-60.0,-78.0,-86.0,-78.0,-86.0,10.0,16.0,11.0,26.0,1
5865,CC:2F:71:3F:1F:24,9602114,10163216786,6383866,9756726572,3218248,406490214,80,1473749,879170325,1465186,878142051,8563,1028274,1420267,619,6388585,654468,80,5995,130000.0,39000.0,-69.0,-64.0,-70.0,-68.0,-68.0,-64.0,-69.0,-68.0,-78.0,-86.0,-78.0,-86.0,9.0,22.0,8.0,18.0,1
5866,F8:59:71:5A:E0:3D,3398795,675212819,180543,268722201,3218252,406490618,0,178775,226807928,173941,226230338,4834,577590,156288,16,183257,3095,0,548,144444.0,43333.0,-67.0,-73.0,-66.0,-71.0,-66.0,-73.0,-65.0,-70.0,-78.0,-86.0,-78.0,-86.0,11.0,13.0,12.0,15.0,1
5867,CC:2F:71:3E:C5:1F,3229685,407889202,11433,1398584,3218252,406490618,6,48777,4085280,40304,3081312,8473,1003968,12056,34,16397,186,6,829,144444.0,39000.0,-68.0,-70.0,-67.0,-60.0,-67.0,-70.0,-67.0,-60.0,-78.0,-86.0,-78.0,-86.0,10.0,16.0,11.0,26.0,1
5868,CC:2F:71:3F:1F:24,9603239,10164945776,6384987,9758455158,3218252,406490618,80,1473949,879283281,1465386,878255007,8563,1028274,1420467,619,6389705,654628,80,5995,130000.0,43333.0,-69.0,-64.0,-70.0,-68.0,-68.0,-64.0,-69.0,-68.0,-78.0,-86.0,-78.0,-86.0,9.0,22.0,8.0,18.0,1
5869,F8:59:71:5A:E0:3D,3398861,675310983,180606,268820103,3218255,406490880,0,178839,226906488,174005,226328898,4834,577590,156352,16,183321,3095,0,548,144444.0,43333.0,-66.0,-73.0,-66.0,-70.0,-66.0,-72.0,-65.0,-70.0,-78.0,-86.0,-78.0,-86.0,12.0,13.0,12.0,16.0,1
5870,CC:2F:71:3E:C5:1F,3229688,407889464,11433,1398584,3218255,406490880,6,48777,4085280,40304,3081312,8473,1003968,12056,34,16397,186,6,829,144444.0,39000.0,-68.0,-70.0,-67.0,-60.0,-67.0,-70.0,-67.0,-60.0,-78.0,-86.0,-78.0,-86.0,10.0,16.0,11.0,26.0,1
5871,CC:2F:71:3F:1F:24,9604489,10166865912,6386234,9760375032,3218255,406490880,80,1474160,879400904,1465597,878372630,8563,1028274,1420678,619,6390953,654800,80,5995,130000.0,43333.0,-69.0,-64.0,-70.0,-68.0,-68.0,-64.0,-69.0,-68.0,-78.0,-86.0,-78.0,-86.0,9.0,22.0,8.0,18.0,1
5872,F8:59:71:5A:E0:3D,3398930,675409379,180669,268917893,3218261,406491486,0,178902,227003508,174068,226425918,4834,577590,156415,16,183384,3100,0,548,144444.0,43333.0,-67.0,-73.0,-65.0,-70.0,-66.0,-72.0,-65.0,-70.0,-78.0,-86.0,-78.0,-86.0,11.0,13.0,13.0,16.0,1
5873,CC:2F:71:3E:C5:1F,3229694,407890070,11433,1398584,3218261,406491486,6,48777,4085280,40304,3081312,8473,1003968,12056,34,16397,186,6,829,144444.0,39000.0,-68.0,-70.0,-67.0,-60.0,-67.0,-70.0,-67.0,-60.0,-78.0,-86.0,-78.0,-86.0,10.0,16.0,11.0,26.0,1
5874,CC:2F:71:3F:1F:24,9605577,10168528882,6387316,9762037396,3218261,406491486,80,1474432,879532300,1465869,878504026,8563,1028274,1420945,619,6392035,655188,80,5996,115556.0,28889.0,-69.0,-64.0,-70.0,-68.0,-68.0,-63.0,-70.0,-68.0,-78.0,-86.0,-78.0,-86.0,9.0,22.0,8.0,18.0,1
5875,F8:59:71:5A:E0:3D,3398997,675513497,180736,269022011,3218261,406491486,0,178969,227106688,174135,226529098,4834,577590,156482,16,183451,3100,0,548,144444.0,43333.0,-67.0,-72.0,-66.0,-70.0,-66.0,-72.0,-65.0,-70.0,-78.0,-86.0,-78.0,-86.0,11.0,14.0,12.0,16.0,1
5876,CC:2F:71:3E:C5:1F,3229696,407890272,11433,1398584,3218263,406491688,6,48777,4085280,40304,3081312,8473,1003968,12056,34,16397,186,6,829,144444.0,39000.0,-68.0,-70.0,-67.0,-60.0,-67.0,-70.0,-67.0,-60.0,-78.0,-86.0,-78.0,-86.0,10.0,16.0,11.0,26.0,1
5877,CC:2F:71:3F:1F:24,9606577,10170062184,6388314,9763570496,3218263,406491688,80,1474708,879655300,1466145,878627026,8563,1028274,1421221,619,6393033,655591,80,5996,115556.0,28889.0,-68.0,-63.0,-70.0,-68.0,-68.0,-63.0,-70.0,-67.0,-78.0,-86.0,-78.0,-86.0,10.0,23.0,8.0,18.0,1
5878,F8:59:71:5A:E0:3D,3399068,675612338,180799,269119913,3218269,406492425,0,179032,227203708,174198,226626118,4834,577590,156545,16,183514,3101,0,548,144444.0,43333.0,-66.0,-73.0,-65.0,-70.0,-66.0,-72.0,-65.0,-70.0,-78.0,-86.0,-78.0,-86.0,12.0,13.0,13.0,16.0,1
5879,CC:2F:71:3E:C5:1F,3229704,407891211,11433,1398584,3218271,406492627,6,48777,4085280,40304,3081312,8473,1003968,12056,34,16397,186,6,829,144444.0,39000.0,-68.0,-70.0,-67.0,-60.0,-67.0,-70.0,-67.0,-60.0,-78.0,-86.0,-78.0,-86.0,10.0,16.0,11.0,26.0,1
5880,CC:2F:71:3F:1F:24,9607660,10171719377,6389389,9765226750,3218271,406492627,80,1474964,879775888,1466401,878747614,8563,1028274,1421477,619,6394096,655865,80,5996,115556.0,28889.0,-69.0,-63.0,-68.0,-67.0,-68.0,-63.0,-69.0,-67.0,-78.0,-86.0,-78.0,-86.0,9.0,23.0,10.0,19.0,1
5881,F8:59:71:5A:E0:3D,3399133,675710442,180862,269217815,3218271,406492627,0,179095,227300728,174261,226723138,4834,577590,156608,16,183577,3102,0,548,144444.0,43333.0,-67.0,-73.0,-65.0,-70.0,-66.0,-72.0,-65.0,-70.0,-78.0,-86.0,-78.0,-86.0,11.0,13.0,13.0,16.0,1
5882,CC:2F:71:3E:C5:1F,3229704,407891211,11433,1398584,3218271,406492627,6,48777,4085280,40304,3081312,8473,1003968,12056,34,16397,186,6,829,144444.0,39000.0,-68.0,-70.0,-67.0,-60.0,-67.0,-70.0,-67.0,-60.0,-78.0,-86.0,-78.0,-86.0,10.0,16.0,11.0,26.0,1
5883,CC:2F:71:3F:1F:24,9608902,10173635851,6390629,9767143022,3218273,406492829,80,1475227,879900028,1466664,878871754,8563,1028274,1421740,619,6395327,656015,80,5996,117000.0,39000.0,-69.0,-63.0,-70.0,-67.0,-68.0,-63.0,-69.0,-67.0,-78.0,-86.0,-78.0,-86.0,9.0,23.0,8.0,19.0,1
5884,F8:59:71:5A:E0:3D,3399203,675813410,180928,269320379,3218275,406493031,0,179161,227402368,174327,226824778,4834,577590,156674,16,183643,3102,0,548,144444.0,43333.0,-66.0,-73.0,-65.0,-70.0,-66.0,-72.0,-65.0,-69.0,-78.0,-86.0,-78.0,-86.0,12.0,13.0,13.0,16.0,1
5885,CC:2F:71:3E:C5:1F,3229710,407891817,11433,1398584,3218277,406493233,6,48777,4085280,40304,3081312,8473,1003968,12056,34,16397,186,6,829,144444.0,39000.0,-68.0,-70.0,-67.0,-60.0,-67.0,-70.0,-67.0,-60.0,-78.0,-86.0,-78.0,-86.0,10.0,16.0,11.0,26.0,1
5886,CC:2F:71:3F:1F:24,9609761,10174934631,6391482,9768441196,3218279,406493435,80,1475466,880022055,1466903,878993781,8563,1028274,1421979,619,6396201,656107,80,5996,115556.0,28889.0,-69.0,-64.0,-70.0,-67.0,-68.0,-63.0,-69.0,-67.0,-78.0,-86.0,-78.0,-86.0,9.0,22.0,8.0,19.0,1
5887,F8:59:71:5A:E0:3D,3399272,675913162,180992,269419667,3218280,406493495,0,179225,227500928,174391,226923338,4834,577590,156738,16,183707,3102,0,548,144444.0,43333.0,-67.0,-73.0,-66.0,-70.0,-66.0,-72.0,-65.0,-70.0,-78.0,-86.0,-78.0,-86.0,11.0,13.0,12.0,16.0,1
5888,CC:2F:71:3E:C5:1F,3229713,407892079,11433,1398584,3218280,406493495,6,48777,4085280,40304,3081312,8473,1003968,12056,34,16397,186,6,829,144444.0,39000.0,-68.0,-70.0,-67.0,-60.0,-67.0,-70.0,-67.0,-60.0,-78.0,-86.0,-78.0,-86.0,10.0,16.0,11.0,26.0,1
5889,CC:2F:71:3F:1F:24,9610905,10176696801,6392625,9770203306,3218280,406493495,80,1475730,880143523,1467167,879115249,8563,1028274,1422243,619,6397344,656130,80,5996,115556.0,28889.0,-68.0,-63.0,-70.0,-67.0,-68.0,-63.0,-70.0,-67.0,-78.0,-86.0,-78.0,-86.0,10.0,23.0,8.0,19.0,1
5890,F8:59:71:5A:E0:3D,3399339,676011468,181055,269517569,3218284,406493899,0,179287,227596408,174453,227018818,4834,577590,156800,16,183770,3103,0,548,144444.0,43333.0,-66.0,-72.0,-65.0,-70.0,-66.0,-72.0,-65.0,-70.0,-78.0,-86.0,-78.0,-86.0,12.0,14.0,13.0,16.0,1
5891,CC:2F:71:3E:C5:1F,3229717,407892483,11433,1398584,3218284,406493899,6,48777,4085280,40304,3081312,8473,1003968,12056,34,16397,186,6,829,144444.0,39000.0,-68.0,-70.0,-67.0,-60.0,-67.0,-70.0,-67.0,-60.0,-78.0,-86.0,-78.0,-86.0,10.0,16.0,11.0,26.0,1
5892,CC:2F:71:3F:1F:24,9612479,10179125457,6394193,9772631356,3218286,406494101,80,1476031,880272255,1467468,879243981,8563,1028274,1422544,619,6398891,656347,80,5996,115556.0,28889.0,-69.0,-63.0,-71.0,-67.0,-68.0,-63.0,-70.0,-67.0,-78.0,-86.0,-78.0,-86.0,9.0,23.0,7.0,19.0,1
5893,F8:59:71:5A:E0:3D,3399411,676113366,181121,269618695,3218290,406494671,0,179352,227696508,174518,227118918,4834,577590,156865,16,183836,3104,0,548,144444.0,43333.0,-66.0,-72.0,-66.0,-70.0,-66.0,-72.0,-65.0,-70.0,-78.0,-86.0,-78.0,-86.0,12.0,14.0,12.0,16.0,1
5894,CC:2F:71:3E:C5:1F,3229724,407893371,11434,1398700,3218290,406494671,6,48779,4085420,40306,3081452,8473,1003968,12056,34,16398,186,6,829,144444.0,39000.0,-70.0,-71.0,-69.0,-60.0,-68.0,-70.0,-67.0,-60.0,-78.0,-86.0,-78.0,-86.0,8.0,15.0,9.0,26.0,1
5895,CC:2F:71:3F:1F:24,9613357,10180463655,6395067,9773968984,3218290,406494671,80,1476269,880389545,1467706,879361271,8563,1028274,1422782,619,6399780,656389,80,5996,115556.0,28889.0,-70.0,-64.0,-70.0,-67.0,-68.0,-64.0,-69.0,-67.0,-78.0,-86.0,-78.0,-86.0,8.0,22.0,8.0,19.0,1
5896,F8:59:71:5A:E0:3D,3399476,676209976,181183,269715043,3218293,406494933,0,179415,227793528,174581,227215938,4834,577590,156928,16,183898,3105,0,548,144444.0,43333.0,-67.0,-71.0,-65.0,-70.0,-66.0,-72.0,-65.0,-70.0,-78.0,-86.0,-78.0,-86.0,11.0,15.0,13.0,16.0,1
5897,CC:2F:71:3E:C5:1F,3229729,407893835,11434,1398700,3218295,406495135,6,48779,4085420,40306,3081452,8473,1003968,12056,34,16398,186,6,829,144444.0,39000.0,-70.0,-71.0,-69.0,-60.0,-68.0,-70.0,-67.0,-60.0,-78.0,-86.0,-78.0,-86.0,8.0,15.0,9.0,26.0,1
5898,CC:2F:71:3F:1F:24,9614679,10182496127,6396384,9776000992,3218295,406495135,80,1476569,880517190,1468006,879488916,8563,1028274,1423080,619,6401104,656431,80,5996,115556.0,28889.0,-69.0,-64.0,-70.0,-68.0,-68.0,-63.0,-69.0,-67.0,-78.0,-86.0,-78.0,-86.0,9.0,22.0,8.0,18.0,1
5899,F8:59:71:5A:E0:3D,3399545,676308484,181246,269812945,3218299,406495539,0,179478,227890548,174644,227312958,4834,577590,156991,16,183961,3105,0,548,144444.0,43333.0,-67.0,-73.0,-66.0,-70.0,-66.0,-72.0,-65.0,-70.0,-78.0,-86.0,-78.0,-86.0,11.0,13.0,12.0,16.0,1
5900,CC:2F:71:3E:C5:1F,3229733,407894239,11434,1398700,3218299,406495539,6,48779,4085420,40306,3081452,8473,1003968,12056,34,16398,186,6,829,144444.0,39000.0,-70.0,-71.0,-69.0,-60.0,-68.0,-70.0,-67.0,-60.0,-78.0,-86.0,-78.0,-86.0,8.0,15.0,9.0,26.0,1
5901,CC:2F:71:3F:1F:24,9616165,10184793279,6397866,9778297740,3218299,406495539,80,1476831,880638760,1468268,879610486,8563,1028274,1423340,619,6402557,656602,80,5998,117000.0,39000.0,-68.0,-64.0,-69.0,-67.0,-68.0,-63.0,-69.0,-67.0,-78.0,-86.0,-78.0,-86.0,10.0,22.0,9.0,19.0,1
5902,F8:59:71:5A:E0:3D,3399612,676409696,181311,269913955,3218301,406495741,0,179542,227989108,174708,227411518,4834,577590,157055,16,184026,3105,0,548,144444.0,43333.0,-66.0,-72.0,-66.0,-70.0,-66.0,-72.0,-65.0,-70.0,-78.0,-86.0,-78.0,-86.0,12.0,14.0,12.0,16.0,1
5903,CC:2F:71:3E:C5:1F,3229735,407894441,11434,1398700,3218301,406495741,6,48779,4085420,40306,3081452,8473,1003968,12056,34,16398,186,6,829,144444.0,39000.0,-70.0,-71.0,-69.0,-60.0,-68.0,-70.0,-67.0,-60.0,-78.0,-86.0,-78.0,-86.0,8.0,15.0,9.0,26.0,1
5904,CC:2F:71:3F:1F:24,9617835,10187383849,6399534,9780888108,3218301,406495741,80,1477141,880768412,1468578,879740138,8563,1028274,1423650,619,6404240,656654,80,5998,115556.0,28889.0,-69.0,-64.0,-70.0,-67.0,-68.0,-63.0,-70.0,-67.0,-78.0,-86.0,-78.0,-86.0,9.0,22.0,8.0,19.0,1
5905,F8:59:71:5A:E0:3D,3399684,676511372,181376,270014965,3218308,406496407,0,179608,228090748,174774,227513158,4834,577590,157121,16,184091,3107,0,548,144444.0,43333.0,-66.0,-72.0,-66.0,-70.0,-66.0,-72.0,-66.0,-69.0,-78.0,-86.0,-78.0,-86.0,12.0,14.0,12.0,16.0,1
5906,CC:2F:71:3E:C5:1F,3229742,407895107,11434,1398700,3218308,406496407,6,48779,4085420,40306,3081452,8473,1003968,12056,34,16398,186,6,829,144444.0,39000.0,-70.0,-71.0,-69.0,-60.0,-68.0,-70.0,-67.0,-60.0,-78.0,-86.0,-78.0,-86.0,8.0,15.0,9.0,26.0,1
5907,CC:2F:71:3F:1F:24,9619899,10190588541,6401591,9784092134,3218308,406496407,80,1477484,880904788,1468921,879876514,8563,1028274,1423993,619,6406311,656848,80,5998,104000.0,26000.0,-69.0,-64.0,-70.0,-68.0,-69.0,-64.0,-70.0,-67.0,-78.0,-86.0,-78.0,-86.0,9.0,22.0,8.0,18.0,1
5908,F8:59:71:5A:E0:3D,3399751,676612584,181441,270115975,3218310,406496609,0,179673,228190848,174839,227613258,4834,577590,157186,16,184156,3107,0,548,144444.0,43333.0,-67.0,-73.0,-66.0,-70.0,-66.0,-72.0,-65.0,-70.0,-78.0,-86.0,-78.0,-86.0,11.0,13.0,12.0,16.0,1
5909,CC:2F:71:3E:C5:1F,3229744,407895309,11434,1398700,3218310,406496609,6,48779,4085420,40306,3081452,8473,1003968,12056,34,16398,186,6,829,144444.0,39000.0,-70.0,-71.0,-69.0,-60.0,-68.0,-70.0,-67.0,-60.0,-78.0,-86.0,-78.0,-86.0,8.0,15.0,9.0,26.0,1
5910,CC:2F:71:3F:1F:24,9621112,10192452009,6402802,9785955400,3218310,406496609,80,1477776,881028749,1469213,880000475,8563,1028274,1424285,619,6407522,656858,80,5998,115556.0,28889.0,-70.0,-64.0,-72.0,-67.0,-69.0,-64.0,-70.0,-67.0,-78.0,-86.0,-78.0,-86.0,8.0,22.0,6.0,19.0,1
5911,F8:59:71:5A:E0:3D,3399834,676729862,181516,270232525,3218318,406497337,0,179747,228304808,174913,227727218,4834,577590,157260,16,184230,3114,0,548,144444.0,43333.0,-67.0,-73.0,-66.0,-70.0,-66.0,-73.0,-66.0,-70.0,-78.0,-86.0,-78.0,-86.0,11.0,13.0,12.0,16.0,1
5912,CC:2F:71:3E:C5:1F,3229763,407901461,11434,1398700,3218329,406502761,6,48781,4085608,40307,3081522,8474,1004086,12057,34,16398,186,6,830,144444.0,39000.0,-68.0,-71.0,-67.0,-60.0,-68.0,-71.0,-68.0,-61.0,-78.0,-86.0,-78.0,-86.0,10.0,15.0,11.0,26.0,1
5913,CC:2F:71:3F:1F:24,9621862,10193567943,6403533,9787065182,3218329,406502761,80,1477997,881178283,1469434,880150009,8563,1028274,1424506,619,6408227,657074,80,5999,86667.0,13000.0,-67.0,-63.0,-69.0,-68.0,-67.0,-63.0,-69.0,-68.0,-78.0,-86.0,-78.0,-86.0,11.0,23.0,9.0,18.0,1
5914,F8:59:71:5A:E0:3D,3399932,676854416,181589,270345967,3218343,406508449,0,179822,228418886,174987,227841178,4835,577708,157335,16,184304,3115,0,549,144444.0,43333.0,-67.0,-72.0,-66.0,-70.0,-67.0,-71.0,-65.0,-70.0,-78.0,-86.0,-78.0,-86.0,11.0,14.0,12.0,16.0,1
5915,CC:2F:71:3E:C5:1F,3229777,407907149,11434,1398700,3218343,406508449,6,48781,4085608,40307,3081522,8474,1004086,12057,34,16398,186,6,830,144444.0,39000.0,-68.0,-71.0,-67.0,-60.0,-68.0,-71.0,-68.0,-61.0,-78.0,-86.0,-78.0,-86.0,10.0,15.0,11.0,26.0,1
5916,CC:2F:71:3F:1F:24,9622816,10195016287,6404473,9788507838,3218343,406508449,80,1478226,881294263,1469663,880265989,8563,1028274,1424735,619,6409189,657092,80,5999,86667.0,14444.0,-68.0,-64.0,-70.0,-68.0,-68.0,-64.0,-69.0,-67.0,-78.0,-86.0,-78.0,-86.0,10.0,22.0,8.0,18.0,1
5917,F8:59:71:5A:E0:3D,3400001,676952924,181652,270443869,3218349,406509055,0,179885,228515906,175050,227938198,4835,577708,157398,16,184367,3115,0,549,144444.0,43333.0,-67.0,-72.0,-67.0,-70.0,-67.0,-72.0,-66.0,-70.0,-78.0,-86.0,-78.0,-86.0,11.0,14.0,11.0,16.0,1
5918,CC:2F:71:3E:C5:1F,3229783,407907755,11434,1398700,3218349,406509055,6,48781,4085608,40307,3081522,8474,1004086,12057,34,16398,186,6,830,144444.0,39000.0,-68.0,-71.0,-67.0,-60.0,-68.0,-71.0,-68.0,-61.0,-78.0,-86.0,-78.0,-86.0,10.0,15.0,11.0,26.0,1
5919,CC:2F:71:3F:1F:24,9624004,10196839776,6405654,9790330448,3218350,406509328,80,1478489,881421589,1469926,880393315,8563,1028274,1424998,619,6410374,657184,80,6000,130000.0,43333.0,-68.0,-63.0,-69.0,-69.0,-68.0,-63.0,-68.0,-69.0,-78.0,-86.0,-78.0,-86.0,10.0,23.0,9.0,17.0,1
5920,F8:59:71:5A:E0:3D,3400076,677063793,181723,270554203,3218353,406509590,0,179956,228625246,175121,228047538,4835,577708,157469,16,184438,3117,0,549,144444.0,43333.0,-67.0,-72.0,-66.0,-70.0,-67.0,-72.0,-66.0,-70.0,-78.0,-86.0,-78.0,-86.0,11.0,14.0,12.0,16.0,1
5921,CC:2F:71:3E:C5:1F,3229787,407908290,11434,1398700,3218353,406509590,6,48781,4085608,40307,3081522,8474,1004086,12057,34,16398,186,6,830,144444.0,39000.0,-68.0,-71.0,-67.0,-60.0,-68.0,-71.0,-68.0,-61.0,-78.0,-86.0,-78.0,-86.0,10.0,15.0,11.0,26.0,1
5922,CC:2F:71:3F:1F:24,9625364,10198933004,6407011,9792423414,3218353,406509590,80,1478715,881546584,1470152,880518310,8563,1028274,1425224,619,6411731,657382,80,6000,130000.0,39000.0,-68.0,-63.0,-69.0,-68.0,-67.0,-63.0,-69.0,-68.0,-78.0,-86.0,-78.0,-86.0,10.0,23.0,9.0,18.0,1
5923,F8:59:71:5A:E0:3D,3400144,677163653,181787,270653659,3218357,406509994,0,180019,228722266,175184,228144558,4835,577708,157532,16,184502,3119,0,549,144444.0,43333.0,-67.0,-73.0,-67.0,-70.0,-66.0,-72.0,-66.0,-70.0,-78.0,-86.0,-78.0,-86.0,11.0,13.0,11.0,16.0,1
5924,CC:2F:71:3E:C5:1F,3229793,407908896,11434,1398700,3218359,406510196,6,48781,4085608,40307,3081522,8474,1004086,12057,34,16398,186,6,830,144444.0,39000.0,-68.0,-71.0,-67.0,-60.0,-68.0,-71.0,-68.0,-61.0,-78.0,-86.0,-78.0,-86.0,10.0,15.0,11.0,26.0,1
5925,CC:2F:71:3F:1F:24,9626901,10201309096,6408542,9794798900,3218359,406510196,80,1478970,881665716,1470407,880637442,8563,1028274,1425479,619,6413244,657472,80,6000,115556.0,28889.0,-68.0,-64.0,-69.0,-69.0,-67.0,-63.0,-69.0,-69.0,-78.0,-86.0,-78.0,-86.0,10.0,22.0,9.0,17.0,1
5926,F8:59:71:5A:E0:3D,3400210,677260405,181849,270750007,3218361,406510398,0,180082,228819286,175247,228241578,4835,577708,157595,16,184564,3119,0,549,144444.0,43333.0,-67.0,-72.0,-67.0,-70.0,-67.0,-72.0,-66.0,-70.0,-78.0,-86.0,-78.0,-86.0,11.0,14.0,11.0,16.0,1
5927,CC:2F:71:3E:C5:1F,3229795,407909098,11434,1398700,3218361,406510398,6,48781,4085608,40307,3081522,8474,1004086,12057,34,16398,186,6,830,144444.0,39000.0,-68.0,-71.0,-67.0,-60.0,-68.0,-71.0,-68.0,-61.0,-78.0,-86.0,-78.0,-86.0,10.0,15.0,11.0,26.0,1
5928,CC:2F:71:3F:1F:24,9628149,10203233966,6409788,9796723568,3218361,406510398,80,1479202,881783618,1470639,880755344,8563,1028274,1425711,619,6414508,657667,80,6000,115556.0,28889.0,-68.0,-63.0,-69.0,-69.0,-68.0,-63.0,-69.0,-69.0,-78.0,-86.0,-78.0,-86.0,10.0,23.0,9.0,17.0,1
5929,F8:59:71:5A:E0:3D,3400279,677360325,181913,270849463,3218366,406510862,0,180145,228916306,175310,228338598,4835,577708,157658,16,184628,3119,0,549,144444.0,43333.0,-67.0,-73.0,-67.0,-70.0,-67.0,-73.0,-66.0,-69.0,-78.0,-86.0,-78.0,-86.0,11.0,13.0,11.0,16.0,1
5930,CC:2F:71:3E:C5:1F,3229800,407909562,11434,1398700,3218366,406510862,6,48781,4085608,40307,3081522,8474,1004086,12057,34,16398,186,6,830,144444.0,39000.0,-68.0,-71.0,-67.0,-60.0,-68.0,-71.0,-68.0,-61.0,-78.0,-86.0,-78.0,-86.0,10.0,15.0,11.0,26.0,1
5931,CC:2F:71:3F:1F:24,9629718,10205662078,6411352,9799151216,3218366,406510862,80,1479491,881907998,1470928,880879724,8563,1028274,1426000,619,6416065,657719,80,6000,115556.0,28889.0,-68.0,-63.0,-69.0,-69.0,-67.0,-63.0,-69.0,-69.0,-78.0,-86.0,-78.0,-86.0,10.0,23.0,9.0,17.0,1
5932,F8:59:71:5A:E0:3D,3400345,677458491,181976,270947365,3218369,406511126,0,180209,229014866,175374,228437158,4835,577708,157722,16,184691,3120,0,549,144444.0,43333.0,-67.0,-72.0,-66.0,-70.0,-66.0,-72.0,-66.0,-69.0,-78.0,-86.0,-78.0,-86.0,11.0,14.0,12.0,16.0,1
5933,CC:2F:71:3E:C5:1F,3229803,407909826,11434,1398700,3218369,406511126,6,48781,4085608,40307,3081522,8474,1004086,12057,34,16398,186,6,830,144444.0,39000.0,-68.0,-71.0,-67.0,-60.0,-68.0,-71.0,-68.0,-61.0,-78.0,-86.0,-78.0,-86.0,10.0,15.0,11.0,26.0,1
5934,CC:2F:71:3F:1F:24,9631097,10207781554,6412726,9801270226,3218371,406511328,80,1479796,882039239,1471232,881010847,8564,1028392,1426305,619,6417446,657733,80,6000,115556.0,28889.0,-68.0,-63.0,-69.0,-69.0,-68.0,-63.0,-69.0,-69.0,-78.0,-86.0,-78.0,-86.0,10.0,23.0,9.0,17.0,1
5935,F8:59:71:5A:E0:3D,3400420,677566323,182045,271054591,3218375,406511732,0,180279,229122722,175444,228545014,4835,577708,157791,16,184760,3122,0,549,144444.0,43333.0,-67.0,-73.0,-66.0,-70.0,-67.0,-73.0,-66.0,-69.0,-78.0,-86.0,-78.0,-86.0,11.0,13.0,12.0,16.0,1
5936,CC:2F:71:3E:C5:1F,3229810,407910492,11434,1398700,3218376,406511792,6,48781,4085608,40307,3081522,8474,1004086,12057,34,16398,186,6,830,144444.0,39000.0,-68.0,-71.0,-67.0,-60.0,-68.0,-71.0,-68.0,-61.0,-78.0,-86.0,-78.0,-86.0,10.0,15.0,11.0,26.0,1
5937,CC:2F:71:3F:1F:24,9632881,10210548816,6414505,9804037024,3218376,406511792,80,1480063,882168335,1471499,881139943,8564,1028392,1426572,619,6419199,657832,80,6000,115556.0,28889.0,-68.0,-63.0,-70.0,-69.0,-68.0,-63.0,-70.0,-69.0,-78.0,-86.0,-78.0,-86.0,10.0,23.0,8.0,17.0,1
5938,F8:59:71:5A:E0:3D,3400488,677667595,182110,271155601,3218378,406511994,0,180345,229224390,175510,228646682,4835,577708,157855,16,184825,3123,0,549,144444.0,43333.0,-67.0,-72.0,-67.0,-70.0,-66.0,-72.0,-66.0,-69.0,-78.0,-86.0,-78.0,-86.0,11.0,14.0,11.0,16.0,1
5939,CC:2F:71:3E:C5:1F,3229812,407910694,11434,1398700,3218378,406511994,6,48781,4085608,40307,3081522,8474,1004086,12057,34,16398,186,6,830,144444.0,39000.0,-68.0,-71.0,-67.0,-60.0,-68.0,-71.0,-68.0,-61.0,-78.0,-86.0,-78.0,-86.0,10.0,15.0,11.0,26.0,1
5940,CC:2F:71:3F:1F:24,9634305,10212752366,6415927,9806240372,3218378,406511994,80,1480327,882292799,1471763,881264407,8564,1028392,1426836,619,6420647,657930,80,6000,115556.0,28889.0,-68.0,-63.0,-70.0,-69.0,-68.0,-63.0,-69.0,-69.0,-78.0,-86.0,-78.0,-86.0,10.0,23.0,8.0,17.0,1
5941,F8:59:71:5A:E0:3D,3400556,677767455,182174,271255057,3218382,406512398,0,180411,229326044,175576,228748336,4835,577708,157920,16,184889,3123,0,549,144444.0,43333.0,-67.0,-73.0,-66.0,-69.0,-67.0,-73.0,-66.0,-69.0,-78.0,-86.0,-78.0,-86.0,11.0,13.0,12.0,17.0,1
5942,CC:2F:71:3E:C5:1F,3229818,407911300,11434,1398700,3218384,406512600,6,48781,4085608,40307,3081522,8474,1004086,12057,34,16398,186,6,830,144444.0,39000.0,-68.0,-71.0,-67.0,-60.0,-68.0,-71.0,-68.0,-61.0,-78.0,-86.0,-78.0,-86.0,10.0,15.0,11.0,26.0,1
5943,CC:2F:71:3F:1F:24,9635783,10215035580,6417399,9808522980,3218384,406512600,80,1480585,882412327,1472021,881383935,8564,1028392,1427094,619,6422118,657946,80,6000,130000.0,39000.0,-68.0,-63.0,-70.0,-69.0,-68.0,-63.0,-69.0,-69.0,-78.0,-86.0,-78.0,-86.0,10.0,23.0,8.0,17.0,1
5944,F8:59:71:5A:E0:3D,3400625,677867375,182238,271354513,3218387,406512862,0,180475,229424604,175640,228846896,4835,577708,157984,16,184953,3123,0,549,144444.0,43333.0,-68.0,-73.0,-66.0,-70.0,-67.0,-73.0,-66.0,-69.0,-78.0,-86.0,-78.0,-86.0,10.0,13.0,12.0,16.0,1
5945,CC:2F:71:3E:C5:1F,3229821,407911562,11434,1398700,3218387,406512862,6,48781,4085608,40307,3081522,8474,1004086,12057,34,16398,186,6,830,144444.0,39000.0,-68.0,-71.0,-67.0,-60.0,-68.0,-71.0,-68.0,-61.0,-78.0,-86.0,-78.0,-86.0,10.0,15.0,11.0,26.0,1
5946,CC:2F:71:3F:1F:24,9637165,10217171256,6418778,9810658394,3218387,406512862,80,1480834,882535185,1472270,881506793,8564,1028392,1427343,619,6423498,658163,80,6001,130000.0,43333.0,-68.0,-63.0,-69.0,-69.0,-68.0,-63.0,-69.0,-69.0,-78.0,-86.0,-78.0,-86.0,10.0,23.0,9.0,17.0,1
5947,F8:59:71:5A:E0:3D,3400694,677967351,182303,271454085,3218391,406513266,0,180539,229521730,175704,228944022,4835,577708,158048,16,185018,3123,0,549,144444.0,43333.0,-67.0,-73.0,-66.0,-70.0,-67.0,-72.0,-66.0,-69.0,-78.0,-86.0,-78.0,-86.0,11.0,13.0,12.0,16.0,1
5948,CC:2F:71:3E:C5:1F,3229825,407911966,11434,1398700,3218391,406513266,6,48781,4085608,40307,3081522,8474,1004086,12057,34,16398,186,6,830,144444.0,39000.0,-68.0,-71.0,-67.0,-60.0,-68.0,-71.0,-68.0,-61.0,-78.0,-86.0,-78.0,-86.0,10.0,15.0,11.0,26.0,1
5949,CC:2F:71:3F:1F:24,9638742,10219600322,6420349,9813086854,3218393,406513468,80,1481109,882659906,1472545,881631514,8564,1028392,1427618,619,6425062,658291,80,6001,130000.0,43333.0,-69.0,-63.0,-70.0,-69.0,-68.0,-63.0,-69.0,-69.0,-78.0,-86.0,-78.0,-86.0,9.0,23.0,8.0,17.0,1
5950,F8:59:71:5A:E0:3D,3400762,678067211,182367,271553541,3218395,406513670,0,180604,229621830,175769,229044122,4835,577708,158113,16,185082,3127,0,549,144444.0,43333.0,-67.0,-73.0,-67.0,-70.0,-66.0,-73.0,-66.0,-69.0,-78.0,-86.0,-78.0,-86.0,11.0,13.0,11.0,16.0,1
5951,CC:2F:71:3E:C5:1F,3229829,407912370,11434,1398700,3218395,406513670,6,48781,4085608,40307,3081522,8474,1004086,12057,34,16398,186,6,830,144444.0,39000.0,-68.0,-71.0,-67.0,-60.0,-68.0,-71.0,-68.0,-61.0,-78.0,-86.0,-78.0,-86.0,10.0,15.0,11.0,26.0,1
5952,CC:2F:71:3F:1F:24,9639831,10221273994,6421436,9814760324,3218395,406513670,80,1481320,882776880,1472756,881748488,8564,1028392,1427829,619,6426156,658526,80,6002,130000.0,43333.0,-68.0,-63.0,-70.0,-69.0,-67.0,-63.0,-69.0,-69.0,-78.0,-86.0,-78.0,-86.0,10.0,23.0,8.0,17.0,1
5953,F8:59:71:5A:E0:3D,3400832,678168517,182432,271654383,3218400,406514134,0,180669,229721958,175834,229144250,4835,577708,158178,16,185147,3128,0,550,144444.0,43333.0,-67.0,-72.0,-66.0,-70.0,-66.0,-72.0,-66.0,-70.0,-78.0,-86.0,-78.0,-85.0,11.0,14.0,12.0,15.0,1
5954,CC:2F:71:3E:C5:1F,3229834,407912834,11434,1398700,3218400,406514134,6,48781,4085608,40307,3081522,8474,1004086,12057,34,16398,186,6,830,144444.0,39000.0,-68.0,-71.0,-67.0,-60.0,-68.0,-71.0,-68.0,-61.0,-78.0,-86.0,-78.0,-85.0,10.0,15.0,11.0,25.0,1
5955,CC:2F:71:3F:1F:24,9640795,10222747512,6422395,9816233378,3218400,406514134,80,1481496,882894022,1472932,881865630,8564,1028392,1428005,619,6427114,658661,80,6002,130000.0,39000.0,-68.0,-63.0,-69.0,-69.0,-68.0,-63.0,-69.0,-69.0,-78.0,-86.0,-78.0,-85.0,10.0,23.0,9.0,16.0,1
5956,F8:59:71:5A:E0:3D,3400903,678273039,182499,271758501,3218404,406514538,0,180736,229825208,175901,229247500,4835,577708,158244,16,185214,3130,0,551,144444.0,43333.0,-67.0,-72.0,-67.0,-70.0,-67.0,-72.0,-66.0,-70.0,-78.0,-86.0,-78.0,-85.0,11.0,14.0,11.0,15.0,1
5957,CC:2F:71:3E:C5:1F,3229838,407913238,11434,1398700,3218404,406514538,6,48781,4085608,40307,3081522,8474,1004086,12057,34,16398,186,6,830,144444.0,39000.0,-68.0,-71.0,-67.0,-60.0,-68.0,-71.0,-68.0,-61.0,-78.0,-86.0,-78.0,-85.0,10.0,15.0,11.0,25.0,1
5958,CC:2F:71:3F:1F:24,9641898,10224440066,6423494,9817925528,3218404,406514538,80,1481716,883013446,1473152,881985054,8564,1028392,1428225,619,6428214,658911,80,6002,115556.0,28889.0,-68.0,-63.0,-70.0,-69.0,-67.0,-63.0,-69.0,-68.0,-78.0,-86.0,-78.0,-85.0,10.0,23.0,8.0,16.0,1
5959,F8:59:71:5A:E0:3D,3400970,678374251,182564,271859511,3218406,406514740,0,180801,229925308,175966,229347600,4835,577708,158309,16,185279,3130,0,551,144444.0,43333.0,-67.0,-72.0,-67.0,-70.0,-67.0,-72.0,-66.0,-70.0,-78.0,-86.0,-78.0,-85.0,11.0,14.0,11.0,15.0,1
5960,CC:2F:71:3E:C5:1F,3229842,407913642,11434,1398700,3218408,406514942,6,48781,4085608,40307,3081522,8474,1004086,12057,34,16398,186,6,830,144444.0,39000.0,-68.0,-71.0,-67.0,-60.0,-68.0,-71.0,-68.0,-61.0,-78.0,-86.0,-78.0,-85.0,10.0,15.0,11.0,25.0,1
5961,CC:2F:71:3F:1F:24,9643300,10226598943,6424891,9820083728,3218409,406515215,80,1482026,883142223,1473462,882113831,8564,1028392,1428535,619,6429611,659002,80,6002,115556.0,28889.0,-67.0,-63.0,-71.0,-69.0,-67.0,-63.0,-70.0,-69.0,-78.0,-86.0,-78.0,-85.0,11.0,23.0,7.0,16.0,1
5962,F8:59:71:5A:E0:3D,3401041,678473092,182627,271957413,3218414,406515679,0,180864,230022328,176029,229444620,4835,577708,158372,16,185342,3132,0,551,144444.0,43333.0,-67.0,-72.0,-66.0,-70.0,-67.0,-72.0,-65.0,-70.0,-78.0,-86.0,-78.0,-85.0,11.0,14.0,12.0,15.0,1
5963,CC:2F:71:3E:C5:1F,3229848,407914379,11434,1398700,3218414,406515679,6,48781,4085608,40307,3081522,8474,1004086,12057,34,16398,186,6,830,144444.0,39000.0,-68.0,-71.0,-67.0,-60.0,-68.0,-71.0,-68.0,-61.0,-78.0,-86.0,-78.0,-85.0,10.0,15.0,11.0,25.0,1
5964,CC:2F:71:3F:1F:24,9644899,10229072747,6426485,9822557068,3218414,406515679,80,1482302,883266801,1473738,882238409,8564,1028392,1428811,619,6431205,659099,80,6002,115556.0,28889.0,-68.0,-63.0,-68.0,-68.0,-68.0,-63.0,-68.0,-68.0,-78.0,-86.0,-78.0,-85.0,10.0,23.0,10.0,17.0,1
5965,F8:59:71:5A:E0:3D,3401106,678571196,182690,272055315,3218416,406515881,0,180928,230120888,176093,229543180,4835,577708,158436,16,185405,3133,0,551,144444.0,43333.0,-66.0,-72.0,-66.0,-70.0,-66.0,-71.0,-65.0,-70.0,-78.0,-86.0,-78.0,-85.0,12.0,14.0,12.0,15.0,1
5966,CC:2F:71:3E:C5:1F,3229850,407914581,11434,1398700,3218416,406515881,6,48781,4085608,40307,3081522,8474,1004086,12057,34,16398,186,6,830,144444.0,39000.0,-68.0,-71.0,-67.0,-60.0,-68.0,-71.0,-68.0,-61.0,-78.0,-86.0,-78.0,-85.0,10.0,15.0,11.0,25.0,1
5967,CC:2F:71:3F:1F:24,9645977,10230730781,6427561,9824214900,3218416,406515881,80,1482510,883381865,1473946,882353473,8564,1028392,1429019,619,6432254,659151,80,6002,115556.0,28889.0,-69.0,-64.0,-69.0,-68.0,-68.0,-63.0,-69.0,-68.0,-78.0,-86.0,-78.0,-85.0,9.0,22.0,9.0,17.0,1
5968,F8:59:71:5A:E0:3D,3401173,678669502,182753,272153217,3218420,406516285,0,180990,230216368,176155,229638660,4835,577708,158498,16,185468,3134,0,551,144444.0,43333.0,-67.0,-72.0,-66.0,-70.0,-66.0,-71.0,-66.0,-69.0,-78.0,-86.0,-78.0,-85.0,11.0,14.0,12.0,15.0,1
5969,CC:2F:71:3E:C5:1F,3229854,407914985,11434,1398700,3218420,406516285,6,48781,4085608,40307,3081522,8474,1004086,12057,34,16398,186,6,830,144444.0,39000.0,-68.0,-71.0,-67.0,-60.0,-68.0,-71.0,-68.0,-61.0,-78.0,-86.0,-78.0,-85.0,10.0,15.0,11.0,25.0,1
5970,CC:2F:71:3F:1F:24,9646919,10232166827,6428497,9825650340,3218422,406516487,80,1482744,883502839,1474180,882474447,8564,1028392,1429253,619,6433217,659164,80,6002,115556.0,28889.0,-68.0,-63.0,-69.0,-68.0,-68.0,-63.0,-69.0,-68.0,-78.0,-86.0,-78.0,-85.0,10.0,23.0,9.0,17.0,1
5971,F8:59:71:5A:E0:3D,3401241,678770774,182818,272254227,3218423,406516547,0,181055,230316468,176220,229738760,4835,577708,158563,16,185533,3134,0,551,144444.0,43333.0,-67.0,-72.0,-65.0,-70.0,-66.0,-72.0,-65.0,-69.0,-78.0,-86.0,-78.0,-85.0,11.0,14.0,13.0,15.0,1
5972,CC:2F:71:3E:C5:1F,3229859,407915449,11434,1398700,3218425,406516749,6,48781,4085608,40307,3081522,8474,1004086,12057,34,16398,186,6,830,144444.0,39000.0,-68.0,-71.0,-67.0,-60.0,-68.0,-71.0,-68.0,-61.0,-78.0,-86.0,-78.0,-85.0,10.0,15.0,11.0,25.0,1
5973,CC:2F:71:3F:1F:24,9648072,10233930697,6429647,9827413948,3218425,406516749,80,1482997,883622136,1474433,882593744,8564,1028392,1429506,619,6434367,659233,80,6003,130000.0,39000.0,-68.0,-63.0,-69.0,-68.0,-68.0,-63.0,-69.0,-68.0,-78.0,-86.0,-78.0,-85.0,10.0,23.0,9.0,17.0,1
5974,F8:59:71:5A:E0:3D,3401312,678870952,182883,272353799,3218429,406517153,0,181120,230416568,176285,229838860,4835,577708,158628,16,185598,3134,0,551,144444.0,43333.0,-67.0,-72.0,-65.0,-71.0,-66.0,-71.0,-65.0,-70.0,-78.0,-86.0,-78.0,-85.0,11.0,14.0,13.0,14.0,1
5975,CC:2F:71:3E:C5:1F,3229864,407915969,11435,1398816,3218429,406517153,6,48782,4085678,40308,3081592,8474,1004086,12057,34,16399,186,6,830,144444.0,39000.0,-68.0,-71.0,-68.0,-60.0,-68.0,-71.0,-68.0,-61.0,-78.0,-86.0,-78.0,-85.0,10.0,15.0,10.0,25.0,1
5976,CC:2F:71:3F:1F:24,9648862,10235127795,6430433,9828610642,3218429,406517153,80,1483195,883740382,1474631,882711990,8564,1028392,1429704,619,6435153,659494,80,6003,130000.0,43333.0,-69.0,-63.0,-70.0,-69.0,-69.0,-63.0,-70.0,-69.0,-78.0,-86.0,-78.0,-85.0,9.0,23.0,8.0,16.0,1
5977,F8:59:71:5A:E0:3D,3401379,678970672,182947,272453255,3218432,406517417,0,181183,230513588,176348,229935880,4835,577708,158691,16,185662,3135,0,551,144444.0,43333.0,-66.0,-72.0,-67.0,-70.0,-66.0,-72.0,-65.0,-70.0,-78.0,-86.0,-78.0,-85.0,12.0,14.0,11.0,15.0,1
5978,CC:2F:71:3E:C5:1F,3229867,407916233,11435,1398816,3218432,406517417,6,48783,4085748,40309,3081662,8474,1004086,12057,34,16399,186,6,830,144444.0,39000.0,-69.0,-71.0,-68.0,-60.0,-69.0,-71.0,-68.0,-61.0,-78.0,-86.0,-78.0,-85.0,9.0,15.0,10.0,25.0,1
5979,CC:2F:71:3F:1F:24,9649791,10236544471,6431356,9830026792,3218435,406517679,80,1483423,883859200,1474858,882830690,8565,1028510,1429932,619,6436076,659742,80,6004,130000.0,43333.0,-68.0,-63.0,-69.0,-69.0,-68.0,-63.0,-69.0,-69.0,-78.0,-86.0,-78.0,-85.0,10.0,23.0,9.0,16.0,1
5980,F8:59:71:5A:E0:3D,3401450,679070794,183011,272552711,3218439,406518083,0,181246,230610608,176411,230032900,4835,577708,158754,16,185726,3135,0,551,144444.0,43333.0,-67.0,-73.0,-66.0,-70.0,-67.0,-72.0,-66.0,-70.0,-78.0,-86.0,-78.0,-85.0,11.0,13.0,12.0,15.0,1
5981,CC:2F:71:3E:C5:1F,3229874,407916899,11435,1398816,3218439,406518083,6,48783,4085748,40309,3081662,8474,1004086,12057,34,16399,186,6,830,144444.0,39000.0,-69.0,-71.0,-68.0,-60.0,-69.0,-71.0,-68.0,-61.0,-78.0,-86.0,-78.0,-85.0,9.0,15.0,10.0,25.0,1
5982,CC:2F:71:3F:1F:24,9650909,10238261023,6432470,9831742940,3218439,406518083,80,1483651,883979430,1475086,882950920,8565,1028510,1430160,619,6437188,660082,80,6004,115556.0,28889.0,-69.0,-64.0,-69.0,-69.0,-68.0,-64.0,-69.0,-69.0,-78.0,-86.0,-78.0,-85.0,9.0,22.0,9.0,16.0,1
5983,F8:59:71:5A:E0:3D,3401521,679176730,183079,272658383,3218442,406518347,0,181315,230716868,176480,230139160,4835,577708,158823,16,185794,3135,0,551,144444.0,43333.0,-67.0,-72.0,-66.0,-70.0,-66.0,-72.0,-66.0,-70.0,-78.0,-86.0,-78.0,-85.0,11.0,14.0,12.0,15.0,1
5984,CC:2F:71:3E:C5:1F,3229877,407917163,11435,1398816,3218442,406518347,6,48785,4085936,40310,3081732,8475,1004204,12058,34,16399,186,6,830,144444.0,39000.0,-65.0,-61.0,-66.0,-59.0,-68.0,-70.0,-68.0,-61.0,-78.0,-86.0,-78.0,-85.0,13.0,25.0,12.0,26.0,1
5985,CC:2F:71:3F:1F:24,9652632,10240927709,6434190,9834409362,3218442,406518347,80,1483971,884112384,1475406,883083874,8565,1028510,1430478,619,6438910,660150,80,6004,115556.0,28889.0,-68.0,-63.0,-69.0,-69.0,-68.0,-63.0,-68.0,-68.0,-78.0,-86.0,-78.0,-85.0,10.0,23.0,9.0,16.0,1
5986,F8:59:71:5A:E0:3D,3401588,679273542,183141,272754731,3218447,406518811,0,181378,230813888,176543,230236180,4835,577708,158886,16,185856,3135,0,551,144444.0,43333.0,-67.0,-71.0,-66.0,-70.0,-67.0,-72.0,-66.0,-70.0,-77.0,-85.0,-77.0,-85.0,10.0,14.0,11.0,15.0,1
5987,CC:2F:71:3E:C5:1F,3229884,407917829,11435,1398816,3218449,406519013,6,48785,4085936,40310,3081732,8475,1004204,12058,34,16399,186,6,830,144444.0,39000.0,-65.0,-61.0,-66.0,-59.0,-68.0,-70.0,-68.0,-61.0,-77.0,-85.0,-77.0,-85.0,12.0,24.0,11.0,26.0,1
5988,CC:2F:71:3F:1F:24,9654392,10243652633,6435943,9837133620,3218449,406519013,80,1484272,884238568,1475707,883210058,8565,1028510,1430779,619,6440643,660204,80,6006,130000.0,43333.0,-69.0,-63.0,-69.0,-68.0,-68.0,-63.0,-68.0,-68.0,-77.0,-85.0,-77.0,-85.0,8.0,22.0,8.0,17.0,1
5989,F8:59:71:5A:E0:3D,3401657,679374956,183206,272855741,3218451,406519215,0,181442,230912448,176607,230334740,4835,577708,158950,16,185921,3135,0,551,144444.0,43333.0,-67.0,-73.0,-66.0,-70.0,-67.0,-72.0,-66.0,-70.0,-77.0,-85.0,-77.0,-85.0,10.0,12.0,11.0,15.0,1
5990,CC:2F:71:3E:C5:1F,3229886,407918031,11435,1398816,3218451,406519215,6,48785,4085936,40310,3081732,8475,1004204,12058,34,16399,186,6,830,144444.0,39000.0,-65.0,-61.0,-66.0,-59.0,-68.0,-70.0,-68.0,-61.0,-77.0,-85.0,-77.0,-85.0,12.0,24.0,11.0,26.0,1
5991,CC:2F:71:3F:1F:24,9655531,10245406317,6437080,9838887102,3218451,406519215,80,1484474,884354250,1475909,883325740,8565,1028510,1430979,619,6441800,660507,80,6006,117000.0,39000.0,-69.0,-63.0,-69.0,-70.0,-69.0,-63.0,-69.0,-69.0,-77.0,-85.0,-77.0,-85.0,8.0,22.0,8.0,15.0,1
5992,F8:59:71:5A:E0:3D,3401724,679473262,183269,272953643,3218455,406519619,0,181506,231011008,176671,230433300,4835,577708,159014,16,185984,3136,0,551,144444.0,43333.0,-67.0,-73.0,-66.0,-70.0,-67.0,-72.0,-65.0,-69.0,-77.0,-85.0,-77.0,-85.0,10.0,12.0,11.0,15.0,1
5993,CC:2F:71:3E:C5:1F,3229890,407918435,11435,1398816,3218455,406519619,6,48785,4085936,40310,3081732,8475,1004204,12058,34,16399,186,6,830,144444.0,39000.0,-65.0,-61.0,-66.0,-59.0,-68.0,-70.0,-68.0,-61.0,-77.0,-85.0,-77.0,-85.0,12.0,24.0,11.0,26.0,1
5994,CC:2F:71:3F:1F:24,9656513,10246908205,6438058,9840388586,3218455,406519619,80,1484705,884472114,1476140,883443604,8565,1028510,1431210,619,6442778,660586,80,6006,130000.0,43333.0,-69.0,-63.0,-70.0,-69.0,-69.0,-63.0,-70.0,-69.0,-77.0,-85.0,-77.0,-85.0,8.0,22.0,7.0,16.0,1
5995,F8:59:71:5A:E0:3D,3401793,679573182,183333,273053099,3218460,406520083,0,181569,231108028,176734,230530320,4835,577708,159077,16,186048,3136,0,551,144444.0,43333.0,-67.0,-73.0,-66.0,-70.0,-67.0,-72.0,-66.0,-70.0,-77.0,-85.0,-77.0,-85.0,10.0,12.0,11.0,15.0,1
5996,CC:2F:71:3E:C5:1F,3229895,407918899,11435,1398816,3218460,406520083,6,48785,4085936,40310,3081732,8475,1004204,12058,34,16399,186,6,830,144444.0,39000.0,-65.0,-61.0,-66.0,-59.0,-68.0,-70.0,-68.0,-61.0,-77.0,-85.0,-77.0,-85.0,12.0,24.0,11.0,26.0,1
5997,CC:2F:71:3F:1F:24,9657398,10248255349,6438938,9841735266,3218460,406520083,80,1484915,884588842,1476350,883560332,8565,1028510,1431420,619,6443658,660664,80,6006,130000.0,43333.0,-69.0,-63.0,-70.0,-69.0,-68.0,-63.0,-69.0,-69.0,-77.0,-85.0,-77.0,-85.0,8.0,22.0,7.0,16.0,1
5998,F8:59:71:5A:E0:3D,3401859,679669934,183395,273149447,3218464,406520487,0,181633,231206602,176798,230628894,4835,577708,159140,16,186110,3136,0,551,144444.0,43333.0,-67.0,-73.0,-66.0,-70.0,-67.0,-72.0,-66.0,-70.0,-77.0,-85.0,-77.0,-85.0,10.0,12.0,11.0,15.0,1
5999,CC:2F:71:3E:C5:1F,3229899,407919303,11435,1398816,3218464,406520487,6,48785,4085936,40310,3081732,8475,1004204,12058,34,16399,186,6,830,144444.0,39000.0,-65.0,-61.0,-66.0,-59.0,-68.0,-70.0,-68.0,-61.0,-77.0,-85.0,-77.0,-85.0,12.0,24.0,11.0,26.0,1
6000,CC:2F:71:3F:1F:24,9658355,10249711719,6439891,9843191232,3218464,406520487,80,1485141,884705069,1476576,883676559,8565,1028510,1431646,619,6444597,660744,80,6006,130000.0,43333.0,-69.0,-63.0,-70.0,-70.0,-69.0,-63.0,-70.0,-69.0,-77.0,-85.0,-77.0,-85.0,8.0,22.0,7.0,15.0,1
6001,F8:59:71:5A:E0:3D,3401928,679768450,183458,273247349,3218470,406521101,0,181696,231303622,176861,230725914,4835,577708,159203,16,186173,3140,0,551,144444.0,43333.0,-67.0,-73.0,-66.0,-70.0,-66.0,-72.0,-66.0,-69.0,-77.0,-85.0,-77.0,-85.0,10.0,12.0,11.0,15.0,1
6002,CC:2F:71:3E:C5:1F,3229905,407919917,11435,1398816,3218470,406521101,6,48785,4085936,40310,3081732,8475,1004204,12058,34,16399,186,6,830,144444.0,39000.0,-65.0,-61.0,-66.0,-59.0,-68.0,-70.0,-68.0,-61.0,-77.0,-85.0,-77.0,-85.0,12.0,24.0,11.0,26.0,1
6003,CC:2F:71:3F:1F:24,9659248,10251071923,6440778,9844550822,3218470,406521101,80,1485362,884821627,1476795,883792795,8567,1028832,1431867,619,6445498,660802,80,6006,130000.0,43333.0,-69.0,-63.0,-71.0,-69.0,-68.0,-63.0,-70.0,-69.0,-77.0,-85.0,-77.0,-85.0,8.0,22.0,6.0,16.0,1
6004,F8:59:71:5A:E0:3D,3401996,679866949,183521,273345251,3218475,406521698,0,181758,231397680,176922,230819854,4836,577826,159265,16,186236,3140,0,551,144444.0,43333.0,-67.0,-73.0,-66.0,-70.0,-67.0,-73.0,-66.0,-70.0,-77.0,-85.0,-77.0,-85.0,10.0,12.0,11.0,15.0,1
6005,CC:2F:71:3E:C5:1F,3229912,407920716,11435,1398816,3218477,406521900,6,48785,4085936,40310,3081732,8475,1004204,12058,34,16399,186,6,830,144444.0,39000.0,-65.0,-61.0,-66.0,-59.0,-68.0,-70.0,-68.0,-61.0,-77.0,-85.0,-77.0,-85.0,12.0,24.0,11.0,26.0,1
6006,CC:2F:71:3F:1F:24,9660701,10253312718,6442224,9846790818,3218477,406521900,80,1485669,884949683,1477102,883920851,8567,1028832,1432174,619,6446914,660882,80,6006,130000.0,43333.0,-69.0,-63.0,-71.0,-69.0,-69.0,-63.0,-70.0,-69.0,-77.0,-85.0,-77.0,-85.0,8.0,22.0,6.0,16.0,1
6007,F8:59:71:5A:E0:3D,3402064,679966809,183585,273444707,3218479,406522102,0,181824,231499320,176988,230921494,4836,577826,159331,16,186300,3140,0,551,144444.0,43333.0,-67.0,-73.0,-66.0,-70.0,-67.0,-72.0,-65.0,-70.0,-77.0,-85.0,-77.0,-85.0,10.0,12.0,11.0,15.0,1
6008,CC:2F:71:3E:C5:1F,3229915,407921052,11435,1398816,3218480,406522236,6,48785,4085936,40310,3081732,8475,1004204,12058,34,16399,186,6,830,144444.0,39000.0,-65.0,-61.0,-66.0,-59.0,-68.0,-70.0,-68.0,-61.0,-77.0,-85.0,-77.0,-85.0,12.0,24.0,11.0,26.0,1
6009,CC:2F:71:3F:1F:24,9661966,10255262970,6443486,9848740734,3218480,406522236,80,1485940,885072039,1477373,884043207,8567,1028832,1432445,619,6448198,660962,80,6006,130000.0,43333.0,-70.0,-63.0,-72.0,-69.0,-69.0,-63.0,-70.0,-69.0,-77.0,-85.0,-77.0,-85.0,7.0,22.0,5.0,16.0,1
6010,F8:59:71:5A:E0:3D,3402130,680065029,183649,273542725,3218481,406522304,0,181888,231596446,177052,231018620,4836,577826,159395,16,186364,3141,0,551,144444.0,43333.0,-67.0,-73.0,-66.0,-70.0,-66.0,-72.0,-66.0,-70.0,-77.0,-85.0,-77.0,-85.0,10.0,12.0,11.0,15.0,1
6011,CC:2F:71:3E:C5:1F,3229916,407921120,11435,1398816,3218481,406522304,6,48785,4085936,40310,3081732,8475,1004204,12058,34,16399,186,6,830,144444.0,39000.0,-65.0,-61.0,-66.0,-59.0,-68.0,-70.0,-68.0,-61.0,-77.0,-85.0,-77.0,-85.0,12.0,24.0,11.0,26.0,1
6012,CC:2F:71:3F:1F:24,9662934,10256736856,6444451,9850214350,3218483,406522506,80,1486184,885191967,1477617,884163135,8567,1028832,1432689,619,6449171,660976,80,6007,130000.0,43333.0,-71.0,-63.0,-72.0,-69.0,-69.0,-63.0,-70.0,-69.0,-77.0,-85.0,-77.0,-85.0,6.0,22.0,5.0,16.0,1
6013,F8:59:71:5A:E0:3D,3402204,680169813,183716,273646843,3218488,406522970,0,181956,231701166,177120,231123340,4836,577826,159463,16,186431,3142,0,551,144444.0,43333.0,-67.0,-73.0,-66.0,-70.0,-67.0,-72.0,-66.0,-69.0,-77.0,-85.0,-77.0,-85.0,10.0,12.0,11.0,15.0,1
6014,CC:2F:71:3E:C5:1F,3229923,407921786,11435,1398816,3218488,406522970,6,48785,4085936,40310,3081732,8475,1004204,12058,34,16399,186,6,830,144444.0,39000.0,-65.0,-61.0,-66.0,-59.0,-68.0,-70.0,-68.0,-61.0,-77.0,-85.0,-77.0,-85.0,12.0,24.0,11.0,26.0,1
6015,CC:2F:71:3F:1F:24,9663884,10258186394,6445396,9851663424,3218488,406522970,80,1486393,885314263,1477826,884285431,8567,1028832,1432898,619,6450089,661087,80,6008,130000.0,43333.0,-70.0,-63.0,-71.0,-69.0,-69.0,-63.0,-70.0,-69.0,-77.0,-85.0,-77.0,-85.0,7.0,22.0,6.0,16.0,1
6016,F8:59:71:5A:E0:3D,3402270,680269471,183780,273746299,3218490,406523172,0,182018,231796646,177182,231218820,4836,577826,159525,16,186495,3144,0,551,144444.0,43333.0,-68.0,-73.0,-65.0,-70.0,-67.0,-72.0,-65.0,-69.0,-77.0,-85.0,-77.0,-85.0,9.0,12.0,12.0,15.0,1
6017,CC:2F:71:3E:C5:1F,3229925,407921988,11435,1398816,3218490,406523172,6,48785,4085936,40310,3081732,8475,1004204,12058,34,16399,186,6,830,144444.0,39000.0,-65.0,-61.0,-66.0,-59.0,-68.0,-70.0,-68.0,-61.0,-77.0,-85.0,-77.0,-85.0,12.0,24.0,11.0,26.0,1
6018,CC:2F:71:3F:1F:24,9665396,10260527832,6446906,9854004660,3218490,406523172,80,1486675,885439197,1478108,884410365,8567,1028832,1433179,619,6451611,661139,80,6008,130000.0,43333.0,-68.0,-63.0,-69.0,-69.0,-69.0,-63.0,-69.0,-69.0,-77.0,-85.0,-77.0,-85.0,9.0,22.0,8.0,16.0,1
6019,F8:59:71:5A:E0:3D,3402342,680372807,183846,273848863,3218496,406523944,0,182085,231899826,177249,231322000,4836,577826,159592,16,186561,3145,0,551,144444.0,43333.0,-67.0,-72.0,-66.0,-70.0,-67.0,-72.0,-66.0,-70.0,-77.0,-85.0,-77.0,-85.0,10.0,13.0,11.0,15.0,1
6020,CC:2F:71:3E:C5:1F,3229933,407922962,11435,1398816,3218498,406524146,6,48785,4085936,40310,3081732,8475,1004204,12058,34,16399,186,6,830,144444.0,39000.0,-65.0,-61.0,-66.0,-59.0,-68.0,-70.0,-68.0,-61.0,-77.0,-85.0,-77.0,-85.0,12.0,24.0,11.0,26.0,1
6021,CC:2F:71:3F:1F:24,9667503,10263797702,6449004,9857273496,3218499,406524206,80,1487016,885579681,1478449,884550849,8567,1028832,1433516,619,6453724,661417,80,6008,130000.0,39000.0,-70.0,-63.0,-70.0,-69.0,-69.0,-63.0,-70.0,-68.0,-77.0,-85.0,-77.0,-85.0,7.0,22.0,7.0,16.0,1
6022,F8:59:71:5A:E0:3D,3402414,680477221,183913,273952813,3218501,406524408,0,182152,232003006,177316,231425180,4836,577826,159659,16,186628,3146,0,551,144444.0,43333.0,-67.0,-72.0,-66.0,-69.0,-66.0,-72.0,-66.0,-70.0,-77.0,-85.0,-77.0,-85.0,10.0,13.0,11.0,16.0,1
6023,CC:2F:71:3E:C5:1F,3229936,407923224,11435,1398816,3218501,406524408,6,48785,4085936,40310,3081732,8475,1004204,12058,34,16399,186,6,830,144444.0,39000.0,-65.0,-61.0,-66.0,-59.0,-68.0,-70.0,-68.0,-61.0,-77.0,-85.0,-77.0,-85.0,12.0,24.0,11.0,26.0,1
6024,CC:2F:71:3F:1F:24,9668830,10265839286,6450329,9859314878,3218501,406524408,80,1487288,885705626,1478721,884676794,8567,1028832,1433788,619,6455049,661769,80,6009,130000.0,43333.0,-69.0,-63.0,-70.0,-69.0,-69.0,-63.0,-70.0,-69.0,-77.0,-85.0,-77.0,-85.0,8.0,22.0,7.0,16.0,1
6025,F8:59:71:5A:E0:3D,3402481,680575527,183976,274050715,3218505,406524812,0,182215,232100026,177379,231522200,4836,577826,159722,16,186691,3151,0,551,144444.0,43333.0,-67.0,-72.0,-66.0,-70.0,-67.0,-72.0,-66.0,-70.0,-77.0,-85.0,-77.0,-85.0,10.0,13.0,11.0,15.0,1
6026,CC:2F:71:3E:C5:1F,3229940,407923628,11435,1398816,3218505,406524812,6,48785,4085936,40310,3081732,8475,1004204,12058,34,16399,186,6,830,144444.0,39000.0,-65.0,-61.0,-66.0,-59.0,-68.0,-70.0,-68.0,-61.0,-77.0,-85.0,-77.0,-85.0,12.0,24.0,11.0,26.0,1
6027,CC:2F:71:3F:1F:24,9669681,10267136048,6451176,9860611236,3218505,406524812,80,1487489,885821306,1478922,884792474,8567,1028832,1433989,619,6455896,661907,80,6009,130000.0,43333.0,-70.0,-63.0,-70.0,-69.0,-69.0,-63.0,-70.0,-69.0,-77.0,-85.0,-77.0,-85.0,7.0,22.0,7.0,16.0,1
6028,F8:59:71:5A:E0:3D,3402550,680675447,184040,274150171,3218510,406525276,0,182278,232197046,177442,231619220,4836,577826,159785,16,186755,3152,0,551,144444.0,43333.0,-67.0,-73.0,-66.0,-70.0,-67.0,-73.0,-66.0,-70.0,-77.0,-85.0,-77.0,-85.0,10.0,12.0,11.0,15.0,1
6029,CC:2F:71:3E:C5:1F,3229945,407924092,11435,1398816,3218510,406525276,6,48785,4085936,40310,3081732,8475,1004204,12058,34,16399,186,6,830,144444.0,39000.0,-65.0,-61.0,-66.0,-59.0,-68.0,-70.0,-68.0,-61.0,-77.0,-85.0,-77.0,-85.0,12.0,24.0,11.0,26.0,1
6030,CC:2F:71:3F:1F:24,9671004,10269174468,6452494,9862649192,3218510,406525276,80,1487746,885947610,1479179,884918778,8567,1028832,1434246,619,6457214,662157,80,6009,130000.0,43333.0,-69.0,-63.0,-71.0,-69.0,-68.0,-63.0,-70.0,-69.0,-77.0,-85.0,-77.0,-85.0,8.0,22.0,6.0,16.0,1
6031,F8:59:71:5A:E0:3D,3402621,680779969,184107,274254289,3218514,406525680,0,182346,232301780,177510,231723954,4836,577826,159852,16,186822,3154,0,551,144444.0,43333.0,-67.0,-73.0,-66.0,-70.0,-67.0,-73.0,-65.0,-70.0,-77.0,-85.0,-77.0,-85.0,10.0,12.0,11.0,15.0,1
6032,CC:2F:71:3E:C5:1F,3229949,407924496,11435,1398816,3218514,406525680,6,48785,4085936,40310,3081732,8475,1004204,12058,34,16399,186,6,830,144444.0,39000.0,-65.0,-61.0,-66.0,-59.0,-68.0,-70.0,-68.0,-61.0,-77.0,-85.0,-77.0,-85.0,12.0,24.0,11.0,26.0,1
6033,CC:2F:71:3F:1F:24,9672387,10271310838,6453873,9864785158,3218514,406525680,80,1488063,886075334,1479496,885046502,8567,1028832,1434563,619,6458577,662217,80,6009,130000.0,43333.0,-69.0,-63.0,-70.0,-69.0,-69.0,-63.0,-69.0,-68.0,-77.0,-85.0,-77.0,-85.0,8.0,22.0,7.0,16.0,1
6034,F8:59:71:5A:E0:3D,3402688,680878275,184170,274352191,3218518,406526084,0,182409,232398800,177573,231820974,4836,577826,159915,16,186885,3154,0,551,144444.0,43333.0,-67.0,-73.0,-65.0,-70.0,-67.0,-72.0,-65.0,-70.0,-77.0,-85.0,-77.0,-85.0,10.0,12.0,12.0,15.0,1
6035,CC:2F:71:3E:C5:1F,3229953,407924900,11435,1398816,3218518,406526084,6,48785,4085936,40310,3081732,8475,1004204,12058,34,16399,186,6,830,144444.0,39000.0,-65.0,-61.0,-66.0,-59.0,-68.0,-70.0,-68.0,-61.0,-77.0,-85.0,-77.0,-85.0,12.0,24.0,11.0,26.0,1
6036,CC:2F:71:3F:1F:24,9673804,10273491840,6455286,9866965756,3218518,406526084,80,1488336,886198379,1479769,885169547,8567,1028832,1434836,619,6460006,662237,80,6010,130000.0,43333.0,-70.0,-63.0,-71.0,-69.0,-69.0,-63.0,-70.0,-68.0,-77.0,-85.0,-77.0,-85.0,7.0,22.0,6.0,16.0,1
6037,F8:59:71:5A:E0:3D,3402757,680978195,184234,274451647,3218523,406526548,0,182474,232498900,177638,231921074,4836,577826,159980,16,186949,3154,0,551,144444.0,43333.0,-68.0,-73.0,-66.0,-70.0,-67.0,-72.0,-65.0,-70.0,-77.0,-85.0,-77.0,-85.0,9.0,12.0,11.0,15.0,1
6038,CC:2F:71:3E:C5:1F,3229958,407925364,11435,1398816,3218523,406526548,6,48785,4085936,40310,3081732,8475,1004204,12058,34,16399,186,6,830,144444.0,39000.0,-65.0,-61.0,-66.0,-59.0,-68.0,-70.0,-68.0,-61.0,-77.0,-85.0,-77.0,-85.0,12.0,24.0,11.0,26.0,1
6039,CC:2F:71:3F:1F:24,9675703,10276439348,6457180,9869912800,3218523,406526548,80,1488630,886326231,1480063,885297399,8567,1028832,1435130,619,6461900,662422,80,6010,130000.0,43333.0,-69.0,-63.0,-69.0,-69.0,-69.0,-63.0,-69.0,-68.0,-77.0,-85.0,-77.0,-85.0,8.0,22.0,8.0,16.0,1
6040,F8:59:71:5A:E0:3D,3402825,681078055,184298,274551103,3218527,406526952,0,182538,232597460,177702,232019634,4836,577826,160044,16,187013,3157,0,551,144444.0,43333.0,-67.0,-72.0,-66.0,-70.0,-67.0,-72.0,-65.0,-70.0,-77.0,-85.0,-77.0,-85.0,10.0,13.0,11.0,15.0,1
6041,CC:2F:71:3E:C5:1F,3229962,407925768,11435,1398816,3218527,406526952,6,48785,4085936,40310,3081732,8475,1004204,12058,34,16399,186,6,830,144444.0,39000.0,-65.0,-61.0,-66.0,-59.0,-68.0,-70.0,-68.0,-61.0,-77.0,-85.0,-77.0,-85.0,12.0,24.0,11.0,26.0,1
6042,CC:2F:71:3F:1F:24,9677384,10279044514,6458857,9872517562,3218527,406526952,80,1488932,886452333,1480365,885423501,8567,1028832,1435431,619,6463549,662505,80,6010,130000.0,43333.0,-70.0,-63.0,-70.0,-69.0,-69.0,-63.0,-70.0,-69.0,-77.0,-85.0,-77.0,-85.0,7.0,22.0,7.0,16.0,1
6043,F8:59:71:5A:E0:3D,3402891,681174807,184360,274647451,3218531,406527356,0,182601,232694494,177765,232116668,4836,577826,160106,16,187075,3158,0,551,144444.0,43333.0,-67.0,-73.0,-66.0,-70.0,-67.0,-72.0,-65.0,-70.0,-77.0,-85.0,-77.0,-85.0,10.0,12.0,11.0,15.0,1
6044,CC:2F:71:3E:C5:1F,3229966,407926172,11435,1398816,3218531,406527356,6,48785,4085936,40310,3081732,8475,1004204,12058,34,16399,186,6,830,144444.0,39000.0,-65.0,-61.0,-66.0,-59.0,-68.0,-70.0,-68.0,-61.0,-77.0,-85.0,-77.0,-85.0,12.0,24.0,11.0,26.0,1
6045,CC:2F:71:3F:1F:24,9678605,10280925248,6460074,9874397892,3218531,406527356,80,1489172,886569701,1480605,885540869,8567,1028832,1435671,619,6464794,662591,80,6010,130000.0,43333.0,-69.0,-63.0,-70.0,-69.0,-69.0,-63.0,-69.0,-69.0,-77.0,-85.0,-77.0,-85.0,8.0,22.0,7.0,16.0,1
6046,F8:59:71:5A:E0:3D,3402960,681274924,184424,274746907,3218536,406528017,0,182664,232791514,177828,232213688,4836,577826,160169,16,187138,3158,0,551,144444.0,43333.0,-68.0,-73.0,-65.0,-70.0,-67.0,-72.0,-65.0,-70.0,-77.0,-85.0,-77.0,-85.0,9.0,12.0,12.0,15.0,1
6047,CC:2F:71:3E:C5:1F,3229971,407926833,11435,1398816,3218536,406528017,6,48785,4085936,40310,3081732,8475,1004204,12058,34,16399,186,6,830,144444.0,39000.0,-65.0,-61.0,-66.0,-59.0,-68.0,-70.0,-68.0,-61.0,-77.0,-85.0,-77.0,-85.0,12.0,24.0,11.0,26.0,1
6048,CC:2F:71:3F:1F:24,9679666,10282551957,6461130,9876023940,3218536,406528017,80,1489387,886685599,1480820,885656767,8567,1028832,1435886,619,6465850,662698,80,6010,130000.0,43333.0,-69.0,-63.0,-71.0,-69.0,-69.0,-63.0,-70.0,-69.0,-77.0,-85.0,-77.0,-85.0,8.0,22.0,6.0,16.0,1
6049,F8:59:71:5A:E0:3D,3403028,681371878,184486,274843255,3218542,406528623,0,182727,232888534,177891,232310708,4836,577826,160232,16,187201,3159,0,551,144444.0,43333.0,-67.0,-73.0,-66.0,-70.0,-67.0,-72.0,-65.0,-70.0,-77.0,-85.0,-77.0,-85.0,10.0,12.0,11.0,15.0,1
6050,CC:2F:71:3E:C5:1F,3229977,407927439,11435,1398816,3218542,406528623,6,48785,4085936,40310,3081732,8475,1004204,12058,34,16399,186,6,830,144444.0,39000.0,-65.0,-61.0,-66.0,-59.0,-68.0,-70.0,-68.0,-61.0,-77.0,-85.0,-77.0,-85.0,12.0,24.0,11.0,26.0,1
6051,CC:2F:71:3F:1F:24,9680448,10283726897,6461906,9877198274,3218542,406528623,80,1489588,886801884,1481021,885773052,8567,1028832,1436087,619,6466626,662777,80,6010,130000.0,43333.0,-69.0,-63.0,-70.0,-69.0,-69.0,-63.0,-70.0,-69.0,-77.0,-85.0,-77.0,-85.0,8.0,22.0,7.0,16.0,1
6052,F8:59:71:5A:E0:3D,3403094,681471536,184550,274942711,3218544,406528825,0,182791,232987094,177955,232409268,4836,577826,160296,16,187265,3161,0,551,144444.0,43333.0,-66.0,-73.0,-66.0,-70.0,-66.0,-72.0,-65.0,-70.0,-77.0,-85.0,-77.0,-85.0,11.0,12.0,11.0,15.0,1
6053,CC:2F:71:3E:C5:1F,3229979,407927641,11435,1398816,3218544,406528825,6,48785,4085936,40310,3081732,8475,1004204,12058,34,16399,186,6,830,144444.0,39000.0,-65.0,-61.0,-66.0,-59.0,-68.0,-70.0,-68.0,-61.0,-77.0,-85.0,-77.0,-85.0,12.0,24.0,11.0,26.0,1
6054,CC:2F:71:3F:1F:24,9681879,10285940293,6463335,9879411468,3218544,406528825,80,1489862,886924500,1481295,885895668,8567,1028832,1436361,619,6468027,663023,80,6010,130000.0,43333.0,-70.0,-63.0,-70.0,-69.0,-69.0,-63.0,-70.0,-69.0,-77.0,-85.0,-77.0,-85.0,7.0,22.0,7.0,16.0,1
6055,F8:59:71:5A:E0:3D,3403161,681571254,184614,275042167,3218547,406529087,0,182854,233084114,178018,232506288,4836,577826,160359,16,187329,3162,0,551,144444.0,43333.0,-67.0,-73.0,-65.0,-70.0,-67.0,-72.0,-65.0,-70.0,-77.0,-85.0,-77.0,-85.0,10.0,12.0,12.0,15.0,1
6056,CC:2F:71:3E:C5:1F,3229984,407928105,11435,1398816,3218549,406529289,6,48785,4085936,40310,3081732,8475,1004204,12058,34,16399,186,6,830,144444.0,39000.0,-65.0,-61.0,-66.0,-59.0,-68.0,-70.0,-68.0,-61.0,-77.0,-85.0,-77.0,-85.0,12.0,24.0,11.0,26.0,1
6057,CC:2F:71:3F:1F:24,9683026,10287701265,6464477,9881171976,3218549,406529289,80,1490135,887047152,1481568,886018320,8567,1028832,1436634,619,6469190,663117,80,6011,130000.0,43333.0,-69.0,-63.0,-70.0,-69.0,-69.0,-63.0,-70.0,-69.0,-77.0,-85.0,-77.0,-85.0,8.0,22.0,7.0,16.0,1
6058,F8:59:71:5A:E0:3D,3403227,681668006,184676,275138515,3218551,406529491,0,182916,233179594,178080,232601768,4836,577826,160421,16,187391,3163,0,551,144444.0,43333.0,-67.0,-72.0,-65.0,-70.0,-67.0,-72.0,-65.0,-70.0,-77.0,-85.0,-77.0,-85.0,10.0,13.0,12.0,15.0,1
6059,CC:2F:71:3E:C5:1F,3229986,407928307,11435,1398816,3218551,406529491,6,48785,4085936,40310,3081732,8475,1004204,12058,34,16399,186,6,830,144444.0,39000.0,-65.0,-61.0,-66.0,-59.0,-68.0,-70.0,-68.0,-61.0,-77.0,-85.0,-77.0,-85.0,12.0,24.0,11.0,26.0,1
6060,CC:2F:71:3F:1F:24,9683997,10289185851,6465444,9882656158,3218553,406529693,80,1490384,887166952,1481817,886138120,8567,1028832,1436883,619,6470136,663132,80,6011,130000.0,43333.0,-69.0,-63.0,-70.0,-69.0,-69.0,-63.0,-69.0,-69.0,-77.0,-85.0,-77.0,-85.0,8.0,22.0,7.0,16.0,1
6061,F8:59:71:5A:E0:3D,3403295,681766428,184740,275236533,3218555,406529895,0,182980,233278168,178144,232700342,4836,577826,160484,16,187455,3163,0,551,144444.0,43333.0,-67.0,-73.0,-65.0,-71.0,-67.0,-72.0,-65.0,-70.0,-77.0,-85.0,-77.0,-85.0,10.0,12.0,12.0,14.0,1
6062,CC:2F:71:3E:C5:1F,3229991,407928827,11436,1398932,3218555,406529895,6,48787,4086076,40312,3081872,8475,1004204,12058,34,16400,186,6,830,144444.0,39000.0,-64.0,-69.0,-64.0,-60.0,-68.0,-70.0,-67.0,-61.0,-77.0,-85.0,-77.0,-85.0,13.0,16.0,13.0,25.0,1
6063,CC:2F:71:3F:1F:24,9685314,10291210345,6466759,9884680450,3218555,406529895,80,1490661,887289056,1482094,886260224,8567,1028832,1437160,619,6471479,663246,80,6011,130000.0,43333.0,-69.0,-63.0,-70.0,-69.0,-69.0,-63.0,-69.0,-69.0,-77.0,-85.0,-77.0,-85.0,8.0,22.0,7.0,16.0,1
6064,F8:59:71:5A:E0:3D,3403362,681863240,184802,275332881,3218560,406530359,0,183043,233375216,178207,232797390,4836,577826,160547,16,187517,3164,0,551,144444.0,43333.0,-67.0,-72.0,-66.0,-70.0,-66.0,-72.0,-66.0,-70.0,-77.0,-85.0,-77.0,-85.0,10.0,13.0,11.0,15.0,1
6065,CC:2F:71:3E:C5:1F,3229996,407929291,11436,1398932,3218560,406530359,6,48787,4086076,40312,3081872,8475,1004204,12058,34,16400,186,6,830,144444.0,39000.0,-64.0,-69.0,-64.0,-60.0,-68.0,-70.0,-67.0,-61.0,-77.0,-85.0,-77.0,-85.0,13.0,16.0,13.0,25.0,1
6066,CC:2F:71:3F:1F:24,9686589,10293174405,6468029,9886644046,3218560,406530359,80,1490940,887415184,1482373,886386352,8567,1028832,1437436,619,6472749,663514,80,6011,115556.0,28889.0,-68.0,-63.0,-71.0,-68.0,-68.0,-63.0,-71.0,-68.0,-77.0,-85.0,-77.0,-85.0,9.0,22.0,6.0,17.0,1
6067,F8:59:71:5A:E0:3D,3403435,681970870,184871,275440107,3218564,406530763,0,183113,233483030,178277,232905204,4836,577826,160616,16,187586,3167,0,551,144444.0,43333.0,-67.0,-73.0,-66.0,-70.0,-66.0,-72.0,-66.0,-70.0,-77.0,-86.0,-77.0,-85.0,10.0,13.0,11.0,15.0,1
6068,CC:2F:71:3E:C5:1F,3230000,407929695,11436,1398932,3218564,406530763,6,48787,4086076,40312,3081872,8475,1004204,12058,34,16400,186,6,830,144444.0,39000.0,-64.0,-69.0,-64.0,-60.0,-68.0,-70.0,-67.0,-61.0,-77.0,-86.0,-77.0,-85.0,13.0,17.0,13.0,25.0,1
6069,CC:2F:71:3F:1F:24,9688365,10295927347,6469800,9889396524,3218565,406530823,80,1491294,887556182,1482727,886527350,8567,1028832,1437790,619,6474505,664064,80,6012,115556.0,28889.0,-68.0,-63.0,-71.0,-68.0,-68.0,-63.0,-70.0,-68.0,-77.0,-86.0,-77.0,-85.0,9.0,23.0,6.0,17.0,1
6070,F8:59:71:5A:E0:3D,3403508,682077006,184939,275545779,3218569,406531227,0,183180,233586210,178344,233008384,4836,577826,160683,16,187654,3167,0,551,144444.0,43333.0,-67.0,-73.0,-67.0,-70.0,-66.0,-71.0,-66.0,-70.0,-77.0,-86.0,-77.0,-85.0,10.0,13.0,10.0,15.0,1
6071,CC:2F:71:3E:C5:1F,3230005,407930159,11436,1398932,3218569,406531227,6,48787,4086076,40312,3081872,8475,1004204,12058,34,16400,186,6,830,144444.0,39000.0,-64.0,-69.0,-64.0,-60.0,-68.0,-70.0,-67.0,-61.0,-77.0,-86.0,-77.0,-85.0,13.0,17.0,13.0,25.0,1
6072,CC:2F:71:3F:1F:24,9690161,10298712323,6471590,9892180976,3218571,406531347,80,1491642,887693498,1483075,886664666,8567,1028832,1438138,619,6476310,664344,80,6012,115556.0,28889.0,-69.0,-63.0,-70.0,-69.0,-68.0,-63.0,-70.0,-69.0,-77.0,-86.0,-77.0,-85.0,8.0,23.0,7.0,16.0,1
6073,F8:59:71:5A:E0:3D,3403578,682176986,185003,275645235,3218575,406531751,0,183245,233686310,178409,233108484,4836,577826,160748,16,187718,3167,0,551,144444.0,43333.0,-67.0,-72.0,-66.0,-70.0,-67.0,-72.0,-65.0,-70.0,-77.0,-86.0,-77.0,-85.0,10.0,14.0,11.0,15.0,1
6074,CC:2F:71:3E:C5:1F,3230011,407930683,11436,1398932,3218575,406531751,6,48787,4086076,40312,3081872,8475,1004204,12058,34,16400,186,6,830,144444.0,39000.0,-64.0,-69.0,-64.0,-60.0,-68.0,-70.0,-67.0,-61.0,-77.0,-86.0,-77.0,-85.0,13.0,17.0,13.0,25.0,1
6075,CC:2F:71:3F:1F:24,9691574,10300887015,6472999,9894355264,3218575,406531751,80,1491919,887817064,1483352,886788232,8567,1028832,1438413,619,6477719,664371,80,6014,115556.0,28889.0,-69.0,-63.0,-70.0,-69.0,-69.0,-63.0,-70.0,-68.0,-77.0,-86.0,-77.0,-85.0,8.0,23.0,7.0,16.0,1
6076,F8:59:71:5A:E0:3D,3403648,682278460,185068,275746245,3218580,406532215,0,183309,233784870,178473,233207044,4836,577826,160812,16,187783,3168,0,551,144444.0,43333.0,-67.0,-73.0,-66.0,-70.0,-66.0,-71.0,-65.0,-69.0,-77.0,-86.0,-77.0,-85.0,10.0,13.0,11.0,15.0,1
6077,CC:2F:71:3E:C5:1F,3230016,407931147,11436,1398932,3218580,406532215,6,48787,4086076,40312,3081872,8475,1004204,12058,34,16400,186,6,830,144444.0,39000.0,-64.0,-69.0,-64.0,-60.0,-68.0,-70.0,-67.0,-61.0,-77.0,-86.0,-77.0,-85.0,13.0,17.0,13.0,25.0,1
6078,CC:2F:71:3F:1F:24,9693072,10303201169,6474492,9896668954,3218580,406532215,80,1492194,887942652,1483627,886913820,8567,1028832,1438686,619,6479212,664539,80,6014,117000.0,39000.0,-70.0,-63.0,-70.0,-69.0,-70.0,-63.0,-70.0,-69.0,-77.0,-86.0,-77.0,-85.0,7.0,23.0,7.0,16.0,1
6079,F8:59:71:5A:E0:3D,3403717,682378380,185132,275845701,3218585,406532679,0,183373,233883430,178537,233305604,4836,577826,160876,16,187847,3168,0,551,144444.0,43333.0,-67.0,-73.0,-66.0,-70.0,-66.0,-72.0,-66.0,-70.0,-77.0,-86.0,-77.0,-85.0,10.0,13.0,11.0,15.0,1
6080,CC:2F:71:3E:C5:1F,3230021,407931611,11436,1398932,3218585,406532679,6,48787,4086076,40312,3081872,8475,1004204,12058,34,16400,186,6,830,144444.0,39000.0,-64.0,-69.0,-64.0,-60.0,-68.0,-70.0,-67.0,-61.0,-77.0,-86.0,-77.0,-85.0,13.0,17.0,13.0,25.0,1
6081,CC:2F:71:3F:1F:24,9694389,10305227536,6475804,9898694857,3218585,406532679,80,1492434,888062919,1483867,887034087,8567,1028832,1438926,619,6480524,664556,80,6014,130000.0,43333.0,-70.0,-63.0,-71.0,-69.0,-69.0,-63.0,-70.0,-68.0,-77.0,-86.0,-77.0,-85.0,7.0,23.0,6.0,16.0,1
6082,F8:59:71:5A:E0:3D,3403784,682478100,185196,275945157,3218588,406532943,0,183437,233981990,178601,233404164,4836,577826,160940,16,187911,3168,0,551,144444.0,43333.0,-67.0,-73.0,-66.0,-71.0,-67.0,-72.0,-66.0,-70.0,-77.0,-86.0,-77.0,-85.0,10.0,13.0,11.0,14.0,1
6083,CC:2F:71:3E:C5:1F,3230024,407931875,11436,1398932,3218588,406532943,6,48787,4086076,40312,3081872,8475,1004204,12058,34,16400,186,6,830,144444.0,39000.0,-64.0,-69.0,-64.0,-60.0,-68.0,-70.0,-67.0,-61.0,-77.0,-86.0,-77.0,-85.0,13.0,17.0,13.0,25.0,1
6084,CC:2F:71:3F:1F:24,9695516,10306958422,6476926,9900425277,3218590,406533145,80,1492681,888185407,1484113,887156457,8568,1028950,1439170,619,6481613,664585,80,6014,130000.0,43333.0,-69.0,-63.0,-70.0,-69.0,-69.0,-63.0,-70.0,-68.0,-77.0,-86.0,-77.0,-85.0,8.0,23.0,7.0,16.0,1
6085,F8:59:71:5A:E0:3D,3403851,682576406,185259,276043059,3218592,406533347,0,183502,234082104,178666,233504278,4836,577826,161004,16,187974,3168,0,551,144444.0,43333.0,-67.0,-73.0,-66.0,-70.0,-67.0,-72.0,-65.0,-70.0,-77.0,-86.0,-77.0,-85.0,10.0,13.0,11.0,15.0,1
6086,CC:2F:71:3E:C5:1F,3230028,407932279,11436,1398932,3218592,406533347,6,48787,4086076,40312,3081872,8475,1004204,12058,34,16400,186,6,830,144444.0,39000.0,-64.0,-69.0,-64.0,-60.0,-68.0,-70.0,-67.0,-61.0,-77.0,-86.0,-77.0,-85.0,13.0,17.0,13.0,25.0,1
6087,CC:2F:71:3F:1F:24,9696692,10308743261,6478098,9902209712,3218594,406533549,80,1492953,888307655,1484385,887278705,8568,1028950,1439442,619,6482818,664674,80,6014,130000.0,43333.0,-70.0,-63.0,-71.0,-69.0,-69.0,-63.0,-70.0,-69.0,-77.0,-86.0,-77.0,-85.0,7.0,23.0,6.0,16.0,1
6088,F8:59:71:5A:E0:3D,3403923,682676721,185324,276142575,3218599,406534146,0,183567,234179348,178730,233601404,4837,577944,161069,16,188039,3169,0,551,130000.0,39000.0,-67.0,-73.0,-66.0,-70.0,-67.0,-72.0,-66.0,-70.0,-77.0,-85.0,-77.0,-85.0,10.0,12.0,11.0,15.0,1
6089,CC:2F:71:3E:C5:1F,3230035,407933078,11436,1398932,3218599,406534146,6,48787,4086076,40312,3081872,8475,1004204,12058,34,16400,186,6,830,144444.0,39000.0,-64.0,-69.0,-64.0,-60.0,-68.0,-70.0,-67.0,-61.0,-77.0,-85.0,-77.0,-85.0,13.0,16.0,13.0,25.0,1
6090,CC:2F:71:3F:1F:24,9697882,10310572244,6479283,9904038098,3218599,406534146,80,1493208,888429767,1484640,887400817,8568,1028950,1439697,619,6484003,664695,80,6014,130000.0,43333.0,-70.0,-63.0,-71.0,-69.0,-69.0,-63.0,-70.0,-68.0,-77.0,-85.0,-77.0,-85.0,7.0,22.0,6.0,16.0,1
6091,F8:59:71:5A:E0:3D,3403989,682773361,185386,276238811,3218603,406534550,0,183630,234276368,178793,233698424,4837,577944,161132,16,188101,3171,0,551,144444.0,43333.0,-67.0,-73.0,-66.0,-70.0,-67.0,-72.0,-66.0,-70.0,-77.0,-85.0,-77.0,-85.0,10.0,12.0,11.0,15.0,1
6092,CC:2F:71:3E:C5:1F,3230039,407933482,11436,1398932,3218603,406534550,6,48787,4086076,40312,3081872,8475,1004204,12058,34,16400,186,6,830,144444.0,39000.0,-64.0,-69.0,-64.0,-60.0,-68.0,-70.0,-67.0,-61.0,-77.0,-85.0,-77.0,-85.0,13.0,16.0,13.0,25.0,1
6093,CC:2F:71:3F:1F:24,9699269,10312714870,6480666,9906180320,3218603,406534550,80,1493472,888551273,1484904,887522323,8568,1028950,1439961,619,6485386,664724,80,6014,130000.0,43333.0,-70.0,-63.0,-70.0,-69.0,-69.0,-63.0,-70.0,-69.0,-77.0,-85.0,-77.0,-85.0,7.0,22.0,7.0,16.0,1
6094,F8:59:71:5A:E0:3D,3404058,682874775,185451,276339821,3218607,406534954,0,183695,234376468,178858,233798524,4837,577944,161197,16,188166,3172,0,551,144444.0,43333.0,-67.0,-72.0,-66.0,-70.0,-66.0,-72.0,-66.0,-70.0,-77.0,-85.0,-77.0,-85.0,10.0,13.0,11.0,15.0,1
6095,CC:2F:71:3E:C5:1F,3230043,407933886,11436,1398932,3218607,406534954,6,48787,4086076,40312,3081872,8475,1004204,12058,34,16400,186,6,830,144444.0,39000.0,-64.0,-69.0,-64.0,-60.0,-68.0,-70.0,-67.0,-61.0,-77.0,-85.0,-77.0,-85.0,13.0,16.0,13.0,25.0,1
6096,CC:2F:71:3F:1F:24,9700660,10314863368,6482053,9908328414,3218607,406534954,80,1493731,888675287,1485163,887646337,8568,1028950,1440220,619,6486773,664844,80,6014,130000.0,43333.0,-70.0,-63.0,-71.0,-69.0,-69.0,-63.0,-70.0,-69.0,-77.0,-85.0,-77.0,-85.0,7.0,22.0,6.0,16.0,1
6097,F8:59:71:5A:E0:3D,3404128,682974757,185515,276439277,3218613,406535480,0,183758,234473488,178921,233895544,4837,577944,161260,16,188229,3172,0,551,144444.0,43333.0,-67.0,-73.0,-67.0,-70.0,-67.0,-72.0,-66.0,-70.0,-77.0,-85.0,-77.0,-85.0,10.0,12.0,10.0,15.0,1
6098,CC:2F:71:3E:C5:1F,3230049,407934412,11436,1398932,3218613,406535480,6,48789,4086264,40313,3081942,8476,1004322,12059,34,16400,186,6,830,144444.0,39000.0,-68.0,-70.0,-68.0,-60.0,-67.0,-69.0,-67.0,-59.0,-77.0,-85.0,-77.0,-85.0,9.0,15.0,9.0,25.0,1
6099,CC:2F:71:3F:1F:24,9701850,10316690702,6483237,9910155222,3218613,406535480,80,1493994,888796915,1485426,887767965,8568,1028950,1440483,619,6487957,664902,80,6014,130000.0,43333.0,-70.0,-63.0,-71.0,-69.0,-69.0,-63.0,-70.0,-69.0,-77.0,-85.0,-77.0,-85.0,7.0,22.0,6.0,16.0,1
6100,F8:59:71:5A:E0:3D,3404194,683071509,185577,276535625,3218617,406535884,0,183821,234570508,178984,233992564,4837,577944,161323,16,188292,3172,0,551,144444.0,43333.0,-67.0,-72.0,-66.0,-70.0,-66.0,-72.0,-66.0,-70.0,-77.0,-85.0,-77.0,-85.0,10.0,13.0,11.0,15.0,1
6101,CC:2F:71:3E:C5:1F,3230053,407934816,11436,1398932,3218617,406535884,6,48789,4086264,40313,3081942,8476,1004322,12059,34,16400,186,6,830,144444.0,39000.0,-68.0,-70.0,-68.0,-60.0,-67.0,-69.0,-67.0,-59.0,-77.0,-85.0,-77.0,-85.0,9.0,15.0,9.0,25.0,1
6102,CC:2F:71:3F:1F:24,9702811,10318153424,6484194,9911617540,3218617,406535884,80,1494212,888915054,1485644,887886104,8568,1028950,1440701,619,6488907,665030,80,6014,117000.0,39000.0,-69.0,-63.0,-71.0,-69.0,-69.0,-63.0,-70.0,-69.0,-77.0,-85.0,-77.0,-85.0,8.0,22.0,6.0,16.0,1
6103,F8:59:71:5A:E0:3D,3404261,683172721,185642,276636635,3218619,406536086,0,183886,234670608,179049,234092664,4837,577944,161388,16,188357,3173,0,551,144444.0,43333.0,-67.0,-72.0,-66.0,-70.0,-67.0,-72.0,-66.0,-70.0,-77.0,-85.0,-77.0,-85.0,10.0,13.0,11.0,15.0,1
6104,CC:2F:71:3E:C5:1F,3230055,407935018,11436,1398932,3218619,406536086,6,48789,4086264,40313,3081942,8476,1004322,12059,34,16400,186,6,830,144444.0,39000.0,-68.0,-70.0,-68.0,-60.0,-67.0,-69.0,-67.0,-59.0,-77.0,-85.0,-77.0,-85.0,9.0,15.0,9.0,25.0,1
6105,CC:2F:71:3F:1F:24,9703970,10319936314,6485349,9913400026,3218621,406536288,80,1494491,889039946,1485923,888010996,8568,1028950,1440980,619,6490069,665049,80,6014,130000.0,43333.0,-69.0,-63.0,-71.0,-69.0,-69.0,-63.0,-71.0,-69.0,-77.0,-85.0,-77.0,-85.0,8.0,22.0,6.0,16.0,1
6106,F8:59:71:5A:E0:3D,3404329,683271087,185705,276734537,3218624,406536550,0,183949,234767628,179112,234189684,4837,577944,161451,16,188420,3174,0,551,144444.0,43333.0,-67.0,-73.0,-66.0,-70.0,-66.0,-72.0,-66.0,-70.0,-77.0,-85.0,-77.0,-85.0,10.0,12.0,11.0,15.0,1
6107,CC:2F:71:3E:C5:1F,3230062,407935684,11436,1398932,3218626,406536752,6,48789,4086264,40313,3081942,8476,1004322,12059,34,16400,186,6,830,144444.0,39000.0,-68.0,-70.0,-68.0,-60.0,-67.0,-69.0,-67.0,-59.0,-77.0,-85.0,-77.0,-85.0,9.0,15.0,9.0,25.0,1
6108,CC:2F:71:3F:1F:24,9704946,10321428944,6486320,9914892192,3218626,406536752,80,1494714,889155398,1486146,888126448,8568,1028950,1441203,619,6491030,665151,80,6014,130000.0,43333.0,-70.0,-63.0,-70.0,-69.0,-69.0,-63.0,-70.0,-69.0,-77.0,-85.0,-77.0,-85.0,7.0,22.0,7.0,16.0,1
6109,F8:59:71:5A:E0:3D,3404397,683370947,185769,276833993,3218628,406536954,0,184013,234866188,179176,234288244,4837,577944,161515,16,188484,3175,0,551,144444.0,43333.0,-67.0,-73.0,-66.0,-71.0,-67.0,-72.0,-66.0,-70.0,-77.0,-85.0,-77.0,-85.0,10.0,12.0,11.0,14.0,1
6110,CC:2F:71:3E:C5:1F,3230064,407935886,11436,1398932,3218628,406536954,6,48789,4086264,40313,3081942,8476,1004322,12059,34,16400,186,6,830,144444.0,39000.0,-68.0,-70.0,-68.0,-60.0,-67.0,-69.0,-67.0,-59.0,-77.0,-85.0,-77.0,-85.0,9.0,15.0,9.0,25.0,1
6111,CC:2F:71:3F:1F:24,9705813,10322753660,6487185,9916216706,3218628,406536954,80,1494937,889275056,1486369,888246106,8568,1028950,1441426,619,6491905,665217,80,6015,130000.0,43333.0,-69.0,-63.0,-71.0,-69.0,-69.0,-63.0,-71.0,-69.0,-77.0,-85.0,-77.0,-85.0,8.0,22.0,6.0,16.0,1
6112,F8:59:71:5A:E0:3D,3404466,683472361,185834,276935003,3218632,406537358,0,184078,234966288,179241,234388344,4837,577944,161580,16,188549,3183,0,551,144444.0,43333.0,-68.0,-73.0,-66.0,-70.0,-67.0,-72.0,-66.0,-70.0,-77.0,-85.0,-77.0,-85.0,9.0,12.0,11.0,15.0,1
6113,CC:2F:71:3E:C5:1F,3230068,407936290,11436,1398932,3218632,406537358,6,48789,4086264,40313,3081942,8476,1004322,12059,34,16400,186,6,830,144444.0,39000.0,-68.0,-70.0,-68.0,-60.0,-67.0,-69.0,-67.0,-59.0,-77.0,-85.0,-77.0,-85.0,9.0,15.0,9.0,25.0,1
6114,CC:2F:71:3F:1F:24,9706961,10324513028,6488329,9917975670,3218632,406537358,80,1495152,889394269,1486584,888365319,8568,1028950,1441641,619,6493049,665347,80,6016,130000.0,43333.0,-70.0,-63.0,-71.0,-69.0,-69.0,-63.0,-71.0,-69.0,-77.0,-85.0,-77.0,-85.0,7.0,22.0,6.0,16.0,1
6115,F8:59:71:5A:E0:3D,3404534,683570727,185897,277032905,3218637,406537822,0,184140,235061768,179303,234483824,4837,577944,161642,16,188612,3183,0,551,144444.0,43333.0,-67.0,-73.0,-66.0,-70.0,-67.0,-72.0,-66.0,-70.0,-77.0,-85.0,-77.0,-85.0,10.0,12.0,11.0,15.0,1
6116,CC:2F:71:3E:C5:1F,3230073,407936754,11436,1398932,3218637,406537822,6,48789,4086264,40313,3081942,8476,1004322,12059,34,16400,186,6,830,144444.0,39000.0,-68.0,-70.0,-68.0,-60.0,-67.0,-69.0,-67.0,-59.0,-77.0,-85.0,-77.0,-85.0,9.0,15.0,9.0,25.0,1
6117,CC:2F:71:3F:1F:24,9708127,10326305374,6489490,9919767552,3218637,406537822,80,1495444,889520493,1486876,888491543,8568,1028950,1441933,619,6494210,665479,80,6016,130000.0,39000.0,-69.0,-63.0,-70.0,-69.0,-69.0,-63.0,-70.0,-68.0,-77.0,-85.0,-77.0,-85.0,8.0,22.0,7.0,16.0,1
6118,F8:59:71:5A:E0:3D,3404599,683668831,185960,277130807,3218639,406538024,0,184204,235160328,179367,234582384,4837,577944,161706,16,188675,3183,0,551,144444.0,43333.0,-67.0,-73.0,-66.0,-70.0,-67.0,-72.0,-66.0,-70.0,-77.0,-85.0,-77.0,-85.0,10.0,12.0,11.0,15.0,1
6119,CC:2F:71:3E:C5:1F,3230075,407936956,11436,1398932,3218639,406538024,6,48789,4086264,40313,3081942,8476,1004322,12059,34,16400,186,6,830,144444.0,39000.0,-68.0,-70.0,-68.0,-60.0,-67.0,-69.0,-67.0,-59.0,-77.0,-85.0,-77.0,-85.0,9.0,15.0,9.0,25.0,1
6120,CC:2F:71:3F:1F:24,9709423,10328305796,6490784,9921767772,3218639,406538024,80,1495687,889638237,1487119,888609287,8568,1028950,1442176,619,6495504,665591,80,6017,130000.0,43333.0,-70.0,-63.0,-71.0,-69.0,-69.0,-63.0,-71.0,-69.0,-77.0,-85.0,-77.0,-85.0,7.0,22.0,6.0,16.0,1
6121,F8:59:71:5A:E0:3D,3404670,683773353,186027,277234925,3218643,406538428,0,184270,235261968,179433,234684024,4837,577944,161772,16,188742,3183,0,551,144444.0,43333.0,-67.0,-73.0,-66.0,-70.0,-67.0,-72.0,-65.0,-70.0,-77.0,-85.0,-77.0,-85.0,10.0,12.0,11.0,15.0,1
6122,CC:2F:71:3E:C5:1F,3230080,407937420,11436,1398932,3218644,406538488,6,48789,4086264,40313,3081942,8476,1004322,12059,34,16400,186,6,830,144444.0,39000.0,-68.0,-70.0,-68.0,-60.0,-67.0,-69.0,-67.0,-59.0,-77.0,-85.0,-77.0,-85.0,9.0,15.0,9.0,25.0,1
6123,CC:2F:71:3F:1F:24,9711299,10331212456,6492653,9924673766,3218646,406538690,80,1495975,889771261,1487407,888742311,8568,1028950,1442464,619,6497348,666010,80,6017,115556.0,28889.0,-69.0,-63.0,-69.0,-70.0,-69.0,-63.0,-68.0,-69.0,-77.0,-85.0,-77.0,-85.0,8.0,22.0,8.0,15.0,1
6124,F8:59:71:5A:E0:3D,3404739,683873273,186091,277334381,3218648,406538892,0,184335,235362096,179498,234784152,4837,577944,161837,16,188806,3183,0,551,144444.0,43333.0,-67.0,-73.0,-66.0,-70.0,-67.0,-73.0,-66.0,-70.0,-77.0,-85.0,-77.0,-85.0,10.0,12.0,11.0,15.0,1
6125,CC:2F:71:3E:C5:1F,3230084,407937824,11436,1398932,3218648,406538892,6,48789,4086264,40313,3081942,8476,1004322,12059,34,16400,186,6,830,144444.0,39000.0,-68.0,-70.0,-68.0,-60.0,-67.0,-69.0,-67.0,-59.0,-77.0,-85.0,-77.0,-85.0,9.0,15.0,9.0,25.0,1
6126,CC:2F:71:3F:1F:24,9712670,10333323826,6494022,9926784934,3218648,406538892,80,1496232,889895561,1487664,888866611,8568,1028950,1442720,619,6498742,666122,80,6018,115556.0,28889.0,-68.0,-63.0,-70.0,-69.0,-68.0,-63.0,-69.0,-69.0,-77.0,-85.0,-77.0,-85.0,9.0,22.0,7.0,16.0,1
6127,F8:59:71:5A:E0:3D,3404808,683974687,186156,277435391,3218652,406539296,0,184399,235460656,179562,234882712,4837,577944,161901,16,188871,3183,0,551,144444.0,43333.0,-67.0,-73.0,-66.0,-70.0,-66.0,-72.0,-66.0,-70.0,-77.0,-85.0,-77.0,-85.0,10.0,12.0,11.0,15.0,1
6128,CC:2F:71:3E:C5:1F,3230088,407938228,11436,1398932,3218652,406539296,6,48789,4086264,40313,3081942,8476,1004322,12059,34,16400,186,6,830,144444.0,39000.0,-68.0,-70.0,-68.0,-60.0,-67.0,-69.0,-67.0,-59.0,-77.0,-85.0,-77.0,-85.0,9.0,15.0,9.0,25.0,1
6129,CC:2F:71:3F:1F:24,9713628,10334789154,6494976,9928249858,3218652,406539296,80,1496501,890016437,1487933,888987487,8568,1028950,1442989,619,6499686,666153,80,6018,130000.0,43333.0,-68.0,-63.0,-70.0,-69.0,-68.0,-63.0,-69.0,-68.0,-77.0,-85.0,-77.0,-85.0,9.0,22.0,7.0,16.0,1
6130,F8:59:71:5A:E0:3D,3404878,684074880,186220,277534847,3218658,406540033,0,184463,235559216,179626,234981272,4837,577944,161965,16,188935,3183,0,551,144444.0,43333.0,-67.0,-73.0,-66.0,-70.0,-66.0,-72.0,-66.0,-70.0,-77.0,-85.0,-77.0,-85.0,10.0,12.0,11.0,15.0,1
6131,CC:2F:71:3E:C5:1F,3230094,407938965,11436,1398932,3218658,406540033,6,48789,4086264,40313,3081942,8476,1004322,12059,34,16400,186,6,830,144444.0,39000.0,-68.0,-70.0,-68.0,-60.0,-67.0,-69.0,-67.0,-59.0,-77.0,-85.0,-77.0,-85.0,9.0,15.0,9.0,25.0,1
6132,CC:2F:71:3F:1F:24,9714823,10336624341,6496165,9930084308,3218658,406540033,80,1496711,890136001,1488143,889107051,8568,1028950,1443198,619,6500854,666240,80,6019,130000.0,43333.0,-68.0,-63.0,-70.0,-69.0,-68.0,-63.0,-69.0,-68.0,-77.0,-85.0,-77.0,-85.0,9.0,22.0,7.0,16.0,1
6133,F8:59:71:5A:E0:3D,3404945,684173186,186283,277632749,3218662,406540437,0,184527,235657776,179690,235079832,4837,577944,162029,16,188998,3184,0,551,144444.0,43333.0,-67.0,-73.0,-66.0,-70.0,-67.0,-73.0,-66.0,-70.0,-77.0,-85.0,-77.0,-85.0,10.0,12.0,11.0,15.0,1
6134,CC:2F:71:3E:C5:1F,3230098,407939369,11436,1398932,3218662,406540437,6,48789,4086264,40313,3081942,8476,1004322,12059,34,16400,186,6,830,144444.0,39000.0,-68.0,-70.0,-68.0,-60.0,-67.0,-69.0,-67.0,-59.0,-77.0,-85.0,-77.0,-85.0,9.0,15.0,9.0,25.0,1
6135,CC:2F:71:3F:1F:24,9716006,10338443663,6497344,9931903226,3218662,406540437,80,1496941,890253635,1488373,889224685,8568,1028950,1443428,619,6502056,666287,80,6019,130000.0,43333.0,-68.0,-63.0,-70.0,-68.0,-68.0,-63.0,-69.0,-68.0,-77.0,-85.0,-77.0,-85.0,9.0,22.0,7.0,17.0,1
6136,F8:59:71:5A:E0:3D,3405011,684269938,186345,277729097,3218666,406540841,0,184589,235753256,179752,235175312,4837,577944,162091,16,189060,3185,0,551,144444.0,43333.0,-66.0,-73.0,-67.0,-70.0,-66.0,-72.0,-66.0,-70.0,-77.0,-85.0,-77.0,-85.0,11.0,12.0,10.0,15.0,1
6137,CC:2F:71:3E:C5:1F,3230102,407939773,11436,1398932,3218666,406540841,6,48789,4086264,40313,3081942,8476,1004322,12059,34,16400,186,6,830,144444.0,39000.0,-68.0,-70.0,-68.0,-60.0,-67.0,-69.0,-67.0,-59.0,-77.0,-85.0,-77.0,-85.0,9.0,15.0,9.0,25.0,1
6138,CC:2F:71:3F:1F:24,9717260,10340376247,6498594,9933835406,3218666,406540841,80,1497216,890378101,1488648,889349151,8568,1028950,1443702,619,6503281,666391,80,6020,130000.0,43333.0,-69.0,-63.0,-71.0,-69.0,-68.0,-63.0,-70.0,-69.0,-77.0,-85.0,-77.0,-85.0,8.0,22.0,6.0,16.0,1
6139,F8:59:71:5A:E0:3D,3405080,684369858,186409,277828553,3218671,406541305,0,184653,235851816,179816,235273872,4837,577944,162155,16,189124,3185,0,551,144444.0,43333.0,-67.0,-73.0,-66.0,-70.0,-66.0,-73.0,-66.0,-70.0,-77.0,-85.0,-77.0,-85.0,10.0,12.0,11.0,15.0,1
6140,CC:2F:71:3E:C5:1F,3230107,407940237,11436,1398932,3218671,406541305,6,48789,4086264,40313,3081942,8476,1004322,12059,34,16400,186,6,830,144444.0,39000.0,-68.0,-70.0,-68.0,-60.0,-67.0,-69.0,-67.0,-59.0,-77.0,-85.0,-77.0,-85.0,9.0,15.0,9.0,25.0,1
6141,CC:2F:71:3F:1F:24,9718417,10342146897,6499746,9935605592,3218671,406541305,80,1497457,890497580,1488889,889468630,8568,1028950,1443943,619,6504466,666435,80,6020,130000.0,43333.0,-69.0,-63.0,-71.0,-69.0,-68.0,-63.0,-70.0,-69.0,-77.0,-85.0,-77.0,-85.0,8.0,22.0,6.0,16.0,1
6142,F8:59:71:5A:E0:3D,3405147,684468164,186472,277926455,3218675,406541709,0,184716,235948850,179879,235370906,4837,577944,162217,16,189187,3185,0,551,144444.0,43333.0,-67.0,-73.0,-66.0,-70.0,-66.0,-72.0,-66.0,-70.0,-77.0,-85.0,-77.0,-85.0,10.0,12.0,11.0,15.0,1
6143,CC:2F:71:3E:C5:1F,3230111,407940641,11436,1398932,3218675,406541709,6,48789,4086264,40313,3081942,8476,1004322,12059,34,16400,186,6,830,144444.0,39000.0,-68.0,-70.0,-68.0,-60.0,-67.0,-69.0,-67.0,-59.0,-77.0,-85.0,-77.0,-85.0,9.0,15.0,9.0,25.0,1
6144,CC:2F:71:3F:1F:24,9719645,10344038653,6500970,9937496944,3218675,406541709,80,1497673,890613650,1489105,889584700,8568,1028950,1444159,619,6505690,666462,80,6021,130000.0,43333.0,-69.0,-63.0,-70.0,-69.0,-68.0,-63.0,-69.0,-69.0,-77.0,-85.0,-77.0,-85.0,8.0,22.0,7.0,16.0,1
6145,F8:59:71:5A:E0:3D,3405217,684569860,186538,278027581,3218679,406542279,0,184781,236048950,179944,235471006,4837,577944,162282,16,189253,3186,0,551,144444.0,43333.0,-67.0,-73.0,-66.0,-70.0,-66.0,-73.0,-65.0,-70.0,-77.0,-85.0,-77.0,-85.0,10.0,12.0,11.0,15.0,1
6146,CC:2F:71:3E:C5:1F,3230118,407941529,11437,1399048,3218681,406542481,6,48791,4086404,40315,3082082,8476,1004322,12059,34,16401,186,6,830,144444.0,39000.0,-69.0,-72.0,-67.0,-60.0,-67.0,-69.0,-66.0,-59.0,-77.0,-85.0,-77.0,-85.0,8.0,13.0,10.0,25.0,1
6147,CC:2F:71:3F:1F:24,9721544,10346982549,6502863,9940440068,3218681,406542481,80,1497946,890741898,1489378,889712948,8568,1028950,1444432,619,6507553,666732,80,6021,130000.0,43333.0,-69.0,-63.0,-69.0,-70.0,-69.0,-63.0,-69.0,-69.0,-77.0,-85.0,-77.0,-85.0,8.0,22.0,8.0,15.0,1
6148,F8:59:71:5A:E0:3D,3405289,684674442,186605,278131699,3218684,406542743,0,184849,236153670,180012,235575726,4837,577944,162350,16,189320,3186,0,551,144444.0,43333.0,-67.0,-73.0,-66.0,-70.0,-67.0,-72.0,-65.0,-70.0,-77.0,-85.0,-77.0,-85.0,10.0,12.0,11.0,15.0,1
6149,CC:2F:71:3E:C5:1F,3230123,407941993,11437,1399048,3218686,406542945,6,48791,4086404,40315,3082082,8476,1004322,12059,34,16401,186,6,830,144444.0,39000.0,-69.0,-72.0,-67.0,-60.0,-67.0,-69.0,-66.0,-59.0,-77.0,-85.0,-77.0,-85.0,8.0,13.0,10.0,25.0,1
6150,CC:2F:71:3F:1F:24,9723186,10349523999,6504500,9942981054,3218686,406542945,80,1498181,890864310,1489613,889835360,8568,1028950,1444667,619,6509220,667132,80,6021,115556.0,28889.0,-69.0,-63.0,-69.0,-69.0,-69.0,-63.0,-69.0,-69.0,-77.0,-85.0,-77.0,-85.0,8.0,22.0,8.0,16.0,1
6151,F8:59:71:5A:E0:3D,3405358,684775856,186670,278232709,3218688,406543147,0,184914,236253770,180077,235675826,4837,577944,162415,16,189385,3186,0,551,144444.0,43333.0,-67.0,-73.0,-66.0,-70.0,-67.0,-73.0,-66.0,-70.0,-77.0,-85.0,-77.0,-85.0,10.0,12.0,11.0,15.0,1
6152,CC:2F:71:3E:C5:1F,3230125,407942195,11437,1399048,3218688,406543147,6,48791,4086404,40315,3082082,8476,1004322,12059,34,16401,186,6,830,144444.0,39000.0,-69.0,-72.0,-67.0,-60.0,-67.0,-69.0,-66.0,-59.0,-77.0,-85.0,-77.0,-85.0,8.0,13.0,10.0,25.0,1
6153,CC:2F:71:3F:1F:24,9724497,10351536285,6505807,9944992936,3218690,406543349,80,1498453,890988779,1489885,889959829,8568,1028950,1444939,619,6510527,667174,80,6021,115556.0,28889.0,-68.0,-64.0,-70.0,-69.0,-68.0,-63.0,-70.0,-69.0,-77.0,-85.0,-77.0,-85.0,9.0,21.0,7.0,16.0,1
6154,F8:59:71:5A:E0:3D,3405426,684875716,186734,278332165,3218692,406543551,0,184978,236352344,180141,235774400,4837,577944,162478,16,189449,3187,0,551,144444.0,43333.0,-67.0,-73.0,-66.0,-70.0,-67.0,-73.0,-66.0,-70.0,-77.0,-85.0,-77.0,-85.0,10.0,12.0,11.0,15.0,1
6155,CC:2F:71:3E:C5:1F,3230129,407942599,11437,1399048,3218692,406543551,6,48791,4086404,40315,3082082,8476,1004322,12059,34,16401,186,6,830,144444.0,39000.0,-69.0,-72.0,-67.0,-60.0,-67.0,-69.0,-66.0,-59.0,-77.0,-85.0,-77.0,-85.0,8.0,13.0,10.0,25.0,1
6156,CC:2F:71:3F:1F:24,9725517,10353102795,6506825,9946559244,3218692,406543551,80,1498715,891110161,1490147,890081211,8568,1028950,1445201,619,6511545,667188,80,6021,115556.0,28889.0,-68.0,-63.0,-70.0,-70.0,-68.0,-63.0,-69.0,-69.0,-77.0,-85.0,-77.0,-85.0,9.0,22.0,7.0,15.0,1
6157,F8:59:71:5A:E0:3D,3405491,684972158,186796,278428345,3218695,406543813,0,185040,236447824,180203,235869880,4837,577944,162540,16,189511,3187,0,551,144444.0,43333.0,-67.0,-73.0,-66.0,-70.0,-66.0,-73.0,-66.0,-70.0,-77.0,-85.0,-77.0,-85.0,10.0,12.0,11.0,15.0,1
6158,CC:2F:71:3E:C5:1F,3230134,407943063,11437,1399048,3218697,406544015,6,48791,4086404,40315,3082082,8476,1004322,12059,34,16401,186,6,830,144444.0,39000.0,-69.0,-72.0,-67.0,-60.0,-67.0,-69.0,-66.0,-59.0,-77.0,-85.0,-77.0,-85.0,8.0,13.0,10.0,25.0,1
6159,CC:2F:71:3F:1F:24,9726357,10354378953,6507660,9947834938,3218697,406544015,80,1498938,891227069,1490370,890198119,8568,1028950,1445424,619,6512378,667253,80,6023,115556.0,28889.0,-69.0,-63.0,-69.0,-69.0,-68.0,-63.0,-69.0,-69.0,-77.0,-85.0,-77.0,-85.0,8.0,22.0,8.0,16.0,1
6160,F8:59:71:5A:E0:3D,3405559,685072018,186860,278527801,3218699,406544217,0,185105,236547924,180268,235969980,4837,577944,162605,16,189575,3188,0,551,144444.0,43333.0,-67.0,-73.0,-66.0,-70.0,-67.0,-73.0,-66.0,-70.0,-77.0,-85.0,-77.0,-85.0,10.0,12.0,11.0,15.0,1
6161,CC:2F:71:3E:C5:1F,3230138,407943467,11437,1399048,3218701,406544419,6,48791,4086404,40315,3082082,8476,1004322,12059,34,16401,186,6,830,144444.0,39000.0,-69.0,-72.0,-67.0,-60.0,-67.0,-69.0,-66.0,-59.0,-77.0,-85.0,-77.0,-85.0,8.0,13.0,10.0,25.0,1
6162,CC:2F:71:3F:1F:24,9727462,10356076415,6508761,9949531996,3218701,406544419,80,1499154,891342945,1490586,890313995,8568,1028950,1445640,619,6513481,667387,80,6023,115556.0,28889.0,-69.0,-64.0,-70.0,-70.0,-68.0,-63.0,-70.0,-69.0,-77.0,-85.0,-77.0,-85.0,8.0,21.0,7.0,15.0,1
6163,F8:59:71:5A:E0:3D,3405627,685171878,186924,278627257,3218703,406544621,0,185168,236644944,180331,236067000,4837,577944,162668,16,189639,3189,0,551,144444.0,43333.0,-67.0,-73.0,-66.0,-70.0,-67.0,-73.0,-66.0,-70.0,-77.0,-85.0,-77.0,-85.0,10.0,12.0,11.0,15.0,1
6164,CC:2F:71:3E:C5:1F,3230140,407943669,11437,1399048,3218703,406544621,6,48791,4086404,40315,3082082,8476,1004322,12059,34,16401,186,6,830,144444.0,39000.0,-69.0,-72.0,-67.0,-60.0,-67.0,-69.0,-66.0,-59.0,-77.0,-85.0,-77.0,-85.0,8.0,13.0,10.0,25.0,1
6165,CC:2F:71:3F:1F:24,9728818,10358161233,6510115,9951616612,3218703,406544621,80,1499428,891470281,1490860,890441331,8568,1028950,1445911,619,6514813,667464,80,6023,115556.0,28889.0,-69.0,-64.0,-69.0,-70.0,-68.0,-64.0,-69.0,-70.0,-77.0,-85.0,-77.0,-85.0,8.0,21.0,8.0,15.0,1
6166,F8:59:71:5A:E0:3D,3405706,685275668,186987,278725159,3218719,406550509,0,185232,236743532,180395,236165588,4837,577944,162732,16,189702,3192,0,552,144444.0,43333.0,-67.0,-73.0,-66.0,-70.0,-67.0,-73.0,-65.0,-70.0,-77.0,-85.0,-77.0,-85.0,10.0,12.0,11.0,15.0,1
6167,CC:2F:71:3E:C5:1F,3230167,407954981,11437,1399048,3218730,406555933,6,48791,4086404,40315,3082082,8476,1004322,12059,34,16401,186,6,830,144444.0,39000.0,-69.0,-72.0,-67.0,-60.0,-67.0,-69.0,-66.0,-59.0,-77.0,-85.0,-77.0,-85.0,8.0,13.0,10.0,25.0,1
6168,CC:2F:71:3F:1F:24,9730012,10359972047,6511282,9953416114,3218730,406555933,80,1499650,891594033,1491082,890565083,8568,1028950,1446131,619,6516002,667826,80,6023,115556.0,28889.0,-68.0,-63.0,-69.0,-70.0,-68.0,-63.0,-69.0,-69.0,-77.0,-85.0,-77.0,-85.0,9.0,22.0,8.0,15.0,1
6169,F8:59:71:5A:E0:3D,3405789,685387168,187055,278830831,3218734,406556337,0,185300,236848252,180463,236270308,4837,577944,162800,16,189770,3194,0,552,144444.0,43333.0,-67.0,-73.0,-66.0,-70.0,-67.0,-72.0,-66.0,-70.0,-77.0,-85.0,-77.0,-85.0,10.0,12.0,11.0,15.0,1
6170,CC:2F:71:3E:C5:1F,3230171,407955385,11437,1399048,3218734,406556337,6,48791,4086404,40315,3082082,8476,1004322,12059,34,16401,186,6,830,144444.0,39000.0,-69.0,-72.0,-67.0,-60.0,-67.0,-69.0,-66.0,-59.0,-77.0,-85.0,-77.0,-85.0,8.0,13.0,10.0,25.0,1
6171,CC:2F:71:3F:1F:24,9731249,10361876413,6512515,9955320076,3218734,406556337,80,1499910,891715193,1491342,890686243,8568,1028950,1446391,619,6517231,667895,80,6023,115556.0,28889.0,-68.0,-63.0,-69.0,-70.0,-68.0,-63.0,-69.0,-70.0,-77.0,-85.0,-77.0,-85.0,9.0,22.0,8.0,15.0,1
6172,F8:59:71:5A:E0:3D,3405858,685487301,187119,278930287,3218739,406557014,0,185364,236946812,180527,236368868,4837,577944,162864,16,189834,3194,0,552,144444.0,43333.0,-68.0,-73.0,-66.0,-70.0,-67.0,-73.0,-66.0,-70.0,-77.0,-85.0,-77.0,-85.0,9.0,12.0,11.0,15.0,1
6173,CC:2F:71:3E:C5:1F,3230177,407956122,11437,1399048,3218740,406557074,6,48791,4086404,40315,3082082,8476,1004322,12059,34,16401,186,6,830,144444.0,39000.0,-69.0,-72.0,-67.0,-60.0,-67.0,-69.0,-66.0,-59.0,-77.0,-85.0,-77.0,-85.0,8.0,13.0,10.0,25.0,1
6174,CC:2F:71:3F:1F:24,9732270,10363438532,6513530,9956881458,3218740,406557074,80,1500167,891838733,1491599,890809783,8568,1028950,1446648,619,6518250,667987,80,6023,104000.0,26000.0,-69.0,-64.0,-70.0,-70.0,-68.0,-63.0,-69.0,-70.0,-77.0,-85.0,-77.0,-85.0,8.0,21.0,7.0,15.0,1
6175,F8:59:71:5A:E0:3D,3405928,685588775,187184,279031297,3218744,406557478,0,185429,237046912,180592,236468968,4837,577944,162929,16,189899,3195,0,552,144444.0,43333.0,-67.0,-73.0,-65.0,-70.0,-66.0,-73.0,-65.0,-70.0,-77.0,-85.0,-77.0,-85.0,10.0,12.0,12.0,15.0,1
6176,CC:2F:71:3E:C5:1F,3230181,407956526,11437,1399048,3218744,406557478,6,48791,4086404,40315,3082082,8476,1004322,12059,34,16401,186,6,830,144444.0,39000.0,-69.0,-72.0,-67.0,-60.0,-67.0,-69.0,-66.0,-59.0,-77.0,-85.0,-77.0,-85.0,8.0,13.0,10.0,25.0,1
6177,CC:2F:71:3F:1F:24,9733455,10365254382,6514711,9958696904,3218744,406557478,80,1500402,891956069,1491834,890927119,8568,1028950,1446883,619,6519407,668102,80,6023,130000.0,43333.0,-69.0,-64.0,-69.0,-69.0,-69.0,-64.0,-68.0,-69.0,-77.0,-85.0,-77.0,-85.0,8.0,21.0,8.0,16.0,1
6178,F8:59:71:5A:E0:3D,3405994,685685527,187246,279127645,3218748,406557882,0,185491,237142392,180654,236564448,4837,577944,162991,16,189961,3195,0,552,144444.0,43333.0,-67.0,-73.0,-66.0,-70.0,-67.0,-72.0,-66.0,-69.0,-77.0,-85.0,-77.0,-85.0,10.0,12.0,11.0,15.0,1
6179,CC:2F:71:3E:C5:1F,3230185,407956930,11437,1399048,3218748,406557882,6,48791,4086404,40315,3082082,8476,1004322,12059,34,16401,186,6,830,144444.0,39000.0,-69.0,-72.0,-67.0,-60.0,-67.0,-69.0,-66.0,-59.0,-77.0,-85.0,-77.0,-85.0,8.0,13.0,10.0,25.0,1
6180,CC:2F:71:3F:1F:24,9734549,10366933170,6515800,9960375226,3218749,406557944,80,1500652,892077433,1492083,891048365,8569,1029068,1447132,619,6520520,668229,80,6023,130000.0,43333.0,-69.0,-63.0,-71.0,-68.0,-69.0,-63.0,-69.0,-67.0,-77.0,-85.0,-77.0,-85.0,8.0,22.0,6.0,17.0,1
6181,F8:59:71:5A:E0:3D,3406066,685785633,187310,279227101,3218756,406558532,0,185557,237242624,180719,236664562,4838,578062,163056,16,190025,3195,0,552,144444.0,43333.0,-67.0,-73.0,-66.0,-70.0,-67.0,-73.0,-65.0,-69.0,-77.0,-85.0,-77.0,-85.0,10.0,12.0,11.0,15.0,1
6182,CC:2F:71:3E:C5:1F,3230193,407957580,11437,1399048,3218756,406558532,6,48793,4086592,40316,3082152,8477,1004440,12060,34,16401,186,6,830,144444.0,39000.0,-69.0,-71.0,-67.0,-60.0,-67.0,-70.0,-67.0,-60.0,-77.0,-85.0,-77.0,-85.0,8.0,14.0,10.0,25.0,1
6183,CC:2F:71:3F:1F:24,9735915,10369037940,6517159,9962479408,3218756,406558532,80,1500913,892200007,1492344,891170939,8569,1029068,1447393,619,6521839,668331,80,6023,130000.0,43333.0,-69.0,-63.0,-70.0,-68.0,-69.0,-63.0,-69.0,-67.0,-77.0,-85.0,-77.0,-85.0,8.0,22.0,7.0,17.0,1
6184,F8:59:71:5A:E0:3D,3406131,685883737,187373,279325003,3218758,406558734,0,185620,237339644,180782,236761582,4838,578062,163119,16,190088,3195,0,552,144444.0,43333.0,-67.0,-73.0,-65.0,-70.0,-67.0,-73.0,-65.0,-69.0,-77.0,-85.0,-77.0,-85.0,10.0,12.0,12.0,15.0,1
6185,CC:2F:71:3E:C5:1F,3230197,407957984,11437,1399048,3218760,406558936,6,48793,4086592,40316,3082152,8477,1004440,12060,34,16401,186,6,830,144444.0,39000.0,-69.0,-71.0,-67.0,-60.0,-67.0,-70.0,-67.0,-60.0,-77.0,-85.0,-77.0,-85.0,8.0,14.0,10.0,25.0,1
6186,CC:2F:71:3F:1F:24,9737407,10371344640,6518647,9964785704,3218760,406558936,80,1501174,892321281,1492605,891292213,8569,1029068,1447654,619,6523355,668442,80,6023,130000.0,43333.0,-69.0,-63.0,-70.0,-68.0,-69.0,-63.0,-69.0,-67.0,-77.0,-85.0,-77.0,-85.0,8.0,22.0,7.0,17.0,1
6187,F8:59:71:5A:E0:3D,3406198,685982043,187436,279422905,3218762,406559138,0,185683,237436664,180845,236858602,4838,578062,163182,16,190151,3196,0,552,144444.0,43333.0,-67.0,-73.0,-65.0,-70.0,-66.0,-72.0,-65.0,-69.0,-77.0,-85.0,-77.0,-85.0,10.0,12.0,12.0,15.0,1
6188,CC:2F:71:3E:C5:1F,3230201,407958388,11437,1399048,3218764,406559340,6,48793,4086592,40316,3082152,8477,1004440,12060,34,16401,186,6,830,144444.0,39000.0,-69.0,-71.0,-67.0,-60.0,-67.0,-70.0,-67.0,-60.0,-77.0,-85.0,-77.0,-85.0,8.0,14.0,10.0,25.0,1
6189,CC:2F:71:3F:1F:24,9738649,10373256792,6519885,9966697452,3218764,406559340,80,1501467,892450619,1492898,891421551,8569,1029068,1447946,619,6524598,668619,80,6023,130000.0,43333.0,-69.0,-63.0,-70.0,-68.0,-68.0,-63.0,-69.0,-68.0,-77.0,-85.0,-77.0,-85.0,8.0,22.0,7.0,17.0,1
6190,F8:59:71:5A:E0:3D,3406279,686099173,187512,279539571,3218767,406559602,0,185759,237552270,180921,236974208,4838,578062,163258,16,190227,3197,0,552,144444.0,43333.0,-67.0,-73.0,-65.0,-70.0,-66.0,-72.0,-65.0,-69.0,-77.0,-85.0,-77.0,-85.0,10.0,12.0,12.0,15.0,1
6191,CC:2F:71:3E:C5:1F,3230206,407958852,11437,1399048,3218769,406559804,6,48793,4086592,40316,3082152,8477,1004440,12060,34,16401,186,6,830,144444.0,39000.0,-69.0,-71.0,-67.0,-60.0,-67.0,-70.0,-67.0,-60.0,-77.0,-85.0,-77.0,-85.0,8.0,14.0,10.0,25.0,1
6192,CC:2F:71:3F:1F:24,9739526,10374582078,6520757,9968022274,3218769,406559804,88,1501733,892602582,1493164,891573514,8569,1029068,1448207,619,6525475,668762,88,6023,130000.0,43333.0,-69.0,-63.0,-70.0,-68.0,-69.0,-63.0,-69.0,-68.0,-77.0,-85.0,-77.0,-85.0,8.0,22.0,7.0,17.0,1
6193,F8:59:71:5A:E0:3D,3406359,686214775,187586,279654567,3218773,406560208,0,185833,237666230,180995,237088168,4838,578062,163332,16,190301,3198,0,552,144444.0,43333.0,-67.0,-73.0,-65.0,-70.0,-66.0,-73.0,-65.0,-70.0,-77.0,-85.0,-77.0,-85.0,10.0,12.0,12.0,15.0,1
6194,CC:2F:71:3E:C5:1F,3230210,407959256,11437,1399048,3218773,406560208,6,48793,4086592,40316,3082152,8477,1004440,12060,34,16401,186,6,830,144444.0,39000.0,-69.0,-71.0,-67.0,-60.0,-67.0,-70.0,-67.0,-60.0,-77.0,-85.0,-77.0,-85.0,8.0,14.0,10.0,25.0,1
6195,CC:2F:71:3F:1F:24,9740120,10375471470,6521347,9968911262,3218773,406560208,88,1501925,892731040,1493356,891701972,8569,1029068,1448392,619,6526067,668875,88,6023,130000.0,43333.0,-69.0,-63.0,-69.0,-68.0,-69.0,-63.0,-69.0,-68.0,-77.0,-85.0,-77.0,-85.0,8.0,22.0,8.0,17.0,1
6196,F8:59:71:5A:E0:3D,3406441,686334897,187663,279774225,3218778,406560672,0,185910,237784810,181072,237206748,4838,578062,163409,16,190378,3198,0,552,144444.0,43333.0,-67.0,-73.0,-65.0,-70.0,-66.0,-73.0,-65.0,-69.0,-77.0,-85.0,-77.0,-85.0,10.0,12.0,12.0,15.0,1
6197,CC:2F:71:3E:C5:1F,3230215,407959720,11437,1399048,3218778,406560672,6,48793,4086592,40316,3082152,8477,1004440,12060,34,16401,186,6,830,144444.0,39000.0,-69.0,-71.0,-67.0,-60.0,-67.0,-70.0,-67.0,-60.0,-77.0,-85.0,-77.0,-85.0,8.0,14.0,10.0,25.0,1
6198,CC:2F:71:3F:1F:24,9740665,10376281822,6521887,9969721150,3218778,406560672,88,1502126,892883650,1493557,891854582,8569,1029068,1448585,619,6526604,669014,88,6023,130000.0,39000.0,-70.0,-63.0,-69.0,-69.0,-69.0,-62.0,-69.0,-68.0,-77.0,-85.0,-77.0,-85.0,7.0,22.0,8.0,16.0,1
6199,F8:59:71:5A:E0:3D,3406540,686480025,187756,279918747,3218784,406561278,0,186003,237928072,181165,237350010,4838,578062,163502,16,190471,3199,0,552,144444.0,43333.0,-67.0,-73.0,-65.0,-70.0,-66.0,-73.0,-65.0,-69.0,-77.0,-85.0,-77.0,-85.0,10.0,12.0,12.0,15.0,1
6200,CC:2F:71:3E:C5:1F,3230221,407960326,11437,1399048,3218784,406561278,6,48793,4086592,40316,3082152,8477,1004440,12060,34,16401,186,6,830,144444.0,39000.0,-69.0,-71.0,-67.0,-60.0,-67.0,-70.0,-67.0,-60.0,-77.0,-85.0,-77.0,-85.0,8.0,14.0,10.0,25.0,1
6201,CC:2F:71:3F:1F:24,9741415,10377406464,6522631,9970845186,3218784,406561278,88,1502329,893024067,1493760,891994999,8569,1029068,1448782,619,6527337,669292,88,6024,130000.0,39000.0,-69.0,-64.0,-69.0,-69.0,-69.0,-64.0,-69.0,-68.0,-77.0,-85.0,-77.0,-85.0,8.0,21.0,8.0,16.0,1
6202,F8:59:71:5A:E0:3D,3406632,686620087,187846,280058607,3218786,406561480,0,186092,238065132,181254,237487070,4838,578062,163591,16,190561,3200,0,552,144444.0,43333.0,-67.0,-73.0,-65.0,-70.0,-67.0,-73.0,-65.0,-69.0,-77.0,-85.0,-77.0,-85.0,10.0,12.0,12.0,15.0,1
6203,CC:2F:71:3E:C5:1F,3230226,407960790,11437,1399048,3218789,406561742,6,48793,4086592,40316,3082152,8477,1004440,12060,34,16401,186,6,830,144444.0,39000.0,-69.0,-71.0,-67.0,-60.0,-67.0,-70.0,-67.0,-60.0,-77.0,-85.0,-77.0,-85.0,8.0,14.0,10.0,25.0,1
6204,CC:2F:71:3F:1F:24,9742277,10378717234,6523488,9972155492,3218789,406561742,88,1502548,893161703,1493979,892132635,8569,1029068,1448995,619,6528208,669440,88,6025,115556.0,28889.0,-70.0,-64.0,-70.0,-68.0,-69.0,-64.0,-70.0,-68.0,-77.0,-85.0,-77.0,-85.0,7.0,21.0,7.0,17.0,1
6205,F8:59:71:5A:E0:3D,3406715,686738857,187922,280176711,3218793,406562146,0,186169,238183740,181331,237605678,4838,578062,163668,16,190637,3200,0,553,144444.0,43333.0,-67.0,-73.0,-65.0,-70.0,-66.0,-72.0,-65.0,-69.0,-77.0,-85.0,-77.0,-85.0,10.0,12.0,12.0,15.0,1
6206,CC:2F:71:3E:C5:1F,3230230,407961194,11437,1399048,3218793,406562146,6,48793,4086592,40316,3082152,8477,1004440,12060,34,16401,186,6,830,144444.0,39000.0,-69.0,-71.0,-67.0,-60.0,-67.0,-70.0,-67.0,-60.0,-77.0,-85.0,-77.0,-85.0,8.0,14.0,10.0,25.0,1
6207,CC:2F:71:3F:1F:24,9743074,10379924110,6524279,9973361762,3218795,406562348,88,1502743,893299041,1494174,892269973,8569,1029068,1449181,619,6528999,669482,88,6025,115556.0,28889.0,-69.0,-64.0,-70.0,-69.0,-68.0,-63.0,-69.0,-67.0,-77.0,-85.0,-77.0,-85.0,8.0,21.0,7.0,16.0,1
6208,F8:59:71:5A:E0:3D,3406787,686844933,187990,280282383,3218797,406562550,0,186237,238288516,181399,237710454,4838,578062,163736,16,190705,3201,0,553,144444.0,43333.0,-67.0,-73.0,-66.0,-69.0,-67.0,-73.0,-65.0,-69.0,-77.0,-85.0,-77.0,-85.0,10.0,12.0,11.0,16.0,1
6209,CC:2F:71:3E:C5:1F,3230234,407961598,11437,1399048,3218797,406562550,6,48793,4086592,40316,3082152,8477,1004440,12060,34,16401,186,6,830,144444.0,39000.0,-69.0,-71.0,-67.0,-60.0,-67.0,-70.0,-67.0,-60.0,-77.0,-85.0,-77.0,-85.0,8.0,14.0,10.0,25.0,1
6210,CC:2F:71:3F:1F:24,9744179,10381613962,6525380,9975051210,3218799,406562752,88,1502975,893426106,1494406,892397038,8569,1029068,1449413,619,6530100,669682,88,6025,115556.0,28889.0,-69.0,-63.0,-71.0,-68.0,-69.0,-63.0,-69.0,-68.0,-77.0,-85.0,-77.0,-85.0,8.0,22.0,6.0,17.0,1
6211,F8:59:71:5A:E0:3D,3406866,686959000,188063,280395713,3218803,406563287,0,186305,238393236,181467,237815174,4838,578062,163804,16,190778,3206,0,553,144444.0,43333.0,-67.0,-73.0,-65.0,-70.0,-67.0,-73.0,-65.0,-69.0,-77.0,-85.0,-77.0,-85.0,10.0,12.0,12.0,15.0,1
6212,CC:2F:71:3E:C5:1F,3230240,407962335,11437,1399048,3218803,406563287,6,48793,4086592,40316,3082152,8477,1004440,12060,34,16401,186,6,830,144444.0,39000.0,-69.0,-71.0,-67.0,-60.0,-67.0,-70.0,-67.0,-60.0,-77.0,-85.0,-77.0,-85.0,8.0,14.0,10.0,25.0,1
6213,CC:2F:71:3F:1F:24,9745296,10383327617,6526491,9976764128,3218805,406563489,88,1503219,893555308,1494650,892526240,8569,1029068,1449657,619,6531211,669724,88,6026,115556.0,28889.0,-69.0,-63.0,-70.0,-68.0,-68.0,-63.0,-69.0,-67.0,-77.0,-85.0,-77.0,-85.0,8.0,22.0,7.0,17.0,1
6214,F8:59:71:5A:E0:3D,3406933,687060212,188128,280496723,3218805,406563489,0,186375,238501036,181537,237922974,4838,578062,163874,16,190843,3208,0,553,144444.0,43333.0,-67.0,-73.0,-66.0,-70.0,-67.0,-72.0,-65.0,-69.0,-77.0,-85.0,-77.0,-85.0,10.0,12.0,11.0,15.0,1
6215,CC:2F:71:3E:C5:1F,3230244,407962739,11437,1399048,3218807,406563691,6,48793,4086592,40316,3082152,8477,1004440,12060,34,16401,186,6,830,144444.0,39000.0,-69.0,-71.0,-67.0,-60.0,-67.0,-70.0,-67.0,-60.0,-77.0,-85.0,-77.0,-85.0,8.0,14.0,10.0,25.0,1
6216,CC:2F:71:3F:1F:24,9746575,10385298131,6527766,9978734238,3218809,406563893,88,1503461,893677120,1494892,892648052,8569,1029068,1449899,619,6532446,669775,88,6026,115556.0,28889.0,-69.0,-63.0,-70.0,-68.0,-69.0,-63.0,-69.0,-68.0,-77.0,-85.0,-77.0,-85.0,8.0,22.0,7.0,17.0,1
6217,F8:59:71:5A:E0:3D,3407005,687163382,188194,280599287,3218811,406564095,0,186441,238602676,181603,238024614,4838,578062,163940,16,190909,3209,0,553,144444.0,43333.0,-67.0,-73.0,-65.0,-70.0,-66.0,-72.0,-65.0,-69.0,-77.0,-85.0,-77.0,-85.0,10.0,12.0,12.0,15.0,1
6218,CC:2F:71:3E:C5:1F,3230248,407963143,11437,1399048,3218811,406564095,6,48793,4086592,40316,3082152,8477,1004440,12060,34,16401,186,6,830,144444.0,39000.0,-69.0,-71.0,-67.0,-60.0,-67.0,-70.0,-67.0,-60.0,-77.0,-85.0,-77.0,-85.0,8.0,14.0,10.0,25.0,1
6219,CC:2F:71:3F:1F:24,9747637,10386930669,6528826,9980366574,3218811,406564095,88,1503675,893795784,1495106,892766716,8569,1029068,1450113,619,6533525,669821,88,6027,115556.0,28889.0,-68.0,-64.0,-67.0,-69.0,-68.0,-64.0,-67.0,-68.0,-77.0,-85.0,-77.0,-85.0,9.0,21.0,10.0,16.0,1
6220,F8:59:71:5A:E0:3D,3407073,687263048,188259,280698691,3218814,406564357,0,186506,238701342,181668,238123280,4838,578062,164005,16,190974,3209,0,553,144444.0,43333.0,-67.0,-73.0,-65.0,-70.0,-67.0,-73.0,-65.0,-70.0,-77.0,-85.0,-77.0,-85.0,10.0,12.0,12.0,15.0,1
6221,CC:2F:71:3E:C5:1F,3230251,407963405,11437,1399048,3218814,406564357,6,48793,4086592,40316,3082152,8477,1004440,12060,34,16401,186,6,830,144444.0,39000.0,-69.0,-71.0,-67.0,-60.0,-67.0,-70.0,-67.0,-60.0,-77.0,-85.0,-77.0,-85.0,8.0,14.0,10.0,25.0,1
6222,CC:2F:71:3F:1F:24,9748661,10388498535,6529847,9981934178,3218814,406564357,88,1503931,893917894,1495362,892888826,8569,1029068,1450369,619,6534567,669890,88,6027,86667.0,14444.0,-69.0,-63.0,-70.0,-69.0,-68.0,-63.0,-70.0,-69.0,-77.0,-85.0,-77.0,-85.0,8.0,22.0,7.0,16.0,1
6223,F8:59:71:5A:E0:3D,3407144,687363226,188324,280798263,3218820,406564963,0,186570,238799902,181732,238221840,4838,578062,164069,16,191039,3209,0,553,144444.0,43333.0,-67.0,-73.0,-66.0,-70.0,-67.0,-72.0,-65.0,-70.0,-77.0,-85.0,-77.0,-85.0,10.0,12.0,11.0,15.0,1
6224,CC:2F:71:3E:C5:1F,3230258,407964127,11438,1399164,3218820,406564963,6,48794,4086662,40317,3082222,8477,1004440,12060,34,16402,186,6,830,144444.0,39000.0,-68.0,-71.0,-69.0,-60.0,-67.0,-70.0,-67.0,-60.0,-77.0,-85.0,-77.0,-85.0,9.0,14.0,8.0,25.0,1
6225,CC:2F:71:3F:1F:24,9749712,10390096654,6530892,9983531691,3218820,406564963,88,1504227,894045267,1495658,893016199,8569,1029068,1450664,619,6535598,669904,88,6027,86667.0,14444.0,-69.0,-63.0,-70.0,-70.0,-69.0,-63.0,-69.0,-69.0,-77.0,-85.0,-77.0,-85.0,8.0,22.0,7.0,15.0,1
6226,F8:59:71:5A:E0:3D,3407209,687461330,188387,280896165,3218822,406565165,0,186633,238896922,181795,238318860,4838,578062,164132,16,191102,3210,0,553,144444.0,43333.0,-67.0,-73.0,-66.0,-70.0,-67.0,-72.0,-66.0,-70.0,-77.0,-85.0,-77.0,-85.0,10.0,12.0,11.0,15.0,1
6227,CC:2F:71:3E:C5:1F,3230261,407964389,11438,1399164,3218823,406565225,6,48795,4086732,40318,3082292,8477,1004440,12060,34,16402,186,6,830,144444.0,39000.0,-68.0,-71.0,-69.0,-60.0,-68.0,-70.0,-68.0,-60.0,-77.0,-85.0,-77.0,-85.0,9.0,14.0,8.0,25.0,1
6228,CC:2F:71:3F:1F:24,9750980,10392052014,6532157,9985486789,3218823,406565225,88,1504535,894174781,1495966,893145713,8569,1029068,1450972,619,6536855,669947,88,6028,104000.0,26000.0,-68.0,-63.0,-69.0,-70.0,-69.0,-63.0,-69.0,-70.0,-77.0,-85.0,-77.0,-85.0,9.0,22.0,8.0,15.0,1
6229,F8:59:71:5A:E0:3D,3407282,687563068,188452,280997175,3218830,406565893,0,186698,238997022,181860,238418960,4838,578062,164197,16,191167,3210,0,553,144444.0,43333.0,-67.0,-73.0,-66.0,-70.0,-67.0,-72.0,-66.0,-70.0,-77.0,-85.0,-77.0,-85.0,10.0,12.0,11.0,15.0,1
6230,CC:2F:71:3E:C5:1F,3230268,407965057,11438,1399164,3218830,406565893,6,48795,4086732,40318,3082292,8477,1004440,12060,34,16402,186,6,830,144444.0,39000.0,-68.0,-71.0,-69.0,-60.0,-68.0,-70.0,-68.0,-60.0,-77.0,-85.0,-77.0,-85.0,9.0,14.0,8.0,25.0,1
6231,CC:2F:71:3F:1F:24,9752880,10394997964,6534050,9988432071,3218830,406565893,88,1504860,894304909,1496290,893275723,8570,1029186,1451293,619,6538770,670132,88,6028,115556.0,28889.0,-69.0,-64.0,-69.0,-69.0,-68.0,-63.0,-69.0,-69.0,-77.0,-85.0,-77.0,-85.0,8.0,21.0,8.0,16.0,1
6232,F8:59:71:5A:E0:3D,3407351,687664729,188517,281098185,3218834,406566544,0,186763,239097122,181925,238519060,4838,578062,164262,16,191232,3211,0,553,144444.0,43333.0,-67.0,-73.0,-66.0,-70.0,-67.0,-72.0,-66.0,-70.0,-77.0,-85.0,-77.0,-85.0,10.0,12.0,11.0,15.0,1
6233,CC:2F:71:3E:C5:1F,3230272,407965708,11438,1399164,3218834,406566544,6,48795,4086732,40318,3082292,8477,1004440,12060,34,16402,186,6,830,144444.0,39000.0,-68.0,-71.0,-69.0,-60.0,-68.0,-70.0,-68.0,-60.0,-77.0,-85.0,-77.0,-85.0,9.0,14.0,8.0,25.0,1
6234,CC:2F:71:3F:1F:24,9754878,10398103555,6536044,9991537011,3218834,406566544,88,1505174,894435013,1496604,893405827,8570,1029186,1451607,619,6540722,670195,88,6028,115556.0,28889.0,-68.0,-63.0,-70.0,-70.0,-68.0,-63.0,-69.0,-70.0,-77.0,-85.0,-77.0,-85.0,9.0,22.0,7.0,15.0,1
6235,F8:59:71:5A:E0:3D,3407424,687767959,188583,281200749,3218841,406567210,0,186828,239197222,181990,238619160,4838,578062,164327,16,191298,3211,0,553,144444.0,43333.0,-67.0,-73.0,-66.0,-70.0,-67.0,-72.0,-65.0,-70.0,-77.0,-85.0,-77.0,-85.0,10.0,12.0,11.0,15.0,1
6236,CC:2F:71:3E:C5:1F,3230279,407966374,11438,1399164,3218841,406567210,6,48795,4086732,40318,3082292,8477,1004440,12060,34,16402,186,6,830,144444.0,39000.0,-68.0,-71.0,-69.0,-60.0,-68.0,-70.0,-68.0,-60.0,-77.0,-85.0,-77.0,-85.0,9.0,14.0,8.0,25.0,1
6237,CC:2F:71:3F:1F:24,9756838,10401136834,6537995,9994569175,3218843,406567659,88,1505497,894568192,1496927,893539006,8570,1029186,1451930,619,6542714,670380,88,6028,115556.0,28889.0,-69.0,-63.0,-71.0,-70.0,-68.0,-63.0,-69.0,-70.0,-77.0,-85.0,-77.0,-85.0,8.0,22.0,6.0,15.0,1
6238,F8:59:71:5A:E0:3D,3407492,687868066,188647,281300205,3218845,406567861,0,186892,239295782,182054,238717720,4838,578062,164391,16,191362,3211,0,553,144444.0,43333.0,-67.0,-73.0,-66.0,-70.0,-67.0,-73.0,-66.0,-70.0,-77.0,-85.0,-77.0,-85.0,10.0,12.0,11.0,15.0,1
6239,CC:2F:71:3E:C5:1F,3230283,407967025,11438,1399164,3218845,406567861,6,48795,4086732,40318,3082292,8477,1004440,12060,34,16402,186,6,830,144444.0,39000.0,-68.0,-71.0,-69.0,-60.0,-68.0,-70.0,-68.0,-60.0,-77.0,-85.0,-77.0,-85.0,9.0,14.0,8.0,25.0,1
6240,CC:2F:71:3F:1F:24,9758348,10403476564,6539503,9996908703,3218845,406567861,88,1505803,894694636,1497233,893665450,8570,1029186,1452236,619,6544223,670401,88,6028,115556.0,28889.0,-69.0,-64.0,-69.0,-70.0,-68.0,-63.0,-69.0,-69.0,-77.0,-85.0,-77.0,-85.0,8.0,21.0,8.0,15.0,1
6241,F8:59:71:5A:E0:3D,3407562,687968375,188711,281399661,3218851,406568714,0,186957,239395882,182119,238817820,4838,578062,164456,16,191426,3212,0,553,144444.0,43333.0,-67.0,-73.0,-66.0,-70.0,-67.0,-73.0,-66.0,-70.0,-77.0,-85.0,-77.0,-85.0,10.0,12.0,11.0,15.0,1
6242,CC:2F:71:3E:C5:1F,3230291,407968080,11438,1399164,3218853,406568916,6,48795,4086732,40318,3082292,8477,1004440,12060,34,16402,186,6,830,144444.0,39000.0,-68.0,-71.0,-69.0,-60.0,-68.0,-70.0,-68.0,-60.0,-77.0,-85.0,-77.0,-85.0,9.0,14.0,8.0,25.0,1
6243,CC:2F:71:3F:1F:24,9759830,10405763495,6540977,9999194579,3218853,406568916,88,1506080,894819060,1497510,893789874,8570,1029186,1452513,619,6545666,670416,88,6028,115556.0,28889.0,-69.0,-64.0,-69.0,-70.0,-68.0,-63.0,-69.0,-69.0,-77.0,-85.0,-77.0,-85.0,8.0,21.0,8.0,15.0,1
6244,F8:59:71:5A:E0:3D,3407629,688066764,188774,281497563,3218855,406569201,0,187020,239492916,182182,238914854,4838,578062,164518,16,191489,3213,0,553,144444.0,43333.0,-67.0,-73.0,-66.0,-70.0,-67.0,-72.0,-65.0,-70.0,-77.0,-85.0,-77.0,-85.0,10.0,12.0,11.0,15.0,1
6245,CC:2F:71:3E:C5:1F,3230294,407968589,11438,1399164,3218856,406569425,6,48795,4086732,40318,3082292,8477,1004440,12060,34,16402,186,6,830,144444.0,39000.0,-68.0,-71.0,-69.0,-60.0,-68.0,-70.0,-68.0,-60.0,-77.0,-85.0,-77.0,-85.0,9.0,14.0,8.0,25.0,1
6246,CC:2F:71:3F:1F:24,9761006,10407570180,6542148,10001000553,3218858,406569627,88,1506333,894945098,1497763,893915912,8570,1029186,1452764,619,6546868,670472,88,6028,115556.0,28889.0,-69.0,-64.0,-69.0,-70.0,-68.0,-63.0,-68.0,-69.0,-77.0,-85.0,-77.0,-85.0,8.0,21.0,8.0,15.0,1
6247,F8:59:71:5A:E0:3D,3407704,688173266,188842,281603235,3218862,406570031,0,187089,239599176,182251,239021114,4838,578062,164587,16,191557,3215,0,553,144444.0,43333.0,-67.0,-73.0,-66.0,-70.0,-67.0,-72.0,-65.0,-70.0,-77.0,-85.0,-77.0,-85.0,10.0,12.0,11.0,15.0,1
6248,CC:2F:71:3E:C5:1F,3230300,407969195,11438,1399164,3218862,406570031,6,48795,4086732,40318,3082292,8477,1004440,12060,34,16402,186,6,830,144444.0,39000.0,-68.0,-71.0,-69.0,-60.0,-68.0,-70.0,-68.0,-60.0,-77.0,-85.0,-77.0,-85.0,9.0,14.0,8.0,25.0,1
6249,CC:2F:71:3F:1F:24,9762006,10409092924,6543142,10002522691,3218864,406570233,88,1506540,895061918,1497970,894032732,8570,1029186,1452971,619,6547862,670523,88,6028,115556.0,26000.0,-69.0,-64.0,-70.0,-70.0,-68.0,-63.0,-69.0,-69.0,-77.0,-85.0,-77.0,-85.0,8.0,21.0,7.0,15.0,1
6250,F8:59:71:5A:E0:3D,3407771,688274478,188907,281704245,3218864,406570233,0,187153,239697736,182315,239119674,4838,578062,164651,16,191622,3215,0,553,144444.0,43333.0,-67.0,-73.0,-66.0,-70.0,-67.0,-73.0,-66.0,-70.0,-77.0,-85.0,-77.0,-85.0,10.0,12.0,11.0,15.0,1
6251,CC:2F:71:3E:C5:1F,3230302,407969397,11438,1399164,3218864,406570233,6,48795,4086732,40318,3082292,8477,1004440,12060,34,16402,186,6,830,144444.0,39000.0,-68.0,-71.0,-69.0,-60.0,-68.0,-70.0,-68.0,-60.0,-77.0,-85.0,-77.0,-85.0,9.0,14.0,8.0,25.0,1
6252,CC:2F:71:3F:1F:24,9762832,10410353370,6543966,10003782931,3218866,406570439,88,1506748,895178354,1498178,894149168,8570,1029186,1453177,619,6548686,670524,88,6028,115556.0,28889.0,-68.0,-64.0,-70.0,-70.0,-68.0,-63.0,-69.0,-69.0,-77.0,-85.0,-77.0,-85.0,9.0,21.0,7.0,15.0,1
6253,F8:59:71:5A:E0:3D,3407838,688370013,188968,281799039,3218870,406570974,0,187215,239793216,182377,239215154,4838,578062,164713,16,191683,3215,0,553,144444.0,43333.0,-68.0,-73.0,-66.0,-70.0,-67.0,-72.0,-66.0,-70.0,-77.0,-85.0,-77.0,-85.0,9.0,12.0,11.0,15.0,1
6254,CC:2F:71:3E:C5:1F,3230312,407970542,11438,1399164,3218874,406571378,6,48795,4086732,40318,3082292,8477,1004440,12060,34,16402,186,6,830,144444.0,39000.0,-68.0,-71.0,-69.0,-60.0,-68.0,-70.0,-68.0,-60.0,-77.0,-85.0,-77.0,-85.0,9.0,14.0,8.0,25.0,1
6255,CC:2F:71:3F:1F:24,9764143,10412368667,6545269,10005797289,3218874,406571378,88,1507026,895302942,1498456,894273756,8570,1029186,1453455,619,6549989,670597,88,6028,115556.0,28889.0,-68.0,-64.0,-70.0,-70.0,-68.0,-63.0,-69.0,-69.0,-77.0,-85.0,-77.0,-85.0,9.0,21.0,7.0,15.0,1
6256,F8:59:71:5A:E0:3D,3407911,688471835,189033,281900049,3218878,406571786,0,187280,239893316,182442,239315254,4838,578062,164778,16,191748,3217,0,553,144444.0,43333.0,-67.0,-73.0,-66.0,-70.0,-67.0,-72.0,-65.0,-70.0,-77.0,-85.0,-77.0,-85.0,10.0,12.0,11.0,15.0,1
6257,CC:2F:71:3E:C5:1F,3230316,407970950,11438,1399164,3218878,406571786,6,48795,4086732,40318,3082292,8477,1004440,12060,34,16402,186,6,830,144444.0,39000.0,-68.0,-71.0,-69.0,-60.0,-68.0,-70.0,-68.0,-60.0,-77.0,-85.0,-77.0,-85.0,9.0,14.0,8.0,25.0,1
6258,CC:2F:71:3F:1F:24,9765047,10413745935,6546168,10007174087,3218879,406571848,88,1507228,895421628,1498658,894392442,8570,1029186,1453657,619,6550888,670614,88,6028,115556.0,28889.0,-69.0,-64.0,-69.0,-70.0,-68.0,-63.0,-68.0,-70.0,-77.0,-85.0,-77.0,-85.0,8.0,21.0,8.0,15.0,1
6259,F8:59:71:5A:E0:3D,3407985,688580941,189103,282008829,3218882,406572112,0,187351,240001346,182512,239423166,4839,578180,164849,16,191818,3217,0,554,144444.0,43333.0,-67.0,-72.0,-66.0,-71.0,-67.0,-72.0,-65.0,-70.0,-77.0,-85.0,-77.0,-85.0,10.0,13.0,11.0,14.0,1
6260,CC:2F:71:3E:C5:1F,3230322,407971478,11438,1399164,3218884,406572314,6,48797,4086920,40319,3082362,8478,1004558,12061,34,16402,186,6,830,144444.0,39000.0,-69.0,-71.0,-67.0,-60.0,-68.0,-71.0,-68.0,-60.0,-77.0,-85.0,-77.0,-85.0,8.0,14.0,10.0,25.0,1
6261,CC:2F:71:3F:1F:24,9765922,10415068405,6547037,10008496031,3218885,406572374,88,1507455,895548315,1498885,894519129,8570,1029186,1453884,619,6551757,670710,88,6028,115556.0,28889.0,-69.0,-63.0,-70.0,-70.0,-68.0,-63.0,-68.0,-70.0,-77.0,-85.0,-77.0,-85.0,8.0,22.0,7.0,15.0,1
6262,F8:59:71:5A:E0:3D,3408064,688693495,189175,282120717,3218889,406572778,0,187422,240110728,182583,239532548,4839,578180,164920,16,191889,3220,0,554,144444.0,43333.0,-67.0,-72.0,-66.0,-70.0,-67.0,-72.0,-65.0,-70.0,-77.0,-85.0,-77.0,-85.0,10.0,13.0,11.0,15.0,1
6263,CC:2F:71:3E:C5:1F,3230327,407971942,11438,1399164,3218889,406572778,6,48797,4086920,40319,3082362,8478,1004558,12061,34,16402,186,6,830,144444.0,39000.0,-69.0,-71.0,-67.0,-60.0,-68.0,-71.0,-68.0,-60.0,-77.0,-85.0,-77.0,-85.0,8.0,14.0,10.0,25.0,1
6264,CC:2F:71:3F:1F:24,9767162,10416977265,6548273,10010404487,3218889,406572778,88,1507699,895680309,1499129,894651123,8570,1029186,1454128,619,6552968,670837,88,6028,115556.0,28889.0,-69.0,-63.0,-70.0,-70.0,-68.0,-63.0,-69.0,-70.0,-77.0,-85.0,-77.0,-85.0,8.0,22.0,7.0,15.0,1
6265,F8:59:71:5A:E0:3D,3408131,688794707,189240,282221727,3218891,406572980,0,187488,240212368,182649,239634188,4839,578180,164986,16,191955,3222,0,554,144444.0,43333.0,-67.0,-73.0,-65.0,-70.0,-67.0,-73.0,-66.0,-70.0,-77.0,-85.0,-77.0,-85.0,10.0,12.0,12.0,15.0,1
6266,CC:2F:71:3E:C5:1F,3230333,407972714,11438,1399164,3218895,406573550,6,48797,4086920,40319,3082362,8478,1004558,12061,34,16402,186,6,830,144444.0,39000.0,-69.0,-71.0,-67.0,-60.0,-68.0,-71.0,-68.0,-60.0,-77.0,-85.0,-77.0,-85.0,8.0,14.0,10.0,25.0,1
6267,CC:2F:71:3F:1F:24,9768161,10418503215,6549266,10011929665,3218895,406573550,88,1507932,895799863,1499362,894770677,8570,1029186,1454361,619,6553986,670930,88,6028,115556.0,28889.0,-69.0,-63.0,-70.0,-70.0,-68.0,-63.0,-69.0,-70.0,-77.0,-85.0,-77.0,-85.0,8.0,22.0,7.0,15.0,1
6268,F8:59:71:5A:E0:3D,3408206,688898305,189306,282324291,3218900,406574014,0,187554,240314008,182715,239735828,4839,578180,165052,16,192021,3223,0,554,144444.0,43333.0,-68.0,-73.0,-66.0,-70.0,-67.0,-72.0,-65.0,-70.0,-77.0,-85.0,-77.0,-85.0,9.0,12.0,11.0,15.0,1
6269,CC:2F:71:3E:C5:1F,3230338,407973178,11438,1399164,3218900,406574014,6,48797,4086920,40319,3082362,8478,1004558,12061,34,16402,186,6,830,144444.0,39000.0,-69.0,-71.0,-67.0,-60.0,-68.0,-71.0,-68.0,-60.0,-77.0,-85.0,-77.0,-85.0,8.0,14.0,10.0,25.0,1
6270,CC:2F:71:3F:1F:24,9768906,10419631079,6550006,10013057065,3218900,406574014,88,1508111,895915841,1499541,894886655,8570,1029186,1454540,619,6554704,671006,88,6028,117000.0,39000.0,-68.0,-63.0,-68.0,-70.0,-68.0,-63.0,-68.0,-70.0,-77.0,-85.0,-77.0,-85.0,9.0,22.0,9.0,15.0,1
6271,F8:59:71:5A:E0:3D,3408274,689001071,189372,282426855,3218902,406574216,0,187620,240415648,182781,239837468,4839,578180,165118,16,192087,3223,0,554,144444.0,43333.0,-68.0,-73.0,-66.0,-70.0,-67.0,-72.0,-65.0,-70.0,-77.0,-85.0,-77.0,-85.0,9.0,12.0,11.0,15.0,1
6272,CC:2F:71:3E:C5:1F,3230340,407973380,11438,1399164,3218902,406574216,6,48797,4086920,40319,3082362,8478,1004558,12061,34,16402,186,6,830,144444.0,39000.0,-69.0,-71.0,-67.0,-60.0,-68.0,-71.0,-68.0,-60.0,-77.0,-85.0,-77.0,-85.0,8.0,14.0,10.0,25.0,1
6273,CC:2F:71:3F:1F:24,9769940,10421208919,6551038,10014634703,3218902,406574216,88,1508332,896041437,1499762,895012251,8570,1029186,1454761,619,6555758,671132,88,6028,115556.0,28889.0,-69.0,-63.0,-70.0,-71.0,-69.0,-63.0,-69.0,-70.0,-77.0,-85.0,-77.0,-85.0,8.0,22.0,7.0,14.0,1
6274,F8:59:71:5A:E0:3D,3408348,689107349,189440,282532527,3218908,406574822,0,187687,240518828,182848,239940648,4839,578180,165185,16,192155,3224,0,554,144444.0,43333.0,-68.0,-73.0,-66.0,-70.0,-67.0,-72.0,-65.0,-70.0,-77.0,-85.0,-77.0,-85.0,9.0,12.0,11.0,15.0,1
6275,CC:2F:71:3E:C5:1F,3230346,407973986,11438,1399164,3218908,406574822,6,48797,4086920,40319,3082362,8478,1004558,12061,34,16402,186,6,830,144444.0,39000.0,-69.0,-71.0,-67.0,-60.0,-68.0,-71.0,-68.0,-60.0,-77.0,-85.0,-77.0,-85.0,8.0,14.0,10.0,25.0,1
6276,CC:2F:71:3F:1F:24,9771505,10423628075,6552597,10017053253,3218908,406574822,88,1508596,896164317,1500026,895135131,8570,1029186,1455025,619,6557317,671237,88,6028,115556.0,28889.0,-70.0,-63.0,-69.0,-70.0,-68.0,-63.0,-69.0,-70.0,-77.0,-85.0,-77.0,-85.0,7.0,22.0,8.0,15.0,1
6277,F8:59:71:5A:E0:3D,3408416,689208621,189505,282633537,3218911,406575084,0,187753,240620468,182914,240042288,4839,578180,165251,16,192220,3224,0,554,144444.0,43333.0,-68.0,-73.0,-66.0,-70.0,-67.0,-73.0,-66.0,-70.0,-77.0,-85.0,-77.0,-85.0,9.0,12.0,11.0,15.0,1
6278,CC:2F:71:3E:C5:1F,3230349,407974248,11438,1399164,3218911,406575084,6,48797,4086920,40319,3082362,8478,1004558,12061,34,16402,186,6,830,144444.0,39000.0,-69.0,-71.0,-67.0,-60.0,-68.0,-71.0,-68.0,-60.0,-77.0,-85.0,-77.0,-85.0,8.0,14.0,10.0,25.0,1
6279,CC:2F:71:3F:1F:24,9773540,10426792865,6554629,10020217781,3218911,406575084,88,1508925,896300397,1500355,895271211,8570,1029186,1455354,619,6559347,671572,88,6028,115556.0,28889.0,-68.0,-63.0,-68.0,-70.0,-68.0,-63.0,-69.0,-70.0,-77.0,-85.0,-77.0,-85.0,9.0,22.0,9.0,15.0,1
6280,F8:59:71:5A:E0:3D,3408488,689311791,189571,282736101,3218917,406575690,0,187819,240722136,182980,240143956,4839,578180,165317,16,192286,3226,0,555,144444.0,43333.0,-68.0,-73.0,-66.0,-70.0,-67.0,-72.0,-65.0,-70.0,-77.0,-85.0,-77.0,-85.0,9.0,12.0,11.0,15.0,1
6281,CC:2F:71:3E:C5:1F,3230355,407974854,11438,1399164,3218917,406575690,6,48797,4086920,40319,3082362,8478,1004558,12061,34,16402,186,6,830,144444.0,39000.0,-69.0,-71.0,-67.0,-60.0,-68.0,-71.0,-68.0,-60.0,-77.0,-85.0,-77.0,-85.0,8.0,14.0,10.0,25.0,1
6282,CC:2F:71:3F:1F:24,9774966,10428994103,6556049,10022418413,3218917,406575690,88,1509179,896422629,1500609,895393443,8570,1029186,1455608,619,6560749,671748,88,6029,115556.0,28889.0,-69.0,-63.0,-70.0,-70.0,-69.0,-63.0,-68.0,-69.0,-77.0,-85.0,-77.0,-85.0,8.0,22.0,7.0,15.0,1
6283,F8:59:71:5A:E0:3D,3408554,689411449,189635,282835557,3218919,406575892,0,187882,240819156,183043,240240976,4839,578180,165380,16,192350,3227,0,555,144444.0,43333.0,-68.0,-73.0,-66.0,-70.0,-67.0,-72.0,-66.0,-70.0,-77.0,-85.0,-77.0,-85.0,9.0,12.0,11.0,15.0,1
6284,CC:2F:71:3E:C5:1F,3230357,407975056,11438,1399164,3218919,406575892,6,48797,4086920,40319,3082362,8478,1004558,12061,34,16402,186,6,830,144444.0,39000.0,-69.0,-71.0,-67.0,-60.0,-68.0,-71.0,-68.0,-60.0,-77.0,-85.0,-77.0,-85.0,8.0,14.0,10.0,25.0,1
6285,CC:2F:71:3F:1F:24,9776495,10431363831,6557576,10024787939,3218919,406575892,88,1509477,896548515,1500907,895519329,8570,1029186,1455906,619,6562295,671864,88,6031,115556.0,28889.0,-68.0,-63.0,-69.0,-70.0,-68.0,-63.0,-69.0,-70.0,-77.0,-85.0,-77.0,-85.0,9.0,22.0,8.0,15.0,1
6286,F8:59:71:5A:E0:3D,3408626,689512957,189700,282936399,3218926,406576558,0,187947,240919256,183108,240341076,4839,578180,165445,16,192415,3227,0,555,144444.0,43333.0,-67.0,-73.0,-66.0,-70.0,-67.0,-73.0,-65.0,-70.0,-77.0,-85.0,-77.0,-85.0,10.0,12.0,11.0,15.0,1
6287,CC:2F:71:3E:C5:1F,3230364,407975722,11438,1399164,3218926,406576558,6,48797,4086920,40319,3082362,8478,1004558,12061,34,16402,186,6,830,144444.0,39000.0,-69.0,-71.0,-67.0,-60.0,-68.0,-71.0,-68.0,-60.0,-77.0,-85.0,-77.0,-85.0,8.0,14.0,10.0,25.0,1
6288,CC:2F:71:3F:1F:24,9777855,10433449961,6558929,10026873403,3218926,406576558,88,1509777,896677674,1501207,895648488,8570,1029186,1456206,619,6563639,671990,88,6031,115556.0,28889.0,-69.0,-63.0,-70.0,-70.0,-68.0,-63.0,-69.0,-70.0,-77.0,-85.0,-77.0,-85.0,8.0,22.0,7.0,15.0,1
6289,F8:59:71:5A:E0:3D,3408691,689611061,189763,283034301,3218928,406576760,0,188011,241017816,183172,240439636,4839,578180,165509,16,192478,3227,0,555,144444.0,43333.0,-68.0,-73.0,-65.0,-71.0,-67.0,-72.0,-65.0,-70.0,-77.0,-85.0,-77.0,-85.0,9.0,12.0,12.0,14.0,1
6290,CC:2F:71:3E:C5:1F,3230366,407975924,11438,1399164,3218928,406576760,6,48797,4086920,40319,3082362,8478,1004558,12061,34,16402,186,6,830,144444.0,39000.0,-69.0,-71.0,-67.0,-60.0,-68.0,-71.0,-68.0,-60.0,-77.0,-85.0,-77.0,-85.0,8.0,14.0,10.0,25.0,1
6291,CC:2F:71:3F:1F:24,9778800,10434896689,6559872,10028319929,3218928,406576760,88,1510031,896798114,1501461,895768928,8570,1029186,1456460,619,6564578,671995,88,6031,115556.0,28889.0,-68.0,-63.0,-70.0,-71.0,-68.0,-63.0,-70.0,-70.0,-77.0,-85.0,-77.0,-85.0,9.0,22.0,7.0,14.0,1
6292,F8:59:71:5A:E0:3D,3408759,689709493,189826,283132203,3218933,406577290,0,188073,241113296,183234,240535116,4839,578180,165571,16,192541,3227,0,555,144444.0,43333.0,-68.0,-73.0,-66.0,-71.0,-67.0,-73.0,-66.0,-70.0,-77.0,-85.0,-77.0,-85.0,9.0,12.0,11.0,14.0,1
6293,CC:2F:71:3E:C5:1F,3230372,407976727,11438,1399164,3218934,406577563,6,48797,4086920,40319,3082362,8478,1004558,12061,34,16402,186,6,830,144444.0,39000.0,-69.0,-71.0,-67.0,-60.0,-68.0,-71.0,-68.0,-60.0,-77.0,-85.0,-77.0,-85.0,8.0,14.0,10.0,25.0,1
6294,CC:2F:71:3F:1F:24,9779970,10436689826,6561034,10030112061,3218936,406577765,88,1510308,896919642,1501738,895890456,8570,1029186,1456737,619,6565727,672007,88,6031,115556.0,28889.0,-68.0,-63.0,-70.0,-70.0,-68.0,-63.0,-69.0,-70.0,-77.0,-85.0,-77.0,-85.0,9.0,22.0,7.0,15.0,1
6295,F8:59:71:5A:E0:3D,3408826,689807930,189889,283230105,3218937,406577825,0,188136,241210316,183297,240632136,4839,578180,165634,16,192604,3227,0,555,144444.0,43333.0,-68.0,-73.0,-66.0,-70.0,-67.0,-73.0,-66.0,-70.0,-77.0,-85.0,-77.0,-85.0,9.0,12.0,11.0,15.0,1
6296,CC:2F:71:3E:C5:1F,3230375,407976989,11438,1399164,3218937,406577825,6,48797,4086920,40319,3082362,8478,1004558,12061,34,16402,186,6,830,144444.0,39000.0,-69.0,-71.0,-67.0,-60.0,-68.0,-71.0,-68.0,-60.0,-77.0,-85.0,-77.0,-85.0,8.0,14.0,10.0,25.0,1
6297,CC:2F:71:3F:1F:24,9780979,10438236804,6562040,10031658777,3218939,406578027,88,1510513,897034518,1501943,896005332,8570,1029186,1456942,619,6566760,672130,88,6031,115556.0,28889.0,-69.0,-63.0,-69.0,-70.0,-68.0,-63.0,-69.0,-70.0,-77.0,-85.0,-77.0,-85.0,8.0,22.0,8.0,15.0,1
6298,F8:59:71:5A:E0:3D,3408896,689907992,189953,283329561,3218943,406578431,0,188200,241308876,183361,240730696,4839,578180,165698,16,192668,3231,0,555,144444.0,43333.0,-67.0,-73.0,-66.0,-70.0,-67.0,-73.0,-66.0,-70.0,-77.0,-85.0,-77.0,-85.0,10.0,12.0,11.0,15.0,1
6299,CC:2F:71:3E:C5:1F,3230381,407977595,11438,1399164,3218943,406578431,6,48797,4086920,40319,3082362,8478,1004558,12061,34,16402,186,6,830,144444.0,39000.0,-69.0,-71.0,-67.0,-60.0,-68.0,-71.0,-68.0,-60.0,-77.0,-85.0,-77.0,-85.0,8.0,14.0,10.0,25.0,1
6300,CC:2F:71:3F:1F:24,9782322,10440301004,6563379,10033722573,3218943,406578431,88,1510799,897161915,1502229,896132729,8570,1029186,1457228,619,6568081,672368,88,6031,115556.0,28889.0,-69.0,-63.0,-69.0,-70.0,-69.0,-63.0,-69.0,-70.0,-77.0,-85.0,-77.0,-85.0,8.0,22.0,8.0,15.0,1
6301,F8:59:71:5A:E0:3D,3408962,690007650,190017,283429017,3218945,406578633,0,188264,241407436,183425,240829256,4839,578180,165762,16,192732,3231,0,555,144444.0,43333.0,-67.0,-72.0,-66.0,-70.0,-67.0,-72.0,-66.0,-70.0,-77.0,-85.0,-77.0,-85.0,10.0,13.0,11.0,15.0,1
6302,CC:2F:71:3E:C5:1F,3230384,407977857,11438,1399164,3218946,406578693,6,48797,4086920,40319,3082362,8478,1004558,12061,34,16402,186,6,830,144444.0,39000.0,-69.0,-71.0,-67.0,-60.0,-68.0,-71.0,-68.0,-60.0,-77.0,-85.0,-77.0,-85.0,8.0,14.0,10.0,25.0,1
6303,CC:2F:71:3F:1F:24,9783497,10442109130,6564551,10035530437,3218946,406578693,88,1511073,897286147,1502503,896256961,8570,1029186,1457502,619,6569271,672553,88,6031,115556.0,28889.0,-69.0,-63.0,-69.0,-70.0,-68.0,-63.0,-69.0,-70.0,-77.0,-85.0,-77.0,-85.0,8.0,22.0,8.0,15.0,1
6304,F8:59:71:5A:E0:3D,3409030,690106016,190080,283526919,3218950,406579097,0,188327,241504456,183488,240926276,4839,578180,165825,16,192795,3231,0,555,144444.0,43333.0,-67.0,-73.0,-65.0,-70.0,-67.0,-72.0,-65.0,-70.0,-77.0,-85.0,-77.0,-85.0,10.0,12.0,12.0,15.0,1
6305,CC:2F:71:3E:C5:1F,3230388,407978261,11438,1399164,3218950,406579097,6,48797,4086920,40319,3082362,8478,1004558,12061,34,16402,186,6,830,144444.0,39000.0,-69.0,-71.0,-67.0,-60.0,-68.0,-71.0,-68.0,-60.0,-77.0,-85.0,-77.0,-85.0,8.0,14.0,10.0,25.0,1
6306,CC:2F:71:3F:1F:24,9784355,10443412240,6565403,10036832941,3218952,406579299,88,1511303,897402295,1502733,896373109,8570,1029186,1457732,619,6570121,672627,88,6031,115556.0,28889.0,-69.0,-63.0,-69.0,-70.0,-68.0,-63.0,-69.0,-70.0,-77.0,-85.0,-77.0,-85.0,8.0,22.0,8.0,15.0,1
6307,F8:59:71:5A:E0:3D,3409097,690202884,190143,283623383,3218954,406579501,0,188390,241601476,183551,241023296,4839,578180,165888,16,192858,3231,0,555,144444.0,43333.0,-67.0,-72.0,-66.0,-71.0,-67.0,-72.0,-66.0,-70.0,-77.0,-85.0,-77.0,-85.0,10.0,13.0,11.0,14.0,1
6308,CC:2F:71:3E:C5:1F,3230393,407978781,11439,1399280,3218954,406579501,6,48798,4086990,40320,3082432,8478,1004558,12061,34,16403,186,6,830,144444.0,39000.0,-68.0,-71.0,-68.0,-60.0,-68.0,-71.0,-68.0,-60.0,-77.0,-85.0,-77.0,-85.0,9.0,14.0,9.0,25.0,1
6309,CC:2F:71:3F:1F:24,9785191,10444685504,6566237,10038106003,3218954,406579501,88,1511550,897521863,1502980,896492677,8570,1029186,1457979,619,6570957,672631,88,6031,115556.0,28889.0,-69.0,-63.0,-70.0,-71.0,-68.0,-63.0,-69.0,-70.0,-77.0,-85.0,-77.0,-85.0,8.0,22.0,7.0,14.0,1
6310,F8:59:71:5A:E0:3D,3409162,690299494,190205,283719731,3218957,406579763,0,188452,241696956,183613,241118776,4839,578180,165950,16,192920,3231,0,555,144444.0,43333.0,-67.0,-73.0,-66.0,-70.0,-67.0,-73.0,-65.0,-70.0,-77.0,-85.0,-77.0,-85.0,10.0,12.0,11.0,15.0,1
6311,CC:2F:71:3E:C5:1F,3230396,407979043,11439,1399280,3218957,406579763,6,48799,4087060,40321,3082502,8478,1004558,12061,34,16403,186,6,830,144444.0,39000.0,-68.0,-71.0,-68.0,-60.0,-68.0,-70.0,-68.0,-60.0,-77.0,-85.0,-77.0,-85.0,9.0,14.0,9.0,25.0,1
6312,CC:2F:71:3F:1F:24,9786017,10445932320,6567058,10039352355,3218959,406579965,88,1511786,897639186,1503216,896610000,8570,1029186,1458215,619,6571778,672691,88,6031,104000.0,26000.0,-69.0,-63.0,-69.0,-69.0,-68.0,-63.0,-69.0,-68.0,-77.0,-85.0,-77.0,-85.0,8.0,22.0,8.0,16.0,1
6313,F8:59:71:5A:E0:3D,3409231,690398002,190268,283817633,3218963,406580369,0,188515,241793976,183676,241215796,4839,578180,166013,16,192983,3233,0,555,144444.0,43333.0,-67.0,-72.0,-65.0,-70.0,-67.0,-72.0,-65.0,-70.0,-77.0,-85.0,-77.0,-85.0,10.0,13.0,12.0,15.0,1
6314,CC:2F:71:3E:C5:1F,3230402,407979649,11439,1399280,3218963,406580369,6,48799,4087060,40321,3082502,8478,1004558,12061,34,16403,186,6,830,144444.0,39000.0,-68.0,-71.0,-68.0,-60.0,-68.0,-70.0,-68.0,-60.0,-77.0,-85.0,-77.0,-85.0,9.0,14.0,9.0,25.0,1
6315,CC:2F:71:3F:1F:24,9786937,10447335476,6567974,10040755107,3218963,406580369,88,1511999,897757610,1503429,896728424,8570,1029186,1458428,619,6572694,672884,88,6031,117000.0,39000.0,-67.0,-64.0,-71.0,-68.0,-67.0,-63.0,-71.0,-68.0,-77.0,-85.0,-77.0,-85.0,10.0,21.0,6.0,17.0,1
6316,F8:59:71:5A:E0:3D,3409298,690499214,190333,283918643,3218965,406580571,0,188579,241892592,183740,241314412,4839,578180,166077,16,193048,3233,0,555,144444.0,43333.0,-67.0,-72.0,-65.0,-70.0,-67.0,-72.0,-65.0,-70.0,-77.0,-85.0,-77.0,-85.0,10.0,13.0,12.0,15.0,1
6317,CC:2F:71:3E:C5:1F,3230404,407979851,11439,1399280,3218965,406580571,6,48799,4087060,40321,3082502,8478,1004558,12061,34,16403,186,6,830,144444.0,39000.0,-68.0,-71.0,-68.0,-60.0,-68.0,-70.0,-68.0,-60.0,-77.0,-85.0,-77.0,-85.0,9.0,14.0,9.0,25.0,1
6318,CC:2F:71:3F:1F:24,9788100,10449127320,6569135,10042546749,3218965,406580571,88,1512207,897872558,1503637,896843372,8570,1029186,1458636,619,6573855,673050,88,6031,130000.0,43333.0,-67.0,-63.0,-71.0,-68.0,-67.0,-63.0,-71.0,-68.0,-77.0,-85.0,-77.0,-85.0,10.0,22.0,6.0,17.0,1
6319,F8:59:71:5A:E0:3D,3409371,690602444,190399,284021207,3218972,406581237,0,188645,241994232,183806,241416052,4839,578180,166143,16,193114,3233,0,555,144444.0,43333.0,-67.0,-73.0,-66.0,-69.0,-67.0,-72.0,-65.0,-69.0,-77.0,-85.0,-77.0,-85.0,10.0,12.0,11.0,16.0,1
6320,CC:2F:71:3E:C5:1F,3230411,407980517,11439,1399280,3218972,406581237,6,48799,4087060,40321,3082502,8478,1004558,12061,34,16403,186,6,830,144444.0,39000.0,-68.0,-71.0,-68.0,-60.0,-68.0,-70.0,-68.0,-60.0,-77.0,-85.0,-77.0,-85.0,9.0,14.0,9.0,25.0,1
6321,CC:2F:71:3F:1F:24,9789475,10451243306,6570503,10044662069,3218972,406581237,88,1512446,897998610,1503876,896969424,8570,1029186,1458875,619,6575223,673279,88,6034,104000.0,26000.0,-69.0,-63.0,-69.0,-68.0,-68.0,-63.0,-69.0,-68.0,-77.0,-85.0,-77.0,-85.0,8.0,22.0,8.0,17.0,1
6322,F8:59:71:5A:E0:3D,3409439,690705210,190465,284123771,3218974,406581439,0,188711,242095914,183872,241517734,4839,578180,166209,16,193180,3233,0,555,144444.0,43333.0,-68.0,-72.0,-66.0,-70.0,-67.0,-72.0,-66.0,-70.0,-77.0,-85.0,-77.0,-85.0,9.0,13.0,11.0,15.0,1
6323,CC:2F:71:3E:C5:1F,3230413,407980719,11439,1399280,3218974,406581439,6,48799,4087060,40321,3082502,8478,1004558,12061,34,16403,186,6,830,144444.0,39000.0,-68.0,-71.0,-68.0,-60.0,-68.0,-70.0,-68.0,-60.0,-77.0,-85.0,-77.0,-85.0,9.0,14.0,9.0,25.0,1
6324,CC:2F:71:3F:1F:24,9790831,10453330862,6571857,10046749423,3218974,406581439,88,1512722,898125061,1504152,897095875,8570,1029186,1459151,619,6576574,673385,88,6034,115556.0,28889.0,-69.0,-63.0,-69.0,-70.0,-69.0,-63.0,-69.0,-69.0,-77.0,-85.0,-77.0,-85.0,8.0,22.0,8.0,15.0,1
6325,F8:59:71:5A:E0:3D,3409508,690806624,190530,284224781,3218978,406581843,0,188777,242197554,183938,241619374,4839,578180,166275,16,193245,3234,0,555,144444.0,43333.0,-67.0,-72.0,-66.0,-70.0,-67.0,-72.0,-66.0,-70.0,-77.0,-85.0,-77.0,-85.0,10.0,13.0,11.0,15.0,1
6326,CC:2F:71:3E:C5:1F,3230419,407981325,11439,1399280,3218980,406582045,6,48799,4087060,40321,3082502,8478,1004558,12061,34,16403,186,6,830,144444.0,39000.0,-68.0,-71.0,-68.0,-60.0,-68.0,-70.0,-68.0,-60.0,-77.0,-85.0,-77.0,-85.0,9.0,14.0,9.0,25.0,1
6327,CC:2F:71:3F:1F:24,9792038,10455186566,6573058,10048604521,3218980,406582045,88,1512975,898247033,1504405,897217847,8570,1029186,1459404,619,6577778,673443,88,6034,115556.0,28889.0,-70.0,-63.0,-70.0,-70.0,-69.0,-63.0,-69.0,-70.0,-77.0,-85.0,-77.0,-85.0,7.0,22.0,7.0,15.0,1
6328,F8:59:71:5A:E0:3D,3409574,690903296,190592,284321129,3218982,406582167,0,188839,242293034,184000,241714854,4839,578180,166337,16,193307,3234,0,555,144444.0,43333.0,-67.0,-72.0,-66.0,-70.0,-67.0,-72.0,-66.0,-70.0,-77.0,-85.0,-77.0,-85.0,10.0,13.0,11.0,15.0,1
6329,CC:2F:71:3E:C5:1F,3230423,407981649,11439,1399280,3218984,406582369,6,48801,4087248,40322,3082572,8479,1004676,12062,34,16403,186,6,831,144444.0,39000.0,-69.0,-72.0,-68.0,-60.0,-68.0,-70.0,-68.0,-59.0,-77.0,-85.0,-77.0,-85.0,8.0,13.0,9.0,25.0,1
6330,CC:2F:71:3F:1F:24,9793035,10456711827,6574051,10050129458,3218984,406582369,88,1513178,898361758,1504608,897332572,8570,1029186,1459607,619,6578757,673524,88,6035,117000.0,39000.0,-70.0,-64.0,-69.0,-70.0,-69.0,-63.0,-69.0,-70.0,-77.0,-85.0,-77.0,-85.0,7.0,21.0,8.0,15.0,1
6331,F8:59:71:5A:E0:3D,3409644,691003358,190656,284420585,3218988,406582773,0,188902,242390054,184063,241811874,4839,578180,166400,16,193371,3234,0,555,144444.0,43333.0,-68.0,-73.0,-66.0,-70.0,-67.0,-72.0,-66.0,-70.0,-77.0,-85.0,-77.0,-85.0,9.0,12.0,11.0,15.0,1
6332,CC:2F:71:3E:C5:1F,3230429,407982255,11439,1399280,3218990,406582975,6,48801,4087248,40322,3082572,8479,1004676,12062,34,16403,186,6,831,144444.0,39000.0,-69.0,-72.0,-68.0,-60.0,-68.0,-70.0,-68.0,-59.0,-77.0,-85.0,-77.0,-85.0,8.0,13.0,9.0,25.0,1
6333,CC:2F:71:3F:1F:24,9794507,10458982557,6575517,10052399582,3218990,406582975,88,1513439,898499912,1504869,897470726,8570,1029186,1459865,619,6580210,673560,88,6035,130000.0,43333.0,-69.0,-63.0,-69.0,-70.0,-69.0,-63.0,-69.0,-69.0,-77.0,-85.0,-77.0,-85.0,8.0,22.0,8.0,15.0,1
6334,F8:59:71:5A:E0:3D,3409734,691136013,190741,284552563,3218993,406583450,0,188987,242520982,184148,241942802,4839,578180,166485,16,193456,3237,0,556,144444.0,43333.0,-68.0,-72.0,-66.0,-70.0,-67.0,-72.0,-66.0,-70.0,-77.0,-85.0,-77.0,-85.0,9.0,13.0,11.0,15.0,1
6335,CC:2F:71:3E:C5:1F,3230432,407982730,11439,1399280,3218993,406583450,6,48801,4087248,40322,3082572,8479,1004676,12062,34,16403,186,6,831,144444.0,39000.0,-69.0,-72.0,-68.0,-60.0,-68.0,-70.0,-68.0,-59.0,-77.0,-85.0,-77.0,-85.0,8.0,13.0,9.0,25.0,1
6336,CC:2F:71:3F:1F:24,9795195,10459994720,6576199,10053411008,3218996,406583712,88,1513652,898646227,1505082,897617041,8570,1029186,1460065,619,6580919,673613,88,6035,117000.0,39000.0,-69.0,-64.0,-69.0,-70.0,-68.0,-63.0,-68.0,-69.0,-77.0,-85.0,-77.0,-85.0,8.0,21.0,8.0,15.0,1
6337,F8:59:71:5A:E0:3D,3409815,691251675,190815,284667559,3219000,406584116,0,189061,242634942,184222,242056762,4839,578180,166559,16,193530,3238,0,556,144444.0,43333.0,-68.0,-73.0,-66.0,-70.0,-67.0,-72.0,-66.0,-70.0,-77.0,-85.0,-77.0,-85.0,9.0,12.0,11.0,15.0,1
6338,CC:2F:71:3E:C5:1F,3230439,407983396,11439,1399280,3219000,406584116,6,48801,4087248,40322,3082572,8479,1004676,12062,34,16403,186,6,831,144444.0,39000.0,-69.0,-72.0,-68.0,-60.0,-68.0,-70.0,-68.0,-59.0,-77.0,-85.0,-77.0,-85.0,8.0,13.0,9.0,25.0,1
6339,CC:2F:71:3F:1F:24,9795862,10461000922,6576862,10054416806,3219000,406584116,88,1513844,898759275,1505274,897730089,8570,1029186,1460255,619,6581582,673648,88,6035,130000.0,43333.0,-69.0,-63.0,-70.0,-70.0,-69.0,-63.0,-69.0,-70.0,-77.0,-85.0,-77.0,-85.0,8.0,22.0,7.0,15.0,1
6340,F8:59:71:5A:E0:3D,3409880,691349779,190878,284765461,3219002,406584318,0,189125,242733502,184286,242155322,4839,578180,166623,16,193593,3239,0,556,144444.0,43333.0,-68.0,-73.0,-66.0,-70.0,-67.0,-72.0,-65.0,-70.0,-77.0,-85.0,-77.0,-85.0,9.0,12.0,11.0,15.0,1
6341,CC:2F:71:3E:C5:1F,3230441,407983598,11439,1399280,3219002,406584318,6,48801,4087248,40322,3082572,8479,1004676,12062,34,16403,186,6,831,144444.0,39000.0,-69.0,-72.0,-68.0,-60.0,-68.0,-70.0,-68.0,-59.0,-77.0,-85.0,-77.0,-85.0,8.0,13.0,9.0,25.0,1
6342,CC:2F:71:3F:1F:24,9796818,10462464704,6577816,10055880386,3219002,406584318,88,1514057,898874871,1505487,897845685,8570,1029186,1460468,619,6582535,673811,88,6035,115556.0,28889.0,-69.0,-64.0,-68.0,-70.0,-69.0,-63.0,-68.0,-70.0,-77.0,-85.0,-77.0,-85.0,8.0,21.0,9.0,15.0,1
6343,F8:59:71:5A:E0:3D,3409952,691454361,190945,284869579,3219007,406584782,0,189191,242835142,184352,242256962,4839,578180,166689,16,193659,3239,0,556,144444.0,43333.0,-67.0,-73.0,-66.0,-70.0,-67.0,-72.0,-66.0,-70.0,-77.0,-85.0,-77.0,-85.0,10.0,12.0,11.0,15.0,1
6344,CC:2F:71:3E:C5:1F,3230448,407984264,11439,1399280,3219009,406584984,6,48801,4087248,40322,3082572,8479,1004676,12062,34,16403,186,6,831,144444.0,39000.0,-69.0,-72.0,-68.0,-60.0,-68.0,-70.0,-68.0,-59.0,-77.0,-85.0,-77.0,-85.0,8.0,13.0,9.0,25.0,1
6345,CC:2F:71:3F:1F:24,9798235,10464648726,6579226,10058063742,3219009,406584984,88,1514362,899007003,1505792,897977817,8570,1029186,1460773,619,6583924,673960,88,6036,115556.0,28889.0,-69.0,-64.0,-69.0,-70.0,-68.0,-63.0,-68.0,-70.0,-77.0,-85.0,-77.0,-85.0,8.0,21.0,8.0,15.0,1
6346,F8:59:71:5A:E0:3D,3410017,691552465,191008,284967481,3219009,406584984,0,189256,242935256,184417,242357076,4839,578180,166753,16,193723,3239,0,556,144444.0,43333.0,-68.0,-73.0,-66.0,-70.0,-67.0,-73.0,-65.0,-70.0,-77.0,-85.0,-77.0,-85.0,9.0,12.0,11.0,15.0,1
6347,CC:2F:71:3E:C5:1F,3230448,407984264,11439,1399280,3219009,406584984,6,48801,4087248,40322,3082572,8479,1004676,12062,34,16403,186,6,831,144444.0,39000.0,-69.0,-72.0,-68.0,-60.0,-68.0,-70.0,-68.0,-59.0,-77.0,-85.0,-77.0,-85.0,8.0,13.0,9.0,25.0,1
6348,CC:2F:71:3F:1F:24,9800022,10467424130,6581011,10060838944,3219011,406585186,88,1514708,899141449,1506138,898112263,8570,1029186,1461118,619,6585697,674161,88,6037,115556.0,28889.0,-69.0,-63.0,-68.0,-70.0,-68.0,-63.0,-68.0,-70.0,-77.0,-85.0,-77.0,-85.0,8.0,22.0,9.0,15.0,1
6349,F8:59:71:5A:E0:3D,3410089,691654143,191073,285068491,3219016,406585652,0,189322,243035474,184482,242457176,4840,578298,166819,16,193788,3239,0,556,144444.0,43333.0,-67.0,-73.0,-66.0,-70.0,-67.0,-73.0,-66.0,-69.0,-77.0,-85.0,-77.0,-85.0,10.0,12.0,11.0,15.0,1
6350,CC:2F:71:3E:C5:1F,3230455,407984932,11439,1399280,3219016,406585652,6,48801,4087248,40322,3082572,8479,1004676,12062,34,16403,186,6,831,144444.0,39000.0,-69.0,-72.0,-68.0,-60.0,-68.0,-70.0,-68.0,-59.0,-77.0,-85.0,-77.0,-85.0,8.0,13.0,9.0,25.0,1
6351,CC:2F:71:3F:1F:24,9801810,10470185822,6582792,10063599968,3219018,406585854,88,1515055,899276168,1506485,898246982,8570,1029186,1461465,619,6587512,674515,88,6038,115556.0,28889.0,-68.0,-63.0,-68.0,-70.0,-68.0,-63.0,-68.0,-70.0,-77.0,-85.0,-77.0,-85.0,9.0,22.0,9.0,15.0,1
6352,F8:59:71:5A:E0:3D,3410161,691761519,191142,285175605,3219019,406585914,0,189391,243141748,184551,242563450,4840,578298,166887,16,193857,3239,0,556,144444.0,39000.0,-68.0,-73.0,-66.0,-70.0,-67.0,-73.0,-66.0,-70.0,-77.0,-85.0,-77.0,-85.0,9.0,12.0,11.0,15.0,1
6353,CC:2F:71:3E:C5:1F,3230458,407985194,11439,1399280,3219019,406585914,6,48801,4087248,40322,3082572,8479,1004676,12062,34,16403,186,6,831,144444.0,39000.0,-69.0,-72.0,-68.0,-60.0,-68.0,-70.0,-68.0,-59.0,-77.0,-85.0,-77.0,-85.0,8.0,13.0,9.0,25.0,1
6354,CC:2F:71:3F:1F:24,9803774,10473241576,6584755,10066655662,3219019,406585914,88,1515407,899419392,1506837,898390206,8570,1029186,1461817,619,6589475,675011,88,6038,115556.0,28889.0,-69.0,-63.0,-68.0,-70.0,-69.0,-63.0,-68.0,-69.0,-77.0,-85.0,-77.0,-85.0,8.0,22.0,9.0,15.0,1
6355,F8:59:71:5A:E0:3D,3410235,691866303,191210,285279783,3219025,406586520,0,189459,243245034,184619,242666736,4840,578298,166955,16,193925,3240,0,556,144444.0,43333.0,-67.0,-73.0,-67.0,-70.0,-67.0,-72.0,-66.0,-69.0,-77.0,-85.0,-77.0,-85.0,10.0,12.0,10.0,15.0,1
6356,CC:2F:71:3E:C5:1F,3230464,407985800,11439,1399280,3219025,406586520,6,48801,4087248,40322,3082572,8479,1004676,12062,34,16403,186,6,831,144444.0,39000.0,-69.0,-72.0,-68.0,-60.0,-68.0,-70.0,-68.0,-59.0,-77.0,-85.0,-77.0,-85.0,8.0,13.0,9.0,25.0,1
6357,CC:2F:71:3F:1F:24,9805809,10476400906,6586784,10069814386,3219025,406586520,88,1515740,899551690,1507170,898522504,8570,1029186,1462150,619,6591504,675388,88,6038,115556.0,28889.0,-69.0,-64.0,-69.0,-71.0,-69.0,-63.0,-68.0,-71.0,-77.0,-85.0,-77.0,-85.0,8.0,21.0,8.0,14.0,1
6358,F8:59:71:5A:E0:3D,3410303,691969069,191276,285382347,3219027,406586722,0,189526,243348214,184686,242769916,4840,578298,167022,16,193991,3240,0,556,144444.0,43333.0,-68.0,-73.0,-65.0,-70.0,-67.0,-72.0,-66.0,-70.0,-77.0,-85.0,-77.0,-85.0,9.0,12.0,12.0,15.0,1
6359,CC:2F:71:3E:C5:1F,3230466,407986002,11439,1399280,3219027,406586722,6,48801,4087248,40322,3082572,8479,1004676,12062,34,16403,186,6,831,144444.0,39000.0,-69.0,-72.0,-68.0,-60.0,-68.0,-70.0,-68.0,-59.0,-77.0,-85.0,-77.0,-85.0,8.0,13.0,9.0,25.0,1
6360,CC:2F:71:3F:1F:24,9807580,10479149472,6588552,10072562690,3219028,406586782,88,1516078,899684916,1507508,898655730,8570,1029186,1462487,619,6593258,675611,88,6038,115556.0,28889.0,-69.0,-63.0,-69.0,-70.0,-68.0,-63.0,-68.0,-69.0,-77.0,-85.0,-77.0,-85.0,8.0,22.0,8.0,15.0,1
6361,F8:59:71:5A:E0:3D,3410371,692067435,191339,285480249,3219032,406587186,0,189590,243446816,184750,242868518,4840,578298,167085,16,194054,3240,0,556,144444.0,43333.0,-67.0,-73.0,-66.0,-70.0,-67.0,-73.0,-66.0,-70.0,-77.0,-85.0,-77.0,-85.0,10.0,12.0,11.0,15.0,1
6362,CC:2F:71:3E:C5:1F,3230471,407986466,11439,1399280,3219032,406587186,6,48801,4087248,40322,3082572,8479,1004676,12062,34,16403,186,6,831,144444.0,39000.0,-69.0,-72.0,-68.0,-60.0,-68.0,-70.0,-68.0,-59.0,-77.0,-85.0,-77.0,-85.0,8.0,13.0,9.0,25.0,1
6363,CC:2F:71:3F:1F:24,9808761,10480952215,6589727,10074364827,3219034,406587388,88,1516339,899806647,1507769,898777461,8570,1029186,1462748,619,6594447,675733,88,6038,115556.0,28889.0,-68.0,-63.0,-69.0,-71.0,-68.0,-63.0,-68.0,-70.0,-77.0,-85.0,-77.0,-85.0,9.0,22.0,8.0,14.0,1
6364,F8:59:71:5A:E0:3D,3410438,692165741,191402,285578151,3219036,406587590,0,189653,243543836,184813,242965538,4840,578298,167148,16,194117,3242,0,556,144444.0,43333.0,-67.0,-73.0,-66.0,-70.0,-67.0,-73.0,-66.0,-70.0,-77.0,-85.0,-77.0,-85.0,10.0,12.0,11.0,15.0,1
6365,CC:2F:71:3E:C5:1F,3230475,407986870,11439,1399280,3219036,406587590,6,48801,4087248,40322,3082572,8479,1004676,12062,34,16403,186,6,831,144444.0,39000.0,-69.0,-72.0,-68.0,-60.0,-68.0,-70.0,-68.0,-59.0,-77.0,-85.0,-77.0,-85.0,8.0,13.0,9.0,25.0,1
6366,CC:2F:71:3F:1F:24,9809850,10482627399,6590814,10076039809,3219036,406587590,88,1516585,899927595,1508015,898898409,8570,1029186,1462994,619,6595534,675857,88,6038,115556.0,28889.0,-69.0,-64.0,-69.0,-71.0,-68.0,-63.0,-68.0,-70.0,-77.0,-85.0,-77.0,-85.0,8.0,21.0,8.0,14.0,1
6367,F8:59:71:5A:E0:3D,3410506,692265601,191466,285677607,3219040,406587994,0,189717,243642438,184877,243064140,4840,578298,167212,16,194181,3242,0,556,144444.0,43333.0,-67.0,-73.0,-66.0,-70.0,-67.0,-72.0,-65.0,-70.0,-77.0,-85.0,-77.0,-85.0,10.0,12.0,11.0,15.0,1
6368,CC:2F:71:3E:C5:1F,3230479,407987274,11439,1399280,3219040,406587994,6,48801,4087248,40322,3082572,8479,1004676,12062,34,16403,186,6,831,144444.0,39000.0,-69.0,-72.0,-68.0,-60.0,-68.0,-70.0,-68.0,-59.0,-77.0,-85.0,-77.0,-85.0,8.0,13.0,9.0,25.0,1
6369,CC:2F:71:3F:1F:24,9811296,10484861681,6592255,10078273627,3219041,406588054,88,1516867,900049821,1508297,899020635,8570,1029186,1463276,619,6596975,675883,88,6039,115556.0,28889.0,-68.0,-64.0,-70.0,-70.0,-69.0,-63.0,-69.0,-70.0,-77.0,-85.0,-77.0,-85.0,9.0,21.0,7.0,15.0,1
6370,F8:59:71:5A:E0:3D,3410574,692363967,191529,285775509,3219045,406588458,0,189780,243739458,184940,243161160,4840,578298,167275,16,194244,3243,0,556,144444.0,43333.0,-68.0,-73.0,-66.0,-71.0,-67.0,-72.0,-65.0,-70.0,-77.0,-85.0,-77.0,-85.0,9.0,12.0,11.0,14.0,1
6371,CC:2F:71:3E:C5:1F,3230484,407987738,11439,1399280,3219045,406588458,6,48801,4087248,40322,3082572,8479,1004676,12062,34,16403,186,6,831,144444.0,39000.0,-69.0,-72.0,-68.0,-60.0,-68.0,-70.0,-68.0,-59.0,-77.0,-85.0,-77.0,-85.0,8.0,13.0,9.0,25.0,1
6372,CC:2F:71:3F:1F:24,9812716,10487054365,6593671,10080465907,3219045,406588458,88,1517132,900172979,1508562,899143793,8570,1029186,1463541,619,6598391,675993,88,6039,130000.0,43333.0,-68.0,-63.0,-69.0,-70.0,-68.0,-63.0,-69.0,-70.0,-77.0,-85.0,-77.0,-85.0,9.0,22.0,8.0,15.0,1
6373,F8:59:71:5A:E0:3D,3410641,692462273,191592,285873411,3219049,406588862,0,189843,243836478,185003,243258180,4840,578298,167338,16,194307,3245,0,556,144444.0,43333.0,-68.0,-73.0,-65.0,-71.0,-67.0,-72.0,-65.0,-70.0,-77.0,-85.0,-77.0,-85.0,9.0,12.0,12.0,14.0,1
6374,CC:2F:71:3E:C5:1F,3230488,407988142,11439,1399280,3219049,406588862,6,48801,4087248,40322,3082572,8479,1004676,12062,34,16403,186,6,831,144444.0,39000.0,-69.0,-72.0,-68.0,-60.0,-68.0,-70.0,-68.0,-59.0,-77.0,-85.0,-77.0,-85.0,8.0,13.0,9.0,25.0,1
6375,CC:2F:71:3F:1F:24,9813805,10488719159,6594756,10082130297,3219049,406588862,88,1517351,900289658,1508781,899260472,8570,1029186,1463760,619,6599440,676181,88,6039,117000.0,39000.0,-69.0,-64.0,-69.0,-70.0,-68.0,-63.0,-69.0,-70.0,-77.0,-85.0,-77.0,-85.0,8.0,21.0,8.0,15.0,1
6376,F8:59:71:5A:E0:3D,3410711,692562466,191656,285972867,3219055,406589599,0,189907,243935038,185067,243356740,4840,578298,167402,16,194371,3246,0,556,144444.0,43333.0,-67.0,-73.0,-66.0,-70.0,-67.0,-72.0,-66.0,-70.0,-77.0,-85.0,-77.0,-85.0,10.0,12.0,11.0,15.0,1
6377,CC:2F:71:3E:C5:1F,3230494,407988879,11439,1399280,3219055,406589599,6,48801,4087248,40322,3082572,8479,1004676,12062,34,16403,186,6,831,144444.0,39000.0,-69.0,-72.0,-68.0,-60.0,-68.0,-70.0,-68.0,-59.0,-77.0,-85.0,-77.0,-85.0,8.0,13.0,9.0,25.0,1
6378,CC:2F:71:3F:1F:24,9815253,10490956324,6596198,10084366725,3219055,406589599,88,1517655,900417298,1509085,899388112,8570,1029186,1464064,619,6600892,676503,88,6039,115556.0,28889.0,-69.0,-64.0,-69.0,-70.0,-68.0,-64.0,-68.0,-70.0,-77.0,-85.0,-77.0,-85.0,8.0,21.0,8.0,15.0,1
6379,F8:59:71:5A:E0:3D,3410778,692660772,191719,286070769,3219059,406590003,0,189970,244032114,185130,243453816,4840,578298,167465,16,194434,3246,0,556,144444.0,43333.0,-68.0,-73.0,-66.0,-70.0,-67.0,-73.0,-66.0,-70.0,-77.0,-85.0,-77.0,-85.0,9.0,12.0,11.0,15.0,1
6380,CC:2F:71:3E:C5:1F,3230498,407989283,11439,1399280,3219059,406590003,6,48801,4087248,40322,3082572,8479,1004676,12062,34,16403,186,6,831,144444.0,39000.0,-69.0,-72.0,-68.0,-60.0,-68.0,-70.0,-68.0,-59.0,-77.0,-85.0,-77.0,-85.0,8.0,13.0,9.0,25.0,1
6381,CC:2F:71:3F:1F:24,9816146,10492317994,6597087,10085727991,3219059,406590003,88,1517906,900540280,1509336,899511094,8570,1029186,1464315,619,6601800,676606,88,6040,115556.0,28889.0,-69.0,-64.0,-68.0,-70.0,-68.0,-64.0,-68.0,-70.0,-77.0,-85.0,-77.0,-85.0,8.0,21.0,9.0,15.0,1
6382,F8:59:71:5A:E0:3D,3410847,692762186,191784,286171779,3219063,406590407,0,190034,244130674,185194,243552376,4840,578298,167529,16,194499,3246,0,556,144444.0,43333.0,-68.0,-73.0,-66.0,-70.0,-67.0,-72.0,-65.0,-70.0,-77.0,-85.0,-77.0,-85.0,9.0,12.0,11.0,15.0,1
6383,CC:2F:71:3E:C5:1F,3230502,407989687,11439,1399280,3219063,406590407,6,48801,4087248,40322,3082572,8479,1004676,12062,34,16403,186,6,831,144444.0,39000.0,-69.0,-72.0,-68.0,-60.0,-68.0,-70.0,-68.0,-59.0,-77.0,-85.0,-77.0,-85.0,8.0,13.0,9.0,25.0,1
6384,CC:2F:71:3F:1F:24,9817059,10493712496,6597996,10087122089,3219063,406590407,88,1518128,900656888,1509558,899627702,8570,1029186,1464537,619,6602710,676701,88,6040,115556.0,28889.0,-69.0,-64.0,-69.0,-71.0,-69.0,-64.0,-69.0,-70.0,-77.0,-85.0,-77.0,-85.0,8.0,21.0,8.0,14.0,1
6385,F8:59:71:5A:E0:3D,3410911,692860148,191847,286269681,3219064,406590467,0,190097,244227694,185257,243649396,4840,578298,167592,16,194562,3248,0,556,144444.0,43333.0,-68.0,-73.0,-66.0,-70.0,-67.0,-73.0,-66.0,-70.0,-77.0,-85.0,-77.0,-85.0,9.0,12.0,11.0,15.0,1
6386,CC:2F:71:3E:C5:1F,3230505,407989949,11439,1399280,3219066,406590669,6,48801,4087248,40322,3082572,8479,1004676,12062,34,16403,186,6,831,144444.0,39000.0,-69.0,-72.0,-68.0,-60.0,-68.0,-70.0,-68.0,-59.0,-77.0,-85.0,-77.0,-85.0,8.0,13.0,9.0,25.0,1
6387,CC:2F:71:3F:1F:24,9818347,10495691414,6599281,10089100745,3219066,406590669,88,1518474,900787013,1509904,899757827,8570,1029186,1464883,619,6604001,676747,88,6040,115556.0,28889.0,-69.0,-63.0,-69.0,-71.0,-68.0,-63.0,-68.0,-70.0,-77.0,-85.0,-77.0,-85.0,8.0,22.0,8.0,14.0,1
6388,F8:59:71:5A:E0:3D,3410978,692955548,191908,286364475,3219070,406591073,0,190159,244323174,185319,243744876,4840,578298,167654,16,194623,3248,0,556,144444.0,43333.0,-68.0,-73.0,-66.0,-70.0,-67.0,-73.0,-66.0,-70.0,-77.0,-85.0,-77.0,-85.0,9.0,12.0,11.0,15.0,1
6389,CC:2F:71:3E:C5:1F,3230509,407990353,11439,1399280,3219070,406591073,6,48801,4087248,40322,3082572,8479,1004676,12062,34,16403,186,6,831,144444.0,39000.0,-69.0,-72.0,-68.0,-60.0,-68.0,-70.0,-68.0,-59.0,-77.0,-85.0,-77.0,-85.0,8.0,13.0,9.0,25.0,1
6390,CC:2F:71:3F:1F:24,9819510,10497480664,6600440,10090889591,3219070,406591073,88,1518732,900906581,1510162,899877395,8570,1029186,1465141,619,6605160,676827,88,6040,115556.0,28889.0,-69.0,-63.0,-68.0,-71.0,-68.0,-63.0,-68.0,-71.0,-77.0,-85.0,-77.0,-85.0,8.0,22.0,9.0,14.0,1
6391,F8:59:71:5A:E0:3D,3411047,693054198,191972,286462493,3219075,406591705,0,190222,244420194,185382,243841896,4840,578298,167717,16,194687,3250,0,556,144444.0,43333.0,-68.0,-73.0,-67.0,-70.0,-67.0,-72.0,-66.0,-70.0,-77.0,-85.0,-77.0,-85.0,9.0,12.0,10.0,15.0,1
6392,CC:2F:71:3E:C5:1F,3230515,407991101,11440,1399396,3219075,406591705,6,48804,4087506,40324,3082712,8480,1004794,12063,34,16404,186,6,831,144444.0,43333.0,-68.0,-71.0,-68.0,-60.0,-68.0,-70.0,-67.0,-59.0,-77.0,-85.0,-77.0,-85.0,9.0,14.0,9.0,25.0,1
6393,CC:2F:71:3F:1F:24,9820528,10499036596,6601453,10092444891,3219075,406591705,88,1518985,901025499,1510415,899996313,8570,1029186,1465394,619,6606169,676904,88,6041,115556.0,28889.0,-69.0,-64.0,-68.0,-71.0,-68.0,-63.0,-68.0,-71.0,-77.0,-85.0,-77.0,-85.0,8.0,21.0,9.0,14.0,1
6394,F8:59:71:5A:E0:3D,3411116,693152680,192036,286560511,3219080,406592169,0,190286,244517334,185446,243939036,4840,578298,167780,16,194751,3251,0,556,144444.0,43333.0,-67.0,-73.0,-66.0,-70.0,-67.0,-72.0,-66.0,-70.0,-77.0,-85.0,-77.0,-85.0,10.0,12.0,11.0,15.0,1
6395,CC:2F:71:3E:C5:1F,3230522,407991767,11440,1399396,3219082,406592371,6,48805,4087576,40325,3082782,8480,1004794,12063,34,16404,186,6,831,144444.0,43333.0,-68.0,-72.0,-69.0,-60.0,-68.0,-70.0,-68.0,-59.0,-77.0,-85.0,-77.0,-85.0,9.0,13.0,8.0,25.0,1
6396,CC:2F:71:3F:1F:24,9821650,10500755166,6602568,10094162795,3219082,406592371,88,1519240,901147361,1510670,900118175,8570,1029186,1465649,619,6607273,676929,88,6041,115556.0,28889.0,-69.0,-64.0,-68.0,-68.0,-69.0,-63.0,-67.0,-68.0,-77.0,-85.0,-77.0,-85.0,8.0,21.0,9.0,17.0,1
6397,F8:59:71:5A:E0:3D,3411183,693250986,192099,286658413,3219084,406592573,0,190350,244615894,185510,244037596,4840,578298,167844,16,194814,3252,0,556,144444.0,43333.0,-67.0,-73.0,-65.0,-70.0,-66.0,-73.0,-65.0,-70.0,-77.0,-85.0,-77.0,-85.0,10.0,12.0,12.0,15.0,1
6398,CC:2F:71:3E:C5:1F,3230524,407991969,11440,1399396,3219084,406592573,6,48805,4087576,40325,3082782,8480,1004794,12063,34,16404,186,6,831,144444.0,43333.0,-68.0,-72.0,-69.0,-60.0,-68.0,-70.0,-68.0,-59.0,-77.0,-85.0,-77.0,-85.0,9.0,13.0,8.0,25.0,1
6399,CC:2F:71:3F:1F:24,9822726,10502408612,6603642,10095816039,3219084,406592573,88,1519464,901264249,1510894,900235063,8570,1029186,1465873,619,6608362,677031,88,6041,115556.0,28889.0,-68.0,-64.0,-71.0,-68.0,-68.0,-64.0,-70.0,-68.0,-77.0,-85.0,-77.0,-85.0,9.0,21.0,6.0,17.0,1
6400,F8:59:71:5A:E0:3D,3411251,693350846,192163,286757869,3219088,406592977,0,190414,244714454,185574,244136156,4840,578298,167908,16,194878,3252,0,556,144444.0,43333.0,-67.0,-73.0,-65.0,-70.0,-67.0,-73.0,-65.0,-69.0,-77.0,-85.0,-77.0,-85.0,10.0,12.0,12.0,15.0,1
6401,CC:2F:71:3E:C5:1F,3230528,407992373,11440,1399396,3219088,406592977,6,48805,4087576,40325,3082782,8480,1004794,12063,34,16404,186,6,831,144444.0,43333.0,-68.0,-72.0,-69.0,-60.0,-68.0,-70.0,-68.0,-59.0,-77.0,-85.0,-77.0,-85.0,9.0,13.0,8.0,25.0,1
6402,CC:2F:71:3F:1F:24,9824437,10505054396,6605349,10098461419,3219088,406592977,88,1519787,901394562,1511217,900365376,8570,1029186,1466195,619,6610069,677258,88,6041,130000.0,43333.0,-70.0,-65.0,-70.0,-69.0,-69.0,-64.0,-69.0,-68.0,-77.0,-85.0,-77.0,-85.0,7.0,20.0,7.0,16.0,1
6403,F8:59:71:5A:E0:3D,3411322,693452382,192228,286858879,3219094,406593503,0,190480,244814672,185639,244236256,4841,578416,167974,16,194943,3253,0,556,144444.0,43333.0,-67.0,-73.0,-65.0,-70.0,-67.0,-72.0,-65.0,-69.0,-77.0,-85.0,-77.0,-85.0,10.0,12.0,12.0,15.0,1
6404,CC:2F:71:3E:C5:1F,3230534,407992899,11440,1399396,3219094,406593503,6,48805,4087576,40325,3082782,8480,1004794,12063,34,16404,186,6,831,144444.0,43333.0,-68.0,-72.0,-69.0,-60.0,-68.0,-70.0,-68.0,-59.0,-77.0,-85.0,-77.0,-85.0,9.0,13.0,8.0,25.0,1
6405,CC:2F:71:3F:1F:24,9826577,10508380726,6607483,10101787223,3219094,406593503,88,1520108,901531210,1511538,900502024,8570,1029186,1466515,619,6612203,677659,88,6041,130000.0,43333.0,-69.0,-65.0,-70.0,-68.0,-69.0,-64.0,-70.0,-68.0,-77.0,-85.0,-77.0,-85.0,8.0,20.0,7.0,17.0,1
6406,F8:59:71:5A:E0:3D,3411395,693560012,192297,286966105,3219098,406593907,0,190549,244920932,185708,244342516,4841,578416,168043,16,195012,3257,0,556,144444.0,43333.0,-67.0,-73.0,-65.0,-70.0,-67.0,-72.0,-65.0,-69.0,-77.0,-85.0,-77.0,-85.0,10.0,12.0,12.0,15.0,1
6407,CC:2F:71:3E:C5:1F,3230540,407993505,11440,1399396,3219100,406594109,6,48805,4087576,40325,3082782,8480,1004794,12063,34,16404,186,6,831,144444.0,43333.0,-68.0,-72.0,-69.0,-60.0,-68.0,-70.0,-68.0,-59.0,-77.0,-85.0,-77.0,-85.0,9.0,13.0,8.0,25.0,1
6408,CC:2F:71:3F:1F:24,9828740,10511741390,6609640,10105147281,3219100,406594109,88,1520456,901682164,1511886,900652978,8570,1029186,1466860,619,6614351,678350,88,6042,115556.0,28889.0,-67.0,-64.0,-71.0,-68.0,-67.0,-64.0,-70.0,-68.0,-77.0,-85.0,-77.0,-85.0,10.0,21.0,6.0,17.0,1
6409,F8:59:71:5A:E0:3D,3411473,693675412,192371,287081101,3219102,406594311,0,190623,245034892,185782,244456476,4841,578416,168117,16,195086,3259,0,556,144444.0,43333.0,-67.0,-72.0,-65.0,-70.0,-67.0,-72.0,-65.0,-70.0,-77.0,-85.0,-77.0,-85.0,10.0,13.0,12.0,15.0,1
6410,CC:2F:71:3E:C5:1F,3230542,407993707,11440,1399396,3219102,406594311,6,48805,4087576,40325,3082782,8480,1004794,12063,34,16404,186,6,831,144444.0,43333.0,-68.0,-72.0,-69.0,-60.0,-68.0,-70.0,-68.0,-59.0,-77.0,-85.0,-77.0,-85.0,9.0,13.0,8.0,25.0,1
6411,CC:2F:71:3F:1F:24,9829853,10513452832,6610750,10106858461,3219103,406594371,88,1520748,901814418,1512178,900785232,8570,1029186,1467152,619,6615470,678445,88,6042,115556.0,28889.0,-67.0,-64.0,-69.0,-69.0,-67.0,-64.0,-69.0,-68.0,-77.0,-85.0,-77.0,-85.0,10.0,21.0,8.0,16.0,1
6412,F8:59:71:5A:E0:3D,3411568,693792396,192439,287186773,3219129,406605623,0,190690,245138072,185849,244559656,4841,578416,168184,16,195154,3259,0,556,144444.0,43333.0,-67.0,-72.0,-65.0,-70.0,-67.0,-72.0,-65.0,-70.0,-77.0,-85.0,-77.0,-85.0,10.0,13.0,12.0,15.0,1
6413,CC:2F:71:3E:C5:1F,3230569,408005019,11440,1399396,3219129,406605623,6,48805,4087576,40325,3082782,8480,1004794,12063,34,16404,186,6,831,144444.0,43333.0,-68.0,-72.0,-69.0,-60.0,-68.0,-70.0,-68.0,-59.0,-77.0,-85.0,-77.0,-85.0,9.0,13.0,8.0,25.0,1
6414,CC:2F:71:3F:1F:24,9830723,10514741958,6611592,10108136133,3219131,406605825,88,1520970,901936073,1512400,900906887,8570,1029186,1467374,619,6616312,678629,88,6042,115556.0,28889.0,-68.0,-64.0,-71.0,-69.0,-68.0,-64.0,-70.0,-69.0,-77.0,-85.0,-77.0,-85.0,9.0,21.0,6.0,16.0,1
6415,F8:59:71:5A:E0:3D,3411637,693893810,192504,287287783,3219133,406606027,0,190756,245239712,185915,244661296,4841,578416,168250,16,195219,3259,0,556,144444.0,43333.0,-67.0,-72.0,-65.0,-70.0,-67.0,-72.0,-65.0,-70.0,-77.0,-85.0,-77.0,-85.0,10.0,13.0,12.0,15.0,1
6416,CC:2F:71:3E:C5:1F,3230573,408005423,11440,1399396,3219133,406606027,6,48805,4087576,40325,3082782,8480,1004794,12063,34,16404,186,6,831,144444.0,43333.0,-68.0,-72.0,-69.0,-60.0,-68.0,-70.0,-68.0,-59.0,-77.0,-85.0,-77.0,-85.0,9.0,13.0,8.0,25.0,1
6417,CC:2F:71:3F:1F:24,9832000,10516711214,6612867,10110105187,3219133,406606027,88,1521265,902064049,1512695,901034863,8570,1029186,1467668,619,6617565,678774,88,6042,115556.0,28889.0,-68.0,-64.0,-70.0,-69.0,-67.0,-64.0,-70.0,-68.0,-77.0,-85.0,-77.0,-85.0,9.0,21.0,7.0,16.0,1
6418,F8:59:71:5A:E0:3D,3411707,693994003,192568,287387239,3219139,406606764,0,190821,245339826,185980,244761410,4841,578416,168314,16,195283,3260,0,556,144444.0,43333.0,-67.0,-72.0,-65.0,-70.0,-67.0,-72.0,-65.0,-70.0,-77.0,-85.0,-77.0,-85.0,10.0,13.0,12.0,15.0,1
6419,CC:2F:71:3E:C5:1F,3230579,408006160,11440,1399396,3219139,406606764,6,48805,4087576,40325,3082782,8480,1004794,12063,34,16404,186,6,831,144444.0,43333.0,-68.0,-72.0,-69.0,-60.0,-68.0,-70.0,-68.0,-59.0,-77.0,-85.0,-77.0,-85.0,9.0,13.0,8.0,25.0,1
6420,CC:2F:71:3F:1F:24,9833194,10518544999,6614055,10111938235,3219139,406606764,88,1521535,902186377,1512965,901157191,8570,1029186,1467938,619,6618758,678878,88,6042,104000.0,26000.0,-68.0,-64.0,-70.0,-68.0,-68.0,-64.0,-70.0,-68.0,-77.0,-85.0,-77.0,-85.0,9.0,21.0,7.0,17.0,1
6421,F8:59:71:5A:E0:3D,3411775,694092203,192631,287484973,3219144,406607230,0,190884,245436846,186043,244858430,4841,578416,168377,16,195346,3262,0,556,144444.0,43333.0,-67.0,-72.0,-65.0,-70.0,-67.0,-71.0,-65.0,-70.0,-77.0,-85.0,-77.0,-85.0,10.0,13.0,12.0,15.0,1
6422,CC:2F:71:3E:C5:1F,3230584,408006626,11440,1399396,3219144,406607230,6,48805,4087576,40325,3082782,8480,1004794,12063,34,16404,186,6,831,144444.0,43333.0,-68.0,-72.0,-69.0,-60.0,-68.0,-70.0,-68.0,-59.0,-77.0,-85.0,-77.0,-85.0,9.0,13.0,8.0,25.0,1
6423,CC:2F:71:3F:1F:24,9834849,10521102075,6615705,10114494845,3219144,406607230,88,1521843,902314928,1513272,901285624,8571,1029304,1468246,619,6620423,678935,88,6042,115556.0,28889.0,-68.0,-64.0,-70.0,-68.0,-67.0,-64.0,-70.0,-68.0,-77.0,-85.0,-77.0,-85.0,9.0,21.0,7.0,17.0,1
6424,F8:59:71:5A:E0:3D,3411844,694192734,192696,287585100,3219148,406607634,0,190949,245535556,186108,244957140,4841,578416,168442,16,195411,3263,0,556,144444.0,43333.0,-67.0,-72.0,-65.0,-70.0,-67.0,-72.0,-65.0,-69.0,-77.0,-85.0,-77.0,-85.0,10.0,13.0,12.0,15.0,1
6425,CC:2F:71:3E:C5:1F,3230588,408007030,11440,1399396,3219148,406607634,6,48805,4087576,40325,3082782,8480,1004794,12063,34,16404,186,6,831,144444.0,43333.0,-68.0,-72.0,-69.0,-60.0,-68.0,-70.0,-68.0,-59.0,-77.0,-85.0,-77.0,-85.0,9.0,13.0,8.0,25.0,1
6426,CC:2F:71:3F:1F:24,9835939,10522767065,6616791,10116159431,3219148,406607634,88,1522075,902436145,1513504,901406841,8571,1029304,1468475,619,6621485,678992,88,6042,115556.0,28889.0,-68.0,-65.0,-70.0,-69.0,-67.0,-64.0,-70.0,-68.0,-77.0,-85.0,-77.0,-85.0,9.0,20.0,7.0,16.0,1
6427,F8:59:71:5A:E0:3D,3411913,694292654,192760,287684556,3219153,406608098,0,191013,245634116,186172,245055700,4841,578416,168506,16,195475,3265,0,556,144444.0,43333.0,-67.0,-72.0,-65.0,-70.0,-66.0,-71.0,-65.0,-69.0,-77.0,-85.0,-77.0,-85.0,10.0,13.0,12.0,15.0,1
6428,CC:2F:71:3E:C5:1F,3230593,408007494,11440,1399396,3219153,406608098,6,48805,4087576,40325,3082782,8480,1004794,12063,34,16404,186,6,831,144444.0,43333.0,-68.0,-72.0,-69.0,-60.0,-68.0,-70.0,-68.0,-59.0,-77.0,-85.0,-77.0,-85.0,9.0,13.0,8.0,25.0,1
6429,CC:2F:71:3F:1F:24,9836980,10524360561,6617827,10117752463,3219153,406608098,88,1522305,902555161,1513734,901525857,8571,1029304,1468705,619,6622547,679087,88,6042,115556.0,28889.0,-67.0,-64.0,-71.0,-69.0,-67.0,-64.0,-70.0,-68.0,-77.0,-85.0,-77.0,-85.0,10.0,21.0,6.0,16.0,1
6430,F8:59:71:5A:E0:3D,3411979,694392312,192824,287784012,3219155,406608300,0,191076,245731136,186235,245152720,4841,578416,168569,16,195539,3266,0,556,144444.0,43333.0,-67.0,-71.0,-66.0,-70.0,-67.0,-71.0,-65.0,-70.0,-77.0,-85.0,-77.0,-85.0,10.0,14.0,11.0,15.0,1
6431,CC:2F:71:3E:C5:1F,3230595,408007696,11440,1399396,3219155,406608300,6,48805,4087576,40325,3082782,8480,1004794,12063,34,16404,186,6,831,144444.0,43333.0,-68.0,-72.0,-69.0,-60.0,-68.0,-70.0,-68.0,-59.0,-77.0,-85.0,-77.0,-85.0,9.0,13.0,8.0,25.0,1
6432,CC:2F:71:3F:1F:24,9838096,10526073949,6618939,10119465447,3219157,406608502,88,1522575,902676081,1514004,901646777,8571,1029304,1468975,619,6623634,679093,88,6042,115556.0,28889.0,-68.0,-64.0,-70.0,-68.0,-68.0,-64.0,-70.0,-68.0,-77.0,-85.0,-77.0,-85.0,9.0,21.0,7.0,17.0,1
6433,F8:59:71:5A:E0:3D,3412045,694489064,192886,287880360,3219159,406608704,0,191139,245828156,186298,245249740,4841,578416,168632,16,195601,3266,0,556,144444.0,43333.0,-67.0,-72.0,-65.0,-70.0,-66.0,-72.0,-65.0,-69.0,-77.0,-85.0,-77.0,-85.0,10.0,13.0,12.0,15.0,1
6434,CC:2F:71:3E:C5:1F,3230601,408008302,11440,1399396,3219161,406608906,6,48805,4087576,40325,3082782,8480,1004794,12063,34,16404,186,6,831,144444.0,43333.0,-68.0,-72.0,-69.0,-60.0,-68.0,-70.0,-68.0,-59.0,-77.0,-85.0,-77.0,-85.0,9.0,13.0,8.0,25.0,1
6435,CC:2F:71:3F:1F:24,9839096,10527605961,6619935,10120997055,3219161,406608906,88,1522817,902795155,1514246,901765851,8571,1029304,1469217,619,6624655,679171,88,6042,115556.0,28889.0,-68.0,-64.0,-70.0,-68.0,-67.0,-64.0,-70.0,-68.0,-77.0,-85.0,-77.0,-85.0,9.0,21.0,7.0,17.0,1
6436,F8:59:71:5A:E0:3D,3412113,694587430,192949,287978262,3219164,406609168,0,191202,245925176,186361,245346760,4841,578416,168695,16,195664,3267,0,556,144444.0,43333.0,-66.0,-71.0,-65.0,-70.0,-66.0,-71.0,-65.0,-70.0,-77.0,-85.0,-77.0,-85.0,11.0,14.0,12.0,15.0,1
6437,CC:2F:71:3E:C5:1F,3230604,408008564,11440,1399396,3219164,406609168,6,48805,4087576,40325,3082782,8480,1004794,12063,34,16404,186,6,831,144444.0,43333.0,-68.0,-72.0,-69.0,-60.0,-68.0,-70.0,-68.0,-59.0,-77.0,-85.0,-77.0,-85.0,9.0,13.0,8.0,25.0,1
6438,CC:2F:71:3F:1F:24,9840115,10529160139,6620951,10122550971,3219164,406609168,88,1523061,902914908,1514490,901885604,8571,1029304,1469461,619,6625669,679191,88,6042,115556.0,28889.0,-68.0,-64.0,-72.0,-68.0,-68.0,-64.0,-70.0,-68.0,-77.0,-85.0,-77.0,-85.0,9.0,21.0,5.0,17.0,1
6439,F8:59:71:5A:E0:3D,3412181,694687290,193013,288077718,3219168,406609572,0,191266,246023736,186425,245445320,4841,578416,168759,16,195728,3268,0,556,144444.0,43333.0,-67.0,-72.0,-65.0,-70.0,-67.0,-71.0,-65.0,-70.0,-77.0,-85.0,-77.0,-85.0,10.0,13.0,12.0,15.0,1
6440,CC:2F:71:3E:C5:1F,3230608,408008968,11440,1399396,3219168,406609572,6,48805,4087576,40325,3082782,8480,1004794,12063,34,16404,186,6,831,144444.0,43333.0,-68.0,-72.0,-69.0,-60.0,-68.0,-70.0,-68.0,-59.0,-77.0,-85.0,-77.0,-85.0,9.0,13.0,8.0,25.0,1
6441,CC:2F:71:3F:1F:24,9841195,10530816719,6622027,10124207147,3219168,406609572,88,1523339,903038204,1514768,902008900,8571,1029304,1469739,619,6626747,679255,88,6042,115556.0,28889.0,-67.0,-64.0,-70.0,-68.0,-67.0,-64.0,-69.0,-68.0,-77.0,-85.0,-77.0,-85.0,10.0,21.0,7.0,17.0,1
6442,F8:59:71:5A:E0:3D,3412245,694783840,193075,288174066,3219170,406609774,0,191327,246117676,186486,245539260,4841,578416,168820,16,195790,3268,0,556,144444.0,43333.0,-67.0,-72.0,-65.0,-70.0,-66.0,-72.0,-65.0,-69.0,-77.0,-85.0,-77.0,-85.0,10.0,13.0,12.0,15.0,1
6443,CC:2F:71:3E:C5:1F,3230612,408009372,11440,1399396,3219172,406609976,6,48805,4087576,40325,3082782,8480,1004794,12063,34,16404,186,6,831,144444.0,43333.0,-68.0,-72.0,-69.0,-60.0,-68.0,-70.0,-68.0,-59.0,-77.0,-85.0,-77.0,-85.0,9.0,13.0,8.0,25.0,1
6444,CC:2F:71:3F:1F:24,9842084,10532172125,6622912,10125562149,3219172,406609976,88,1523523,903150506,1514952,902121202,8571,1029304,1469923,619,6627632,679269,88,6042,115556.0,28889.0,-68.0,-64.0,-70.0,-68.0,-68.0,-64.0,-69.0,-68.0,-77.0,-85.0,-77.0,-85.0,9.0,21.0,7.0,17.0,1
6445,F8:59:71:5A:E0:3D,3412314,694882322,193139,288272084,3219175,406610238,0,191392,246216342,186551,245637926,4841,578416,168885,16,195854,3270,0,556,144444.0,43333.0,-66.0,-72.0,-66.0,-70.0,-67.0,-71.0,-65.0,-69.0,-77.0,-85.0,-77.0,-85.0,11.0,13.0,11.0,15.0,1
6446,CC:2F:71:3E:C5:1F,3230615,408009634,11440,1399396,3219175,406610238,6,48805,4087576,40325,3082782,8480,1004794,12063,34,16404,186,6,831,144444.0,43333.0,-68.0,-72.0,-69.0,-60.0,-68.0,-70.0,-68.0,-59.0,-77.0,-85.0,-77.0,-85.0,9.0,13.0,8.0,25.0,1
6447,CC:2F:71:3F:1F:24,9843383,10534177147,6624208,10127566909,3219175,406610238,88,1523793,903272790,1515222,902243486,8571,1029304,1470193,619,6628928,679322,88,6043,115556.0,28889.0,-68.0,-64.0,-70.0,-68.0,-67.0,-64.0,-70.0,-68.0,-77.0,-85.0,-77.0,-85.0,9.0,21.0,7.0,17.0,1
6448,F8:59:71:5A:E0:3D,3412382,694980744,193203,288370102,3219179,406610642,0,191455,246311928,186614,245733512,4841,578416,168948,16,195918,3271,0,556,144444.0,43333.0,-67.0,-71.0,-65.0,-69.0,-66.0,-71.0,-64.0,-69.0,-77.0,-85.0,-77.0,-85.0,10.0,14.0,12.0,16.0,1
6449,CC:2F:71:3E:C5:1F,3230619,408010038,11440,1399396,3219179,406610642,6,48805,4087576,40325,3082782,8480,1004794,12063,34,16404,186,6,831,144444.0,43333.0,-68.0,-72.0,-69.0,-60.0,-68.0,-70.0,-68.0,-59.0,-77.0,-85.0,-77.0,-85.0,9.0,13.0,8.0,25.0,1
6450,CC:2F:71:3F:1F:24,9844475,10535854111,6625296,10129243469,3219179,406610642,88,1524025,903392166,1515454,902362862,8571,1029304,1470425,619,6630016,679455,88,6043,115556.0,28889.0,-68.0,-64.0,-71.0,-68.0,-67.0,-64.0,-70.0,-68.0,-77.0,-85.0,-77.0,-85.0,9.0,21.0,6.0,17.0,1
6451,F8:59:71:5A:E0:3D,3412450,695080604,193267,288469558,3219183,406611046,0,191519,246410488,186678,245832072,4841,578416,169012,16,195982,3272,0,556,144444.0,43333.0,-67.0,-72.0,-65.0,-70.0,-67.0,-72.0,-65.0,-69.0,-77.0,-85.0,-77.0,-85.0,10.0,13.0,12.0,15.0,1
6452,CC:2F:71:3E:C5:1F,3230623,408010442,11440,1399396,3219183,406611046,6,48805,4087576,40325,3082782,8480,1004794,12063,34,16404,186,6,831,144444.0,43333.0,-68.0,-72.0,-69.0,-60.0,-68.0,-70.0,-68.0,-59.0,-77.0,-85.0,-77.0,-85.0,9.0,13.0,8.0,25.0,1
6453,CC:2F:71:3F:1F:24,9845173,10536903445,6625990,10130292399,3219183,406611046,88,1524241,903507284,1515670,902477980,8571,1029304,1470641,619,6630709,679471,88,6044,115556.0,28889.0,-67.0,-64.0,-71.0,-68.0,-67.0,-64.0,-71.0,-67.0,-77.0,-85.0,-77.0,-85.0,10.0,21.0,6.0,17.0,1
6454,F8:59:71:5A:E0:3D,3412518,695178970,193330,288567460,3219188,406611510,0,191583,246509090,186742,245930674,4841,578416,169076,16,196045,3272,0,556,144444.0,43333.0,-67.0,-72.0,-65.0,-70.0,-66.0,-71.0,-65.0,-69.0,-77.0,-85.0,-77.0,-85.0,10.0,13.0,12.0,15.0,1
6455,CC:2F:71:3E:C5:1F,3230628,408010906,11440,1399396,3219188,406611510,6,48805,4087576,40325,3082782,8480,1004794,12063,34,16404,186,6,831,144444.0,43333.0,-68.0,-72.0,-69.0,-60.0,-68.0,-70.0,-68.0,-59.0,-77.0,-85.0,-77.0,-85.0,9.0,13.0,8.0,25.0,1
6456,CC:2F:71:3F:1F:24,9846202,10538479309,6627014,10131867799,3219188,406611510,88,1524466,903624476,1515895,902595172,8571,1029304,1470866,619,6631731,679694,88,6046,130000.0,43333.0,-66.0,-64.0,-70.0,-68.0,-66.0,-64.0,-70.0,-67.0,-77.0,-85.0,-77.0,-85.0,11.0,21.0,7.0,17.0,1
6457,F8:59:71:5A:E0:3D,3412585,695277276,193393,288665362,3219192,406611914,0,191645,246604570,186804,246026154,4841,578416,169138,16,196108,3272,0,556,144444.0,43333.0,-67.0,-72.0,-65.0,-69.0,-67.0,-72.0,-65.0,-69.0,-77.0,-85.0,-77.0,-85.0,10.0,13.0,12.0,16.0,1
6458,CC:2F:71:3E:C5:1F,3230632,408011310,11440,1399396,3219192,406611914,6,48805,4087576,40325,3082782,8480,1004794,12063,34,16404,186,6,831,144444.0,43333.0,-68.0,-72.0,-69.0,-60.0,-68.0,-70.0,-68.0,-59.0,-77.0,-85.0,-77.0,-85.0,9.0,13.0,8.0,25.0,1
6459,CC:2F:71:3F:1F:24,9847590,10540623561,6628398,10134011647,3219192,406611914,88,1524762,903751272,1516191,902721968,8571,1029304,1471162,619,6633118,679758,88,6046,130000.0,43333.0,-67.0,-64.0,-71.0,-68.0,-67.0,-64.0,-70.0,-67.0,-77.0,-85.0,-77.0,-85.0,10.0,21.0,6.0,17.0,1
6460,F8:59:71:5A:E0:3D,3412652,695375582,193456,288763264,3219196,406612318,0,191708,246701590,186867,246123174,4841,578416,169201,16,196171,3272,0,556,144444.0,43333.0,-67.0,-72.0,-65.0,-70.0,-67.0,-71.0,-65.0,-69.0,-77.0,-85.0,-77.0,-85.0,10.0,13.0,12.0,15.0,1
6461,CC:2F:71:3E:C5:1F,3230637,408011987,11440,1399396,3219197,406612591,6,48805,4087576,40325,3082782,8480,1004794,12063,34,16404,186,6,831,144444.0,43333.0,-68.0,-72.0,-69.0,-60.0,-68.0,-70.0,-68.0,-59.0,-77.0,-85.0,-77.0,-85.0,9.0,13.0,8.0,25.0,1
6462,CC:2F:71:3F:1F:24,9848898,10542638822,6629700,10136026171,3219198,406612651,88,1525010,903869580,1516439,902840276,8571,1029304,1471410,619,6634420,679787,88,6046,130000.0,43333.0,-67.0,-64.0,-70.0,-68.0,-66.0,-64.0,-70.0,-68.0,-77.0,-85.0,-77.0,-85.0,10.0,21.0,7.0,17.0,1
6463,F8:59:71:5A:E0:3D,3412718,695472465,193518,288859612,3219200,406612853,0,191771,246798624,186930,246220208,4841,578416,169263,16,196233,3273,0,556,144444.0,43333.0,-67.0,-72.0,-65.0,-69.0,-67.0,-72.0,-65.0,-69.0,-77.0,-85.0,-77.0,-85.0,10.0,13.0,12.0,16.0,1
6464,CC:2F:71:3E:C5:1F,3230640,408012249,11440,1399396,3219200,406612853,6,48805,4087576,40325,3082782,8480,1004794,12063,34,16404,186,6,831,144444.0,43333.0,-68.0,-72.0,-69.0,-60.0,-68.0,-70.0,-68.0,-59.0,-77.0,-85.0,-77.0,-85.0,9.0,13.0,8.0,25.0,1
6465,CC:2F:71:3F:1F:24,9849762,10543946734,6630560,10137333679,3219202,406613055,88,1525230,903987989,1516659,902958685,8571,1029304,1471630,619,6635274,679852,88,6046,130000.0,43333.0,-67.0,-64.0,-71.0,-68.0,-67.0,-64.0,-69.0,-68.0,-77.0,-85.0,-77.0,-85.0,10.0,21.0,6.0,17.0,1
6466,F8:59:71:5A:E0:3D,3412786,695572325,193582,288959068,3219204,406613257,0,191835,246897184,186994,246318768,4841,578416,169327,16,196297,3274,0,556,144444.0,43333.0,-68.0,-72.0,-65.0,-70.0,-67.0,-72.0,-64.0,-69.0,-77.0,-85.0,-77.0,-85.0,9.0,13.0,12.0,15.0,1
6467,CC:2F:71:3E:C5:1F,3230644,408012653,11440,1399396,3219204,406613257,6,48805,4087576,40325,3082782,8480,1004794,12063,34,16404,186,6,831,144444.0,43333.0,-68.0,-72.0,-69.0,-60.0,-68.0,-70.0,-68.0,-59.0,-77.0,-85.0,-77.0,-85.0,9.0,13.0,8.0,25.0,1
6468,CC:2F:71:3F:1F:24,9850937,10545754416,6631731,10139140957,3219206,406613459,88,1525460,904104161,1516889,903074857,8571,1029304,1471860,619,6636450,680155,88,6046,115556.0,28889.0,-68.0,-64.0,-70.0,-68.0,-67.0,-64.0,-70.0,-68.0,-77.0,-85.0,-77.0,-85.0,9.0,21.0,7.0,17.0,1
6469,F8:59:71:5A:E0:3D,3412854,695672129,193646,289058468,3219208,406613661,0,191900,246997284,187059,246418868,4841,578416,169392,16,196361,3277,0,556,144444.0,43333.0,-67.0,-72.0,-65.0,-70.0,-67.0,-72.0,-65.0,-69.0,-77.0,-85.0,-77.0,-85.0,10.0,13.0,12.0,15.0,1
6470,CC:2F:71:3E:C5:1F,3230649,408013117,11440,1399396,3219209,406613721,6,48805,4087576,40325,3082782,8480,1004794,12063,34,16404,186,6,831,144444.0,43333.0,-68.0,-72.0,-69.0,-60.0,-68.0,-70.0,-68.0,-59.0,-77.0,-85.0,-77.0,-85.0,9.0,13.0,8.0,25.0,1
6471,CC:2F:71:3F:1F:24,9852473,10548132128,6633264,10141518407,3219209,406613721,88,1525822,904242697,1517251,903213393,8571,1029304,1472222,619,6637984,680293,88,6047,115556.0,28889.0,-68.0,-64.0,-70.0,-68.0,-67.0,-64.0,-70.0,-68.0,-77.0,-85.0,-77.0,-85.0,9.0,21.0,7.0,17.0,1
6472,F8:59:71:5A:E0:3D,3412922,695773345,193711,289159422,3219211,406613923,0,191965,247097384,187124,246518968,4841,578416,169457,16,196426,3278,0,556,144444.0,43333.0,-68.0,-73.0,-65.0,-70.0,-67.0,-72.0,-65.0,-69.0,-77.0,-85.0,-77.0,-85.0,9.0,12.0,12.0,15.0,1
6473,CC:2F:71:3E:C5:1F,3230653,408013521,11440,1399396,3219213,406614125,6,48805,4087576,40325,3082782,8480,1004794,12063,34,16404,186,6,831,144444.0,43333.0,-68.0,-72.0,-69.0,-60.0,-68.0,-70.0,-68.0,-59.0,-77.0,-85.0,-77.0,-85.0,9.0,13.0,8.0,25.0,1
6474,CC:2F:71:3F:1F:24,9853779,10550146808,6634566,10143532683,3219213,406614125,88,1526063,904360419,1517492,903331115,8571,1029304,1472463,619,6639279,680461,88,6047,115556.0,28889.0,-67.0,-65.0,-70.0,-69.0,-67.0,-64.0,-70.0,-68.0,-77.0,-85.0,-77.0,-85.0,10.0,20.0,7.0,16.0,1
6475,F8:59:71:5A:E0:3D,3412990,695868861,193773,289254332,3219217,406614529,0,192026,247191324,187185,246612908,4841,578416,169518,16,196488,3278,0,556,144444.0,43333.0,-67.0,-72.0,-66.0,-70.0,-67.0,-72.0,-65.0,-69.0,-77.0,-85.0,-77.0,-85.0,10.0,13.0,11.0,15.0,1
6476,CC:2F:71:3E:C5:1F,3230658,408013985,11441,1399456,3219217,406614529,6,48807,4087716,40327,3082922,8480,1004794,12063,34,16405,186,6,831,130000.0,39000.0,-65.0,-68.0,-64.0,-60.0,-67.0,-69.0,-67.0,-59.0,-77.0,-85.0,-77.0,-85.0,12.0,17.0,13.0,25.0,1
6477,CC:2F:71:3F:1F:24,9854620,10551418886,6635403,10144804357,3219217,406614529,88,1526294,904477218,1517723,903447914,8571,1029304,1472694,619,6640123,680514,88,6048,115556.0,28889.0,-67.0,-64.0,-70.0,-68.0,-66.0,-64.0,-70.0,-68.0,-77.0,-85.0,-77.0,-85.0,10.0,21.0,7.0,17.0,1
6478,F8:59:71:5A:E0:3D,3413057,695968579,193837,289353788,3219220,406614791,0,192089,247288372,187248,246709956,4841,578416,169581,16,196552,3278,0,556,144444.0,43333.0,-67.0,-72.0,-65.0,-70.0,-67.0,-72.0,-65.0,-69.0,-77.0,-85.0,-77.0,-85.0,10.0,13.0,12.0,15.0,1
6479,CC:2F:71:3E:C5:1F,3230661,408014247,11441,1399456,3219220,406614791,6,48807,4087716,40327,3082922,8480,1004794,12063,34,16405,186,6,831,130000.0,39000.0,-65.0,-68.0,-64.0,-60.0,-67.0,-69.0,-67.0,-59.0,-77.0,-85.0,-77.0,-85.0,12.0,17.0,13.0,25.0,1
6480,CC:2F:71:3F:1F:24,9855619,10552950644,6636399,10146335853,3219220,406614791,88,1526542,904596848,1517971,903567544,8571,1029304,1472942,619,6641119,680594,88,6048,115556.0,28889.0,-67.0,-64.0,-70.0,-68.0,-67.0,-64.0,-70.0,-68.0,-77.0,-85.0,-77.0,-85.0,10.0,21.0,7.0,17.0,1
6481,F8:59:71:5A:E0:3D,3413123,696065331,193899,289450136,3219224,406615195,0,192152,247385392,187311,246806976,4841,578416,169644,16,196614,3281,0,556,144444.0,43333.0,-68.0,-73.0,-65.0,-70.0,-67.0,-72.0,-65.0,-69.0,-77.0,-85.0,-77.0,-85.0,9.0,12.0,12.0,15.0,1
6482,CC:2F:71:3E:C5:1F,3230667,408014853,11441,1399456,3219226,406615397,6,48807,4087716,40327,3082922,8480,1004794,12063,34,16405,186,6,831,130000.0,39000.0,-65.0,-68.0,-64.0,-60.0,-67.0,-69.0,-67.0,-59.0,-77.0,-85.0,-77.0,-85.0,12.0,17.0,13.0,25.0,1
6483,CC:2F:71:3F:1F:24,9856822,10554798140,6637596,10148182743,3219226,406615397,88,1526817,904721130,1518246,903691826,8571,1029304,1473217,619,6642316,680728,88,6048,115556.0,28889.0,-67.0,-64.0,-70.0,-68.0,-66.0,-64.0,-70.0,-68.0,-77.0,-85.0,-77.0,-85.0,10.0,21.0,7.0,17.0,1
6484,F8:59:71:5A:E0:3D,3413192,696166745,193964,289551146,3219228,406615599,0,192215,247482412,187374,246903996,4841,578416,169707,16,196679,3281,0,556,144444.0,43333.0,-67.0,-72.0,-65.0,-70.0,-67.0,-72.0,-65.0,-69.0,-77.0,-85.0,-77.0,-85.0,10.0,13.0,12.0,15.0,1
6485,CC:2F:71:3E:C5:1F,3230669,408015055,11441,1399456,3219228,406615599,6,48807,4087716,40327,3082922,8480,1004794,12063,34,16405,186,6,831,130000.0,39000.0,-65.0,-68.0,-64.0,-60.0,-67.0,-69.0,-67.0,-59.0,-77.0,-85.0,-77.0,-85.0,12.0,17.0,13.0,25.0,1
6486,CC:2F:71:3F:1F:24,9858337,10557145728,6639109,10150530129,3219228,406615599,88,1527136,904850710,1518565,903821406,8571,1029304,1473536,619,6643829,680943,88,6048,115556.0,28889.0,-67.0,-64.0,-71.0,-68.0,-67.0,-64.0,-70.0,-68.0,-77.0,-85.0,-77.0,-85.0,10.0,21.0,6.0,17.0,1
6487,F8:59:71:5A:E0:3D,3413262,696266727,194028,289650602,3219234,406616125,0,192281,247582630,187439,247004096,4842,578534,169773,16,196743,3282,0,556,144444.0,43333.0,-68.0,-72.0,-65.0,-70.0,-67.0,-72.0,-65.0,-70.0,-77.0,-85.0,-77.0,-85.0,9.0,13.0,12.0,15.0,1
6488,CC:2F:71:3E:C5:1F,3230675,408015581,11441,1399456,3219234,406616125,6,48807,4087716,40327,3082922,8480,1004794,12063,34,16405,186,6,831,130000.0,39000.0,-65.0,-68.0,-64.0,-60.0,-67.0,-69.0,-67.0,-59.0,-77.0,-85.0,-77.0,-85.0,12.0,17.0,13.0,25.0,1
6489,CC:2F:71:3F:1F:24,9859403,10558770261,6640167,10152153934,3219236,406616327,88,1527404,904977740,1518833,903948436,8571,1029304,1473804,619,6644887,681038,88,6048,115556.0,26000.0,-67.0,-64.0,-69.0,-69.0,-66.0,-64.0,-69.0,-68.0,-77.0,-85.0,-77.0,-85.0,10.0,21.0,8.0,16.0,1
6490,F8:59:71:5A:E0:3D,3413333,696369589,194094,289752998,3219239,406616591,0,192348,247685810,187506,247107276,4842,578534,169840,16,196809,3282,0,556,144444.0,43333.0,-68.0,-72.0,-65.0,-70.0,-67.0,-72.0,-65.0,-70.0,-77.0,-85.0,-77.0,-85.0,9.0,13.0,12.0,15.0,1
6491,CC:2F:71:3E:C5:1F,3230684,408016708,11445,1400117,3219239,406616591,6,48814,4088649,40333,3083737,8481,1004912,12069,34,16409,186,6,832,130000.0,39000.0,-69.0,-72.0,-68.0,-60.0,-68.0,-71.0,-67.0,-60.0,-77.0,-85.0,-77.0,-85.0,8.0,13.0,9.0,25.0,1
6492,CC:2F:71:3F:1F:24,9860205,10559985920,6640966,10153369329,3219239,406616591,88,1527613,905094410,1519042,904065106,8571,1029304,1474013,619,6645686,681053,88,6048,115556.0,28889.0,-67.0,-64.0,-72.0,-68.0,-66.0,-64.0,-71.0,-68.0,-77.0,-85.0,-77.0,-85.0,10.0,21.0,5.0,17.0,1
6493,F8:59:71:5A:E0:3D,3413400,696467895,194157,289850900,3219243,406616995,0,192411,247782844,187569,247204310,4842,578534,169902,16,196872,3282,0,556,144444.0,43333.0,-68.0,-73.0,-65.0,-70.0,-67.0,-72.0,-65.0,-70.0,-77.0,-85.0,-77.0,-85.0,9.0,12.0,12.0,15.0,1
6494,CC:2F:71:3E:C5:1F,3230688,408017112,11445,1400117,3219243,406616995,6,48814,4088649,40333,3083737,8481,1004912,12069,34,16409,186,6,832,130000.0,39000.0,-69.0,-72.0,-68.0,-60.0,-68.0,-71.0,-67.0,-60.0,-77.0,-85.0,-77.0,-85.0,8.0,13.0,9.0,25.0,1
6495,CC:2F:71:3F:1F:24,9860879,10561002056,6641636,10154385061,3219243,406616995,88,1527806,905207920,1519235,904178616,8571,1029304,1474206,619,6646356,681066,88,6049,115556.0,28889.0,-67.0,-64.0,-71.0,-68.0,-67.0,-64.0,-70.0,-68.0,-77.0,-85.0,-77.0,-85.0,10.0,21.0,6.0,17.0,1
6496,F8:59:71:5A:E0:3D,3413476,696577255,194228,289959796,3219248,406617459,0,192480,247887670,187638,247309136,4842,578534,169971,16,196943,3282,0,556,144444.0,43333.0,-68.0,-73.0,-65.0,-70.0,-67.0,-72.0,-65.0,-69.0,-77.0,-85.0,-77.0,-85.0,9.0,12.0,12.0,15.0,1
6497,CC:2F:71:3E:C5:1F,3230693,408017576,11445,1400117,3219248,406617459,6,48814,4088649,40333,3083737,8481,1004912,12069,34,16409,186,6,832,130000.0,39000.0,-69.0,-72.0,-68.0,-60.0,-68.0,-71.0,-67.0,-60.0,-77.0,-85.0,-77.0,-85.0,8.0,13.0,9.0,25.0,1
6498,CC:2F:71:3F:1F:24,9861823,10562440856,6642575,10155823397,3219248,406617459,88,1527991,905331834,1519420,904302530,8571,1029304,1474391,619,6647295,681184,88,6049,115556.0,28889.0,-67.0,-64.0,-71.0,-68.0,-67.0,-64.0,-71.0,-68.0,-77.0,-85.0,-77.0,-85.0,10.0,21.0,6.0,17.0,1
6499,F8:59:71:5A:E0:3D,3413543,696675561,194291,290057698,3219252,406617863,0,192546,247989310,187704,247410776,4842,578534,170037,16,197006,3283,0,556,144444.0,43333.0,-67.0,-73.0,-66.0,-69.0,-67.0,-73.0,-65.0,-69.0,-77.0,-85.0,-77.0,-85.0,10.0,12.0,11.0,16.0,1
6500,CC:2F:71:3E:C5:1F,3230697,408017980,11445,1400117,3219252,406617863,6,48814,4088649,40333,3083737,8481,1004912,12069,34,16409,186,6,832,130000.0,39000.0,-69.0,-72.0,-68.0,-60.0,-68.0,-71.0,-67.0,-60.0,-77.0,-85.0,-77.0,-85.0,8.0,13.0,9.0,25.0,1
6501,CC:2F:71:3F:1F:24,9862771,10563889364,6643519,10157271501,3219252,406617863,88,1528223,905448406,1519652,904419102,8571,1029304,1474623,619,6648238,681213,88,6049,115556.0,28889.0,-68.0,-64.0,-70.0,-68.0,-67.0,-64.0,-69.0,-68.0,-77.0,-85.0,-77.0,-85.0,9.0,21.0,7.0,17.0,1
6502,F8:59:71:5A:E0:3D,3413609,696775219,194355,290157154,3219254,406618065,0,192609,248086330,187767,247507796,4842,578534,170100,16,197070,3283,0,556,144444.0,43333.0,-66.0,-72.0,-66.0,-69.0,-66.0,-72.0,-65.0,-69.0,-77.0,-85.0,-77.0,-85.0,11.0,13.0,11.0,16.0,1
6503,CC:2F:71:3E:C5:1F,3230701,408018384,11445,1400117,3219256,406618267,6,48814,4088649,40333,3083737,8481,1004912,12069,34,16409,186,6,832,130000.0,39000.0,-69.0,-72.0,-68.0,-60.0,-68.0,-71.0,-67.0,-60.0,-77.0,-85.0,-77.0,-85.0,8.0,13.0,9.0,25.0,1
6504,CC:2F:71:3F:1F:24,9863781,10565425555,6644524,10158807015,3219257,406618540,88,1528442,905566741,1519871,904537437,8571,1029304,1474842,619,6649244,681425,88,6049,130000.0,43333.0,-67.0,-64.0,-69.0,-67.0,-67.0,-64.0,-69.0,-67.0,-77.0,-85.0,-77.0,-85.0,10.0,21.0,8.0,18.0,1
6505,F8:59:71:5A:E0:3D,3413677,696875210,194419,290256610,3219258,406618600,0,192672,248183350,187830,247604816,4842,578534,170163,16,197134,3283,0,556,144444.0,43333.0,-66.0,-72.0,-66.0,-70.0,-66.0,-72.0,-66.0,-70.0,-77.0,-85.0,-77.0,-85.0,11.0,13.0,11.0,15.0,1
6506,CC:2F:71:3E:C5:1F,3230707,408019121,11445,1400117,3219262,406619004,6,48814,4088649,40333,3083737,8481,1004912,12069,34,16409,186,6,832,130000.0,39000.0,-69.0,-72.0,-68.0,-60.0,-68.0,-71.0,-67.0,-60.0,-77.0,-85.0,-77.0,-85.0,8.0,13.0,9.0,25.0,1
6507,CC:2F:71:3F:1F:24,9864770,10566937195,6645508,10160318191,3219262,406619004,88,1528688,905689089,1520117,904659785,8571,1029304,1475088,619,6650228,681443,88,6049,130000.0,43333.0,-67.0,-64.0,-69.0,-69.0,-67.0,-64.0,-68.0,-68.0,-77.0,-85.0,-77.0,-85.0,10.0,21.0,8.0,16.0,1
6508,F8:59:71:5A:E0:3D,3413746,696973718,194482,290354512,3219264,406619206,0,192737,248283450,187895,247704916,4842,578534,170228,16,197197,3283,0,556,144444.0,43333.0,-67.0,-73.0,-66.0,-70.0,-66.0,-73.0,-66.0,-70.0,-77.0,-85.0,-77.0,-85.0,10.0,12.0,11.0,15.0,1
6509,CC:2F:71:3E:C5:1F,3230709,408019323,11445,1400117,3219264,406619206,6,48814,4088649,40333,3083737,8481,1004912,12069,34,16409,186,6,832,130000.0,39000.0,-69.0,-72.0,-68.0,-60.0,-68.0,-71.0,-67.0,-60.0,-77.0,-85.0,-77.0,-85.0,8.0,13.0,9.0,25.0,1
6510,CC:2F:71:3F:1F:24,9865992,10568820757,6646728,10162201551,3219264,406619206,88,1528935,905810039,1520364,904780735,8571,1029304,1475335,619,6651448,681563,88,6049,130000.0,43333.0,-67.0,-63.0,-70.0,-68.0,-67.0,-63.0,-69.0,-68.0,-77.0,-85.0,-77.0,-85.0,10.0,22.0,7.0,17.0,1
6511,F8:59:71:5A:E0:3D,3413813,697074930,194547,290455522,3219266,406619408,0,192802,248383550,187960,247805016,4842,578534,170293,16,197262,3283,0,556,144444.0,43333.0,-68.0,-73.0,-65.0,-70.0,-66.0,-72.0,-65.0,-70.0,-77.0,-85.0,-77.0,-85.0,9.0,12.0,12.0,15.0,1
6512,CC:2F:71:3E:C5:1F,3230712,408019641,11446,1400233,3219266,406619408,6,48816,4088825,40335,3083913,8481,1004912,12070,34,16410,186,6,832,130000.0,39000.0,-68.0,-70.0,-68.0,-60.0,-68.0,-71.0,-68.0,-60.0,-77.0,-85.0,-77.0,-85.0,9.0,15.0,9.0,25.0,1
6513,CC:2F:71:3F:1F:24,9867521,10571182987,6648250,10164563115,3219271,406619872,88,1529219,905938237,1520648,904908933,8571,1029304,1475616,619,6652970,681614,88,6049,130000.0,43333.0,-68.0,-64.0,-69.0,-67.0,-68.0,-64.0,-68.0,-67.0,-77.0,-85.0,-77.0,-85.0,9.0,21.0,8.0,18.0,1
6514,F8:59:71:5A:E0:3D,3413890,697182884,194616,290562748,3219274,406620136,0,192869,248486730,188027,247908196,4842,578534,170360,16,197331,3286,0,556,144444.0,43333.0,-66.0,-73.0,-66.0,-70.0,-66.0,-72.0,-65.0,-70.0,-77.0,-85.0,-77.0,-85.0,11.0,12.0,11.0,15.0,1
6515,CC:2F:71:3E:C5:1F,3230720,408020369,11446,1400233,3219274,406620136,6,48817,4088895,40336,3083983,8481,1004912,12070,34,16410,186,6,832,130000.0,39000.0,-68.0,-71.0,-67.0,-60.0,-68.0,-71.0,-67.0,-60.0,-77.0,-85.0,-77.0,-85.0,9.0,14.0,10.0,25.0,1
6516,CC:2F:71:3F:1F:24,9868660,10572927663,6649386,10166307527,3219274,406620136,88,1529434,906060349,1520862,905030927,8572,1029422,1475829,619,6654075,681800,88,6051,130000.0,43333.0,-69.0,-64.0,-69.0,-68.0,-67.0,-64.0,-68.0,-67.0,-77.0,-85.0,-77.0,-85.0,8.0,21.0,8.0,17.0,1
6517,F8:59:71:5A:E0:3D,3413959,697287204,194683,290666866,3219276,406620338,0,192938,248593004,188096,248014470,4842,578534,170428,16,197398,3286,0,556,144444.0,43333.0,-66.0,-73.0,-66.0,-70.0,-66.0,-72.0,-66.0,-69.0,-77.0,-85.0,-77.0,-85.0,11.0,12.0,11.0,15.0,1
6518,CC:2F:71:3E:C5:1F,3230724,408020939,11446,1400233,3219278,406620706,6,48817,4088895,40336,3083983,8481,1004912,12070,34,16410,186,6,832,130000.0,39000.0,-68.0,-71.0,-67.0,-60.0,-68.0,-71.0,-67.0,-60.0,-77.0,-85.0,-77.0,-85.0,9.0,14.0,10.0,25.0,1
6519,CC:2F:71:3F:1F:24,9869440,10574109841,6650162,10167489135,3219278,406620706,88,1529663,906185111,1521091,905155689,8572,1029422,1476057,619,6654882,681803,88,6051,130000.0,43333.0,-68.0,-64.0,-68.0,-68.0,-68.0,-64.0,-68.0,-67.0,-77.0,-85.0,-77.0,-85.0,9.0,21.0,9.0,17.0,1
6520,F8:59:71:5A:E0:3D,3414033,697389248,194748,290767876,3219285,406621372,0,193004,248694700,188162,248116166,4842,578534,170494,16,197463,3286,0,556,144444.0,43333.0,-67.0,-72.0,-67.0,-70.0,-66.0,-72.0,-66.0,-69.0,-77.0,-85.0,-77.0,-85.0,10.0,13.0,10.0,15.0,1
6521,CC:2F:71:3E:C5:1F,3230731,408021605,11446,1400233,3219285,406621372,6,48817,4088895,40336,3083983,8481,1004912,12070,34,16410,186,6,832,130000.0,39000.0,-68.0,-71.0,-67.0,-60.0,-68.0,-71.0,-67.0,-60.0,-77.0,-85.0,-77.0,-85.0,9.0,14.0,10.0,25.0,1
6522,CC:2F:71:3F:1F:24,9870576,10575851909,6651291,10169230537,3219285,406621372,88,1529865,906300751,1521293,905271329,8572,1029422,1476259,619,6656011,681895,88,6051,130000.0,39000.0,-69.0,-64.0,-68.0,-68.0,-68.0,-64.0,-68.0,-68.0,-77.0,-85.0,-77.0,-85.0,8.0,21.0,9.0,17.0,1
6523,F8:59:71:5A:E0:3D,3414099,697488906,194812,290867332,3219287,406621574,0,193068,248793274,188226,248214740,4842,578534,170557,16,197527,3288,0,556,144444.0,43333.0,-67.0,-73.0,-65.0,-70.0,-66.0,-72.0,-66.0,-69.0,-77.0,-85.0,-77.0,-85.0,10.0,12.0,12.0,15.0,1
6524,CC:2F:71:3E:C5:1F,3230733,408021807,11446,1400233,3219287,406621574,6,48817,4088895,40336,3083983,8481,1004912,12070,34,16410,186,6,832,130000.0,39000.0,-68.0,-71.0,-67.0,-60.0,-68.0,-71.0,-67.0,-60.0,-77.0,-85.0,-77.0,-85.0,9.0,14.0,10.0,25.0,1
6525,CC:2F:71:3F:1F:24,9872043,10578123441,6652756,10171501867,3219287,406621574,88,1530144,906429735,1521572,905400313,8572,1029422,1476536,619,6657476,682048,88,6051,130000.0,43333.0,-68.0,-64.0,-68.0,-68.0,-67.0,-64.0,-68.0,-68.0,-77.0,-85.0,-77.0,-85.0,9.0,21.0,9.0,17.0,1
6526,F8:59:71:5A:E0:3D,3414172,697593630,194879,290971450,3219293,406622180,0,193135,248896454,188293,248317920,4842,578534,170624,16,197594,3288,0,556,144444.0,43333.0,-66.0,-72.0,-67.0,-70.0,-66.0,-72.0,-66.0,-70.0,-77.0,-85.0,-77.0,-85.0,11.0,13.0,10.0,15.0,1
6527,CC:2F:71:3E:C5:1F,3230739,408022413,11446,1400233,3219293,406622180,6,48817,4088895,40336,3083983,8481,1004912,12070,34,16410,186,6,832,130000.0,39000.0,-68.0,-71.0,-67.0,-60.0,-68.0,-71.0,-67.0,-60.0,-77.0,-85.0,-77.0,-85.0,9.0,14.0,10.0,25.0,1
6528,CC:2F:71:3F:1F:24,9873448,10580283969,6654155,10173661789,3219293,406622180,88,1530381,906551438,1521809,905522016,8572,1029422,1476773,619,6658846,682143,88,6051,130000.0,43333.0,-68.0,-64.0,-69.0,-68.0,-68.0,-64.0,-68.0,-68.0,-77.0,-85.0,-77.0,-85.0,9.0,21.0,8.0,17.0,1
6529,F8:59:71:5A:E0:3D,3414241,697696456,194945,291074014,3219296,406622442,0,193202,248999634,188360,248421100,4842,578534,170691,16,197660,3288,0,556,144444.0,43333.0,-67.0,-73.0,-66.0,-70.0,-66.0,-73.0,-66.0,-70.0,-77.0,-85.0,-77.0,-85.0,10.0,12.0,11.0,15.0,1
6530,CC:2F:71:3E:C5:1F,3230742,408022675,11446,1400233,3219296,406622442,6,48817,4088895,40336,3083983,8481,1004912,12070,34,16410,186,6,832,130000.0,39000.0,-68.0,-71.0,-67.0,-60.0,-68.0,-71.0,-67.0,-60.0,-77.0,-85.0,-77.0,-85.0,9.0,14.0,10.0,25.0,1
6531,CC:2F:71:3F:1F:24,9875274,10583118885,6655978,10176496443,3219296,406622442,88,1530680,906693130,1522108,905663708,8572,1029422,1477058,619,6660698,682253,88,6051,130000.0,39000.0,-68.0,-64.0,-68.0,-68.0,-67.0,-64.0,-68.0,-68.0,-77.0,-85.0,-77.0,-85.0,9.0,21.0,9.0,17.0,1
6532,F8:59:71:5A:E0:3D,3414312,697798072,195010,291175024,3219302,406623048,0,193267,249099734,188425,248521200,4842,578534,170756,16,197725,3289,0,556,144444.0,43333.0,-67.0,-73.0,-66.0,-70.0,-66.0,-72.0,-66.0,-70.0,-77.0,-85.0,-77.0,-85.0,10.0,12.0,11.0,15.0,1
6533,CC:2F:71:3E:C5:1F,3230748,408023281,11446,1400233,3219302,406623048,6,48817,4088895,40336,3083983,8481,1004912,12070,34,16410,186,6,832,130000.0,39000.0,-68.0,-71.0,-67.0,-60.0,-68.0,-71.0,-67.0,-60.0,-77.0,-85.0,-77.0,-85.0,9.0,14.0,10.0,25.0,1
6534,CC:2F:71:3F:1F:24,9876441,10584911189,6657139,10178288141,3219302,406623048,88,1530916,906821964,1522344,905792542,8572,1029422,1477269,619,6661859,682409,88,6051,130000.0,43333.0,-67.0,-64.0,-68.0,-68.0,-67.0,-64.0,-68.0,-68.0,-77.0,-85.0,-77.0,-85.0,10.0,21.0,9.0,17.0,1
6535,F8:59:71:5A:E0:3D,3414378,697897730,195074,291274480,3219304,406623250,0,193331,249198294,188489,248619760,4842,578534,170820,16,197789,3290,0,556,144444.0,43333.0,-66.0,-73.0,-67.0,-70.0,-66.0,-72.0,-66.0,-70.0,-77.0,-85.0,-77.0,-85.0,11.0,12.0,10.0,15.0,1
6536,CC:2F:71:3E:C5:1F,3230750,408023483,11446,1400233,3219304,406623250,6,48817,4088895,40336,3083983,8481,1004912,12070,34,16410,186,6,832,130000.0,39000.0,-68.0,-71.0,-67.0,-60.0,-68.0,-71.0,-67.0,-60.0,-77.0,-85.0,-77.0,-85.0,9.0,14.0,10.0,25.0,1
6537,CC:2F:71:3F:1F:24,9877630,10586745845,6658326,10180122595,3219304,406623250,88,1531195,906945244,1522623,905915822,8572,1029422,1477548,619,6663046,682426,88,6051,130000.0,43333.0,-68.0,-64.0,-68.0,-68.0,-67.0,-64.0,-68.0,-68.0,-77.0,-85.0,-77.0,-85.0,9.0,21.0,9.0,17.0,1
6538,F8:59:71:5A:E0:3D,3414448,697996298,195137,291372382,3219311,406623916,0,193393,249293774,188551,248715240,4842,578534,170882,16,197852,3290,0,556,144444.0,43333.0,-66.0,-72.0,-66.0,-70.0,-66.0,-72.0,-65.0,-70.0,-77.0,-85.0,-77.0,-85.0,11.0,13.0,11.0,15.0,1
6539,CC:2F:71:3E:C5:1F,3230757,408024149,11446,1400233,3219311,406623916,6,48817,4088895,40336,3083983,8481,1004912,12070,34,16410,186,6,832,130000.0,39000.0,-68.0,-71.0,-67.0,-60.0,-68.0,-71.0,-67.0,-60.0,-77.0,-85.0,-77.0,-85.0,9.0,14.0,10.0,25.0,1
6540,CC:2F:71:3F:1F:24,9878772,10588491113,6659461,10181867197,3219311,406623916,88,1531452,907066470,1522880,906037048,8572,1029422,1477805,619,6664181,682518,88,6051,130000.0,43333.0,-67.0,-64.0,-68.0,-68.0,-67.0,-64.0,-68.0,-68.0,-77.0,-85.0,-77.0,-85.0,10.0,21.0,9.0,17.0,1
6541,F8:59:71:5A:E0:3D,3414513,698094402,195200,291470284,3219313,406624118,0,193457,249392334,188615,248813800,4842,578534,170946,16,197915,3292,0,556,144444.0,43333.0,-66.0,-73.0,-67.0,-70.0,-66.0,-72.0,-66.0,-70.0,-77.0,-85.0,-77.0,-85.0,11.0,12.0,10.0,15.0,1
6542,CC:2F:71:3E:C5:1F,3230759,408024351,11446,1400233,3219313,406624118,6,48817,4088895,40336,3083983,8481,1004912,12070,34,16410,186,6,832,130000.0,39000.0,-68.0,-71.0,-67.0,-60.0,-68.0,-71.0,-67.0,-60.0,-77.0,-85.0,-77.0,-85.0,9.0,14.0,10.0,25.0,1
6543,CC:2F:71:3F:1F:24,9880292,10590844839,6660979,10184220721,3219313,406624118,88,1531712,907192106,1523140,906162684,8572,1029422,1478064,619,6665699,682570,88,6052,130000.0,43333.0,-68.0,-65.0,-68.0,-68.0,-67.0,-64.0,-68.0,-68.0,-77.0,-85.0,-77.0,-85.0,9.0,20.0,9.0,17.0,1
6544,F8:59:71:5A:E0:3D,3414584,698196018,195265,291571294,3219319,406624724,0,193522,249492434,188680,248913900,4842,578534,171011,16,197980,3293,0,556,144444.0,43333.0,-66.0,-73.0,-66.0,-70.0,-66.0,-72.0,-66.0,-70.0,-77.0,-85.0,-77.0,-85.0,11.0,12.0,11.0,15.0,1
6545,CC:2F:71:3E:C5:1F,3230765,408024957,11446,1400233,3219319,406624724,6,48817,4088895,40336,3083983,8481,1004912,12070,34,16410,186,6,832,130000.0,39000.0,-68.0,-71.0,-67.0,-60.0,-68.0,-71.0,-67.0,-60.0,-77.0,-85.0,-77.0,-85.0,9.0,14.0,10.0,25.0,1
6546,CC:2F:71:3F:1F:24,9881521,10592732502,6662200,10186107379,3219321,406625123,88,1531934,907311926,1523362,906282504,8572,1029422,1478285,619,6666890,682675,88,6052,130000.0,43333.0,-68.0,-64.0,-69.0,-68.0,-68.0,-64.0,-68.0,-68.0,-77.0,-85.0,-77.0,-85.0,9.0,21.0,8.0,17.0,1
6547,F8:59:71:5A:E0:3D,3414652,698297487,195330,291672304,3219322,406625183,0,193585,249589454,188743,249010920,4842,578534,171074,16,198045,3293,0,556,144444.0,43333.0,-67.0,-72.0,-66.0,-70.0,-66.0,-72.0,-66.0,-70.0,-77.0,-85.0,-77.0,-85.0,10.0,13.0,11.0,15.0,1
6548,CC:2F:71:3E:C5:1F,3230768,408025416,11446,1400233,3219322,406625183,6,48817,4088895,40336,3083983,8481,1004912,12070,34,16410,186,6,832,130000.0,39000.0,-68.0,-71.0,-67.0,-60.0,-68.0,-71.0,-67.0,-60.0,-77.0,-85.0,-77.0,-85.0,9.0,14.0,10.0,25.0,1
6549,CC:2F:71:3F:1F:24,9883161,10595274150,6663837,10188648765,3219324,406625385,88,1532196,907435148,1523624,906405726,8572,1029422,1478547,619,6668557,682793,88,6055,130000.0,43333.0,-68.0,-64.0,-68.0,-68.0,-68.0,-64.0,-68.0,-68.0,-77.0,-85.0,-77.0,-85.0,9.0,21.0,9.0,17.0,1
6550,F8:59:71:5A:E0:3D,3414720,698397347,195394,291771760,3219326,406625587,0,193651,249691094,188809,249112560,4842,578534,171140,16,198109,3293,0,556,144444.0,43333.0,-67.0,-73.0,-66.0,-70.0,-66.0,-72.0,-66.0,-70.0,-77.0,-85.0,-77.0,-85.0,10.0,12.0,11.0,15.0,1
6551,CC:2F:71:3E:C5:1F,3230772,408025820,11446,1400233,3219326,406625587,6,48817,4088895,40336,3083983,8481,1004912,12070,34,16410,186,6,832,130000.0,39000.0,-68.0,-71.0,-67.0,-60.0,-68.0,-71.0,-67.0,-60.0,-77.0,-85.0,-77.0,-85.0,9.0,14.0,10.0,25.0,1
6552,CC:2F:71:3F:1F:24,9884269,10596972160,6664939,10190346169,3219330,406625991,88,1532403,907551742,1523831,906522320,8572,1029422,1478754,619,6669659,682838,88,6057,130000.0,43333.0,-68.0,-64.0,-69.0,-68.0,-68.0,-64.0,-68.0,-68.0,-77.0,-85.0,-77.0,-85.0,9.0,21.0,8.0,17.0,1
6553,F8:59:71:5A:E0:3D,3414787,698495653,195457,291869662,3219330,406625991,0,193715,249789724,188873,249211190,4842,578534,171203,16,198172,3293,0,556,144444.0,43333.0,-67.0,-73.0,-66.0,-70.0,-66.0,-72.0,-66.0,-70.0,-77.0,-85.0,-77.0,-85.0,10.0,12.0,11.0,15.0,1
6554,CC:2F:71:3E:C5:1F,3230777,408026284,11446,1400233,3219331,406626051,6,48817,4088895,40336,3083983,8481,1004912,12070,34,16410,186,6,832,130000.0,39000.0,-68.0,-71.0,-67.0,-60.0,-68.0,-71.0,-67.0,-60.0,-77.0,-85.0,-77.0,-85.0,9.0,14.0,10.0,25.0,1
6555,CC:2F:71:3F:1F:24,9885342,10598616184,6666011,10191990133,3219331,406626051,88,1532626,907670697,1524054,906641275,8572,1029422,1478976,619,6670731,682921,88,6057,130000.0,43333.0,-68.0,-64.0,-69.0,-68.0,-68.0,-64.0,-68.0,-68.0,-77.0,-85.0,-77.0,-85.0,9.0,21.0,8.0,17.0,1
6556,F8:59:71:5A:E0:3D,3414854,698595203,195521,291968950,3219333,406626253,0,193779,249888284,188937,249309750,4842,578534,171267,16,198236,3293,0,556,144444.0,43333.0,-66.0,-73.0,-66.0,-70.0,-66.0,-72.0,-66.0,-70.0,-77.0,-85.0,-77.0,-85.0,11.0,12.0,11.0,15.0,1
6557,CC:2F:71:3E:C5:1F,3230781,408026688,11446,1400233,3219335,406626455,6,48817,4088895,40336,3083983,8481,1004912,12070,34,16410,186,6,832,130000.0,39000.0,-68.0,-71.0,-67.0,-60.0,-68.0,-71.0,-67.0,-60.0,-77.0,-85.0,-77.0,-85.0,9.0,14.0,10.0,25.0,1
6558,CC:2F:71:3F:1F:24,9886758,10600802884,6667423,10194176429,3219335,406626455,88,1532890,907795325,1524318,906765903,8572,1029422,1479240,619,6672143,683025,88,6058,130000.0,43333.0,-67.0,-64.0,-67.0,-68.0,-67.0,-64.0,-67.0,-68.0,-77.0,-85.0,-77.0,-85.0,10.0,21.0,10.0,17.0,1
6559,F8:59:71:5A:E0:3D,3414927,698698489,195588,292071630,3219339,406626859,0,193845,249989924,189003,249411390,4842,578534,171333,16,198303,3295,0,556,144444.0,43333.0,-66.0,-71.0,-66.0,-70.0,-66.0,-72.0,-65.0,-70.0,-77.0,-85.0,-77.0,-85.0,11.0,14.0,11.0,15.0,1
6560,CC:2F:71:3E:C5:1F,3230786,408027208,11447,1400349,3219339,406626859,6,48819,4089035,40338,3084123,8481,1004912,12070,34,16411,186,6,832,130000.0,39000.0,-67.0,-71.0,-67.0,-60.0,-68.0,-71.0,-67.0,-60.0,-77.0,-85.0,-77.0,-85.0,10.0,14.0,10.0,25.0,1
6561,CC:2F:71:3F:1F:24,9888066,10602819362,6668727,10196192503,3219339,406626859,88,1533129,907915855,1524557,906886433,8572,1029422,1479479,619,6673447,683094,88,6058,130000.0,43333.0,-67.0,-64.0,-68.0,-67.0,-67.0,-64.0,-68.0,-67.0,-77.0,-85.0,-77.0,-85.0,10.0,21.0,9.0,18.0,1
6562,F8:59:71:5A:E0:3D,3414994,698796715,195651,292169532,3219343,406627183,0,193909,250087062,189066,249508410,4843,578652,171397,16,198366,3296,0,556,144444.0,43333.0,-67.0,-73.0,-65.0,-70.0,-66.0,-72.0,-65.0,-70.0,-77.0,-85.0,-77.0,-85.0,10.0,12.0,12.0,15.0,1
6563,CC:2F:71:3E:C5:1F,3230790,408027532,11447,1400349,3219343,406627183,6,48819,4089035,40338,3084123,8481,1004912,12070,34,16411,186,6,832,130000.0,39000.0,-67.0,-71.0,-67.0,-60.0,-68.0,-71.0,-67.0,-60.0,-77.0,-85.0,-77.0,-85.0,10.0,14.0,10.0,25.0,1
6564,CC:2F:71:3F:1F:24,9889621,10605227060,6670278,10198599877,3219343,406627183,88,1533406,908039059,1524834,907009637,8572,1029422,1479756,619,6674966,683159,88,6060,130000.0,43333.0,-68.0,-64.0,-70.0,-68.0,-68.0,-64.0,-69.0,-67.0,-77.0,-85.0,-77.0,-85.0,9.0,21.0,7.0,17.0,1
6565,F8:59:71:5A:E0:3D,3415065,698898219,195716,292270430,3219349,406627789,0,193973,250185622,189130,249606970,4843,578652,171461,16,198430,3296,0,556,144444.0,43333.0,-67.0,-73.0,-65.0,-70.0,-66.0,-72.0,-65.0,-70.0,-77.0,-85.0,-77.0,-85.0,10.0,12.0,12.0,15.0,1
6566,CC:2F:71:3E:C5:1F,3230796,408028138,11447,1400349,3219349,406627789,6,48819,4089035,40338,3084123,8481,1004912,12070,34,16411,186,6,832,130000.0,39000.0,-67.0,-71.0,-67.0,-60.0,-68.0,-71.0,-67.0,-60.0,-77.0,-85.0,-77.0,-85.0,10.0,14.0,10.0,25.0,1
6567,CC:2F:71:3F:1F:24,9890933,10607237514,6671584,10200609725,3219349,406627789,88,1533653,908160676,1525081,907131254,8572,1029422,1480003,619,6676304,683277,88,6060,130000.0,43333.0,-68.0,-64.0,-68.0,-68.0,-67.0,-64.0,-68.0,-67.0,-77.0,-85.0,-77.0,-85.0,9.0,21.0,9.0,17.0,1
6568,F8:59:71:5A:E0:3D,3415130,698996323,195779,292368332,3219351,406627991,0,194037,250284182,189194,249705530,4843,578652,171525,16,198494,3298,0,556,144444.0,43333.0,-66.0,-73.0,-66.0,-70.0,-66.0,-72.0,-65.0,-69.0,-77.0,-85.0,-77.0,-85.0,11.0,12.0,11.0,15.0,1
6569,CC:2F:71:3E:C5:1F,3230798,408028340,11447,1400349,3219351,406627991,6,48819,4089035,40338,3084123,8481,1004912,12070,34,16411,186,6,832,130000.0,39000.0,-67.0,-71.0,-67.0,-60.0,-68.0,-71.0,-67.0,-60.0,-77.0,-85.0,-77.0,-85.0,10.0,14.0,10.0,25.0,1
6570,CC:2F:71:3F:1F:24,9892350,10609428962,6672999,10202800971,3219351,406627991,88,1533927,908290448,1525355,907261026,8572,1029422,1480277,619,6677719,683327,88,6060,130000.0,43333.0,-67.0,-64.0,-69.0,-67.0,-67.0,-64.0,-68.0,-67.0,-77.0,-85.0,-77.0,-85.0,10.0,21.0,8.0,18.0,1
6571,F8:59:71:5A:E0:3D,3415208,699105831,195849,292477112,3219359,406628719,0,194106,250390512,189263,249811860,4843,578652,171594,16,198564,3299,0,559,144444.0,43333.0,-66.0,-73.0,-66.0,-70.0,-66.0,-72.0,-65.0,-69.0,-77.0,-85.0,-77.0,-85.0,11.0,12.0,11.0,15.0,1
6572,CC:2F:71:3E:C5:1F,3230806,408029068,11447,1400349,3219359,406628719,6,48819,4089035,40338,3084123,8481,1004912,12070,34,16411,186,6,832,130000.0,39000.0,-67.0,-71.0,-67.0,-60.0,-68.0,-71.0,-67.0,-60.0,-77.0,-85.0,-77.0,-85.0,10.0,14.0,10.0,25.0,1
6573,CC:2F:71:3F:1F:24,9893821,10611697856,6674462,10205069137,3219359,406628719,88,1534175,908418968,1525602,907389428,8573,1029540,1480525,619,6679150,683377,88,6060,130000.0,43333.0,-69.0,-64.0,-67.0,-69.0,-68.0,-63.0,-67.0,-68.0,-77.0,-85.0,-77.0,-85.0,8.0,21.0,10.0,16.0,1
6574,F8:59:71:5A:E0:3D,3415281,699213379,195918,292584338,3219363,406629041,0,194178,250501420,189335,249922768,4843,578652,171664,16,198633,3299,0,559,144444.0,43333.0,-67.0,-73.0,-66.0,-70.0,-67.0,-73.0,-65.0,-69.0,-77.0,-85.0,-77.0,-85.0,10.0,12.0,11.0,15.0,1
6575,CC:2F:71:3E:C5:1F,3230810,408029390,11447,1400349,3219363,406629041,6,48819,4089035,40338,3084123,8481,1004912,12070,34,16411,186,6,832,130000.0,39000.0,-67.0,-71.0,-67.0,-60.0,-68.0,-71.0,-67.0,-60.0,-77.0,-85.0,-77.0,-85.0,10.0,14.0,10.0,25.0,1
6576,CC:2F:71:3F:1F:24,9895259,10613919182,6675896,10207290141,3219363,406629041,88,1534430,908545148,1525857,907515608,8573,1029540,1480780,619,6680586,683496,88,6060,130000.0,43333.0,-68.0,-64.0,-68.0,-69.0,-68.0,-64.0,-67.0,-69.0,-77.0,-85.0,-77.0,-85.0,9.0,21.0,9.0,16.0,1
6577,F8:59:71:5A:E0:3D,3415352,699314995,195983,292685348,3219369,406629647,0,194243,250601520,189400,250022868,4843,578652,171729,16,198698,3300,0,559,144444.0,43333.0,-67.0,-73.0,-65.0,-69.0,-67.0,-73.0,-65.0,-69.0,-77.0,-85.0,-77.0,-85.0,10.0,12.0,12.0,16.0,1
6578,CC:2F:71:3E:C5:1F,3230816,408029996,11447,1400349,3219369,406629647,6,48819,4089035,40338,3084123,8481,1004912,12070,34,16411,186,6,832,130000.0,39000.0,-67.0,-71.0,-67.0,-60.0,-68.0,-71.0,-67.0,-60.0,-77.0,-85.0,-77.0,-85.0,10.0,14.0,10.0,25.0,1
6579,CC:2F:71:3F:1F:24,9896967,10616557364,6677598,10209927717,3219369,406629647,88,1534685,908676031,1526112,907646491,8573,1029540,1481035,619,6682284,683800,88,6060,117000.0,39000.0,-69.0,-64.0,-68.0,-69.0,-68.0,-63.0,-67.0,-69.0,-77.0,-85.0,-77.0,-85.0,8.0,21.0,9.0,16.0,1
6580,F8:59:71:5A:E0:3D,3415427,699424159,196053,292794128,3219374,406630031,0,194313,250709362,189470,250130710,4843,578652,171799,16,198768,3300,0,559,144444.0,43333.0,-67.0,-73.0,-65.0,-70.0,-66.0,-73.0,-65.0,-69.0,-77.0,-85.0,-77.0,-85.0,10.0,12.0,12.0,15.0,1
6581,CC:2F:71:3E:C5:1F,3230821,408030380,11447,1400349,3219374,406630031,6,48821,4089223,40339,3084193,8482,1005030,12071,34,16411,186,6,832,130000.0,39000.0,-65.0,-63.0,-65.0,-60.0,-67.0,-69.0,-67.0,-60.0,-77.0,-85.0,-77.0,-85.0,12.0,22.0,12.0,25.0,1
6582,CC:2F:71:3F:1F:24,9898247,10618525177,6678873,10211895146,3219374,406630031,88,1534970,908801554,1526397,907772014,8573,1029540,1481320,619,6683593,683893,88,6060,130000.0,43333.0,-68.0,-63.0,-69.0,-68.0,-68.0,-63.0,-68.0,-68.0,-77.0,-85.0,-77.0,-85.0,9.0,22.0,8.0,17.0,1
6583,F8:59:71:5A:E0:3D,3415496,699522667,196116,292892030,3219380,406630637,0,194377,250807936,189534,250229284,4843,578652,171862,16,198831,3300,0,559,144444.0,43333.0,-67.0,-73.0,-66.0,-70.0,-67.0,-73.0,-65.0,-69.0,-77.0,-85.0,-77.0,-85.0,10.0,12.0,11.0,15.0,1
6584,CC:2F:71:3E:C5:1F,3230827,408030986,11447,1400349,3219380,406630637,6,48821,4089223,40339,3084193,8482,1005030,12071,34,16411,186,6,832,130000.0,39000.0,-65.0,-63.0,-65.0,-60.0,-67.0,-69.0,-67.0,-60.0,-77.0,-85.0,-77.0,-85.0,12.0,22.0,12.0,25.0,1
6585,CC:2F:71:3F:1F:24,9899411,10620311411,6680031,10213680774,3219380,406630637,88,1535227,908923816,1526654,907894276,8573,1029540,1481574,619,6684751,684008,88,6060,130000.0,43333.0,-69.0,-64.0,-69.0,-68.0,-68.0,-63.0,-68.0,-68.0,-77.0,-85.0,-77.0,-85.0,8.0,21.0,8.0,17.0,1
6586,F8:59:71:5A:E0:3D,3415563,699622598,196180,292991486,3219383,406631112,0,194440,250904956,189597,250326304,4843,578652,171925,16,198895,3301,0,559,144444.0,43333.0,-67.0,-73.0,-65.0,-70.0,-67.0,-73.0,-65.0,-69.0,-77.0,-85.0,-77.0,-85.0,10.0,12.0,12.0,15.0,1
6587,CC:2F:71:3E:C5:1F,3230831,408031521,11447,1400349,3219384,406631172,6,48821,4089223,40339,3084193,8482,1005030,12071,34,16411,186,6,832,130000.0,39000.0,-65.0,-63.0,-65.0,-60.0,-67.0,-69.0,-67.0,-60.0,-77.0,-85.0,-77.0,-85.0,12.0,22.0,12.0,25.0,1
6588,CC:2F:71:3F:1F:24,9900843,10622523746,6681459,10215892574,3219384,406631172,88,1535541,909051338,1526968,908021798,8573,1029540,1481888,619,6686179,684080,88,6060,130000.0,43333.0,-70.0,-64.0,-69.0,-69.0,-69.0,-63.0,-69.0,-68.0,-77.0,-85.0,-77.0,-85.0,7.0,21.0,8.0,16.0,1
6589,F8:59:71:5A:E0:3D,3415645,699739814,196255,293108036,3219390,406631778,0,194516,251021996,189673,250443344,4843,578652,172001,16,198970,3301,0,559,144444.0,43333.0,-67.0,-73.0,-65.0,-70.0,-67.0,-73.0,-65.0,-69.0,-77.0,-85.0,-77.0,-85.0,10.0,12.0,12.0,15.0,1
6590,CC:2F:71:3E:C5:1F,3230837,408032127,11447,1400349,3219390,406631778,6,48821,4089223,40339,3084193,8482,1005030,12071,34,16411,186,6,832,130000.0,39000.0,-65.0,-63.0,-65.0,-60.0,-67.0,-69.0,-67.0,-60.0,-77.0,-85.0,-77.0,-85.0,12.0,22.0,12.0,25.0,1
6591,CC:2F:71:3F:1F:24,9902205,10624602211,6682815,10217970433,3219390,406631778,88,1535807,909205455,1527234,908175915,8573,1029540,1482150,619,6687535,684145,88,6060,130000.0,43333.0,-70.0,-63.0,-68.0,-69.0,-69.0,-63.0,-68.0,-69.0,-77.0,-85.0,-77.0,-85.0,7.0,22.0,9.0,16.0,1
6592,F8:59:71:5A:E0:3D,3415732,699872106,196340,293240126,3219392,406631980,0,194601,251152896,189758,250574244,4843,578652,172086,16,199055,3301,0,559,144444.0,43333.0,-67.0,-73.0,-65.0,-70.0,-67.0,-72.0,-65.0,-69.0,-77.0,-85.0,-77.0,-85.0,10.0,12.0,12.0,15.0,1
6593,CC:2F:71:3E:C5:1F,3230839,408032329,11447,1400349,3219392,406631980,6,48821,4089223,40339,3084193,8482,1005030,12071,34,16411,186,6,832,130000.0,39000.0,-65.0,-63.0,-65.0,-60.0,-67.0,-69.0,-67.0,-60.0,-77.0,-85.0,-77.0,-85.0,12.0,22.0,12.0,25.0,1
6594,CC:2F:71:3F:1F:24,9902818,10625523011,6683426,10218891031,3219392,406631980,88,1535975,909332697,1527402,908303157,8573,1029540,1482306,619,6688146,684250,88,6060,130000.0,43333.0,-69.0,-63.0,-68.0,-69.0,-68.0,-63.0,-68.0,-69.0,-77.0,-85.0,-77.0,-85.0,8.0,22.0,9.0,16.0,1
6595,F8:59:71:5A:E0:3D,3415802,699970674,196403,293338028,3219399,406632646,0,194663,251248376,189820,250669724,4843,578652,172148,16,199118,3302,0,559,144444.0,43333.0,-67.0,-73.0,-66.0,-69.0,-67.0,-73.0,-65.0,-69.0,-77.0,-85.0,-77.0,-85.0,10.0,12.0,11.0,16.0,1
6596,CC:2F:71:3E:C5:1F,3230846,408032995,11447,1400349,3219399,406632646,6,48821,4089223,40339,3084193,8482,1005030,12071,34,16411,186,6,832,130000.0,39000.0,-65.0,-63.0,-65.0,-60.0,-67.0,-69.0,-67.0,-60.0,-77.0,-85.0,-77.0,-85.0,12.0,22.0,12.0,25.0,1
6597,CC:2F:71:3F:1F:24,9903829,10627066461,6684430,10220433815,3219399,406632646,88,1536183,909446353,1527610,908416813,8573,1029540,1482514,619,6689150,684333,88,6060,130000.0,43333.0,-68.0,-63.0,-68.0,-68.0,-68.0,-63.0,-68.0,-68.0,-77.0,-85.0,-77.0,-85.0,9.0,22.0,9.0,17.0,1
6598,F8:59:71:5A:E0:3D,3415868,700070332,196467,293437484,3219401,406632848,0,194727,251346936,189884,250768284,4843,578652,172212,16,199182,3302,0,559,144444.0,43333.0,-67.0,-73.0,-65.0,-69.0,-66.0,-72.0,-65.0,-69.0,-77.0,-85.0,-77.0,-85.0,10.0,12.0,12.0,16.0,1
6599,CC:2F:71:3E:C5:1F,3230848,408033197,11447,1400349,3219401,406632848,6,48821,4089223,40339,3084193,8482,1005030,12071,34,16411,186,6,832,130000.0,39000.0,-65.0,-63.0,-65.0,-60.0,-67.0,-69.0,-67.0,-60.0,-77.0,-85.0,-77.0,-85.0,12.0,22.0,12.0,25.0,1
6600,CC:2F:71:3F:1F:24,9905253,10629270475,6685852,10222637627,3219401,406632848,88,1536433,909569063,1527860,908539523,8573,1029540,1482764,619,6690568,684384,88,6060,130000.0,43333.0,-69.0,-64.0,-68.0,-69.0,-68.0,-63.0,-67.0,-69.0,-77.0,-85.0,-77.0,-85.0,8.0,21.0,9.0,16.0,1
6601,F8:59:71:5A:E0:3D,3415938,700170394,196531,293536940,3219407,406633454,0,194793,251448590,189950,250869938,4843,578652,172277,16,199246,3302,0,559,144444.0,43333.0,-67.0,-73.0,-65.0,-70.0,-67.0,-73.0,-65.0,-69.0,-77.0,-85.0,-77.0,-85.0,10.0,12.0,12.0,15.0,1
6602,CC:2F:71:3E:C5:1F,3230854,408033803,11447,1400349,3219407,406633454,6,48821,4089223,40339,3084193,8482,1005030,12071,34,16411,186,6,832,130000.0,39000.0,-65.0,-63.0,-65.0,-60.0,-67.0,-69.0,-67.0,-60.0,-77.0,-85.0,-77.0,-85.0,12.0,22.0,12.0,25.0,1
6603,CC:2F:71:3F:1F:24,9906543,10631246215,6687136,10224612761,3219407,406633454,88,1536671,909689403,1528098,908659863,8573,1029540,1483000,619,6691856,684669,88,6060,115556.0,28889.0,-68.0,-63.0,-68.0,-68.0,-68.0,-63.0,-68.0,-68.0,-77.0,-85.0,-77.0,-85.0,9.0,22.0,9.0,17.0,1
6604,F8:59:71:5A:E0:3D,3416003,700267004,196593,293633288,3219410,406633716,0,194855,251544070,190012,250965418,4843,578652,172339,16,199308,3302,0,559,144444.0,43333.0,-67.0,-73.0,-65.0,-70.0,-67.0,-73.0,-65.0,-69.0,-77.0,-85.0,-77.0,-85.0,10.0,12.0,12.0,15.0,1
6605,CC:2F:71:3E:C5:1F,3230857,408034065,11447,1400349,3219410,406633716,6,48821,4089223,40339,3084193,8482,1005030,12071,34,16411,186,6,832,130000.0,39000.0,-65.0,-63.0,-65.0,-60.0,-67.0,-69.0,-67.0,-60.0,-77.0,-85.0,-77.0,-85.0,12.0,22.0,12.0,25.0,1
6606,CC:2F:71:3F:1F:24,9907404,10632557219,6687994,10225923503,3219410,406633716,88,1536861,909802561,1528288,908773021,8573,1029540,1483190,619,6692714,684778,88,6060,115556.0,28889.0,-69.0,-63.0,-69.0,-68.0,-68.0,-63.0,-68.0,-68.0,-77.0,-85.0,-77.0,-85.0,8.0,22.0,8.0,17.0,1
6607,F8:59:71:5A:E0:3D,3416072,700366980,196658,293732860,3219414,406634120,0,194920,251642736,190077,251064084,4843,578652,172404,16,199373,3302,0,559,144444.0,43333.0,-67.0,-73.0,-65.0,-70.0,-67.0,-73.0,-65.0,-69.0,-77.0,-85.0,-77.0,-85.0,10.0,12.0,12.0,15.0,1
6608,CC:2F:71:3E:C5:1F,3230863,408034671,11447,1400349,3219416,406634322,6,48821,4089223,40339,3084193,8482,1005030,12071,34,16411,186,6,832,130000.0,39000.0,-65.0,-63.0,-65.0,-60.0,-67.0,-69.0,-67.0,-60.0,-77.0,-85.0,-77.0,-85.0,12.0,22.0,12.0,25.0,1
6609,CC:2F:71:3F:1F:24,9908553,10634318495,6689137,10227684173,3219416,406634322,88,1537116,909926083,1528543,908896543,8573,1029540,1483441,619,6693857,684801,88,6060,115556.0,26000.0,-69.0,-63.0,-69.0,-69.0,-68.0,-63.0,-68.0,-68.0,-77.0,-85.0,-77.0,-85.0,8.0,22.0,8.0,16.0,1
6610,F8:59:71:5A:E0:3D,3416138,700466638,196722,293832316,3219416,406634322,0,194984,251741296,190141,251162644,4843,578652,172468,16,199437,3303,0,559,144444.0,43333.0,-67.0,-73.0,-66.0,-69.0,-67.0,-73.0,-65.0,-69.0,-77.0,-85.0,-77.0,-85.0,10.0,12.0,11.0,16.0,1
6611,CC:2F:71:3E:C5:1F,3230863,408034671,11447,1400349,3219416,406634322,6,48821,4089223,40339,3084193,8482,1005030,12071,34,16411,186,6,832,130000.0,39000.0,-65.0,-63.0,-65.0,-60.0,-67.0,-69.0,-67.0,-60.0,-77.0,-85.0,-77.0,-85.0,12.0,22.0,12.0,25.0,1
6612,CC:2F:71:3F:1F:24,9909468,10635715917,6690049,10229081333,3219419,406634584,88,1537289,910037069,1528716,909007529,8573,1029540,1483614,619,6694743,684904,88,6060,130000.0,43333.0,-69.0,-64.0,-68.0,-69.0,-68.0,-63.0,-68.0,-68.0,-77.0,-85.0,-77.0,-85.0,8.0,21.0,9.0,16.0,1
6613,F8:59:71:5A:E0:3D,3416208,700565206,196785,293930218,3219423,406634988,0,195045,251835236,190202,251256584,4843,578652,172529,16,199500,3303,0,559,144444.0,43333.0,-67.0,-73.0,-66.0,-70.0,-67.0,-73.0,-65.0,-69.0,-77.0,-85.0,-77.0,-85.0,10.0,12.0,11.0,15.0,1
6614,CC:2F:71:3E:C5:1F,3230870,408035337,11447,1400349,3219423,406634988,6,48821,4089223,40339,3084193,8482,1005030,12071,34,16411,186,6,832,130000.0,39000.0,-65.0,-63.0,-65.0,-60.0,-67.0,-69.0,-67.0,-60.0,-77.0,-85.0,-77.0,-85.0,12.0,22.0,12.0,25.0,1
6615,CC:2F:71:3F:1F:24,9910534,10637341551,6691109,10230706361,3219425,406635190,88,1537526,910155968,1528953,909126428,8573,1029540,1483851,619,6695829,684947,88,6060,130000.0,43333.0,-69.0,-64.0,-69.0,-69.0,-69.0,-63.0,-68.0,-68.0,-77.0,-85.0,-77.0,-85.0,8.0,21.0,8.0,16.0,1
6616,F8:59:71:5A:E0:3D,3416273,700663310,196848,294028120,3219425,406635190,0,195110,251935490,190267,251356838,4843,578652,172594,16,199563,3306,0,561,144444.0,43333.0,-67.0,-72.0,-65.0,-69.0,-67.0,-72.0,-65.0,-69.0,-77.0,-85.0,-77.0,-85.0,10.0,13.0,12.0,16.0,1
6617,CC:2F:71:3E:C5:1F,3230872,408035539,11447,1400349,3219425,406635190,6,48821,4089223,40339,3084193,8482,1005030,12071,34,16411,186,6,832,130000.0,39000.0,-65.0,-63.0,-65.0,-60.0,-67.0,-69.0,-67.0,-60.0,-77.0,-85.0,-77.0,-85.0,12.0,22.0,12.0,25.0,1
6618,CC:2F:71:3F:1F:24,9911508,10638836651,6692083,10232201461,3219425,406635190,88,1537727,910274610,1529154,909245070,8573,1029540,1484052,619,6696803,684996,88,6061,130000.0,43333.0,-69.0,-64.0,-68.0,-69.0,-68.0,-63.0,-67.0,-68.0,-77.0,-85.0,-77.0,-85.0,8.0,21.0,9.0,16.0,1
6619,F8:59:71:5A:E0:3D,3416349,700771202,196917,294135346,3219432,406635856,0,195179,252041876,190336,251463224,4843,578652,172663,16,199632,3307,0,561,144444.0,43333.0,-67.0,-73.0,-66.0,-70.0,-66.0,-73.0,-65.0,-69.0,-77.0,-85.0,-77.0,-85.0,10.0,12.0,11.0,15.0,1
6620,CC:2F:71:3E:C5:1F,3230879,408036205,11447,1400349,3219432,406635856,6,48821,4089223,40339,3084193,8482,1005030,12071,34,16411,186,6,832,130000.0,39000.0,-65.0,-63.0,-65.0,-60.0,-67.0,-69.0,-67.0,-60.0,-77.0,-85.0,-77.0,-85.0,12.0,22.0,12.0,25.0,1
6621,CC:2F:71:3F:1F:24,9912698,10640662339,6693266,10234026483,3219432,406635856,88,1537957,910395156,1529384,909365616,8573,1029540,1484282,619,6697986,685115,88,6061,130000.0,43333.0,-69.0,-63.0,-69.0,-69.0,-69.0,-63.0,-68.0,-68.0,-77.0,-85.0,-77.0,-85.0,8.0,22.0,8.0,16.0,1
6622,F8:59:71:5A:E0:3D,3416416,700872246,196982,294236188,3219434,406636058,0,195243,252140436,190400,251561784,4843,578652,172727,16,199697,3308,0,561,144444.0,43333.0,-67.0,-71.0,-64.0,-69.0,-67.0,-72.0,-65.0,-69.0,-77.0,-85.0,-77.0,-85.0,10.0,14.0,13.0,16.0,1
6623,CC:2F:71:3E:C5:1F,3230881,408036407,11447,1400349,3219434,406636058,6,48821,4089223,40339,3084193,8482,1005030,12071,34,16411,186,6,832,130000.0,39000.0,-65.0,-63.0,-65.0,-60.0,-67.0,-69.0,-67.0,-60.0,-77.0,-85.0,-77.0,-85.0,12.0,22.0,12.0,25.0,1
6624,CC:2F:71:3F:1F:24,9913469,10641835751,6694035,10235199693,3219434,406636058,88,1538172,910521206,1529599,909491666,8573,1029540,1484497,619,6698754,685138,88,6061,130000.0,43333.0,-69.0,-64.0,-68.0,-68.0,-68.0,-63.0,-68.0,-68.0,-77.0,-85.0,-77.0,-85.0,8.0,21.0,9.0,17.0,1
6625,F8:59:71:5A:E0:3D,3416489,700979764,197051,294343302,3219438,406636462,0,195312,252246696,190469,251668044,4843,578652,172796,16,199766,3312,0,561,144444.0,43333.0,-67.0,-73.0,-66.0,-70.0,-67.0,-72.0,-65.0,-69.0,-77.0,-85.0,-77.0,-85.0,10.0,12.0,11.0,15.0,1
6626,CC:2F:71:3E:C5:1F,3230885,408036811,11447,1400349,3219438,406636462,6,48821,4089223,40339,3084193,8482,1005030,12071,34,16411,186,6,832,130000.0,39000.0,-65.0,-63.0,-65.0,-60.0,-67.0,-69.0,-67.0,-60.0,-77.0,-85.0,-77.0,-85.0,12.0,22.0,12.0,25.0,1
6627,CC:2F:71:3F:1F:24,9914255,10643016425,6694815,10236379761,3219440,406636664,88,1538363,910634835,1529790,909605295,8573,1029540,1484688,619,6699535,685207,88,6062,130000.0,43333.0,-69.0,-63.0,-69.0,-69.0,-69.0,-63.0,-68.0,-69.0,-77.0,-85.0,-77.0,-85.0,8.0,22.0,8.0,16.0,1
6628,F8:59:71:5A:E0:3D,3416563,701086173,197119,294448974,3219444,406637199,0,195380,252351416,190537,251772764,4843,578652,172864,16,199832,3313,0,561,144444.0,43333.0,-67.0,-73.0,-65.0,-70.0,-67.0,-72.0,-65.0,-69.0,-77.0,-85.0,-77.0,-85.0,10.0,12.0,12.0,15.0,1
6629,CC:2F:71:3E:C5:1F,3230891,408037548,11447,1400349,3219444,406637199,6,48821,4089223,40339,3084193,8482,1005030,12071,34,16411,186,6,832,130000.0,39000.0,-65.0,-63.0,-65.0,-60.0,-67.0,-69.0,-67.0,-60.0,-77.0,-85.0,-77.0,-85.0,12.0,22.0,12.0,25.0,1
6630,CC:2F:71:3F:1F:24,9915299,10644615768,6695855,10237978569,3219444,406637199,88,1538572,910760273,1529999,909730733,8573,1029540,1484897,619,6700561,685628,88,6063,130000.0,39000.0,-68.0,-63.0,-69.0,-68.0,-68.0,-63.0,-68.0,-68.0,-77.0,-85.0,-77.0,-85.0,9.0,22.0,8.0,17.0,1
6631,F8:59:71:5A:E0:3D,3416634,701189257,197186,294551654,3219448,406637603,0,195447,252453162,190604,251874510,4843,578652,172931,16,199901,3314,0,561,144444.0,43333.0,-67.0,-73.0,-65.0,-69.0,-67.0,-73.0,-65.0,-69.0,-77.0,-85.0,-77.0,-85.0,10.0,12.0,12.0,16.0,1
6632,CC:2F:71:3E:C5:1F,3230895,408037952,11447,1400349,3219448,406637603,6,48821,4089223,40339,3084193,8482,1005030,12071,34,16411,186,6,832,130000.0,39000.0,-65.0,-63.0,-65.0,-60.0,-67.0,-69.0,-67.0,-60.0,-77.0,-85.0,-77.0,-85.0,12.0,22.0,12.0,25.0,1
6633,CC:2F:71:3F:1F:24,9916837,10646995146,6697389,10240357543,3219448,406637603,88,1538892,910891333,1530319,909861793,8573,1029540,1485213,619,6702109,685745,88,6063,115556.0,28889.0,-68.0,-63.0,-68.0,-68.0,-68.0,-63.0,-68.0,-68.0,-77.0,-85.0,-77.0,-85.0,9.0,22.0,9.0,17.0,1
6634,F8:59:71:5A:E0:3D,3416701,701287563,197249,294649556,3219452,406638007,0,195511,252551722,190668,251973070,4843,578652,172995,16,199964,3314,0,561,144444.0,43333.0,-67.0,-73.0,-65.0,-70.0,-67.0,-73.0,-65.0,-69.0,-77.0,-85.0,-77.0,-85.0,10.0,12.0,12.0,15.0,1
6635,CC:2F:71:3E:C5:1F,3230899,408038356,11447,1400349,3219452,406638007,6,48821,4089223,40339,3084193,8482,1005030,12071,34,16411,186,6,832,130000.0,39000.0,-65.0,-63.0,-65.0,-60.0,-67.0,-69.0,-67.0,-60.0,-77.0,-85.0,-77.0,-85.0,12.0,22.0,12.0,25.0,1
6636,CC:2F:71:3F:1F:24,9918240,10649161620,6698788,10242523613,3219452,406638007,88,1539168,911015977,1530595,909986437,8573,1029540,1485489,619,6703508,685914,88,6064,115556.0,28889.0,-68.0,-64.0,-69.0,-69.0,-68.0,-63.0,-69.0,-68.0,-77.0,-85.0,-77.0,-85.0,9.0,21.0,8.0,16.0,1
6637,F8:59:71:5A:E0:3D,3416771,701389037,197314,294750566,3219457,406638471,0,195574,252648742,190731,252070090,4843,578652,173058,16,200028,3316,0,561,144444.0,43333.0,-67.0,-71.0,-65.0,-69.0,-67.0,-72.0,-65.0,-69.0,-77.0,-85.0,-77.0,-85.0,10.0,14.0,12.0,16.0,1
6638,CC:2F:71:3E:C5:1F,3230904,408038820,11447,1400349,3219457,406638471,6,48821,4089223,40339,3084193,8482,1005030,12071,34,16411,186,6,832,130000.0,39000.0,-65.0,-63.0,-65.0,-60.0,-67.0,-69.0,-67.0,-60.0,-77.0,-85.0,-77.0,-85.0,12.0,22.0,12.0,25.0,1
6639,CC:2F:71:3F:1F:24,9919534,10651145292,6700077,10244506821,3219457,406638471,88,1539474,911153252,1530901,910123712,8573,1029540,1485795,619,6704797,686048,88,6064,115556.0,28889.0,-69.0,-64.0,-68.0,-69.0,-68.0,-64.0,-68.0,-69.0,-77.0,-85.0,-77.0,-85.0,8.0,21.0,9.0,16.0,1
6640,F8:59:71:5A:E0:3D,3416846,701498337,197385,294859462,3219461,406638875,0,195646,252759720,190803,252181068,4843,578652,173129,16,200100,3316,0,561,144444.0,43333.0,-67.0,-73.0,-65.0,-70.0,-67.0,-73.0,-65.0,-69.0,-77.0,-85.0,-77.0,-85.0,10.0,12.0,12.0,15.0,1
6641,CC:2F:71:3E:C5:1F,3230909,408039340,11448,1400465,3219461,406638875,6,48822,4089293,40340,3084263,8482,1005030,12071,34,16412,186,6,832,130000.0,39000.0,-66.0,-66.0,-67.0,-60.0,-67.0,-69.0,-67.0,-60.0,-77.0,-85.0,-77.0,-85.0,11.0,19.0,10.0,25.0,1
6642,CC:2F:71:3F:1F:24,9920703,10652941052,6701242,10246302177,3219461,406638875,88,1539762,911280478,1531189,910250938,8573,1029540,1486083,619,6705962,686068,88,6064,115556.0,28889.0,-69.0,-63.0,-70.0,-69.0,-69.0,-63.0,-69.0,-69.0,-77.0,-85.0,-77.0,-85.0,8.0,22.0,7.0,16.0,1
6643,F8:59:71:5A:E0:3D,3416914,701598363,197449,294958918,3219465,406639445,0,195711,252859820,190868,252281168,4843,578652,173194,16,200164,3316,0,561,144444.0,43333.0,-67.0,-73.0,-65.0,-70.0,-66.0,-72.0,-65.0,-69.0,-77.0,-85.0,-77.0,-85.0,10.0,12.0,12.0,15.0,1
6644,CC:2F:71:3E:C5:1F,3230915,408040112,11448,1400465,3219467,406639647,6,48823,4089363,40341,3084333,8482,1005030,12071,34,16412,186,6,832,130000.0,39000.0,-68.0,-71.0,-67.0,-60.0,-67.0,-69.0,-67.0,-60.0,-77.0,-85.0,-77.0,-85.0,9.0,14.0,10.0,25.0,1
6645,CC:2F:71:3F:1F:24,9921704,10654468864,6702236,10247829157,3219468,406639707,88,1540018,911401194,1531445,910371654,8573,1029540,1486339,619,6706956,686100,88,6064,115556.0,28889.0,-69.0,-63.0,-69.0,-68.0,-68.0,-63.0,-69.0,-67.0,-77.0,-85.0,-77.0,-85.0,8.0,22.0,8.0,17.0,1
6646,F8:59:71:5A:E0:3D,3416985,701698485,197513,295058374,3219472,406640111,0,195774,252956840,190931,252378188,4843,578652,173257,16,200228,3317,0,561,144444.0,43333.0,-66.0,-72.0,-66.0,-70.0,-66.0,-72.0,-65.0,-70.0,-77.0,-85.0,-77.0,-85.0,11.0,13.0,11.0,15.0,1
6647,CC:2F:71:3E:C5:1F,3230920,408040576,11448,1400465,3219472,406640111,6,48823,4089363,40341,3084333,8482,1005030,12071,34,16412,186,6,832,130000.0,39000.0,-68.0,-71.0,-67.0,-60.0,-67.0,-69.0,-67.0,-60.0,-77.0,-85.0,-77.0,-85.0,9.0,14.0,10.0,25.0,1
6648,CC:2F:71:3F:1F:24,9922960,10656403068,6703488,10249762957,3219472,406640111,88,1540279,911526756,1531706,910497216,8573,1029540,1486600,619,6708208,686171,88,6064,117000.0,39000.0,-70.0,-64.0,-70.0,-68.0,-68.0,-63.0,-70.0,-67.0,-77.0,-85.0,-77.0,-85.0,7.0,21.0,7.0,17.0,1
6649,F8:59:71:5A:E0:3D,3417053,701799759,197578,295159384,3219475,406640375,0,195841,253058598,190997,252479828,4844,578770,173324,16,200293,3318,0,561,144444.0,43333.0,-66.0,-72.0,-66.0,-70.0,-66.0,-72.0,-65.0,-70.0,-77.0,-85.0,-77.0,-85.0,11.0,13.0,11.0,15.0,1
6650,CC:2F:71:3E:C5:1F,3230923,408040840,11448,1400465,3219475,406640375,6,48823,4089363,40341,3084333,8482,1005030,12071,34,16412,186,6,832,130000.0,39000.0,-68.0,-71.0,-67.0,-60.0,-67.0,-69.0,-67.0,-60.0,-77.0,-85.0,-77.0,-85.0,9.0,14.0,10.0,25.0,1
6651,CC:2F:71:3F:1F:24,9924493,10658774198,6705016,10252133621,3219477,406640577,88,1540548,911650426,1531975,910620886,8573,1029540,1486869,619,6709717,686304,88,6064,115556.0,28889.0,-69.0,-63.0,-69.0,-67.0,-68.0,-63.0,-70.0,-67.0,-77.0,-85.0,-77.0,-85.0,8.0,22.0,8.0,18.0,1
6652,F8:59:71:5A:E0:3D,3417124,701899881,197642,295258840,3219482,406641041,0,195905,253157158,191061,252578388,4844,578770,173388,16,200357,3321,0,561,144444.0,43333.0,-67.0,-73.0,-65.0,-70.0,-66.0,-72.0,-65.0,-70.0,-77.0,-85.0,-77.0,-85.0,10.0,12.0,12.0,15.0,1
6653,CC:2F:71:3E:C5:1F,3230930,408041506,11448,1400465,3219482,406641041,6,48823,4089363,40341,3084333,8482,1005030,12071,34,16412,186,6,832,130000.0,39000.0,-68.0,-71.0,-67.0,-60.0,-67.0,-69.0,-67.0,-60.0,-77.0,-85.0,-77.0,-85.0,9.0,14.0,10.0,25.0,1
6654,CC:2F:71:3F:1F:24,9925844,10660851024,6706362,10254209983,3219482,406641041,88,1540823,911773786,1532250,910744246,8573,1029540,1487144,619,6711082,686347,88,6064,115556.0,28889.0,-69.0,-64.0,-70.0,-67.0,-69.0,-63.0,-70.0,-67.0,-77.0,-85.0,-77.0,-85.0,8.0,21.0,7.0,18.0,1
6655,F8:59:71:5A:E0:3D,3417190,701999539,197706,295358296,3219484,406641243,0,195969,253255718,191125,252676948,4844,578770,173452,16,200421,3322,0,561,144444.0,43333.0,-67.0,-72.0,-65.0,-70.0,-66.0,-72.0,-65.0,-70.0,-77.0,-85.0,-77.0,-85.0,10.0,13.0,12.0,15.0,1
6656,CC:2F:71:3E:C5:1F,3230932,408041708,11448,1400465,3219484,406641243,6,48823,4089363,40341,3084333,8482,1005030,12071,34,16412,186,6,832,130000.0,39000.0,-68.0,-71.0,-67.0,-60.0,-67.0,-69.0,-67.0,-60.0,-77.0,-85.0,-77.0,-85.0,9.0,14.0,10.0,25.0,1
6657,CC:2F:71:3F:1F:24,9926912,10662491518,6707428,10255850275,3219484,406641243,88,1541126,911901492,1532553,910871952,8573,1029540,1487447,619,6712148,686453,88,6064,115556.0,28889.0,-69.0,-64.0,-71.0,-67.0,-68.0,-63.0,-70.0,-67.0,-77.0,-85.0,-77.0,-85.0,8.0,21.0,6.0,18.0,1
6658,F8:59:71:5A:E0:3D,3417260,702098109,197769,295456198,3219491,406641911,0,196032,253352738,191188,252773968,4844,578770,173515,16,200484,3324,0,561,144444.0,43333.0,-66.0,-72.0,-66.0,-70.0,-66.0,-72.0,-65.0,-70.0,-77.0,-85.0,-77.0,-85.0,11.0,13.0,11.0,15.0,1
6659,CC:2F:71:3E:C5:1F,3230939,408042376,11448,1400465,3219491,406641911,6,48823,4089363,40341,3084333,8482,1005030,12071,34,16412,186,6,832,130000.0,39000.0,-68.0,-71.0,-67.0,-60.0,-67.0,-69.0,-67.0,-60.0,-77.0,-85.0,-77.0,-85.0,9.0,14.0,10.0,25.0,1
6660,CC:2F:71:3F:1F:24,9927817,10663867702,6708326,10257225791,3219491,406641911,88,1541387,912024266,1532813,910994608,8574,1029658,1487708,619,6713046,686455,88,6066,115556.0,28889.0,-69.0,-63.0,-70.0,-67.0,-68.0,-63.0,-70.0,-67.0,-77.0,-85.0,-77.0,-85.0,8.0,22.0,7.0,18.0,1
6661,F8:59:71:5A:E0:3D,3417325,702197625,197833,295555654,3219492,406641971,0,196096,253451298,191252,252872528,4844,578770,173579,16,200548,3324,0,561,144444.0,43333.0,-66.0,-72.0,-66.0,-70.0,-66.0,-72.0,-66.0,-70.0,-77.0,-85.0,-77.0,-85.0,11.0,13.0,11.0,15.0,1
6662,CC:2F:71:3E:C5:1F,3230940,408042436,11448,1400465,3219492,406641971,6,48823,4089363,40341,3084333,8482,1005030,12071,34,16412,186,6,832,130000.0,39000.0,-68.0,-71.0,-67.0,-60.0,-67.0,-69.0,-67.0,-60.0,-77.0,-85.0,-77.0,-85.0,9.0,14.0,10.0,25.0,1
6663,CC:2F:71:3F:1F:24,9928874,10665489592,6709380,10258847419,3219494,406642173,88,1541604,912140314,1533030,911110656,8574,1029658,1487925,619,6714072,686468,88,6066,117000.0,39000.0,-69.0,-63.0,-71.0,-67.0,-68.0,-63.0,-70.0,-67.0,-77.0,-85.0,-77.0,-85.0,8.0,22.0,6.0,18.0,1
6664,F8:59:71:5A:E0:3D,3417415,702308333,197897,295655110,3219518,406653223,0,196160,253549858,191316,252971088,4844,578770,173643,16,200612,3324,0,561,144444.0,43333.0,-67.0,-72.0,-65.0,-70.0,-66.0,-72.0,-65.0,-69.0,-77.0,-85.0,-77.0,-85.0,10.0,13.0,12.0,15.0,1
6665,CC:2F:71:3E:C5:1F,3230966,408053688,11448,1400465,3219518,406653223,6,48823,4089363,40341,3084333,8482,1005030,12071,34,16412,186,6,832,130000.0,39000.0,-68.0,-71.0,-67.0,-60.0,-67.0,-69.0,-67.0,-60.0,-77.0,-85.0,-77.0,-85.0,9.0,14.0,10.0,25.0,1
6666,CC:2F:71:3F:1F:24,9929611,10666568724,6710089,10259915097,3219522,406653627,88,1541817,912258046,1533243,911228388,8574,1029658,1488138,619,6714809,686603,88,6066,115556.0,28889.0,-69.0,-63.0,-69.0,-69.0,-68.0,-63.0,-68.0,-68.0,-77.0,-85.0,-77.0,-85.0,8.0,22.0,8.0,16.0,1
6667,F8:59:71:5A:E0:3D,3417481,702405085,197959,295751458,3219522,406653627,0,196222,253645338,191378,253066568,4844,578770,173705,16,200674,3324,0,561,144444.0,43333.0,-66.0,-72.0,-66.0,-70.0,-66.0,-72.0,-65.0,-69.0,-77.0,-85.0,-77.0,-85.0,11.0,13.0,11.0,15.0,1
6668,CC:2F:71:3E:C5:1F,3230970,408054092,11448,1400465,3219522,406653627,6,48823,4089363,40341,3084333,8482,1005030,12071,34,16412,186,6,832,130000.0,39000.0,-68.0,-71.0,-67.0,-60.0,-67.0,-69.0,-67.0,-60.0,-77.0,-85.0,-77.0,-85.0,9.0,14.0,10.0,25.0,1
6669,CC:2F:71:3F:1F:24,9930756,10668334006,6711234,10261680379,3219522,406653627,88,1542089,912380438,1533515,911350780,8574,1029658,1488410,619,6715946,686643,88,6066,115556.0,28889.0,-69.0,-63.0,-68.0,-69.0,-69.0,-63.0,-68.0,-68.0,-77.0,-85.0,-77.0,-85.0,8.0,22.0,9.0,16.0,1
6670,F8:59:71:5A:E0:3D,3417551,702505278,198023,295850914,3219528,406654364,0,196286,253743898,191442,253165128,4844,578770,173769,16,200738,3325,0,561,144444.0,43333.0,-66.0,-73.0,-66.0,-69.0,-66.0,-73.0,-65.0,-69.0,-77.0,-85.0,-77.0,-85.0,11.0,12.0,11.0,16.0,1
6671,CC:2F:71:3E:C5:1F,3230976,408054829,11448,1400465,3219528,406654364,6,48823,4089363,40341,3084333,8482,1005030,12071,34,16412,186,6,832,130000.0,39000.0,-68.0,-71.0,-67.0,-60.0,-67.0,-69.0,-67.0,-60.0,-77.0,-85.0,-77.0,-85.0,9.0,14.0,10.0,25.0,1
6672,CC:2F:71:3F:1F:24,9932162,10670503559,6712634,10263849195,3219528,406654364,88,1542353,912502030,1533779,911472372,8574,1029658,1488674,619,6717326,686780,88,6067,117000.0,39000.0,-68.0,-63.0,-69.0,-68.0,-69.0,-63.0,-69.0,-68.0,-77.0,-85.0,-77.0,-85.0,9.0,22.0,8.0,17.0,1
6673,F8:59:71:5A:E0:3D,3417619,702605138,198087,295950370,3219532,406654768,0,196350,253842458,191506,253263688,4844,578770,173833,16,200802,3325,0,561,144444.0,43333.0,-66.0,-73.0,-65.0,-70.0,-66.0,-72.0,-65.0,-69.0,-77.0,-85.0,-77.0,-85.0,11.0,12.0,12.0,15.0,1
6674,CC:2F:71:3E:C5:1F,3230980,408055233,11448,1400465,3219532,406654768,6,48823,4089363,40341,3084333,8482,1005030,12071,34,16412,186,6,832,130000.0,39000.0,-68.0,-71.0,-67.0,-60.0,-67.0,-69.0,-67.0,-60.0,-77.0,-85.0,-77.0,-85.0,9.0,14.0,10.0,25.0,1
6675,CC:2F:71:3F:1F:24,9933694,10672872835,6714162,10266218067,3219532,406654768,88,1542626,912626044,1534052,911596386,8574,1029658,1488947,619,6718855,687215,88,6067,130000.0,43333.0,-69.0,-63.0,-69.0,-68.0,-69.0,-63.0,-69.0,-68.0,-77.0,-85.0,-77.0,-85.0,8.0,22.0,8.0,17.0,1
6676,F8:59:71:5A:E0:3D,3417685,702701890,198149,296046718,3219536,406655172,0,196412,253937938,191568,253359168,4844,578770,173895,16,200864,3325,0,561,144444.0,43333.0,-67.0,-73.0,-65.0,-70.0,-67.0,-73.0,-65.0,-69.0,-77.0,-85.0,-77.0,-85.0,10.0,12.0,12.0,15.0,1
6677,CC:2F:71:3E:C5:1F,3230984,408055637,11448,1400465,3219536,406655172,6,48823,4089363,40341,3084333,8482,1005030,12071,34,16412,186,6,832,130000.0,39000.0,-68.0,-71.0,-67.0,-60.0,-67.0,-69.0,-67.0,-60.0,-77.0,-85.0,-77.0,-85.0,9.0,14.0,10.0,25.0,1
6678,CC:2F:71:3F:1F:24,9934463,10674031688,6714927,10267376516,3219536,406655172,88,1542828,912742878,1534254,911713220,8574,1029658,1489149,619,6719627,687544,88,6067,115556.0,28889.0,-70.0,-63.0,-68.0,-69.0,-69.0,-63.0,-67.0,-68.0,-77.0,-85.0,-77.0,-85.0,7.0,22.0,9.0,16.0,1
6679,F8:59:71:5A:E0:3D,3417756,702803426,198214,296147728,3219542,406655698,0,196476,254036540,191632,253457770,4844,578770,173959,16,200929,3326,0,561,144444.0,43333.0,-68.0,-73.0,-65.0,-70.0,-67.0,-72.0,-65.0,-69.0,-77.0,-85.0,-77.0,-85.0,9.0,12.0,12.0,15.0,1
6680,CC:2F:71:3E:C5:1F,3230990,408056163,11448,1400465,3219542,406655698,6,48825,4089551,40342,3084403,8483,1005148,12072,34,16412,186,6,832,130000.0,39000.0,-68.0,-71.0,-68.0,-60.0,-67.0,-69.0,-67.0,-60.0,-77.0,-85.0,-77.0,-85.0,9.0,14.0,9.0,25.0,1
6681,CC:2F:71:3F:1F:24,9935413,10675480318,6715871,10268824620,3219542,406655698,88,1543079,912862838,1534505,911833180,8574,1029658,1489400,619,6720591,687586,88,6067,115556.0,28889.0,-70.0,-63.0,-70.0,-68.0,-69.0,-63.0,-69.0,-68.0,-77.0,-85.0,-77.0,-85.0,7.0,22.0,7.0,17.0,1
6682,F8:59:71:5A:E0:3D,3417824,702903286,198278,296247184,3219546,406656102,0,196540,254135100,191696,253556330,4844,578770,174023,16,200993,3327,0,561,144444.0,43333.0,-67.0,-73.0,-65.0,-70.0,-66.0,-72.0,-65.0,-69.0,-77.0,-85.0,-77.0,-85.0,10.0,12.0,12.0,15.0,1
6683,CC:2F:71:3E:C5:1F,3230994,408056567,11448,1400465,3219546,406656102,6,48825,4089551,40342,3084403,8483,1005148,12072,34,16412,186,6,832,130000.0,39000.0,-68.0,-71.0,-68.0,-60.0,-67.0,-69.0,-67.0,-60.0,-77.0,-85.0,-77.0,-85.0,9.0,14.0,9.0,25.0,1
6684,CC:2F:71:3F:1F:24,9936650,10677387788,6717104,10270731686,3219546,406656102,88,1543367,912988838,1534793,911959180,8574,1029658,1489685,619,6721824,687635,88,6069,115556.0,28889.0,-69.0,-63.0,-69.0,-68.0,-69.0,-63.0,-69.0,-68.0,-77.0,-85.0,-77.0,-85.0,8.0,22.0,8.0,17.0,1
6685,F8:59:71:5A:E0:3D,3417893,703004700,198343,296348194,3219550,406656506,0,196605,254235200,191761,253656430,4844,578770,174088,16,201058,3327,0,561,144444.0,43333.0,-66.0,-72.0,-66.0,-70.0,-66.0,-72.0,-65.0,-70.0,-77.0,-85.0,-77.0,-85.0,11.0,13.0,11.0,15.0,1
6686,CC:2F:71:3E:C5:1F,3230998,408056971,11448,1400465,3219550,406656506,6,48825,4089551,40342,3084403,8483,1005148,12072,34,16412,186,6,832,130000.0,39000.0,-68.0,-71.0,-68.0,-60.0,-67.0,-69.0,-67.0,-60.0,-77.0,-85.0,-77.0,-85.0,9.0,14.0,9.0,25.0,1
6687,CC:2F:71:3F:1F:24,9937817,10679182734,6718267,10272526228,3219550,406656506,88,1543609,913113552,1535035,912083894,8574,1029658,1489924,619,6722965,687737,88,6069,115556.0,28889.0,-70.0,-64.0,-72.0,-67.0,-69.0,-63.0,-71.0,-67.0,-77.0,-85.0,-77.0,-85.0,7.0,21.0,5.0,18.0,1
6688,F8:59:71:5A:E0:3D,3417966,703110724,198411,296453754,3219555,406656970,0,196674,254341460,191830,253762690,4844,578770,174157,16,201126,3327,0,561,144444.0,39000.0,-66.0,-73.0,-66.0,-70.0,-66.0,-72.0,-66.0,-70.0,-77.0,-85.0,-77.0,-85.0,11.0,12.0,11.0,15.0,1
6689,CC:2F:71:3E:C5:1F,3231003,408057435,11448,1400465,3219555,406656970,6,48825,4089551,40342,3084403,8483,1005148,12072,34,16412,186,6,832,130000.0,39000.0,-68.0,-71.0,-68.0,-60.0,-67.0,-69.0,-67.0,-60.0,-77.0,-85.0,-77.0,-85.0,9.0,14.0,9.0,25.0,1
6690,CC:2F:71:3F:1F:24,9939304,10681479946,6719749,10274822976,3219555,406656970,88,1543940,913247216,1535366,912217558,8574,1029658,1490253,619,6724445,687863,88,6070,115556.0,28889.0,-69.0,-64.0,-70.0,-68.0,-68.0,-63.0,-70.0,-67.0,-77.0,-85.0,-77.0,-85.0,8.0,21.0,7.0,17.0,1
6691,F8:59:71:5A:E0:3D,3418032,703207420,198473,296550046,3219559,406657374,0,196737,254438536,191893,253859766,4844,578770,174219,16,201188,3327,0,561,144444.0,43333.0,-67.0,-73.0,-66.0,-70.0,-66.0,-72.0,-66.0,-70.0,-77.0,-85.0,-77.0,-85.0,10.0,12.0,11.0,15.0,1
6692,CC:2F:71:3E:C5:1F,3231007,408057839,11448,1400465,3219559,406657374,6,48825,4089551,40342,3084403,8483,1005148,12072,34,16412,186,6,832,130000.0,39000.0,-68.0,-71.0,-68.0,-60.0,-67.0,-69.0,-67.0,-60.0,-77.0,-85.0,-77.0,-85.0,9.0,14.0,9.0,25.0,1
6693,CC:2F:71:3F:1F:24,9940533,10683365558,6720974,10276708184,3219559,406657374,88,1544205,913372377,1535631,912342719,8574,1029658,1490518,619,6725694,687989,88,6070,115556.0,26000.0,-68.0,-63.0,-70.0,-68.0,-68.0,-63.0,-70.0,-68.0,-77.0,-85.0,-77.0,-85.0,9.0,22.0,7.0,17.0,1
6694,F8:59:71:5A:E0:3D,3418099,703308632,198538,296651056,3219561,406657576,0,196802,254538678,191958,253959908,4844,578770,174284,16,201253,3328,0,562,144444.0,43333.0,-67.0,-72.0,-65.0,-70.0,-66.0,-72.0,-65.0,-70.0,-77.0,-85.0,-77.0,-85.0,10.0,13.0,12.0,15.0,1
6695,CC:2F:71:3E:C5:1F,3231012,408058303,11448,1400465,3219564,406657838,6,48825,4089551,40342,3084403,8483,1005148,12072,34,16412,186,6,832,130000.0,39000.0,-68.0,-71.0,-68.0,-60.0,-67.0,-69.0,-67.0,-60.0,-77.0,-85.0,-77.0,-85.0,9.0,14.0,9.0,25.0,1
6696,CC:2F:71:3F:1F:24,9941476,10684804706,6721912,10278146868,3219564,406657838,88,1544447,913492771,1535873,912463113,8574,1029658,1490759,619,6726632,688076,88,6070,115556.0,28889.0,-68.0,-63.0,-69.0,-67.0,-68.0,-63.0,-70.0,-67.0,-77.0,-85.0,-77.0,-85.0,9.0,22.0,8.0,18.0,1
6697,F8:59:71:5A:E0:3D,3418174,703414970,198606,296756728,3219568,406658242,0,196870,254643398,192026,254064628,4844,578770,174352,16,201321,3330,0,562,144444.0,43333.0,-66.0,-72.0,-66.0,-70.0,-66.0,-72.0,-65.0,-69.0,-77.0,-85.0,-77.0,-85.0,11.0,13.0,11.0,15.0,1
6698,CC:2F:71:3E:C5:1F,3231016,408058707,11448,1400465,3219568,406658242,6,48825,4089551,40342,3084403,8483,1005148,12072,34,16412,186,6,832,130000.0,39000.0,-68.0,-71.0,-68.0,-60.0,-67.0,-69.0,-67.0,-60.0,-77.0,-85.0,-77.0,-85.0,9.0,14.0,9.0,25.0,1
6699,CC:2F:71:3F:1F:24,9942489,10686355712,6722921,10279697470,3219568,406658242,88,1544692,913617793,1536118,912588135,8574,1029658,1491003,619,6727617,688113,88,6070,115556.0,28889.0,-69.0,-64.0,-70.0,-68.0,-68.0,-63.0,-70.0,-67.0,-77.0,-85.0,-77.0,-85.0,8.0,21.0,7.0,17.0,1
6700,F8:59:71:5A:E0:3D,3418239,703515980,198671,296857738,3219568,406658242,0,196934,254741958,192090,254163188,4844,578770,174416,16,201385,3330,0,562,144444.0,43333.0,-66.0,-72.0,-66.0,-70.0,-66.0,-72.0,-65.0,-70.0,-77.0,-85.0,-77.0,-85.0,11.0,13.0,11.0,15.0,1
6701,CC:2F:71:3E:C5:1F,3231016,408058707,11448,1400465,3219568,406658242,6,48825,4089551,40342,3084403,8483,1005148,12072,34,16412,186,6,832,130000.0,39000.0,-68.0,-71.0,-68.0,-60.0,-67.0,-69.0,-67.0,-60.0,-77.0,-85.0,-77.0,-85.0,9.0,14.0,9.0,25.0,1
6702,CC:2F:71:3F:1F:24,9944053,10688777220,6724481,10282118574,3219572,406658646,88,1545023,913749893,1536449,912720235,8574,1029658,1491334,619,6729197,688349,88,6070,115556.0,28889.0,-69.0,-63.0,-70.0,-68.0,-68.0,-63.0,-69.0,-68.0,-77.0,-85.0,-77.0,-85.0,8.0,22.0,7.0,17.0,1
6703,F8:59:71:5A:E0:3D,3418308,703612994,198733,296954086,3219575,406658908,0,196998,254840560,192154,254261790,4844,578770,174479,16,201448,3332,0,562,144444.0,43333.0,-67.0,-73.0,-66.0,-70.0,-67.0,-73.0,-65.0,-69.0,-77.0,-85.0,-77.0,-85.0,10.0,12.0,11.0,15.0,1
6704,CC:2F:71:3E:C5:1F,3231025,408059575,11448,1400465,3219577,406659110,6,48825,4089551,40342,3084403,8483,1005148,12072,34,16412,186,6,832,130000.0,39000.0,-68.0,-71.0,-68.0,-60.0,-67.0,-69.0,-67.0,-60.0,-77.0,-85.0,-77.0,-85.0,9.0,14.0,9.0,25.0,1
6705,CC:2F:71:3F:1F:24,9944907,10690066836,6725330,10283407726,3219577,406659110,88,1545260,913869015,1536686,912839357,8574,1029658,1491571,619,6730050,688394,88,6070,115556.0,28889.0,-68.0,-64.0,-71.0,-68.0,-67.0,-63.0,-71.0,-68.0,-77.0,-85.0,-77.0,-85.0,9.0,21.0,6.0,17.0,1
6706,F8:59:71:5A:E0:3D,3418374,703712652,198797,297053542,3219577,406659110,0,197061,254937580,192217,254358810,4844,578770,174542,16,201512,3332,0,562,144444.0,43333.0,-67.0,-72.0,-66.0,-70.0,-67.0,-72.0,-65.0,-69.0,-77.0,-85.0,-77.0,-85.0,10.0,13.0,11.0,15.0,1
6707,CC:2F:71:3E:C5:1F,3231025,408059575,11448,1400465,3219577,406659110,6,48825,4089551,40342,3084403,8483,1005148,12072,34,16412,186,6,832,130000.0,39000.0,-68.0,-71.0,-68.0,-60.0,-67.0,-69.0,-67.0,-60.0,-77.0,-85.0,-77.0,-85.0,9.0,14.0,9.0,25.0,1
6708,CC:2F:71:3F:1F:24,9945925,10691633184,6726348,10284974074,3219577,406659110,88,1545526,913990997,1536952,912961339,8574,1029658,1491837,619,6731064,688403,88,6071,115556.0,28889.0,-67.0,-63.0,-72.0,-68.0,-67.0,-63.0,-71.0,-67.0,-77.0,-85.0,-77.0,-85.0,10.0,22.0,5.0,17.0,1
6709,F8:59:71:5A:E0:3D,3418441,703810958,198860,297151444,3219581,406659514,0,197124,255034600,192280,254455830,4844,578770,174605,16,201575,3332,0,562,144444.0,43333.0,-67.0,-73.0,-66.0,-69.0,-67.0,-73.0,-65.0,-69.0,-77.0,-85.0,-77.0,-85.0,10.0,12.0,11.0,16.0,1
6710,CC:2F:71:3E:C5:1F,3231029,408059979,11448,1400465,3219581,406659514,6,48825,4089551,40342,3084403,8483,1005148,12072,34,16412,186,6,832,130000.0,39000.0,-68.0,-71.0,-68.0,-60.0,-67.0,-69.0,-67.0,-60.0,-77.0,-85.0,-77.0,-85.0,9.0,14.0,9.0,25.0,1
6711,CC:2F:71:3F:1F:24,9946793,10692953554,6727210,10286293838,3219583,406659716,88,1545766,914108357,1537192,913078699,8574,1029658,1492077,619,6731930,688439,88,6071,130000.0,43333.0,-68.0,-63.0,-70.0,-68.0,-68.0,-63.0,-70.0,-68.0,-77.0,-85.0,-77.0,-85.0,9.0,22.0,7.0,17.0,1
6712,F8:59:71:5A:E0:3D,3418509,703908043,198922,297247792,3219587,406660251,0,197187,255131620,192343,254552850,4844,578770,174668,16,201637,3332,0,562,144444.0,43333.0,-66.0,-72.0,-66.0,-70.0,-66.0,-72.0,-65.0,-69.0,-77.0,-85.0,-77.0,-85.0,11.0,13.0,11.0,15.0,1
6713,CC:2F:71:3E:C5:1F,3231035,408060716,11448,1400465,3219587,406660251,6,48825,4089551,40342,3084403,8483,1005148,12072,34,16412,186,6,832,130000.0,39000.0,-68.0,-71.0,-68.0,-60.0,-67.0,-69.0,-67.0,-60.0,-77.0,-85.0,-77.0,-85.0,9.0,14.0,9.0,25.0,1
6714,CC:2F:71:3F:1F:24,9947690,10694321395,6728103,10287661144,3219587,406660251,88,1545961,914223383,1537387,913193725,8574,1029658,1492272,619,6732806,688696,88,6071,130000.0,43333.0,-69.0,-64.0,-71.0,-67.0,-68.0,-64.0,-70.0,-67.0,-77.0,-85.0,-77.0,-85.0,8.0,21.0,6.0,18.0,1
6715,F8:59:71:5A:E0:3D,3418582,704014085,198990,297353352,3219592,406660733,0,197254,255234856,192410,254656086,4844,578770,174735,16,201705,3332,0,562,144444.0,43333.0,-67.0,-72.0,-66.0,-70.0,-66.0,-72.0,-66.0,-69.0,-77.0,-85.0,-77.0,-85.0,10.0,13.0,11.0,15.0,1
6716,CC:2F:71:3E:C5:1F,3231040,408061198,11448,1400465,3219592,406660733,6,48825,4089551,40342,3084403,8483,1005148,12072,34,16412,186,6,832,130000.0,39000.0,-68.0,-71.0,-68.0,-60.0,-67.0,-69.0,-67.0,-60.0,-77.0,-85.0,-77.0,-85.0,9.0,14.0,9.0,25.0,1
6717,CC:2F:71:3F:1F:24,9948708,10695873218,6729116,10289212485,3219592,406660733,88,1546196,914347956,1537622,913318298,8574,1029658,1492507,619,6733804,688882,88,6071,115556.0,28889.0,-68.0,-64.0,-70.0,-69.0,-68.0,-64.0,-69.0,-68.0,-77.0,-85.0,-77.0,-85.0,9.0,21.0,7.0,16.0,1
6718,F8:59:71:5A:E0:3D,3418649,704112391,199053,297451254,3219596,406661137,0,197318,255333416,192474,254754646,4844,578770,174799,16,201768,3332,0,562,144444.0,43333.0,-67.0,-72.0,-66.0,-70.0,-66.0,-72.0,-65.0,-70.0,-77.0,-85.0,-77.0,-85.0,10.0,13.0,11.0,15.0,1
6719,CC:2F:71:3E:C5:1F,3231044,408061602,11448,1400465,3219596,406661137,6,48825,4089551,40342,3084403,8483,1005148,12072,34,16412,186,6,832,130000.0,39000.0,-68.0,-71.0,-68.0,-60.0,-67.0,-69.0,-67.0,-60.0,-77.0,-85.0,-77.0,-85.0,9.0,14.0,9.0,25.0,1
6720,CC:2F:71:3F:1F:24,9949992,10697851766,6730396,10291190629,3219596,406661137,88,1546479,914481726,1537905,913452068,8574,1029658,1492788,619,6735116,688953,88,6072,115556.0,28889.0,-68.0,-64.0,-69.0,-68.0,-67.0,-63.0,-69.0,-67.0,-77.0,-85.0,-77.0,-85.0,9.0,21.0,8.0,17.0,1
6721,F8:59:71:5A:E0:3D,3418706,704182681,199105,297521080,3219601,406661601,0,197371,255402635,192527,254823865,4844,578770,174850,16,201820,3332,0,562,144444.0,43333.0,-66.0,-72.0,-66.0,-70.0,-66.0,-71.0,-65.0,-69.0,-77.0,-85.0,-77.0,-85.0,11.0,13.0,11.0,15.0,1
6722,CC:2F:71:3E:C5:1F,3231049,408062066,11448,1400465,3219601,406661601,6,48825,4089551,40342,3084403,8483,1005148,12072,34,16412,186,6,832,130000.0,39000.0,-68.0,-71.0,-68.0,-60.0,-67.0,-69.0,-67.0,-60.0,-77.0,-85.0,-77.0,-85.0,9.0,14.0,9.0,25.0,1
6723,CC:2F:71:3F:1F:24,9951153,10699621437,6731548,10292959432,3219605,406662005,88,1546677,914542840,1538103,913513182,8574,1029658,1492977,619,6736264,689175,88,6072,130000.0,39000.0,-69.0,-64.0,-70.0,-68.0,-67.0,-63.0,-69.0,-67.0,-77.0,-85.0,-77.0,-85.0,8.0,21.0,7.0,17.0,1
6724,F8:59:71:5A:E0:3D,3418711,704183201,199106,297521196,3219605,406662005,0,197374,255402845,192530,254824075,4844,578770,174850,16,201821,3332,0,562,144444.0,43333.0,-72.0,-81.0,-73.0,-74.0,-67.0,-74.0,-67.0,-70.0,-77.0,-85.0,-77.0,-85.0,5.0,4.0,4.0,11.0,1
6725,CC:2F:71:3E:C5:1F,3231054,408062586,11449,1400581,3219605,406662005,6,48827,4089691,40344,3084543,8483,1005148,12072,34,16413,186,6,832,130000.0,39000.0,-68.0,-71.0,-68.0,-60.0,-67.0,-69.0,-67.0,-60.0,-77.0,-85.0,-77.0,-85.0,9.0,14.0,9.0,25.0,1
6726,CC:2F:71:3F:1F:24,9953253,10702894887,6733648,10296232882,3219605,406662005,88,1546976,914578944,1538402,913549286,8574,1029658,1493274,619,6738360,689705,88,6072,115556.0,28889.0,-69.0,-63.0,-70.0,-67.0,-68.0,-63.0,-70.0,-67.0,-77.0,-85.0,-77.0,-85.0,8.0,22.0,7.0,18.0,1
6727,F8:59:71:5A:E0:3D,3418716,704183665,199106,297521196,3219610,406662469,0,197374,255402845,192530,254824075,4844,578770,174850,16,201821,3332,0,562,144444.0,43333.0,-72.0,-81.0,-73.0,-74.0,-67.0,-74.0,-67.0,-70.0,-77.0,-85.0,-77.0,-85.0,5.0,4.0,4.0,11.0,1
6728,CC:2F:71:3E:C5:1F,3231059,408063050,11449,1400581,3219610,406662469,6,48827,4089691,40344,3084543,8483,1005148,12072,34,16413,186,6,832,130000.0,39000.0,-68.0,-71.0,-68.0,-60.0,-67.0,-69.0,-67.0,-60.0,-77.0,-85.0,-77.0,-85.0,9.0,14.0,9.0,25.0,1
6729,CC:2F:71:3F:1F:24,9954659,10705060007,6735049,10298397538,3219610,406662469,88,1547198,914606689,1538624,913577031,8574,1029658,1493496,619,6739769,689774,88,6072,115556.0,28889.0,-68.0,-63.0,-71.0,-67.0,-68.0,-63.0,-70.0,-67.0,-77.0,-85.0,-77.0,-85.0,9.0,22.0,6.0,18.0,1
6730,F8:59:71:5A:E0:3D,3418721,704184131,199106,297521196,3219615,406662935,0,197376,255403033,192531,254824145,4845,578888,174851,16,201821,3332,0,562,144444.0,43333.0,-65.0,-70.0,-65.0,-69.0,-67.0,-74.0,-67.0,-70.0,-77.0,-85.0,-77.0,-85.0,12.0,15.0,12.0,16.0,1
6731,CC:2F:71:3E:C5:1F,3231064,408063516,11449,1400581,3219615,406662935,6,48827,4089691,40344,3084543,8483,1005148,12072,34,16413,186,6,832,130000.0,39000.0,-68.0,-71.0,-68.0,-60.0,-67.0,-69.0,-67.0,-60.0,-77.0,-85.0,-77.0,-85.0,9.0,14.0,9.0,25.0,1
6732,CC:2F:71:3F:1F:24,9955555,10706427695,6735940,10299764760,3219615,406662935,88,1547342,914624537,1538768,913594879,8574,1029658,1493640,619,6740660,689839,88,6072,115556.0,28889.0,-69.0,-63.0,-69.0,-68.0,-68.0,-63.0,-69.0,-67.0,-77.0,-85.0,-77.0,-85.0,8.0,22.0,8.0,17.0,1
6733,F8:59:71:5A:E0:3D,3418728,704185046,199106,297521196,3219622,406663850,0,197376,255403033,192531,254824145,4845,578888,174851,16,201821,3332,0,562,144444.0,43333.0,-65.0,-70.0,-65.0,-69.0,-67.0,-74.0,-67.0,-70.0,-77.0,-85.0,-77.0,-85.0,12.0,15.0,12.0,16.0,1
6734,CC:2F:71:3E:C5:1F,3231071,408064431,11449,1400581,3219622,406663850,6,48829,4089879,40345,3084613,8484,1005266,12073,34,16413,186,6,832,130000.0,39000.0,-68.0,-71.0,-67.0,-60.0,-67.0,-70.0,-67.0,-60.0,-77.0,-85.0,-77.0,-85.0,9.0,14.0,10.0,25.0,1
6735,CC:2F:71:3F:1F:24,9956673,10708142992,6737051,10301479142,3219622,406663850,88,1547506,914644697,1538932,913615039,8574,1029658,1493804,619,6741771,689924,88,6072,115556.0,28889.0,-68.0,-63.0,-71.0,-67.0,-68.0,-63.0,-70.0,-67.0,-77.0,-85.0,-77.0,-85.0,9.0,22.0,6.0,18.0,1
6736,F8:59:71:5A:E0:3D,3418734,704185735,199106,297521196,3219628,406664539,0,197376,255403033,192531,254824145,4845,578888,174851,16,201821,3332,0,562,144444.0,43333.0,-65.0,-70.0,-65.0,-69.0,-67.0,-74.0,-67.0,-70.0,-77.0,-85.0,-77.0,-85.0,12.0,15.0,12.0,16.0,1
6737,CC:2F:71:3E:C5:1F,3231078,408065344,11449,1400581,3219629,406664763,6,48829,4089879,40345,3084613,8484,1005266,12073,34,16413,186,6,832,130000.0,39000.0,-68.0,-71.0,-67.0,-60.0,-67.0,-70.0,-67.0,-60.0,-77.0,-85.0,-77.0,-85.0,9.0,14.0,10.0,25.0,1
6738,CC:2F:71:3F:1F:24,9958104,10710350809,6738475,10303686046,3219629,406664763,88,1547716,914670359,1539142,913640701,8574,1029658,1494014,619,6743195,690204,88,6072,115556.0,26000.0,-70.0,-64.0,-70.0,-68.0,-69.0,-63.0,-70.0,-67.0,-77.0,-85.0,-77.0,-85.0,7.0,21.0,7.0,17.0,1
6739,F8:59:71:5A:E0:3D,3418737,704186161,199106,297521196,3219631,406664965,0,197376,255403033,192531,254824145,4845,578888,174851,16,201821,3332,0,562,144444.0,43333.0,-65.0,-70.0,-65.0,-69.0,-67.0,-74.0,-67.0,-70.0,-77.0,-85.0,-77.0,-85.0,12.0,15.0,12.0,16.0,1
6740,CC:2F:71:3E:C5:1F,3231080,408065546,11449,1400581,3219631,406664965,6,48829,4089879,40345,3084613,8484,1005266,12073,34,16413,186,6,832,130000.0,39000.0,-68.0,-71.0,-67.0,-60.0,-67.0,-70.0,-67.0,-60.0,-77.0,-85.0,-77.0,-85.0,9.0,14.0,10.0,25.0,1
6741,CC:2F:71:3F:1F:24,9959526,10712542637,6739893,10305877470,3219633,406665167,88,1547922,914696190,1539348,913666532,8574,1029658,1494220,619,6744596,690443,88,6073,115556.0,28889.0,-69.0,-63.0,-70.0,-67.0,-68.0,-63.0,-69.0,-67.0,-77.0,-85.0,-77.0,-85.0,8.0,22.0,7.0,18.0,1
6742,F8:59:71:5A:E0:3D,3418745,704187216,199106,297521196,3219639,406666020,0,197376,255403033,192531,254824145,4845,578888,174851,16,201821,3332,0,562,144444.0,43333.0,-65.0,-70.0,-65.0,-69.0,-67.0,-74.0,-67.0,-70.0,-77.0,-85.0,-77.0,-85.0,12.0,15.0,12.0,16.0,1
6743,CC:2F:71:3E:C5:1F,3231088,408066601,11449,1400581,3219639,406666020,6,48829,4089879,40345,3084613,8484,1005266,12073,34,16413,186,6,832,130000.0,39000.0,-68.0,-71.0,-67.0,-60.0,-67.0,-70.0,-67.0,-60.0,-77.0,-85.0,-77.0,-85.0,9.0,14.0,10.0,25.0,1
6744,CC:2F:71:3F:1F:24,9960643,10714256424,6741004,10307590404,3219639,406666020,88,1548101,914718258,1539527,913688600,8574,1029658,1494399,619,6745722,690538,88,6073,115556.0,28889.0,-69.0,-63.0,-70.0,-68.0,-68.0,-63.0,-70.0,-67.0,-77.0,-85.0,-77.0,-85.0,8.0,22.0,7.0,17.0,1
6745,F8:59:71:5A:E0:3D,3418750,704187927,199106,297521196,3219644,406666731,0,197376,255403033,192531,254824145,4845,578888,174851,16,201821,3332,0,562,144444.0,43333.0,-65.0,-70.0,-65.0,-69.0,-67.0,-74.0,-67.0,-70.0,-77.0,-85.0,-77.0,-85.0,12.0,15.0,12.0,16.0,1
6746,CC:2F:71:3E:C5:1F,3231093,408067312,11449,1400581,3219644,406666731,6,48829,4089879,40345,3084613,8484,1005266,12073,34,16413,186,6,832,130000.0,39000.0,-68.0,-71.0,-67.0,-60.0,-67.0,-70.0,-67.0,-60.0,-77.0,-85.0,-77.0,-85.0,9.0,14.0,10.0,25.0,1
6747,CC:2F:71:3F:1F:24,9961729,10715922953,6742085,10309256222,3219644,406666731,88,1548302,914742730,1539728,913713072,8574,1029658,1494600,619,6746805,690643,88,6073,115556.0,28889.0,-69.0,-63.0,-70.0,-68.0,-68.0,-63.0,-70.0,-67.0,-77.0,-85.0,-77.0,-85.0,8.0,22.0,7.0,17.0,1
6748,F8:59:71:5A:E0:3D,3418756,704188533,199106,297521196,3219650,406667337,0,197376,255403033,192531,254824145,4845,578888,174851,16,201821,3332,0,562,144444.0,43333.0,-65.0,-70.0,-65.0,-69.0,-67.0,-74.0,-67.0,-70.0,-77.0,-85.0,-77.0,-85.0,12.0,15.0,12.0,16.0,1
6749,CC:2F:71:3E:C5:1F,3231099,408067918,11449,1400581,3219650,406667337,6,48829,4089879,40345,3084613,8484,1005266,12073,34,16413,186,6,832,130000.0,39000.0,-68.0,-71.0,-67.0,-60.0,-67.0,-70.0,-67.0,-60.0,-77.0,-85.0,-77.0,-85.0,9.0,14.0,10.0,25.0,1
6750,CC:2F:71:3F:1F:24,9962598,10717246821,6742948,10310579484,3219650,406667337,88,1548476,914764096,1539902,913734438,8574,1029658,1494773,619,6747668,690712,88,6073,115556.0,28889.0,-69.0,-63.0,-71.0,-67.0,-68.0,-63.0,-70.0,-67.0,-77.0,-85.0,-77.0,-85.0,8.0,22.0,6.0,18.0,1
6751,F8:59:71:5A:E0:3D,3418758,704188735,199106,297521196,3219652,406667539,0,197376,255403033,192531,254824145,4845,578888,174851,16,201821,3332,0,562,144444.0,43333.0,-65.0,-70.0,-65.0,-69.0,-67.0,-74.0,-67.0,-70.0,-77.0,-85.0,-77.0,-85.0,12.0,15.0,12.0,16.0,1
6752,CC:2F:71:3E:C5:1F,3231101,408068120,11449,1400581,3219652,406667539,6,48829,4089879,40345,3084613,8484,1005266,12073,34,16413,186,6,832,130000.0,39000.0,-68.0,-71.0,-67.0,-60.0,-67.0,-70.0,-67.0,-60.0,-77.0,-85.0,-77.0,-85.0,9.0,14.0,10.0,25.0,1
6753,CC:2F:71:3F:1F:24,9963502,10718623639,6743850,10311956100,3219652,406667539,88,1548657,914786812,1540083,913757154,8574,1029658,1494954,619,6748566,690781,88,6073,130000.0,43333.0,-69.0,-63.0,-69.0,-71.0,-69.0,-63.0,-68.0,-70.0,-77.0,-85.0,-77.0,-85.0,8.0,22.0,8.0,14.0,1
6754,F8:59:71:5A:E0:3D,3418765,704189534,199106,297521196,3219659,406668338,0,197376,255403033,192531,254824145,4845,578888,174851,16,201821,3332,0,562,144444.0,43333.0,-65.0,-70.0,-65.0,-69.0,-67.0,-74.0,-67.0,-70.0,-77.0,-85.0,-77.0,-85.0,12.0,15.0,12.0,16.0,1
6755,CC:2F:71:3E:C5:1F,3231110,408069121,11449,1400581,3219661,406668540,6,48829,4089879,40345,3084613,8484,1005266,12073,34,16413,186,6,832,130000.0,39000.0,-68.0,-71.0,-67.0,-60.0,-67.0,-70.0,-67.0,-60.0,-77.0,-85.0,-77.0,-85.0,9.0,14.0,10.0,25.0,1
6756,CC:2F:71:3F:1F:24,9964340,10719892522,6744679,10313223982,3219661,406668540,88,1548783,914802574,1540208,913772798,8575,1029776,1495080,619,6749383,691151,88,6074,115556.0,28889.0,-69.0,-64.0,-70.0,-69.0,-69.0,-64.0,-70.0,-69.0,-77.0,-85.0,-77.0,-85.0,8.0,21.0,7.0,16.0,1
6757,F8:59:71:5A:E0:3D,3418769,704189938,199106,297521196,3219663,406668742,0,197376,255403033,192531,254824145,4845,578888,174851,16,201821,3332,0,562,144444.0,43333.0,-65.0,-70.0,-65.0,-69.0,-67.0,-74.0,-67.0,-70.0,-77.0,-85.0,-77.0,-85.0,12.0,15.0,12.0,16.0,1
6758,CC:2F:71:3E:C5:1F,3231112,408069323,11449,1400581,3219663,406668742,6,48829,4089879,40345,3084613,8484,1005266,12073,34,16413,186,6,832,130000.0,39000.0,-68.0,-71.0,-67.0,-60.0,-67.0,-70.0,-67.0,-60.0,-77.0,-85.0,-77.0,-85.0,9.0,14.0,10.0,25.0,1
6759,CC:2F:71:3F:1F:24,9965171,10721161958,6745508,10314493216,3219663,406668742,88,1548975,914826056,1540400,913796280,8575,1029776,1495271,619,6750228,691313,88,6074,86667.0,14444.0,-68.0,-64.0,-69.0,-66.0,-67.0,-63.0,-69.0,-66.0,-77.0,-85.0,-77.0,-85.0,9.0,21.0,8.0,19.0,1
6760,F8:59:71:5A:E0:3D,3418773,704190342,199106,297521196,3219667,406669146,0,197376,255403033,192531,254824145,4845,578888,174851,16,201821,3332,0,562,144444.0,43333.0,-65.0,-70.0,-65.0,-69.0,-67.0,-74.0,-67.0,-70.0,-77.0,-85.0,-77.0,-85.0,12.0,15.0,12.0,16.0,1
6761,CC:2F:71:3E:C5:1F,3231116,408069727,11449,1400581,3219667,406669146,6,48829,4089879,40345,3084613,8484,1005266,12073,34,16413,186,6,832,130000.0,39000.0,-68.0,-71.0,-67.0,-60.0,-67.0,-70.0,-67.0,-60.0,-77.0,-85.0,-77.0,-85.0,9.0,14.0,10.0,25.0,1
6762,CC:2F:71:3F:1F:24,9966004,10722429766,6746336,10315760560,3219668,406669206,88,1549183,914851412,1540608,913821636,8575,1029776,1495479,619,6751056,691315,88,6074,86667.0,14444.0,-67.0,-64.0,-69.0,-67.0,-67.0,-63.0,-70.0,-67.0,-77.0,-85.0,-77.0,-85.0,10.0,21.0,8.0,18.0,1
6763,F8:59:71:5A:E0:3D,3418778,704190806,199106,297521196,3219672,406669610,0,197376,255403033,192531,254824145,4845,578888,174851,16,201821,3332,0,562,144444.0,43333.0,-65.0,-70.0,-65.0,-69.0,-67.0,-74.0,-67.0,-70.0,-77.0,-85.0,-77.0,-85.0,12.0,15.0,12.0,16.0,1
6764,CC:2F:71:3E:C5:1F,3231121,408070191,11449,1400581,3219672,406669610,6,48829,4089879,40345,3084613,8484,1005266,12073,34,16413,186,6,832,130000.0,39000.0,-68.0,-71.0,-67.0,-60.0,-67.0,-70.0,-67.0,-60.0,-77.0,-85.0,-77.0,-85.0,9.0,14.0,10.0,25.0,1
6765,CC:2F:71:3F:1F:24,9967048,10724032162,6747376,10317362552,3219672,406669610,88,1549356,914872648,1540781,913842872,8575,1029776,1495652,619,6752079,691373,88,6074,130000.0,43333.0,-68.0,-64.0,-70.0,-67.0,-67.0,-64.0,-70.0,-67.0,-77.0,-85.0,-77.0,-85.0,9.0,21.0,7.0,18.0,1
6766,F8:59:71:5A:E0:3D,3418780,704191008,199106,297521196,3219674,406669812,0,197376,255403033,192531,254824145,4845,578888,174851,16,201821,3332,0,562,144444.0,43333.0,-65.0,-70.0,-65.0,-69.0,-67.0,-74.0,-67.0,-70.0,-77.0,-85.0,-77.0,-85.0,12.0,15.0,12.0,16.0,1
6767,CC:2F:71:3E:C5:1F,3231125,408070595,11449,1400581,3219676,406670014,6,48829,4089879,40345,3084613,8484,1005266,12073,34,16413,186,6,832,130000.0,39000.0,-68.0,-71.0,-67.0,-60.0,-67.0,-70.0,-67.0,-60.0,-77.0,-85.0,-77.0,-85.0,9.0,14.0,10.0,25.0,1
6768,CC:2F:71:3F:1F:24,9968137,10725697900,6748461,10319027886,3219676,406670014,88,1549564,914898375,1540989,913868599,8575,1029776,1495860,619,6753181,691634,88,6074,130000.0,43333.0,-68.0,-64.0,-70.0,-67.0,-67.0,-64.0,-69.0,-67.0,-77.0,-85.0,-77.0,-85.0,9.0,21.0,7.0,18.0,1
6769,F8:59:71:5A:E0:3D,3418786,704191780,199106,297521196,3219680,406670584,0,197376,255403033,192531,254824145,4845,578888,174851,16,201821,3332,0,562,144444.0,43333.0,-65.0,-70.0,-65.0,-69.0,-67.0,-74.0,-67.0,-70.0,-77.0,-85.0,-77.0,-85.0,12.0,15.0,12.0,16.0,1
6770,CC:2F:71:3E:C5:1F,3231130,408071225,11449,1400581,3219681,406670644,6,48829,4089879,40345,3084613,8484,1005266,12073,34,16413,186,6,832,130000.0,39000.0,-68.0,-71.0,-67.0,-60.0,-67.0,-70.0,-67.0,-60.0,-77.0,-85.0,-77.0,-85.0,9.0,14.0,10.0,25.0,1
6771,CC:2F:71:3F:1F:24,9969240,10727389668,6749557,10320718822,3219683,406670846,88,1549753,914921623,1541178,913891847,8575,1029776,1496049,619,6754277,691701,88,6074,130000.0,43333.0,-67.0,-64.0,-69.0,-67.0,-67.0,-64.0,-69.0,-67.0,-77.0,-85.0,-77.0,-85.0,10.0,21.0,8.0,18.0,1
6772,F8:59:71:5A:E0:3D,3418789,704192042,199106,297521196,3219683,406670846,0,197376,255403033,192531,254824145,4845,578888,174851,16,201821,3332,0,562,144444.0,43333.0,-65.0,-70.0,-65.0,-69.0,-67.0,-74.0,-67.0,-70.0,-77.0,-85.0,-77.0,-85.0,12.0,15.0,12.0,16.0,1
6773,CC:2F:71:3E:C5:1F,3231132,408071427,11449,1400581,3219683,406670846,6,48829,4089879,40345,3084613,8484,1005266,12073,34,16413,186,6,832,130000.0,39000.0,-68.0,-71.0,-67.0,-60.0,-67.0,-70.0,-67.0,-60.0,-77.0,-85.0,-77.0,-85.0,9.0,14.0,10.0,25.0,1
6774,CC:2F:71:3F:1F:24,9970349,10729100894,6750666,10322430048,3219683,406670846,88,1549900,914939843,1541325,913910067,8575,1029776,1496196,619,6755356,691776,88,6074,130000.0,43333.0,-67.0,-64.0,-69.0,-67.0,-67.0,-64.0,-69.0,-67.0,-77.0,-85.0,-77.0,-85.0,10.0,21.0,8.0,18.0,1
6775,F8:59:71:5A:E0:3D,3418795,704192648,199106,297521196,3219689,406671452,0,197376,255403033,192531,254824145,4845,578888,174851,16,201821,3332,0,562,144444.0,43333.0,-65.0,-70.0,-65.0,-69.0,-67.0,-74.0,-67.0,-70.0,-77.0,-85.0,-77.0,-85.0,12.0,15.0,12.0,16.0,1
6776,CC:2F:71:3E:C5:1F,3231138,408072033,11449,1400581,3219689,406671452,6,48829,4089879,40345,3084613,8484,1005266,12073,34,16413,186,6,832,130000.0,39000.0,-68.0,-71.0,-67.0,-60.0,-67.0,-70.0,-67.0,-60.0,-77.0,-85.0,-77.0,-85.0,9.0,14.0,10.0,25.0,1
6777,CC:2F:71:3F:1F:24,9971586,10731005594,6751897,10324334142,3219689,406671452,88,1550079,914961775,1541504,913931999,8575,1029776,1496375,619,6756617,691820,88,6074,130000.0,43333.0,-68.0,-64.0,-70.0,-67.0,-68.0,-64.0,-70.0,-67.0,-77.0,-85.0,-77.0,-85.0,9.0,21.0,7.0,18.0,1
6778,F8:59:71:5A:E0:3D,3418798,704192910,199106,297521196,3219692,406671714,0,197376,255403033,192531,254824145,4845,578888,174851,16,201821,3332,0,562,144444.0,43333.0,-65.0,-70.0,-65.0,-69.0,-67.0,-74.0,-67.0,-70.0,-77.0,-85.0,-77.0,-85.0,12.0,15.0,12.0,16.0,1
6779,CC:2F:71:3E:C5:1F,3231141,408072295,11449,1400581,3219692,406671714,6,48829,4089879,40345,3084613,8484,1005266,12073,34,16413,186,6,832,130000.0,39000.0,-68.0,-71.0,-67.0,-60.0,-67.0,-70.0,-67.0,-60.0,-77.0,-85.0,-77.0,-85.0,9.0,14.0,10.0,25.0,1
6780,CC:2F:71:3F:1F:24,9972525,10732435068,6752833,10325763354,3219692,406671714,88,1550246,914982675,1541671,913952899,8575,1029776,1496540,619,6757553,691991,88,6074,130000.0,43333.0,-68.0,-64.0,-70.0,-67.0,-68.0,-63.0,-69.0,-67.0,-77.0,-85.0,-77.0,-85.0,9.0,21.0,7.0,18.0,1
6781,F8:59:71:5A:E0:3D,3418804,704193516,199106,297521196,3219698,406672320,0,197376,255403033,192531,254824145,4845,578888,174851,16,201821,3332,0,562,144444.0,43333.0,-65.0,-70.0,-65.0,-69.0,-67.0,-74.0,-67.0,-70.0,-77.0,-85.0,-77.0,-85.0,12.0,15.0,12.0,16.0,1
6782,CC:2F:71:3E:C5:1F,3231147,408072901,11449,1400581,3219698,406672320,6,48829,4089879,40345,3084613,8484,1005266,12073,34,16413,186,6,832,130000.0,39000.0,-68.0,-71.0,-67.0,-60.0,-67.0,-70.0,-67.0,-60.0,-77.0,-85.0,-77.0,-85.0,9.0,14.0,10.0,25.0,1
6783,CC:2F:71:3F:1F:24,9973778,10734363440,6754080,10327691120,3219698,406672320,88,1550470,915009915,1541895,913980139,8575,1029776,1496764,619,6758800,692083,88,6074,130000.0,43333.0,-67.0,-64.0,-70.0,-66.0,-67.0,-63.0,-70.0,-66.0,-77.0,-85.0,-77.0,-85.0,10.0,21.0,7.0,19.0,1
6784,F8:59:71:5A:E0:3D,3418806,704193718,199106,297521196,3219700,406672522,0,197376,255403033,192531,254824145,4845,578888,174851,16,201821,3332,0,562,144444.0,43333.0,-65.0,-70.0,-65.0,-69.0,-67.0,-74.0,-67.0,-70.0,-77.0,-85.0,-77.0,-84.0,12.0,15.0,12.0,15.0,1
6785,CC:2F:71:3E:C5:1F,3231149,408073103,11449,1400581,3219700,406672522,6,48829,4089879,40345,3084613,8484,1005266,12073,34,16413,186,6,832,130000.0,39000.0,-68.0,-71.0,-67.0,-60.0,-67.0,-70.0,-67.0,-60.0,-77.0,-85.0,-77.0,-84.0,9.0,14.0,10.0,24.0,1
6786,CC:2F:71:3F:1F:24,9974646,10735691470,6754946,10329018948,3219700,406672522,88,1550616,915028067,1542041,913998291,8575,1029776,1496910,619,6759666,692120,88,6074,144444.0,43333.0,-67.0,-64.0,-70.0,-66.0,-67.0,-64.0,-69.0,-66.0,-77.0,-85.0,-77.0,-84.0,10.0,21.0,7.0,18.0,1
6787,F8:59:71:5A:E0:3D,3418813,704194384,199106,297521196,3219707,406673188,0,197376,255403033,192531,254824145,4845,578888,174851,16,201821,3332,0,562,144444.0,43333.0,-65.0,-70.0,-65.0,-69.0,-67.0,-74.0,-67.0,-70.0,-77.0,-85.0,-77.0,-84.0,12.0,15.0,12.0,15.0,1
6788,CC:2F:71:3E:C5:1F,3231156,408073769,11449,1400581,3219707,406673188,6,48829,4089879,40345,3084613,8484,1005266,12073,34,16413,186,6,832,130000.0,39000.0,-68.0,-71.0,-67.0,-60.0,-67.0,-70.0,-67.0,-60.0,-77.0,-85.0,-77.0,-84.0,9.0,14.0,10.0,24.0,1
6789,CC:2F:71:3F:1F:24,9975517,10737018368,6755810,10330345180,3219707,406673188,88,1550768,915046855,1542193,914017079,8575,1029776,1497062,619,6760530,692212,88,6074,130000.0,43333.0,-67.0,-64.0,-70.0,-67.0,-67.0,-64.0,-70.0,-67.0,-77.0,-85.0,-77.0,-84.0,10.0,21.0,7.0,17.0,1
6790,F8:59:71:5A:E0:3D,3418815,704194586,199106,297521196,3219709,406673390,0,197376,255403033,192531,254824145,4845,578888,174851,16,201821,3332,0,562,144444.0,43333.0,-65.0,-70.0,-65.0,-69.0,-67.0,-74.0,-67.0,-70.0,-77.0,-85.0,-77.0,-84.0,12.0,15.0,12.0,15.0,1
6791,CC:2F:71:3E:C5:1F,3231158,408073971,11449,1400581,3219709,406673390,6,48829,4089879,40345,3084613,8484,1005266,12073,34,16413,186,6,832,130000.0,39000.0,-68.0,-71.0,-67.0,-60.0,-67.0,-70.0,-67.0,-60.0,-77.0,-85.0,-77.0,-84.0,9.0,14.0,10.0,24.0,1
6792,CC:2F:71:3F:1F:24,9976465,10738464103,6756756,10331790713,3219709,406673390,88,1550922,915066486,1542347,914036710,8575,1029776,1497216,619,6761476,692248,88,6074,130000.0,43333.0,-67.0,-64.0,-71.0,-67.0,-66.0,-64.0,-70.0,-67.0,-77.0,-85.0,-77.0,-84.0,10.0,21.0,6.0,17.0,1
6793,F8:59:71:5A:E0:3D,3418819,704194990,199106,297521196,3219713,406673794,0,197376,255403033,192531,254824145,4845,578888,174851,16,201821,3332,0,562,144444.0,43333.0,-65.0,-70.0,-65.0,-69.0,-67.0,-74.0,-67.0,-70.0,-77.0,-85.0,-77.0,-84.0,12.0,15.0,12.0,15.0,1
6794,CC:2F:71:3E:C5:1F,3231162,408074375,11449,1400581,3219713,406673794,6,48829,4089879,40345,3084613,8484,1005266,12073,34,16413,186,6,832,130000.0,39000.0,-68.0,-71.0,-67.0,-60.0,-67.0,-70.0,-67.0,-60.0,-77.0,-85.0,-77.0,-84.0,9.0,14.0,10.0,24.0,1
6795,CC:2F:71:3F:1F:24,9977526,10740090947,6757811,10333416951,3219715,406673996,88,1551083,915086330,1542508,914056554,8575,1029776,1497377,619,6762531,692284,88,6074,130000.0,43333.0,-67.0,-64.0,-70.0,-67.0,-67.0,-64.0,-70.0,-67.0,-77.0,-85.0,-77.0,-84.0,10.0,21.0,7.0,17.0,1
6796,F8:59:71:5A:E0:3D,3418826,704195853,199106,297521196,3219720,406674657,0,197376,255403033,192531,254824145,4845,578888,174851,16,201821,3332,0,562,144444.0,43333.0,-65.0,-70.0,-65.0,-69.0,-67.0,-74.0,-67.0,-70.0,-77.0,-85.0,-77.0,-84.0,12.0,15.0,12.0,15.0,1
6797,CC:2F:71:3E:C5:1F,3231169,408075238,11449,1400581,3219720,406674657,6,48829,4089879,40345,3084613,8484,1005266,12073,34,16413,186,6,832,130000.0,39000.0,-68.0,-71.0,-67.0,-60.0,-67.0,-70.0,-67.0,-60.0,-77.0,-85.0,-77.0,-84.0,9.0,14.0,10.0,24.0,1
6798,CC:2F:71:3F:1F:24,9978485,10741556964,6758765,10334882307,3219720,406674657,88,1551236,915105198,1542661,914075422,8575,1029776,1497530,619,6763485,692332,88,6074,130000.0,39000.0,-67.0,-64.0,-69.0,-67.0,-66.0,-64.0,-69.0,-67.0,-77.0,-85.0,-77.0,-84.0,10.0,21.0,8.0,17.0,1
6799,F8:59:71:5A:E0:3D,3418828,704196055,199106,297521196,3219722,406674859,0,197376,255403033,192531,254824145,4845,578888,174851,16,201821,3332,0,562,144444.0,43333.0,-65.0,-70.0,-65.0,-69.0,-67.0,-74.0,-67.0,-70.0,-77.0,-85.0,-77.0,-84.0,12.0,15.0,12.0,15.0,1
6800,CC:2F:71:3E:C5:1F,3231173,408075642,11449,1400581,3219724,406675061,6,48829,4089879,40345,3084613,8484,1005266,12073,34,16413,186,6,832,130000.0,39000.0,-68.0,-71.0,-67.0,-60.0,-67.0,-70.0,-67.0,-60.0,-77.0,-85.0,-77.0,-84.0,9.0,14.0,10.0,24.0,1
6801,CC:2F:71:3F:1F:24,9979890,10743727978,6760166,10337052917,3219724,406675061,88,1551415,915127198,1542840,914097422,8575,1029776,1497709,619,6764886,692355,88,6074,130000.0,43333.0,-67.0,-64.0,-71.0,-67.0,-67.0,-64.0,-70.0,-67.0,-77.0,-85.0,-77.0,-84.0,10.0,21.0,6.0,17.0,1
6802,F8:59:71:5A:E0:3D,3418839,704197845,199111,297522380,3219728,406675465,0,197383,255403928,192538,254825040,4845,578888,174857,16,201826,3332,0,562,130000.0,39000.0,-66.0,-71.0,-63.0,-71.0,-65.0,-71.0,-63.0,-70.0,-77.0,-85.0,-77.0,-84.0,11.0,14.0,14.0,13.0,1
6803,CC:2F:71:3E:C5:1F,3231177,408076046,11449,1400581,3219728,406675465,6,48829,4089879,40345,3084613,8484,1005266,12073,34,16413,186,6,832,130000.0,39000.0,-68.0,-71.0,-67.0,-60.0,-67.0,-70.0,-67.0,-60.0,-77.0,-85.0,-77.0,-84.0,9.0,14.0,10.0,24.0,1
6804,CC:2F:71:3F:1F:24,9981413,10746086812,6761685,10339411347,3219728,406675465,88,1551603,915150286,1543028,914120510,8575,1029776,1497897,619,6766405,692447,88,6074,130000.0,43333.0,-67.0,-64.0,-71.0,-67.0,-67.0,-64.0,-70.0,-66.0,-77.0,-85.0,-77.0,-84.0,10.0,21.0,6.0,17.0,1
6805,F8:59:71:5A:E0:3D,3418843,704198367,199111,297522380,3219732,406675987,0,197383,255403928,192538,254825040,4845,578888,174857,16,201826,3332,0,562,130000.0,39000.0,-66.0,-71.0,-63.0,-71.0,-65.0,-71.0,-63.0,-70.0,-77.0,-85.0,-77.0,-84.0,11.0,14.0,14.0,13.0,1
6806,CC:2F:71:3E:C5:1F,3231181,408076568,11449,1400581,3219732,406675987,6,48829,4089879,40345,3084613,8484,1005266,12073,34,16413,186,6,832,130000.0,39000.0,-68.0,-71.0,-67.0,-60.0,-67.0,-70.0,-67.0,-60.0,-77.0,-85.0,-77.0,-84.0,9.0,14.0,10.0,24.0,1
6807,CC:2F:71:3F:1F:24,9982752,10748146224,6763020,10341470237,3219732,406675987,88,1551801,915175041,1543226,914145265,8575,1029776,1498095,619,6767708,692460,88,6074,144444.0,43333.0,-67.0,-63.0,-71.0,-66.0,-66.0,-63.0,-71.0,-66.0,-77.0,-85.0,-77.0,-84.0,10.0,22.0,6.0,18.0,1
6808,F8:59:71:5A:E0:3D,3418849,704198973,199111,297522380,3219738,406676593,0,197383,255403928,192538,254825040,4845,578888,174857,16,201826,3332,0,562,130000.0,39000.0,-66.0,-71.0,-63.0,-71.0,-65.0,-71.0,-63.0,-70.0,-77.0,-85.0,-77.0,-84.0,11.0,14.0,14.0,13.0,1
6809,CC:2F:71:3E:C5:1F,3231187,408077174,11449,1400581,3219738,406676593,6,48829,4089879,40345,3084613,8484,1005266,12073,34,16413,186,6,832,130000.0,39000.0,-68.0,-71.0,-67.0,-60.0,-67.0,-70.0,-67.0,-60.0,-77.0,-85.0,-77.0,-84.0,9.0,14.0,10.0,24.0,1
6810,CC:2F:71:3F:1F:24,9983737,10749649950,6763999,10342973357,3219738,406676593,88,1551948,915193261,1543373,914163485,8575,1029776,1498242,619,6768719,692602,88,6074,130000.0,43333.0,-67.0,-64.0,-68.0,-68.0,-67.0,-64.0,-68.0,-67.0,-77.0,-85.0,-77.0,-84.0,10.0,21.0,9.0,16.0,1
6811,F8:59:71:5A:E0:3D,3418850,704199089,199112,297522496,3219738,406676593,0,197385,255404068,192540,254825180,4845,578888,174857,16,201827,3332,0,562,130000.0,39000.0,-65.0,-72.0,-64.0,-71.0,-65.0,-70.0,-63.0,-69.0,-77.0,-85.0,-77.0,-84.0,12.0,13.0,13.0,13.0,1
6812,CC:2F:71:3E:C5:1F,3231188,408077290,11450,1400697,3219738,406676593,6,48831,4090019,40347,3084753,8484,1005266,12073,34,16414,186,6,832,130000.0,39000.0,-69.0,-71.0,-66.0,-60.0,-68.0,-72.0,-68.0,-61.0,-77.0,-85.0,-77.0,-84.0,8.0,14.0,11.0,24.0,1
6813,CC:2F:71:3F:1F:24,9984758,10751219768,6765020,10344543175,3219738,406676593,88,1552125,915214997,1543550,914185221,8575,1029776,1498419,619,6769730,692638,88,6074,130000.0,43333.0,-67.0,-64.0,-69.0,-68.0,-67.0,-64.0,-68.0,-67.0,-77.0,-85.0,-77.0,-84.0,10.0,21.0,8.0,16.0,1
6814,F8:59:71:5A:E0:3D,3418857,704199755,199112,297522496,3219745,406677259,0,197385,255404068,192540,254825180,4845,578888,174857,16,201827,3332,0,562,130000.0,39000.0,-65.0,-72.0,-64.0,-71.0,-65.0,-70.0,-63.0,-69.0,-77.0,-85.0,-77.0,-84.0,12.0,13.0,13.0,13.0,1
6815,CC:2F:71:3E:C5:1F,3231195,408077956,11450,1400697,3219745,406677259,6,48831,4090019,40347,3084753,8484,1005266,12073,34,16414,186,6,832,130000.0,39000.0,-69.0,-71.0,-66.0,-60.0,-68.0,-72.0,-68.0,-61.0,-77.0,-85.0,-77.0,-84.0,8.0,14.0,11.0,24.0,1
6816,CC:2F:71:3F:1F:24,9986027,10753168692,6766280,10346491231,3219747,406677461,88,1552315,915238169,1543740,914208393,8575,1029776,1498609,619,6770987,692747,88,6074,130000.0,43333.0,-68.0,-64.0,-68.0,-67.0,-67.0,-64.0,-68.0,-67.0,-77.0,-85.0,-77.0,-84.0,9.0,21.0,9.0,17.0,1
6817,F8:59:71:5A:E0:3D,3418859,704199957,199112,297522496,3219747,406677461,0,197385,255404068,192540,254825180,4845,578888,174857,16,201827,3332,0,562,130000.0,39000.0,-65.0,-72.0,-64.0,-71.0,-65.0,-70.0,-63.0,-69.0,-77.0,-85.0,-77.0,-84.0,12.0,13.0,13.0,13.0,1
6818,CC:2F:71:3E:C5:1F,3231197,408078158,11450,1400697,3219747,406677461,6,48831,4090019,40347,3084753,8484,1005266,12073,34,16414,186,6,832,130000.0,39000.0,-69.0,-71.0,-66.0,-60.0,-68.0,-72.0,-68.0,-61.0,-77.0,-85.0,-77.0,-84.0,8.0,14.0,11.0,24.0,1
6819,CC:2F:71:3F:1F:24,9987301,10755130852,6767554,10348453391,3219747,406677461,88,1552507,915262230,1543932,914232454,8575,1029776,1498801,619,6772260,692831,88,6075,130000.0,43333.0,-67.0,-64.0,-68.0,-68.0,-67.0,-64.0,-67.0,-68.0,-77.0,-85.0,-77.0,-84.0,10.0,21.0,9.0,16.0,1
6820,F8:59:71:5A:E0:3D,3418865,704200563,199112,297522496,3219753,406678067,0,197385,255404068,192540,254825180,4845,578888,174857,16,201827,3332,0,562,130000.0,39000.0,-65.0,-72.0,-64.0,-71.0,-65.0,-70.0,-63.0,-69.0,-77.0,-85.0,-77.0,-84.0,12.0,13.0,13.0,13.0,1
6821,CC:2F:71:3E:C5:1F,3231204,408078824,11450,1400697,3219754,406678127,6,48831,4090019,40347,3084753,8484,1005266,12073,34,16414,186,6,832,130000.0,39000.0,-69.0,-71.0,-66.0,-60.0,-68.0,-72.0,-68.0,-61.0,-77.0,-85.0,-77.0,-84.0,8.0,14.0,11.0,24.0,1
6822,CC:2F:71:3F:1F:24,9988273,10756612968,6768519,10349934841,3219754,406678127,88,1552658,915281050,1544083,914251274,8575,1029776,1498952,619,6773239,692864,88,6075,130000.0,43333.0,-68.0,-64.0,-68.0,-67.0,-67.0,-64.0,-68.0,-67.0,-77.0,-85.0,-77.0,-84.0,9.0,21.0,9.0,17.0,1
6823,F8:59:71:5A:E0:3D,3418869,704200941,199113,297522612,3219756,406678329,0,197387,255404244,192542,254825356,4845,578888,174858,16,201828,3332,0,562,130000.0,39000.0,-65.0,-72.0,-63.0,-72.0,-65.0,-71.0,-63.0,-70.0,-77.0,-85.0,-77.0,-84.0,12.0,13.0,14.0,12.0,1
6824,CC:2F:71:3E:C5:1F,3231206,408079026,11450,1400697,3219756,406678329,6,48831,4090019,40347,3084753,8484,1005266,12073,34,16414,186,6,832,130000.0,39000.0,-69.0,-71.0,-66.0,-60.0,-68.0,-72.0,-68.0,-61.0,-77.0,-85.0,-77.0,-84.0,8.0,14.0,11.0,24.0,1
6825,CC:2F:71:3F:1F:24,9989408,10758362268,6769652,10351683939,3219756,406678329,88,1552853,915304802,1544278,914275026,8575,1029776,1499147,619,6774363,692942,88,6075,130000.0,43333.0,-68.0,-64.0,-70.0,-67.0,-68.0,-64.0,-69.0,-67.0,-77.0,-85.0,-77.0,-84.0,9.0,21.0,7.0,17.0,1
6826,F8:59:71:5A:E0:3D,3418876,704201585,199114,297522728,3219762,406678857,0,197390,255404490,192545,254825602,4845,578888,174859,16,201829,3332,0,562,130000.0,39000.0,-65.0,-71.0,-63.0,-72.0,-64.0,-71.0,-63.0,-70.0,-77.0,-85.0,-77.0,-84.0,12.0,14.0,14.0,12.0,1
6827,CC:2F:71:3E:C5:1F,3231212,408079554,11450,1400697,3219762,406678857,6,48833,4090207,40348,3084823,8485,1005384,12074,34,16414,186,6,832,130000.0,39000.0,-68.0,-71.0,-67.0,-61.0,-68.0,-72.0,-67.0,-61.0,-77.0,-85.0,-77.0,-84.0,9.0,14.0,10.0,23.0,1
6828,CC:2F:71:3F:1F:24,9990681,10760320616,6770917,10353641557,3219764,406679059,88,1553018,915325124,1544442,914295230,8576,1029894,1499312,619,6775625,692969,88,6075,130000.0,43333.0,-67.0,-64.0,-69.0,-67.0,-67.0,-64.0,-69.0,-67.0,-77.0,-85.0,-77.0,-84.0,10.0,21.0,8.0,17.0,1
6829,F8:59:71:5A:E0:3D,3418881,704202049,199114,297522728,3219767,406679321,0,197390,255404490,192545,254825602,4845,578888,174859,16,201829,3332,0,562,130000.0,39000.0,-65.0,-71.0,-63.0,-72.0,-64.0,-71.0,-63.0,-70.0,-77.0,-85.0,-77.0,-84.0,12.0,14.0,14.0,12.0,1
6830,CC:2F:71:3E:C5:1F,3231217,408080018,11450,1400697,3219767,406679321,6,48833,4090207,40348,3084823,8485,1005384,12074,34,16414,186,6,832,130000.0,39000.0,-68.0,-71.0,-67.0,-61.0,-68.0,-72.0,-67.0,-61.0,-77.0,-85.0,-77.0,-84.0,9.0,14.0,10.0,23.0,1
6831,CC:2F:71:3F:1F:24,9991793,10762026204,6772026,10355346883,3219767,406679321,88,1553212,915349371,1544636,914319477,8576,1029894,1499506,619,6776713,692989,88,6075,130000.0,43333.0,-68.0,-64.0,-68.0,-67.0,-67.0,-64.0,-69.0,-67.0,-77.0,-85.0,-77.0,-84.0,9.0,21.0,9.0,17.0,1
6832,F8:59:71:5A:E0:3D,3418883,704202251,199114,297522728,3219769,406679523,0,197390,255404490,192545,254825602,4845,578888,174859,16,201829,3332,0,562,130000.0,39000.0,-65.0,-71.0,-63.0,-72.0,-64.0,-71.0,-63.0,-70.0,-77.0,-85.0,-77.0,-84.0,12.0,14.0,14.0,12.0,1
6833,CC:2F:71:3E:C5:1F,3231221,408080422,11450,1400697,3219771,406679725,6,48833,4090207,40348,3084823,8485,1005384,12074,34,16414,186,6,832,130000.0,39000.0,-68.0,-71.0,-67.0,-61.0,-68.0,-72.0,-67.0,-61.0,-77.0,-85.0,-77.0,-84.0,9.0,14.0,10.0,23.0,1
6834,CC:2F:71:3F:1F:24,9992819,10763600548,6773048,10356920823,3219771,406679725,88,1553346,915366219,1544770,914336325,8576,1029894,1499640,619,6777747,693103,88,6075,130000.0,43333.0,-68.0,-64.0,-68.0,-67.0,-67.0,-64.0,-68.0,-67.0,-77.0,-85.0,-77.0,-84.0,9.0,21.0,9.0,17.0,1
6835,F8:59:71:5A:E0:3D,3418889,704202857,199114,297522728,3219775,406680129,0,197390,255404490,192545,254825602,4845,578888,174859,16,201829,3332,0,562,130000.0,39000.0,-65.0,-71.0,-63.0,-72.0,-64.0,-71.0,-63.0,-70.0,-77.0,-85.0,-77.0,-84.0,12.0,14.0,14.0,12.0,1
6836,CC:2F:71:3E:C5:1F,3231225,408080826,11450,1400697,3219775,406680129,6,48833,4090207,40348,3084823,8485,1005384,12074,34,16414,186,6,832,130000.0,39000.0,-68.0,-71.0,-67.0,-61.0,-68.0,-72.0,-67.0,-61.0,-77.0,-85.0,-77.0,-84.0,9.0,14.0,10.0,23.0,1
6837,CC:2F:71:3F:1F:24,9993835,10765157927,6774060,10358477798,3219775,406680129,88,1553491,915384246,1544915,914354352,8576,1029894,1499785,619,6778780,693156,88,6075,130000.0,43333.0,-67.0,-64.0,-70.0,-67.0,-67.0,-64.0,-69.0,-67.0,-77.0,-85.0,-77.0,-84.0,10.0,21.0,7.0,17.0,1
6838,F8:59:71:5A:E0:3D,3418893,704203392,199114,297522728,3219779,406680664,0,197390,255404490,192545,254825602,4845,578888,174859,16,201829,3332,0,562,130000.0,39000.0,-65.0,-71.0,-63.0,-72.0,-64.0,-71.0,-63.0,-70.0,-77.0,-85.0,-77.0,-84.0,12.0,14.0,14.0,12.0,1
6839,CC:2F:71:3E:C5:1F,3231229,408081361,11450,1400697,3219779,406680664,6,48833,4090207,40348,3084823,8485,1005384,12074,34,16414,186,6,832,130000.0,39000.0,-68.0,-71.0,-67.0,-61.0,-68.0,-72.0,-67.0,-61.0,-77.0,-85.0,-77.0,-84.0,9.0,14.0,10.0,23.0,1
6840,CC:2F:71:3F:1F:24,9994933,10766841968,6775152,10360161102,3219781,406680866,88,1553635,915402142,1545059,914372248,8576,1029894,1499929,619,6779872,693195,88,6075,130000.0,43333.0,-67.0,-64.0,-68.0,-67.0,-67.0,-64.0,-68.0,-67.0,-77.0,-85.0,-77.0,-84.0,10.0,21.0,9.0,17.0,1
6841,F8:59:71:5A:E0:3D,3418899,704203998,199114,297522728,3219785,406681270,0,197390,255404490,192545,254825602,4845,578888,174859,16,201829,3332,0,562,130000.0,39000.0,-65.0,-71.0,-63.0,-72.0,-64.0,-71.0,-63.0,-70.0,-77.0,-85.0,-77.0,-84.0,12.0,14.0,14.0,12.0,1
6842,CC:2F:71:3E:C5:1F,3231235,408081967,11450,1400697,3219785,406681270,6,48833,4090207,40348,3084823,8485,1005384,12074,34,16414,186,6,832,130000.0,39000.0,-68.0,-71.0,-67.0,-61.0,-68.0,-72.0,-67.0,-61.0,-77.0,-85.0,-77.0,-84.0,9.0,14.0,10.0,23.0,1
6843,CC:2F:71:3F:1F:24,9996164,10768739802,6776379,10362058532,3219785,406681270,88,1553838,915426762,1545262,914396868,8576,1029894,1500132,619,6781099,693225,88,6075,130000.0,43333.0,-68.0,-64.0,-70.0,-67.0,-67.0,-64.0,-69.0,-67.0,-77.0,-85.0,-77.0,-84.0,9.0,21.0,7.0,17.0,1
6844,F8:59:71:5A:E0:3D,3418899,704203998,199114,297522728,3219785,406681270,0,197390,255404490,192545,254825602,4845,578888,174859,16,201829,3332,0,562,130000.0,39000.0,-65.0,-71.0,-63.0,-72.0,-64.0,-71.0,-63.0,-70.0,-77.0,-85.0,-77.0,-84.0,12.0,14.0,14.0,12.0,1
6845,CC:2F:71:3E:C5:1F,3231237,408082169,11450,1400697,3219787,406681472,6,48833,4090207,40348,3084823,8485,1005384,12074,34,16414,186,6,832,130000.0,39000.0,-68.0,-71.0,-67.0,-61.0,-68.0,-72.0,-67.0,-61.0,-77.0,-85.0,-77.0,-84.0,9.0,14.0,10.0,23.0,1
6846,CC:2F:71:3F:1F:24,9997282,10770440500,6777495,10363759028,3219787,406681472,88,1554038,915452461,1545462,914422567,8576,1029894,1500332,619,6782213,693305,88,6075,130000.0,43333.0,-68.0,-64.0,-70.0,-67.0,-68.0,-64.0,-70.0,-67.0,-77.0,-85.0,-77.0,-84.0,9.0,21.0,7.0,17.0,1
6847,F8:59:71:5A:E0:3D,3418908,704204866,199114,297522728,3219794,406682138,0,197390,255404490,192545,254825602,4845,578888,174859,16,201829,3332,0,562,130000.0,39000.0,-65.0,-71.0,-63.0,-72.0,-64.0,-71.0,-63.0,-70.0,-77.0,-85.0,-77.0,-84.0,12.0,14.0,14.0,12.0,1
6848,CC:2F:71:3E:C5:1F,3231244,408082835,11450,1400697,3219794,406682138,6,48833,4090207,40348,3084823,8485,1005384,12074,34,16414,186,6,832,130000.0,39000.0,-68.0,-71.0,-67.0,-61.0,-68.0,-72.0,-67.0,-61.0,-77.0,-85.0,-77.0,-84.0,9.0,14.0,10.0,23.0,1
6849,CC:2F:71:3F:1F:24,9998296,10771990212,6778502,10365308074,3219794,406682138,88,1554230,915475943,1545654,914446049,8576,1029894,1500523,619,6783222,693351,88,6075,130000.0,43333.0,-68.0,-64.0,-68.0,-68.0,-67.0,-64.0,-68.0,-68.0,-77.0,-85.0,-77.0,-84.0,9.0,21.0,9.0,16.0,1
6850,F8:59:71:5A:E0:3D,3418908,704204866,199114,297522728,3219794,406682138,0,197390,255404490,192545,254825602,4845,578888,174859,16,201829,3332,0,562,130000.0,39000.0,-65.0,-71.0,-63.0,-72.0,-64.0,-71.0,-63.0,-70.0,-77.0,-85.0,-77.0,-84.0,12.0,14.0,14.0,12.0,1
6851,CC:2F:71:3E:C5:1F,3231244,408082835,11450,1400697,3219794,406682138,6,48833,4090207,40348,3084823,8485,1005384,12074,34,16414,186,6,832,130000.0,39000.0,-68.0,-71.0,-67.0,-61.0,-68.0,-72.0,-67.0,-61.0,-77.0,-85.0,-77.0,-84.0,9.0,14.0,10.0,23.0,1
6852,CC:2F:71:3F:1F:24,9999081,10773190054,6779287,10366507916,3219794,406682138,88,1554396,915496383,1545820,914466489,8576,1029894,1500689,619,6784007,693397,88,6075,130000.0,39000.0,-68.0,-63.0,-69.0,-69.0,-67.0,-63.0,-68.0,-69.0,-77.0,-85.0,-77.0,-84.0,9.0,22.0,8.0,15.0,1
6853,F8:59:71:5A:E0:3D,3418915,704205534,199114,297522728,3219801,406682806,0,197392,255404678,192546,254825672,4846,579006,174860,16,201829,3332,0,562,130000.0,39000.0,-66.0,-72.0,-63.0,-70.0,-65.0,-71.0,-63.0,-71.0,-77.0,-85.0,-77.0,-84.0,11.0,13.0,14.0,14.0,1
6854,CC:2F:71:3E:C5:1F,3231253,408083705,11450,1400697,3219803,406683008,6,48833,4090207,40348,3084823,8485,1005384,12074,34,16414,186,6,832,130000.0,39000.0,-68.0,-71.0,-67.0,-61.0,-68.0,-72.0,-67.0,-61.0,-77.0,-85.0,-77.0,-84.0,9.0,14.0,10.0,23.0,1
6855,CC:2F:71:3F:1F:24,10000211,10774919806,6780408,10368236798,3219803,406683008,88,1554523,915512283,1545947,914482389,8576,1029894,1500816,619,6785093,693403,88,6075,130000.0,43333.0,-67.0,-64.0,-69.0,-69.0,-67.0,-63.0,-69.0,-68.0,-77.0,-85.0,-77.0,-84.0,10.0,21.0,8.0,15.0,1
6856,F8:59:71:5A:E0:3D,3418919,704205866,199114,297522728,3219805,406683138,0,197393,255404804,192546,254825672,4847,579132,174861,16,201829,3332,0,562,130000.0,39000.0,-66.0,-72.0,-63.0,-71.0,-65.0,-71.0,-63.0,-71.0,-77.0,-85.0,-77.0,-84.0,11.0,13.0,14.0,13.0,1
6857,CC:2F:71:3E:C5:1F,3231255,408083835,11450,1400697,3219805,406683138,6,48833,4090207,40348,3084823,8485,1005384,12074,34,16414,186,6,832,130000.0,39000.0,-68.0,-71.0,-67.0,-61.0,-68.0,-72.0,-67.0,-61.0,-77.0,-85.0,-77.0,-84.0,9.0,14.0,10.0,23.0,1
6858,CC:2F:71:3F:1F:24,10001699,10777217550,6781894,10370534412,3219805,406683138,88,1554712,915535810,1546136,914505916,8576,1029894,1501005,619,6786614,693477,88,6075,117000.0,39000.0,-67.0,-64.0,-70.0,-68.0,-67.0,-63.0,-70.0,-68.0,-77.0,-85.0,-77.0,-84.0,10.0,21.0,7.0,16.0,1
6859,F8:59:71:5A:E0:3D,3418921,704206068,199114,297522728,3219807,406683340,0,197394,255404874,192547,254825742,4847,579132,174861,16,201829,3332,0,562,130000.0,39000.0,-66.0,-72.0,-63.0,-71.0,-65.0,-71.0,-63.0,-71.0,-77.0,-85.0,-77.0,-84.0,11.0,13.0,14.0,13.0,1
6860,CC:2F:71:3E:C5:1F,3231259,408084239,11450,1400697,3219809,406683542,6,48833,4090207,40348,3084823,8485,1005384,12074,34,16414,186,6,832,130000.0,39000.0,-68.0,-71.0,-67.0,-61.0,-68.0,-72.0,-67.0,-61.0,-77.0,-85.0,-77.0,-84.0,9.0,14.0,10.0,23.0,1
6861,CC:2F:71:3F:1F:24,10003198,10779535446,6783387,10372851702,3219811,406683744,88,1554905,915559452,1546329,914529558,8576,1029894,1501198,619,6788107,693483,88,6075,130000.0,43333.0,-67.0,-63.0,-71.0,-67.0,-67.0,-63.0,-71.0,-67.0,-77.0,-85.0,-77.0,-84.0,10.0,22.0,6.0,17.0,1
6862,F8:59:71:5A:E0:3D,3418927,704206674,199114,297522728,3219813,406683946,0,197394,255404874,192547,254825742,4847,579132,174861,16,201829,3332,0,562,130000.0,39000.0,-66.0,-72.0,-63.0,-71.0,-65.0,-71.0,-63.0,-71.0,-77.0,-85.0,-77.0,-84.0,11.0,13.0,14.0,13.0,1
6863,CC:2F:71:3E:C5:1F,3231263,408084643,11450,1400697,3219813,406683946,6,48833,4090207,40348,3084823,8485,1005384,12074,34,16414,186,6,832,130000.0,39000.0,-68.0,-71.0,-67.0,-61.0,-68.0,-72.0,-67.0,-61.0,-77.0,-85.0,-77.0,-84.0,9.0,14.0,10.0,23.0,1
6864,CC:2F:71:3F:1F:24,10004832,10782073968,6785019,10375390022,3219813,406683946,88,1555112,915584726,1546536,914554832,8576,1029894,1501405,619,6789703,693557,88,6075,130000.0,43333.0,-67.0,-63.0,-71.0,-67.0,-67.0,-63.0,-71.0,-67.0,-77.0,-85.0,-77.0,-84.0,10.0,22.0,6.0,17.0,1
6865,F8:59:71:5A:E0:3D,3418930,704206936,199114,297522728,3219816,406684208,0,197394,255404874,192547,254825742,4847,579132,174861,16,201829,3332,0,562,130000.0,39000.0,-66.0,-72.0,-63.0,-71.0,-65.0,-71.0,-63.0,-71.0,-77.0,-85.0,-77.0,-84.0,11.0,13.0,14.0,13.0,1
6866,CC:2F:71:3E:C5:1F,3231266,408084905,11450,1400697,3219816,406684208,6,48833,4090207,40348,3084823,8485,1005384,12074,34,16414,186,6,832,130000.0,39000.0,-68.0,-71.0,-67.0,-61.0,-68.0,-72.0,-67.0,-61.0,-77.0,-85.0,-77.0,-84.0,9.0,14.0,10.0,23.0,1
6867,CC:2F:71:3F:1F:24,10006196,10784180214,6786378,10377495804,3219818,406684410,88,1555300,915607726,1546724,914577832,8576,1029894,1501593,619,6791098,693704,88,6075,130000.0,43333.0,-67.0,-63.0,-71.0,-67.0,-67.0,-63.0,-71.0,-67.0,-77.0,-85.0,-77.0,-84.0,10.0,22.0,6.0,17.0,1
6868,F8:59:71:5A:E0:3D,3418936,704207542,199114,297522728,3219822,406684814,0,197394,255404874,192547,254825742,4847,579132,174861,16,201829,3332,0,562,130000.0,39000.0,-66.0,-72.0,-63.0,-71.0,-65.0,-71.0,-63.0,-71.0,-77.0,-85.0,-77.0,-84.0,11.0,13.0,14.0,13.0,1
6869,CC:2F:71:3E:C5:1F,3231272,408085511,11450,1400697,3219822,406684814,6,48833,4090207,40348,3084823,8485,1005384,12074,34,16414,186,6,832,130000.0,39000.0,-68.0,-71.0,-67.0,-61.0,-68.0,-72.0,-67.0,-61.0,-77.0,-85.0,-77.0,-84.0,9.0,14.0,10.0,23.0,1
6870,CC:2F:71:3F:1F:24,10007539,10786245932,6787717,10379561118,3219822,406684814,88,1555493,915631748,1546917,914601854,8576,1029894,1501784,619,6792437,693714,88,6075,130000.0,43333.0,-67.0,-63.0,-71.0,-68.0,-67.0,-63.0,-71.0,-67.0,-77.0,-85.0,-77.0,-84.0,10.0,22.0,6.0,16.0,1
6871,F8:59:71:5A:E0:3D,3418938,704207744,199114,297522728,3219824,406685016,0,197394,255404874,192547,254825742,4847,579132,174861,16,201829,3332,0,562,130000.0,39000.0,-66.0,-72.0,-63.0,-71.0,-65.0,-71.0,-63.0,-71.0,-77.0,-85.0,-77.0,-84.0,11.0,13.0,14.0,13.0,1
6872,CC:2F:71:3E:C5:1F,3231274,408085713,11450,1400697,3219824,406685016,6,48833,4090207,40348,3084823,8485,1005384,12074,34,16414,186,6,832,130000.0,39000.0,-68.0,-71.0,-67.0,-61.0,-68.0,-72.0,-67.0,-61.0,-77.0,-85.0,-77.0,-84.0,9.0,14.0,10.0,23.0,1
6873,CC:2F:71:3F:1F:24,10008577,10787842110,6788753,10381157094,3219824,406685016,88,1555635,915649308,1547059,914619414,8576,1029894,1501924,619,6793447,693937,88,6075,115556.0,28889.0,-68.0,-63.0,-70.0,-69.0,-67.0,-63.0,-69.0,-69.0,-77.0,-85.0,-77.0,-84.0,9.0,22.0,7.0,15.0,1
6874,F8:59:71:5A:E0:3D,3418945,704208410,199114,297522728,3219831,406685682,0,197394,255404874,192547,254825742,4847,579132,174861,16,201829,3332,0,562,130000.0,39000.0,-66.0,-72.0,-63.0,-71.0,-65.0,-71.0,-63.0,-71.0,-77.0,-85.0,-77.0,-84.0,11.0,13.0,14.0,13.0,1
6875,CC:2F:71:3E:C5:1F,3231281,408086379,11450,1400697,3219831,406685682,6,48833,4090207,40348,3084823,8485,1005384,12074,34,16414,186,6,832,130000.0,39000.0,-68.0,-71.0,-67.0,-61.0,-68.0,-72.0,-67.0,-61.0,-77.0,-85.0,-77.0,-84.0,9.0,14.0,10.0,23.0,1
6876,CC:2F:71:3F:1F:24,10009820,10789756080,6789989,10383070398,3219831,406685682,88,1555830,915673228,1547254,914643334,8576,1029894,1502119,619,6794709,694070,88,6075,115556.0,28889.0,-68.0,-63.0,-70.0,-69.0,-67.0,-63.0,-69.0,-69.0,-77.0,-85.0,-77.0,-84.0,9.0,22.0,7.0,15.0,1
6877,F8:59:71:5A:E0:3D,3418945,704208410,199114,297522728,3219831,406685682,0,197394,255404874,192547,254825742,4847,579132,174861,16,201829,3332,0,562,130000.0,39000.0,-66.0,-72.0,-63.0,-71.0,-65.0,-71.0,-63.0,-71.0,-77.0,-85.0,-77.0,-84.0,11.0,13.0,14.0,13.0,1
6878,CC:2F:71:3E:C5:1F,3231281,408086379,11450,1400697,3219831,406685682,6,48833,4090207,40348,3084823,8485,1005384,12074,34,16414,186,6,832,130000.0,39000.0,-68.0,-71.0,-67.0,-61.0,-68.0,-72.0,-67.0,-61.0,-77.0,-85.0,-77.0,-84.0,9.0,14.0,10.0,23.0,1
6879,CC:2F:71:3F:1F:24,10010714,10791125306,6790881,10384439422,3219833,406685884,88,1555988,915692816,1547412,914662922,8576,1029894,1502275,619,6795601,694075,88,6075,115556.0,28889.0,-68.0,-63.0,-70.0,-68.0,-67.0,-63.0,-70.0,-68.0,-77.0,-85.0,-77.0,-84.0,9.0,22.0,7.0,16.0,1
6880,F8:59:71:5A:E0:3D,3418953,704209218,199114,297522728,3219839,406686490,0,197394,255404874,192547,254825742,4847,579132,174861,16,201829,3332,0,562,130000.0,39000.0,-66.0,-72.0,-63.0,-71.0,-65.0,-71.0,-63.0,-71.0,-77.0,-85.0,-77.0,-85.0,11.0,13.0,14.0,14.0,1
6881,CC:2F:71:3E:C5:1F,3231289,408087187,11450,1400697,3219839,406686490,6,48833,4090207,40348,3084823,8485,1005384,12074,34,16414,186,6,832,130000.0,39000.0,-68.0,-71.0,-67.0,-61.0,-68.0,-72.0,-67.0,-61.0,-77.0,-85.0,-77.0,-85.0,9.0,14.0,10.0,24.0,1
6882,CC:2F:71:3F:1F:24,10011448,10792231257,6791607,10385544434,3219841,406686823,88,1556138,915711402,1547562,914681508,8576,1029894,1502425,619,6796327,694125,88,6075,130000.0,43333.0,-67.0,-63.0,-70.0,-69.0,-67.0,-63.0,-70.0,-68.0,-77.0,-85.0,-77.0,-85.0,10.0,22.0,7.0,16.0,1
6883,F8:59:71:5A:E0:3D,3418955,704209551,199114,297522728,3219841,406686823,0,197394,255404874,192547,254825742,4847,579132,174861,16,201829,3332,0,562,130000.0,39000.0,-66.0,-72.0,-63.0,-71.0,-65.0,-71.0,-63.0,-71.0,-77.0,-85.0,-77.0,-85.0,11.0,13.0,14.0,14.0,1
6884,CC:2F:71:3E:C5:1F,3231291,408087520,11450,1400697,3219841,406686823,6,48833,4090207,40348,3084823,8485,1005384,12074,34,16414,186,6,832,130000.0,39000.0,-68.0,-71.0,-67.0,-61.0,-68.0,-72.0,-67.0,-61.0,-77.0,-85.0,-77.0,-85.0,9.0,14.0,10.0,24.0,1
6885,CC:2F:71:3F:1F:24,10012483,10793819643,6792642,10387132820,3219841,406686823,88,1556285,915730129,1547709,914700235,8576,1029894,1502572,619,6797362,694331,88,6076,117000.0,39000.0,-68.0,-63.0,-69.0,-68.0,-67.0,-63.0,-70.0,-68.0,-77.0,-85.0,-77.0,-85.0,9.0,22.0,8.0,17.0,1
6886,F8:59:71:5A:E0:3D,3418964,704211030,199115,297523399,3219849,406687631,0,197396,255405188,192549,254826056,4847,579132,174862,16,201830,3332,0,562,130000.0,39000.0,-73.0,-83.0,-72.0,-75.0,-66.0,-73.0,-64.0,-71.0,-77.0,-85.0,-77.0,-85.0,4.0,2.0,5.0,10.0,1
6887,CC:2F:71:3E:C5:1F,3231299,408088328,11450,1400697,3219849,406687631,6,48833,4090207,40348,3084823,8485,1005384,12074,34,16414,186,6,832,130000.0,39000.0,-68.0,-71.0,-67.0,-61.0,-68.0,-72.0,-67.0,-61.0,-77.0,-85.0,-77.0,-85.0,9.0,14.0,10.0,24.0,1
6888,CC:2F:71:3F:1F:24,10013216,10794925501,6793367,10388237870,3219849,406687631,88,1556455,915751225,1547879,914721331,8576,1029894,1502742,619,6798087,694453,88,6076,117000.0,39000.0,-68.0,-63.0,-71.0,-68.0,-67.0,-63.0,-70.0,-68.0,-77.0,-85.0,-77.0,-85.0,9.0,22.0,6.0,17.0,1
6889,F8:59:71:5A:E0:3D,3418965,704211090,199115,297523399,3219850,406687691,0,197397,255405258,192550,254826126,4847,579132,174862,16,201830,3332,0,562,130000.0,39000.0,-66.0,-72.0,-63.0,-70.0,-66.0,-73.0,-64.0,-71.0,-77.0,-85.0,-77.0,-85.0,11.0,13.0,14.0,15.0,1
6890,CC:2F:71:3E:C5:1F,3231300,408088388,11450,1400697,3219850,406687691,6,48833,4090207,40348,3084823,8485,1005384,12074,34,16414,186,6,832,130000.0,39000.0,-68.0,-71.0,-67.0,-61.0,-68.0,-72.0,-67.0,-61.0,-77.0,-85.0,-77.0,-85.0,9.0,14.0,10.0,24.0,1
6891,CC:2F:71:3F:1F:24,10013927,10796008725,6794077,10389321034,3219850,406687691,88,1556606,915769917,1548030,914740023,8576,1029894,1502893,619,6798797,694501,88,6077,130000.0,43333.0,-68.0,-63.0,-70.0,-68.0,-68.0,-63.0,-70.0,-68.0,-77.0,-85.0,-77.0,-85.0,9.0,22.0,7.0,17.0,1
6892,F8:59:71:5A:E0:3D,3418973,704211898,199115,297523399,3219858,406688499,0,197397,255405258,192550,254826126,4847,579132,174862,16,201830,3332,0,562,130000.0,39000.0,-66.0,-72.0,-63.0,-70.0,-66.0,-73.0,-64.0,-71.0,-77.0,-85.0,-77.0,-85.0,11.0,13.0,14.0,15.0,1
6893,CC:2F:71:3E:C5:1F,3231308,408089196,11450,1400697,3219858,406688499,6,48833,4090207,40348,3084823,8485,1005384,12074,34,16414,186,6,832,130000.0,39000.0,-68.0,-71.0,-67.0,-61.0,-68.0,-72.0,-67.0,-61.0,-77.0,-85.0,-77.0,-85.0,9.0,14.0,10.0,24.0,1
6894,CC:2F:71:3F:1F:24,10014583,10796991685,6794725,10390303186,3219858,406688499,88,1556717,915783973,1548141,914754079,8576,1029894,1503004,619,6799445,694758,88,6077,130000.0,39000.0,-68.0,-64.0,-69.0,-69.0,-68.0,-63.0,-69.0,-69.0,-77.0,-85.0,-77.0,-85.0,9.0,21.0,8.0,16.0,1
6895,F8:59:71:5A:E0:3D,3418974,704212014,199116,297523515,3219858,406688499,0,197399,255405398,192552,254826266,4847,579132,174862,16,201831,3332,0,562,130000.0,39000.0,-65.0,-68.0,-62.0,-61.0,-67.0,-74.0,-65.0,-70.0,-77.0,-85.0,-77.0,-85.0,12.0,17.0,15.0,24.0,1
6896,CC:2F:71:3E:C5:1F,3231309,408089312,11451,1400813,3219858,406688499,6,48835,4090347,40350,3084963,8485,1005384,12074,34,16415,186,6,832,130000.0,39000.0,-73.0,-82.0,-72.0,-71.0,-68.0,-73.0,-67.0,-63.0,-77.0,-85.0,-77.0,-85.0,4.0,3.0,5.0,14.0,1
6897,CC:2F:71:3F:1F:24,10015534,10798424755,6795674,10391735888,3219860,406688867,88,1556882,915807320,1548306,914777426,8576,1029894,1503169,619,6800394,694875,88,6077,130000.0,43333.0,-67.0,-63.0,-70.0,-69.0,-67.0,-63.0,-69.0,-69.0,-77.0,-85.0,-77.0,-85.0,10.0,22.0,7.0,16.0,1
6898,F8:59:71:5A:E0:3D,3418980,704212706,199116,297523515,3219864,406689191,0,197399,255405398,192552,254826266,4847,579132,174862,16,201831,3332,0,562,130000.0,39000.0,-65.0,-68.0,-62.0,-61.0,-67.0,-74.0,-65.0,-70.0,-77.0,-85.0,-77.0,-85.0,12.0,17.0,15.0,24.0,1
6899,CC:2F:71:3E:C5:1F,3231318,408090340,11451,1400813,3219867,406689527,6,48837,4090535,40351,3085033,8486,1005502,12075,34,16415,186,6,832,130000.0,39000.0,-68.0,-70.0,-67.0,-60.0,-69.0,-73.0,-67.0,-63.0,-77.0,-85.0,-77.0,-85.0,9.0,15.0,10.0,25.0,1
6900,CC:2F:71:3F:1F:24,10016554,10799975082,6796683,10393285223,3219871,406689859,88,1557028,915825562,1548452,914795668,8576,1029894,1503315,619,6801403,694894,88,6077,130000.0,43333.0,-69.0,-63.0,-71.0,-68.0,-68.0,-63.0,-70.0,-68.0,-77.0,-85.0,-77.0,-85.0,8.0,22.0,6.0,17.0,1
6901,F8:59:71:5A:E0:3D,3418987,704213374,199116,297523515,3219871,406689859,0,197401,255405586,192553,254826336,4848,579250,174863,16,201831,3332,0,562,130000.0,39000.0,-66.0,-73.0,-63.0,-70.0,-67.0,-74.0,-65.0,-70.0,-77.0,-85.0,-77.0,-85.0,11.0,12.0,14.0,15.0,1
6902,CC:2F:71:3E:C5:1F,3231322,408090672,11451,1400813,3219871,406689859,6,48837,4090535,40351,3085033,8486,1005502,12075,34,16415,186,6,832,130000.0,39000.0,-68.0,-70.0,-67.0,-60.0,-69.0,-73.0,-67.0,-63.0,-77.0,-85.0,-77.0,-85.0,9.0,15.0,10.0,25.0,1
6903,CC:2F:71:3F:1F:24,10017326,10801150202,6797455,10394460343,3219871,406689859,88,1557209,915847742,1548633,914817848,8576,1029894,1503496,619,6802175,694949,88,6077,130000.0,43333.0,-68.0,-63.0,-70.0,-68.0,-68.0,-63.0,-70.0,-68.0,-77.0,-85.0,-77.0,-85.0,9.0,22.0,7.0,17.0,1
6904,F8:59:71:5A:E0:3D,3418989,704213576,199116,297523515,3219873,406690061,0,197401,255405586,192553,254826336,4848,579250,174863,16,201831,3332,0,562,130000.0,39000.0,-66.0,-73.0,-63.0,-70.0,-67.0,-74.0,-65.0,-70.0,-77.0,-85.0,-77.0,-85.0,11.0,12.0,14.0,15.0,1
6905,CC:2F:71:3E:C5:1F,3231324,408090874,11451,1400813,3219873,406690061,6,48837,4090535,40351,3085033,8486,1005502,12075,34,16415,186,6,832,130000.0,39000.0,-68.0,-70.0,-67.0,-60.0,-69.0,-73.0,-67.0,-63.0,-77.0,-85.0,-77.0,-85.0,9.0,15.0,10.0,25.0,1
6906,CC:2F:71:3F:1F:24,10018674,10803235616,6798801,10396545555,3219873,406690061,88,1557442,915875978,1548866,914846084,8576,1029894,1503729,619,6803521,695050,88,6077,130000.0,43333.0,-68.0,-63.0,-70.0,-68.0,-68.0,-63.0,-70.0,-68.0,-77.0,-85.0,-77.0,-85.0,9.0,22.0,7.0,17.0,1
6907,F8:59:71:5A:E0:3D,3418996,704214242,199116,297523515,3219880,406690727,0,197401,255405586,192553,254826336,4848,579250,174863,16,201831,3332,0,562,130000.0,39000.0,-66.0,-73.0,-63.0,-70.0,-67.0,-74.0,-65.0,-70.0,-77.0,-85.0,-77.0,-85.0,11.0,12.0,14.0,15.0,1
6908,CC:2F:71:3E:C5:1F,3231331,408091540,11451,1400813,3219880,406690727,6,48837,4090535,40351,3085033,8486,1005502,12075,34,16415,186,6,832,130000.0,39000.0,-68.0,-70.0,-67.0,-60.0,-69.0,-73.0,-67.0,-63.0,-77.0,-85.0,-77.0,-85.0,9.0,15.0,10.0,25.0,1
6909,CC:2F:71:3F:1F:24,10020011,10805288898,6800131,10398598171,3219880,406690727,88,1557648,915901625,1549072,914871731,8576,1029894,1503935,619,6804836,695150,88,6077,130000.0,43333.0,-68.0,-63.0,-70.0,-68.0,-67.0,-63.0,-70.0,-68.0,-77.0,-85.0,-77.0,-85.0,9.0,22.0,7.0,17.0,1
6910,F8:59:71:5A:E0:3D,3418996,704214242,199116,297523515,3219880,406690727,0,197401,255405586,192553,254826336,4848,579250,174863,16,201831,3332,0,562,130000.0,39000.0,-66.0,-73.0,-63.0,-70.0,-67.0,-74.0,-65.0,-70.0,-77.0,-85.0,-77.0,-85.0,11.0,12.0,14.0,15.0,1
6911,CC:2F:71:3E:C5:1F,3231333,408091742,11451,1400813,3219882,406690929,6,48837,4090535,40351,3085033,8486,1005502,12075,34,16415,186,6,832,130000.0,39000.0,-68.0,-70.0,-67.0,-60.0,-69.0,-73.0,-67.0,-63.0,-77.0,-85.0,-77.0,-85.0,9.0,15.0,10.0,25.0,1
6912,CC:2F:71:3F:1F:24,10021300,10807279762,6801418,10400588833,3219882,406690929,88,1557833,915924641,1549257,914894747,8576,1029894,1504119,619,6806114,695309,88,6077,130000.0,43333.0,-68.0,-63.0,-71.0,-68.0,-67.0,-63.0,-70.0,-68.0,-77.0,-85.0,-77.0,-85.0,9.0,22.0,6.0,17.0,1
6913,F8:59:71:5A:E0:3D,3419004,704215050,199116,297523515,3219888,406691535,0,197401,255405586,192553,254826336,4848,579250,174863,16,201831,3332,0,562,130000.0,39000.0,-66.0,-73.0,-63.0,-70.0,-67.0,-74.0,-65.0,-70.0,-77.0,-85.0,-77.0,-85.0,11.0,12.0,14.0,15.0,1
6914,CC:2F:71:3E:C5:1F,3231339,408092348,11451,1400813,3219888,406691535,6,48837,4090535,40351,3085033,8486,1005502,12075,34,16415,186,6,832,130000.0,39000.0,-68.0,-70.0,-67.0,-60.0,-69.0,-73.0,-67.0,-63.0,-77.0,-85.0,-77.0,-85.0,9.0,15.0,10.0,25.0,1
6915,CC:2F:71:3F:1F:24,10022193,10808641166,6802305,10401949631,3219888,406691535,88,1558017,915947307,1549441,914917413,8576,1029894,1504303,619,6807025,695528,88,6077,117000.0,39000.0,-69.0,-64.0,-69.0,-69.0,-68.0,-63.0,-68.0,-68.0,-77.0,-85.0,-77.0,-85.0,8.0,21.0,8.0,16.0,1
6916,F8:59:71:5A:E0:3D,3419005,704215110,199116,297523515,3219889,406691595,0,197401,255405586,192553,254826336,4848,579250,174863,16,201831,3332,0,562,130000.0,39000.0,-66.0,-73.0,-63.0,-70.0,-67.0,-74.0,-65.0,-70.0,-77.0,-85.0,-77.0,-85.0,11.0,12.0,14.0,15.0,1
6917,CC:2F:71:3E:C5:1F,3231340,408092408,11451,1400813,3219889,406691595,6,48837,4090535,40351,3085033,8486,1005502,12075,34,16415,186,6,832,130000.0,39000.0,-68.0,-70.0,-67.0,-60.0,-69.0,-73.0,-67.0,-63.0,-77.0,-85.0,-77.0,-85.0,9.0,15.0,10.0,25.0,1
6918,CC:2F:71:3F:1F:24,10023045,10809933338,6803145,10403236319,3219900,406697019,88,1558174,915966825,1549598,914936931,8576,1029894,1504460,619,6807864,695767,88,6077,130000.0,43333.0,-68.0,-63.0,-69.0,-69.0,-68.0,-63.0,-69.0,-69.0,-77.0,-85.0,-77.0,-85.0,9.0,22.0,8.0,16.0,1
6919,F8:59:71:5A:E0:3D,3419035,704226766,199116,297523515,3219919,406703251,0,197401,255405586,192553,254826336,4848,579250,174863,16,201831,3332,0,562,130000.0,39000.0,-66.0,-73.0,-63.0,-70.0,-67.0,-74.0,-65.0,-70.0,-77.0,-85.0,-77.0,-85.0,11.0,12.0,14.0,15.0,1
6920,CC:2F:71:3E:C5:1F,3231370,408104064,11451,1400813,3219919,406703251,6,48837,4090535,40351,3085033,8486,1005502,12075,34,16415,186,6,832,130000.0,39000.0,-68.0,-70.0,-67.0,-60.0,-69.0,-73.0,-67.0,-63.0,-77.0,-85.0,-77.0,-85.0,9.0,15.0,10.0,25.0,1
6921,CC:2F:71:3F:1F:24,10023812,10811079706,6803893,10404376455,3219919,406703251,88,1558316,915984509,1549740,914954615,8576,1029894,1504602,619,6808613,696119,88,6077,130000.0,43333.0,-68.0,-64.0,-68.0,-68.0,-67.0,-63.0,-69.0,-68.0,-77.0,-85.0,-77.0,-85.0,9.0,21.0,9.0,17.0,1
6922,F8:59:71:5A:E0:3D,3419035,704226766,199116,297523515,3219919,406703251,0,197401,255405586,192553,254826336,4848,579250,174863,16,201831,3332,0,562,130000.0,39000.0,-66.0,-73.0,-63.0,-70.0,-67.0,-74.0,-65.0,-70.0,-77.0,-85.0,-77.0,-85.0,11.0,12.0,14.0,15.0,1
6923,CC:2F:71:3E:C5:1F,3231370,408104064,11451,1400813,3219919,406703251,6,48837,4090535,40351,3085033,8486,1005502,12075,34,16415,186,6,832,130000.0,39000.0,-68.0,-70.0,-67.0,-60.0,-69.0,-73.0,-67.0,-63.0,-77.0,-85.0,-77.0,-85.0,9.0,15.0,10.0,25.0,1
6924,CC:2F:71:3F:1F:24,10024912,10812767996,6804993,10406064745,3219919,406703251,88,1558500,916007610,1549924,914977716,8576,1029894,1504786,619,6809693,696404,88,6077,130000.0,43333.0,-68.0,-64.0,-70.0,-69.0,-67.0,-63.0,-69.0,-69.0,-77.0,-85.0,-77.0,-85.0,9.0,21.0,7.0,16.0,1
6925,F8:59:71:5A:E0:3D,3419045,704227907,199116,297523515,3219929,406704392,0,197401,255405586,192553,254826336,4848,579250,174863,16,201831,3332,0,562,130000.0,39000.0,-66.0,-73.0,-63.0,-70.0,-67.0,-74.0,-65.0,-70.0,-77.0,-85.0,-77.0,-85.0,11.0,12.0,14.0,15.0,1
6926,CC:2F:71:3E:C5:1F,3231380,408105205,11451,1400813,3219929,406704392,6,48837,4090535,40351,3085033,8486,1005502,12075,34,16415,186,6,832,130000.0,39000.0,-68.0,-70.0,-67.0,-60.0,-69.0,-73.0,-67.0,-63.0,-77.0,-85.0,-77.0,-85.0,9.0,15.0,10.0,25.0,1
6927,CC:2F:71:3F:1F:24,10025959,10814366803,6806030,10407662411,3219929,406704392,88,1558676,916029218,1550100,914999324,8576,1029894,1504962,619,6810721,696617,88,6077,130000.0,39000.0,-68.0,-63.0,-70.0,-68.0,-68.0,-63.0,-69.0,-68.0,-77.0,-85.0,-77.0,-85.0,9.0,22.0,7.0,17.0,1
6928,F8:59:71:5A:E0:3D,3419045,704227907,199116,297523515,3219929,406704392,0,197401,255405586,192553,254826336,4848,579250,174863,16,201831,3332,0,562,130000.0,39000.0,-66.0,-73.0,-63.0,-70.0,-67.0,-74.0,-65.0,-70.0,-77.0,-85.0,-77.0,-85.0,11.0,12.0,14.0,15.0,1
6929,CC:2F:71:3E:C5:1F,3231380,408105205,11451,1400813,3219929,406704392,6,48837,4090535,40351,3085033,8486,1005502,12075,34,16415,186,6,832,130000.0,39000.0,-68.0,-70.0,-67.0,-60.0,-69.0,-73.0,-67.0,-63.0,-77.0,-85.0,-77.0,-85.0,9.0,15.0,10.0,25.0,1
6930,CC:2F:71:3F:1F:24,10026993,10815959847,6807064,10409255455,3219929,406704392,88,1558845,916050136,1550269,915020242,8576,1029894,1505131,619,6811782,696743,88,6077,130000.0,43333.0,-66.0,-63.0,-70.0,-67.0,-66.0,-63.0,-69.0,-67.0,-77.0,-85.0,-77.0,-85.0,11.0,22.0,7.0,18.0,1
6931,F8:59:71:5A:E0:3D,3419051,704228513,199116,297523515,3219935,406704998,0,197401,255405586,192553,254826336,4848,579250,174863,16,201831,3332,0,562,130000.0,39000.0,-66.0,-73.0,-63.0,-70.0,-67.0,-74.0,-65.0,-70.0,-77.0,-85.0,-77.0,-85.0,11.0,12.0,14.0,15.0,1
6932,CC:2F:71:3E:C5:1F,3231386,408105811,11451,1400813,3219935,406704998,6,48837,4090535,40351,3085033,8486,1005502,12075,34,16415,186,6,832,130000.0,39000.0,-68.0,-70.0,-67.0,-60.0,-69.0,-73.0,-67.0,-63.0,-77.0,-85.0,-77.0,-85.0,9.0,15.0,10.0,25.0,1
6933,CC:2F:71:3F:1F:24,10027929,10817383719,6807992,10410678519,3219937,406705200,88,1559027,916072440,1550451,915042546,8576,1029894,1505313,619,6812712,696766,88,6077,130000.0,43333.0,-67.0,-64.0,-69.0,-67.0,-67.0,-64.0,-69.0,-67.0,-77.0,-85.0,-77.0,-85.0,10.0,21.0,8.0,18.0,1
6934,F8:59:71:5A:E0:3D,3419054,704228775,199116,297523515,3219938,406705260,0,197401,255405586,192553,254826336,4848,579250,174863,16,201831,3332,0,562,130000.0,39000.0,-66.0,-73.0,-63.0,-70.0,-67.0,-74.0,-65.0,-70.0,-77.0,-85.0,-77.0,-85.0,11.0,12.0,14.0,15.0,1
6935,CC:2F:71:3E:C5:1F,3231389,408106073,11451,1400813,3219938,406705260,6,48837,4090535,40351,3085033,8486,1005502,12075,34,16415,186,6,832,130000.0,39000.0,-68.0,-70.0,-67.0,-60.0,-69.0,-73.0,-67.0,-63.0,-77.0,-85.0,-77.0,-85.0,9.0,15.0,10.0,25.0,1
6936,CC:2F:71:3F:1F:24,10028712,10818571483,6808774,10411866223,3219938,406705260,88,1559174,916091274,1550598,915061380,8576,1029894,1505457,619,6813494,696817,88,6077,144444.0,43333.0,-67.0,-64.0,-69.0,-68.0,-67.0,-64.0,-68.0,-68.0,-77.0,-85.0,-77.0,-85.0,10.0,21.0,8.0,17.0,1
6937,F8:59:71:5A:E0:3D,3419058,704229179,199116,297523515,3219942,406705664,0,197401,255405586,192553,254826336,4848,579250,174863,16,201831,3332,0,562,130000.0,39000.0,-66.0,-73.0,-63.0,-70.0,-67.0,-74.0,-65.0,-70.0,-77.0,-85.0,-77.0,-85.0,11.0,12.0,14.0,15.0,1
6938,CC:2F:71:3E:C5:1F,3231394,408106539,11451,1400813,3219943,406705726,6,48837,4090535,40351,3085033,8486,1005502,12075,34,16415,186,6,832,130000.0,39000.0,-68.0,-70.0,-67.0,-60.0,-69.0,-73.0,-67.0,-63.0,-77.0,-85.0,-77.0,-85.0,9.0,15.0,10.0,25.0,1
6939,CC:2F:71:3F:1F:24,10029625,10819963267,6809680,10413257339,3219945,406705928,88,1559360,916114040,1550783,915084028,8577,1030012,1505643,619,6814398,696886,88,6077,144444.0,43333.0,-67.0,-64.0,-68.0,-67.0,-66.0,-64.0,-68.0,-67.0,-77.0,-85.0,-77.0,-85.0,10.0,21.0,9.0,18.0,1
6940,F8:59:71:5A:E0:3D,3419063,704229645,199116,297523515,3219947,406706130,0,197401,255405586,192553,254826336,4848,579250,174863,16,201831,3332,0,562,130000.0,39000.0,-66.0,-73.0,-63.0,-70.0,-67.0,-74.0,-65.0,-70.0,-77.0,-85.0,-77.0,-85.0,11.0,12.0,14.0,15.0,1
6941,CC:2F:71:3E:C5:1F,3231398,408106943,11451,1400813,3219947,406706130,6,48837,4090535,40351,3085033,8486,1005502,12075,34,16415,186,6,832,130000.0,39000.0,-68.0,-70.0,-67.0,-60.0,-69.0,-73.0,-67.0,-63.0,-77.0,-85.0,-77.0,-85.0,9.0,15.0,10.0,25.0,1
6942,CC:2F:71:3F:1F:24,10030926,10821972941,6810978,10415266751,3219948,406706190,88,1559535,916135488,1550958,915105476,8577,1030012,1505818,619,6815698,697089,88,6077,130000.0,43333.0,-67.0,-64.0,-68.0,-68.0,-67.0,-64.0,-68.0,-67.0,-77.0,-85.0,-77.0,-85.0,10.0,21.0,9.0,17.0,1
6943,F8:59:71:5A:E0:3D,3419066,704229907,199116,297523515,3219950,406706392,0,197401,255405586,192553,254826336,4848,579250,174863,16,201831,3332,0,562,130000.0,39000.0,-66.0,-73.0,-63.0,-70.0,-67.0,-74.0,-65.0,-70.0,-77.0,-85.0,-77.0,-85.0,11.0,12.0,14.0,15.0,1
6944,CC:2F:71:3E:C5:1F,3231401,408107205,11451,1400813,3219950,406706392,6,48837,4090535,40351,3085033,8486,1005502,12075,34,16415,186,6,832,130000.0,39000.0,-68.0,-70.0,-67.0,-60.0,-69.0,-73.0,-67.0,-63.0,-77.0,-85.0,-77.0,-85.0,9.0,15.0,10.0,25.0,1
6945,CC:2F:71:3F:1F:24,10032624,10824607925,6812672,10417901331,3219952,406706594,88,1559735,916159900,1551158,915129888,8577,1030012,1506018,619,6817392,697212,88,6077,130000.0,43333.0,-67.0,-64.0,-68.0,-67.0,-67.0,-64.0,-68.0,-67.0,-77.0,-85.0,-77.0,-85.0,10.0,21.0,9.0,18.0,1
6946,F8:59:71:5A:E0:3D,3419072,704230513,199116,297523515,3219956,406706998,0,197401,255405586,192553,254826336,4848,579250,174863,16,201831,3332,0,562,130000.0,39000.0,-66.0,-73.0,-63.0,-70.0,-67.0,-74.0,-65.0,-70.0,-77.0,-85.0,-77.0,-85.0,11.0,12.0,14.0,15.0,1
6947,CC:2F:71:3E:C5:1F,3231407,408107811,11451,1400813,3219956,406706998,6,48837,4090535,40351,3085033,8486,1005502,12075,34,16415,186,6,832,130000.0,39000.0,-68.0,-70.0,-67.0,-60.0,-69.0,-73.0,-67.0,-63.0,-77.0,-85.0,-77.0,-85.0,9.0,15.0,10.0,25.0,1
6948,CC:2F:71:3F:1F:24,10034691,10827817507,6814735,10421110509,3219956,406706998,88,1560013,916193982,1551436,915163970,8577,1030012,1506296,619,6819455,697383,88,6077,117000.0,39000.0,-67.0,-63.0,-70.0,-67.0,-67.0,-63.0,-69.0,-67.0,-77.0,-85.0,-77.0,-85.0,10.0,22.0,7.0,18.0,1
6949,F8:59:71:5A:E0:3D,3419073,704230573,199116,297523515,3219957,406707058,0,197401,255405586,192553,254826336,4848,579250,174863,16,201831,3332,0,562,130000.0,39000.0,-66.0,-73.0,-63.0,-70.0,-67.0,-74.0,-65.0,-70.0,-77.0,-85.0,-77.0,-85.0,11.0,12.0,14.0,15.0,1
6950,CC:2F:71:3E:C5:1F,3231408,408107871,11451,1400813,3219957,406707058,6,48837,4090535,40351,3085033,8486,1005502,12075,34,16415,186,6,832,130000.0,39000.0,-68.0,-70.0,-67.0,-60.0,-69.0,-73.0,-67.0,-63.0,-77.0,-85.0,-77.0,-85.0,9.0,15.0,10.0,25.0,1
6951,CC:2F:71:3F:1F:24,10036089,10829983369,6816132,10423276311,3219957,406707058,88,1560188,916215638,1551611,915185626,8577,1030012,1506471,619,6820843,697428,88,6077,130000.0,43333.0,-68.0,-63.0,-69.0,-68.0,-68.0,-63.0,-69.0,-68.0,-77.0,-85.0,-77.0,-85.0,9.0,22.0,8.0,17.0,1
6952,F8:59:71:5A:E0:3D,3419081,704231381,199116,297523515,3219965,406707866,0,197401,255405586,192553,254826336,4848,579250,174863,16,201831,3332,0,562,130000.0,39000.0,-66.0,-73.0,-63.0,-70.0,-67.0,-74.0,-65.0,-70.0,-77.0,-85.0,-77.0,-85.0,11.0,12.0,14.0,15.0,1
6953,CC:2F:71:3E:C5:1F,3231416,408108679,11451,1400813,3219965,406707866,6,48837,4090535,40351,3085033,8486,1005502,12075,34,16415,186,6,832,130000.0,39000.0,-68.0,-70.0,-67.0,-60.0,-69.0,-73.0,-67.0,-63.0,-77.0,-85.0,-77.0,-85.0,9.0,15.0,10.0,25.0,1
6954,CC:2F:71:3F:1F:24,10037147,10831602525,6817182,10424894659,3219965,406707866,88,1560382,916239298,1551805,915209286,8577,1030012,1506665,619,6821902,697434,88,6077,130000.0,43333.0,-68.0,-63.0,-70.0,-68.0,-68.0,-63.0,-69.0,-68.0,-77.0,-85.0,-77.0,-85.0,9.0,22.0,7.0,17.0,1
6955,F8:59:71:5A:E0:3D,3419081,704231381,199116,297523515,3219965,406707866,0,197401,255405586,192553,254826336,4848,579250,174863,16,201831,3332,0,562,130000.0,39000.0,-66.0,-73.0,-63.0,-70.0,-67.0,-74.0,-65.0,-70.0,-77.0,-85.0,-77.0,-85.0,11.0,12.0,14.0,15.0,1
6956,CC:2F:71:3E:C5:1F,3231416,408108679,11451,1400813,3219965,406707866,6,48837,4090535,40351,3085033,8486,1005502,12075,34,16415,186,6,832,130000.0,39000.0,-68.0,-70.0,-67.0,-60.0,-69.0,-73.0,-67.0,-63.0,-77.0,-85.0,-77.0,-85.0,9.0,15.0,10.0,25.0,1
6957,CC:2F:71:3F:1F:24,10037770,10832546899,6817805,10425839033,3219965,406707866,88,1560499,916254110,1551922,915224098,8577,1030012,1506782,619,6822525,697508,88,6077,130000.0,39000.0,-68.0,-63.0,-69.0,-68.0,-68.0,-63.0,-69.0,-68.0,-77.0,-85.0,-77.0,-85.0,9.0,22.0,8.0,17.0,1
6958,F8:59:71:5A:E0:3D,3419090,704232249,199116,297523515,3219974,406708734,0,197401,255405586,192553,254826336,4848,579250,174863,16,201831,3332,0,562,130000.0,39000.0,-66.0,-73.0,-63.0,-70.0,-67.0,-74.0,-65.0,-70.0,-77.0,-85.0,-77.0,-85.0,11.0,12.0,14.0,15.0,1
6959,CC:2F:71:3E:C5:1F,3231425,408109547,11451,1400813,3219974,406708734,6,48837,4090535,40351,3085033,8486,1005502,12075,34,16415,186,6,832,130000.0,39000.0,-68.0,-70.0,-67.0,-60.0,-69.0,-73.0,-67.0,-63.0,-77.0,-85.0,-77.0,-85.0,9.0,15.0,10.0,25.0,1
6960,CC:2F:71:3F:1F:24,10038550,10833715140,6818576,10427006406,3219974,406708734,88,1560646,916272872,1552069,915242860,8577,1030012,1506927,619,6823296,697530,88,6077,130000.0,43333.0,-68.0,-63.0,-69.0,-68.0,-68.0,-63.0,-69.0,-68.0,-77.0,-85.0,-77.0,-85.0,9.0,22.0,8.0,17.0,1
6961,F8:59:71:5A:E0:3D,3419090,704232249,199116,297523515,3219974,406708734,0,197401,255405586,192553,254826336,4848,579250,174863,16,201831,3332,0,562,130000.0,39000.0,-66.0,-73.0,-63.0,-70.0,-67.0,-74.0,-65.0,-70.0,-77.0,-85.0,-77.0,-85.0,11.0,12.0,14.0,15.0,1
6962,CC:2F:71:3E:C5:1F,3231425,408109547,11451,1400813,3219974,406708734,6,48837,4090535,40351,3085033,8486,1005502,12075,34,16415,186,6,832,130000.0,39000.0,-68.0,-70.0,-67.0,-60.0,-69.0,-73.0,-67.0,-63.0,-77.0,-85.0,-77.0,-85.0,9.0,15.0,10.0,25.0,1
6963,CC:2F:71:3F:1F:24,10039323,10834892615,6819349,10428183881,3219974,406708734,88,1560800,916291884,1552223,915261872,8577,1030012,1507079,619,6824069,697576,88,6077,130000.0,43333.0,-66.0,-63.0,-68.0,-67.0,-66.0,-63.0,-68.0,-67.0,-77.0,-85.0,-77.0,-85.0,11.0,22.0,9.0,18.0,1
6964,F8:59:71:5A:E0:3D,3419096,704232855,199116,297523515,3219980,406709340,0,197401,255405586,192553,254826336,4848,579250,174863,16,201831,3332,0,562,130000.0,39000.0,-66.0,-73.0,-63.0,-70.0,-67.0,-74.0,-65.0,-70.0,-77.0,-85.0,-77.0,-85.0,11.0,12.0,14.0,15.0,1
6965,CC:2F:71:3E:C5:1F,3231433,408110355,11451,1400813,3219982,406709542,6,48837,4090535,40351,3085033,8486,1005502,12075,34,16415,186,6,832,130000.0,39000.0,-68.0,-70.0,-67.0,-60.0,-69.0,-73.0,-67.0,-63.0,-77.0,-85.0,-77.0,-85.0,9.0,15.0,10.0,25.0,1
6966,CC:2F:71:3F:1F:24,10039990,10835894733,6820008,10429185191,3219982,406709542,88,1560924,916307428,1552347,915277416,8577,1030012,1507201,619,6824728,697597,88,6077,144444.0,43333.0,-67.0,-65.0,-68.0,-67.0,-67.0,-65.0,-67.0,-67.0,-77.0,-85.0,-77.0,-85.0,10.0,20.0,9.0,18.0,1
6967,F8:59:71:5A:E0:3D,3419100,704233390,199116,297523515,3219984,406709875,0,197401,255405586,192553,254826336,4848,579250,174863,16,201831,3332,0,562,130000.0,39000.0,-66.0,-73.0,-63.0,-70.0,-67.0,-74.0,-65.0,-70.0,-77.0,-85.0,-77.0,-85.0,11.0,12.0,14.0,15.0,1
6968,CC:2F:71:3E:C5:1F,3231435,408110688,11451,1400813,3219984,406709875,6,48837,4090535,40351,3085033,8486,1005502,12075,34,16415,186,6,832,130000.0,39000.0,-68.0,-70.0,-67.0,-60.0,-69.0,-73.0,-67.0,-63.0,-77.0,-85.0,-77.0,-85.0,9.0,15.0,10.0,25.0,1
6969,CC:2F:71:3F:1F:24,10041175,10837723288,6821191,10431013413,3219984,406709875,88,1561115,916330754,1552538,915300742,8577,1030012,1507392,619,6825911,697624,88,6077,144444.0,43333.0,-68.0,-65.0,-68.0,-67.0,-68.0,-65.0,-68.0,-67.0,-77.0,-85.0,-77.0,-85.0,9.0,20.0,9.0,18.0,1
6970,F8:59:71:5A:E0:3D,3419104,704233794,199116,297523515,3219988,406710279,0,197401,255405586,192553,254826336,4848,579250,174863,16,201831,3332,0,562,130000.0,39000.0,-66.0,-73.0,-63.0,-70.0,-67.0,-74.0,-65.0,-70.0,-77.0,-85.0,-77.0,-85.0,11.0,12.0,14.0,15.0,1
6971,CC:2F:71:3E:C5:1F,3231441,408111294,11451,1400813,3219990,406710481,6,48837,4090535,40351,3085033,8486,1005502,12075,34,16415,186,6,832,130000.0,39000.0,-68.0,-70.0,-67.0,-60.0,-69.0,-73.0,-67.0,-63.0,-77.0,-85.0,-77.0,-85.0,9.0,15.0,10.0,25.0,1
6972,CC:2F:71:3F:1F:24,10042766,10840184966,6822774,10433474283,3219992,406710683,88,1561293,916352522,1552716,915322510,8577,1030012,1507570,619,6827458,697721,88,6077,144444.0,43333.0,-67.0,-65.0,-68.0,-67.0,-67.0,-65.0,-68.0,-67.0,-77.0,-85.0,-77.0,-85.0,10.0,20.0,9.0,18.0,1
6973,F8:59:71:5A:E0:3D,3419108,704234198,199116,297523515,3219992,406710683,0,197401,255405586,192553,254826336,4848,579250,174863,16,201831,3332,0,562,130000.0,39000.0,-66.0,-73.0,-63.0,-70.0,-67.0,-74.0,-65.0,-70.0,-77.0,-85.0,-77.0,-85.0,11.0,12.0,14.0,15.0,1
6974,CC:2F:71:3E:C5:1F,3231443,408111496,11451,1400813,3219992,406710683,6,48837,4090535,40351,3085033,8486,1005502,12075,34,16415,186,6,832,130000.0,39000.0,-68.0,-70.0,-67.0,-60.0,-69.0,-73.0,-67.0,-63.0,-77.0,-85.0,-77.0,-85.0,9.0,15.0,10.0,25.0,1
6975,CC:2F:71:3F:1F:24,10044298,10842556338,6824306,10435845655,3219992,406710683,88,1561496,916377823,1552919,915347811,8577,1030012,1507773,619,6829026,697765,88,6077,144444.0,43333.0,-67.0,-64.0,-68.0,-67.0,-67.0,-64.0,-68.0,-66.0,-77.0,-85.0,-77.0,-85.0,10.0,21.0,9.0,18.0,1
6976,F8:59:71:5A:E0:3D,3419111,704234460,199116,297523515,3219995,406710945,0,197401,255405586,192553,254826336,4848,579250,174863,16,201831,3332,0,562,130000.0,39000.0,-66.0,-73.0,-63.0,-70.0,-67.0,-74.0,-65.0,-70.0,-77.0,-85.0,-77.0,-85.0,11.0,12.0,14.0,15.0,1
6977,CC:2F:71:3E:C5:1F,3231446,408111758,11451,1400813,3219995,406710945,6,48837,4090535,40351,3085033,8486,1005502,12075,34,16415,186,6,832,130000.0,39000.0,-68.0,-70.0,-67.0,-60.0,-69.0,-73.0,-67.0,-63.0,-77.0,-85.0,-77.0,-85.0,9.0,15.0,10.0,25.0,1
6978,CC:2F:71:3F:1F:24,10046152,10845435972,6826155,10438724825,3219997,406711147,88,1561716,916404553,1553139,915374541,8577,1030012,1507993,619,6830875,697850,88,6077,144444.0,43333.0,-67.0,-64.0,-68.0,-66.0,-66.0,-64.0,-68.0,-66.0,-77.0,-85.0,-77.0,-85.0,10.0,21.0,9.0,19.0,1
6979,F8:59:71:5A:E0:3D,3419117,704235066,199116,297523515,3220001,406711551,0,197401,255405586,192553,254826336,4848,579250,174863,16,201831,3332,0,562,130000.0,39000.0,-66.0,-73.0,-63.0,-70.0,-67.0,-74.0,-65.0,-70.0,-77.0,-85.0,-77.0,-85.0,11.0,12.0,14.0,15.0,1
6980,CC:2F:71:3E:C5:1F,3231452,408112364,11451,1400813,3220001,406711551,6,48837,4090535,40351,3085033,8486,1005502,12075,34,16415,186,6,832,130000.0,39000.0,-68.0,-70.0,-67.0,-60.0,-69.0,-73.0,-67.0,-63.0,-77.0,-85.0,-77.0,-85.0,9.0,15.0,10.0,25.0,1
6981,CC:2F:71:3F:1F:24,10047947,10848221112,6827946,10441509561,3220001,406711551,88,1561941,916431983,1553364,915401971,8577,1030012,1508218,619,6832666,697879,88,6077,144444.0,43333.0,-67.0,-63.0,-69.0,-68.0,-67.0,-63.0,-68.0,-68.0,-77.0,-85.0,-77.0,-85.0,10.0,22.0,8.0,17.0,1
6982,F8:59:71:5A:E0:3D,3419120,704235384,199117,297523631,3220003,406711753,0,197403,255405726,192555,254826476,4848,579250,174863,16,201832,3332,0,562,130000.0,39000.0,-65.0,-71.0,-64.0,-71.0,-67.0,-73.0,-65.0,-69.0,-77.0,-85.0,-77.0,-85.0,12.0,14.0,13.0,14.0,1
6983,CC:2F:71:3E:C5:1F,3231455,408112682,11452,1400929,3220003,406711753,6,48839,4090675,40353,3085173,8486,1005502,12075,34,16416,186,6,832,130000.0,39000.0,-64.0,-68.0,-62.0,-60.0,-68.0,-72.0,-67.0,-63.0,-77.0,-85.0,-77.0,-85.0,13.0,17.0,15.0,25.0,1
6984,CC:2F:71:3F:1F:24,10049558,10850721708,6829555,10444009955,3220003,406711753,88,1562123,916454281,1553546,915424269,8577,1030012,1508400,619,6834275,698421,88,6077,130000.0,43333.0,-68.0,-63.0,-70.0,-70.0,-67.0,-63.0,-69.0,-69.0,-77.0,-85.0,-77.0,-85.0,9.0,22.0,7.0,15.0,1
6985,F8:59:71:5A:E0:3D,3419128,704236112,199117,297523631,3220011,406712481,0,197403,255405726,192555,254826476,4848,579250,174863,16,201832,3332,0,562,130000.0,39000.0,-65.0,-71.0,-64.0,-71.0,-67.0,-73.0,-65.0,-69.0,-77.0,-85.0,-77.0,-85.0,12.0,14.0,13.0,14.0,1
6986,CC:2F:71:3E:C5:1F,3231463,408113410,11452,1400929,3220011,406712481,6,48839,4090675,40353,3085173,8486,1005502,12075,34,16416,186,6,832,130000.0,39000.0,-64.0,-68.0,-62.0,-60.0,-68.0,-72.0,-67.0,-63.0,-77.0,-85.0,-77.0,-85.0,13.0,17.0,15.0,25.0,1
6987,CC:2F:71:3F:1F:24,10050893,10852769665,6830882,10446057184,3220011,406712481,88,1562304,916477235,1553726,915447105,8578,1030130,1508581,619,6835602,698451,88,6077,130000.0,43333.0,-67.0,-63.0,-71.0,-69.0,-68.0,-63.0,-70.0,-68.0,-77.0,-85.0,-77.0,-85.0,10.0,22.0,6.0,16.0,1
6988,F8:59:71:5A:E0:3D,3419130,704236314,199117,297523631,3220013,406712683,0,197403,255405726,192555,254826476,4848,579250,174863,16,201832,3332,0,562,130000.0,39000.0,-65.0,-71.0,-64.0,-71.0,-67.0,-73.0,-65.0,-69.0,-77.0,-85.0,-77.0,-85.0,12.0,14.0,13.0,14.0,1
6989,CC:2F:71:3E:C5:1F,3231465,408113612,11452,1400929,3220013,406712683,6,48839,4090675,40353,3085173,8486,1005502,12075,34,16416,186,6,832,130000.0,39000.0,-64.0,-68.0,-62.0,-60.0,-68.0,-72.0,-67.0,-63.0,-77.0,-85.0,-77.0,-85.0,13.0,17.0,15.0,25.0,1
6990,CC:2F:71:3F:1F:24,10051618,10853872209,6831605,10447159526,3220013,406712683,88,1562446,916494887,1553868,915464757,8578,1030130,1508723,619,6836325,698495,88,6077,130000.0,43333.0,-68.0,-63.0,-70.0,-69.0,-68.0,-63.0,-69.0,-69.0,-77.0,-85.0,-77.0,-85.0,9.0,22.0,7.0,16.0,1
6991,F8:59:71:5A:E0:3D,3419136,704236920,199117,297523631,3220019,406713289,0,197403,255405726,192555,254826476,4848,579250,174863,16,201832,3332,0,562,130000.0,39000.0,-65.0,-71.0,-64.0,-71.0,-67.0,-73.0,-65.0,-69.0,-77.0,-85.0,-77.0,-85.0,12.0,14.0,13.0,14.0,1
6992,CC:2F:71:3E:C5:1F,3231472,408114278,11452,1400929,3220020,406713349,6,48839,4090675,40353,3085173,8486,1005502,12075,34,16416,186,6,832,130000.0,39000.0,-64.0,-68.0,-62.0,-60.0,-68.0,-72.0,-67.0,-63.0,-77.0,-85.0,-77.0,-85.0,13.0,17.0,15.0,25.0,1
6993,CC:2F:71:3F:1F:24,10052713,10855549347,6832693,10448835998,3220020,406713349,88,1562579,916511477,1554001,915481347,8578,1030130,1508856,619,6837413,698700,88,6077,130000.0,43333.0,-67.0,-63.0,-70.0,-69.0,-67.0,-63.0,-69.0,-68.0,-77.0,-85.0,-77.0,-85.0,10.0,22.0,7.0,16.0,1
6994,F8:59:71:5A:E0:3D,3419137,704236980,199117,297523631,3220020,406713349,0,197403,255405726,192555,254826476,4848,579250,174863,16,201832,3332,0,562,130000.0,39000.0,-65.0,-71.0,-64.0,-71.0,-67.0,-73.0,-65.0,-69.0,-77.0,-85.0,-77.0,-85.0,12.0,14.0,13.0,14.0,1
6995,CC:2F:71:3E:C5:1F,3231472,408114278,11452,1400929,3220020,406713349,6,48839,4090675,40353,3085173,8486,1005502,12075,34,16416,186,6,832,130000.0,39000.0,-64.0,-68.0,-62.0,-60.0,-68.0,-72.0,-67.0,-63.0,-77.0,-85.0,-77.0,-85.0,13.0,17.0,15.0,25.0,1
6996,CC:2F:71:3F:1F:24,10053783,10857194853,6833761,10450481302,3220022,406713551,88,1562770,916534789,1554192,915504659,8578,1030130,1509047,619,6838481,698724,88,6077,130000.0,43333.0,-68.0,-63.0,-70.0,-69.0,-67.0,-63.0,-69.0,-69.0,-77.0,-85.0,-77.0,-85.0,9.0,22.0,7.0,16.0,1
6997,F8:59:71:5A:E0:3D,3419144,704237648,199117,297523631,3220027,406714017,0,197405,255405914,192556,254826546,4849,579368,174864,16,201832,3332,0,562,130000.0,39000.0,-65.0,-71.0,-63.0,-71.0,-66.0,-72.0,-63.0,-68.0,-77.0,-85.0,-77.0,-85.0,12.0,14.0,14.0,14.0,1
6998,CC:2F:71:3E:C5:1F,3231479,408114946,11452,1400929,3220027,406714017,6,48839,4090675,40353,3085173,8486,1005502,12075,34,16416,186,6,832,130000.0,39000.0,-64.0,-68.0,-62.0,-60.0,-68.0,-72.0,-67.0,-63.0,-77.0,-85.0,-77.0,-85.0,13.0,17.0,15.0,25.0,1
6999,CC:2F:71:3F:1F:24,10054793,10858735157,6834766,10452021140,3220027,406714017,88,1562915,916553317,1554337,915523187,8578,1030130,1509192,619,6839470,698770,88,6077,130000.0,39000.0,-67.0,-63.0,-69.0,-69.0,-67.0,-63.0,-68.0,-68.0,-77.0,-85.0,-77.0,-85.0,10.0,22.0,8.0,16.0,1
7000,F8:59:71:5A:E0:3D,3419148,704237972,199117,297523631,3220031,406714341,0,197405,255405914,192556,254826546,4849,579368,174864,16,201832,3332,0,562,130000.0,39000.0,-65.0,-71.0,-63.0,-71.0,-66.0,-72.0,-63.0,-68.0,-77.0,-85.0,-77.0,-85.0,12.0,14.0,14.0,14.0,1
7001,CC:2F:71:3E:C5:1F,3231483,408115270,11452,1400929,3220031,406714341,6,48843,4091003,40356,3085383,8487,1005620,12076,34,16417,186,6,832,130000.0,39000.0,-69.0,-70.0,-67.0,-60.0,-68.0,-71.0,-66.0,-61.0,-77.0,-85.0,-77.0,-85.0,8.0,15.0,10.0,25.0,1
7002,CC:2F:71:3F:1F:24,10055705,10860129585,6835674,10453415244,3220031,406714341,88,1563045,916569595,1554467,915539465,8578,1030130,1509322,619,6840394,698801,88,6077,130000.0,43333.0,-68.0,-63.0,-69.0,-69.0,-67.0,-63.0,-69.0,-68.0,-77.0,-85.0,-77.0,-85.0,9.0,22.0,8.0,16.0,1
7003,F8:59:71:5A:E0:3D,3419152,704238376,199117,297523631,3220035,406714745,0,197405,255405914,192556,254826546,4849,579368,174864,16,201832,3332,0,562,130000.0,39000.0,-65.0,-71.0,-63.0,-71.0,-66.0,-72.0,-63.0,-68.0,-77.0,-85.0,-77.0,-85.0,12.0,14.0,14.0,14.0,1
7004,CC:2F:71:3E:C5:1F,3231489,408115876,11452,1400929,3220037,406714947,6,48843,4091003,40356,3085383,8487,1005620,12076,34,16417,186,6,832,130000.0,39000.0,-69.0,-70.0,-67.0,-60.0,-68.0,-71.0,-66.0,-61.0,-77.0,-85.0,-77.0,-85.0,8.0,15.0,10.0,25.0,1
7005,CC:2F:71:3F:1F:24,10056826,10861849437,6836789,10455134490,3220037,406714947,88,1563188,916587351,1554610,915557221,8578,1030130,1509465,619,6841509,698858,88,6077,130000.0,43333.0,-67.0,-63.0,-69.0,-69.0,-67.0,-63.0,-69.0,-68.0,-77.0,-85.0,-77.0,-85.0,10.0,22.0,8.0,16.0,1
7006,F8:59:71:5A:E0:3D,3419156,704238780,199117,297523631,3220039,406715149,0,197405,255405914,192556,254826546,4849,579368,174864,16,201832,3332,0,562,130000.0,39000.0,-65.0,-71.0,-63.0,-71.0,-66.0,-72.0,-63.0,-68.0,-77.0,-85.0,-77.0,-85.0,12.0,14.0,14.0,14.0,1
7007,CC:2F:71:3E:C5:1F,3231491,408116078,11452,1400929,3220039,406715149,6,48843,4091003,40356,3085383,8487,1005620,12076,34,16417,186,6,832,130000.0,39000.0,-69.0,-70.0,-67.0,-60.0,-68.0,-71.0,-66.0,-61.0,-77.0,-85.0,-77.0,-85.0,8.0,15.0,10.0,25.0,1
7008,CC:2F:71:3F:1F:24,10058085,10863793017,6838046,10457077868,3220039,406715149,88,1563358,916608191,1554780,915578061,8578,1030130,1509635,619,6842729,698929,88,6077,130000.0,43333.0,-68.0,-63.0,-68.0,-69.0,-67.0,-63.0,-68.0,-68.0,-77.0,-85.0,-77.0,-85.0,9.0,22.0,9.0,16.0,1
7009,F8:59:71:5A:E0:3D,3419162,704239517,199117,297523631,3220045,406715886,0,197405,255405914,192556,254826546,4849,579368,174864,16,201832,3332,0,562,130000.0,39000.0,-65.0,-71.0,-63.0,-71.0,-66.0,-72.0,-63.0,-68.0,-77.0,-85.0,-77.0,-85.0,12.0,14.0,14.0,14.0,1
7010,CC:2F:71:3E:C5:1F,3231497,408116815,11452,1400929,3220045,406715886,6,48843,4091003,40356,3085383,8487,1005620,12076,34,16417,186,6,832,130000.0,39000.0,-69.0,-70.0,-67.0,-60.0,-68.0,-71.0,-66.0,-61.0,-77.0,-85.0,-77.0,-85.0,8.0,15.0,10.0,25.0,1
7011,CC:2F:71:3F:1F:24,10059676,10866248760,6839631,10459532874,3220045,406715886,88,1563595,916637453,1555017,915607323,8578,1030130,1509870,619,6844351,698956,88,6077,130000.0,43333.0,-68.0,-63.0,-69.0,-69.0,-67.0,-63.0,-69.0,-68.0,-77.0,-85.0,-77.0,-85.0,9.0,22.0,8.0,16.0,1
7012,F8:59:71:5A:E0:3D,3419166,704239921,199117,297523631,3220049,406716290,0,197405,255405914,192556,254826546,4849,579368,174864,16,201832,3332,0,562,130000.0,39000.0,-65.0,-71.0,-63.0,-71.0,-66.0,-72.0,-63.0,-68.0,-77.0,-85.0,-77.0,-85.0,12.0,14.0,14.0,14.0,1
7013,CC:2F:71:3E:C5:1F,3231501,408117219,11452,1400929,3220049,406716290,6,48843,4091003,40356,3085383,8487,1005620,12076,34,16417,186,6,832,130000.0,39000.0,-69.0,-70.0,-67.0,-60.0,-68.0,-71.0,-66.0,-61.0,-77.0,-85.0,-77.0,-85.0,8.0,15.0,10.0,25.0,1
7014,CC:2F:71:3F:1F:24,10060692,10867807548,6840643,10461091258,3220049,406716290,88,1563756,916657333,1555178,915627203,8578,1030130,1510031,619,6845363,698958,88,6077,130000.0,43333.0,-68.0,-63.0,-68.0,-68.0,-67.0,-63.0,-68.0,-68.0,-77.0,-85.0,-77.0,-85.0,9.0,22.0,9.0,17.0,1
7015,F8:59:71:5A:E0:3D,3419168,704240123,199117,297523631,3220051,406716492,0,197405,255405914,192556,254826546,4849,579368,174864,16,201832,3332,0,562,130000.0,39000.0,-65.0,-71.0,-63.0,-71.0,-66.0,-72.0,-63.0,-68.0,-77.0,-85.0,-77.0,-85.0,12.0,14.0,14.0,14.0,1
7016,CC:2F:71:3E:C5:1F,3231503,408117421,11452,1400929,3220051,406716492,6,48843,4091003,40356,3085383,8487,1005620,12076,34,16417,186,6,832,130000.0,39000.0,-69.0,-70.0,-67.0,-60.0,-68.0,-71.0,-66.0,-61.0,-77.0,-85.0,-77.0,-85.0,8.0,15.0,10.0,25.0,1
7017,CC:2F:71:3F:1F:24,10061697,10869347362,6841644,10462630668,3220053,406716694,88,1563885,916673441,1555307,915643311,8578,1030130,1510160,619,6846344,698979,88,6077,144444.0,43333.0,-68.0,-63.0,-70.0,-68.0,-68.0,-63.0,-69.0,-68.0,-77.0,-85.0,-77.0,-85.0,9.0,22.0,7.0,17.0,1
7018,F8:59:71:5A:E0:3D,3419175,704240789,199117,297523631,3220058,406717158,0,197405,255405914,192556,254826546,4849,579368,174864,16,201832,3332,0,562,130000.0,39000.0,-65.0,-71.0,-63.0,-71.0,-66.0,-72.0,-63.0,-68.0,-77.0,-85.0,-77.0,-85.0,12.0,14.0,14.0,14.0,1
7019,CC:2F:71:3E:C5:1F,3231510,408118087,11452,1400929,3220058,406717158,6,48843,4091003,40356,3085383,8487,1005620,12076,34,16417,186,6,832,130000.0,39000.0,-69.0,-70.0,-67.0,-60.0,-68.0,-71.0,-66.0,-61.0,-77.0,-85.0,-77.0,-85.0,8.0,15.0,10.0,25.0,1
7020,CC:2F:71:3F:1F:24,10062642,10870792442,6842584,10464075284,3220058,406717158,88,1564057,916694609,1555479,915664479,8578,1030130,1510332,619,6847304,699043,88,6077,130000.0,43333.0,-68.0,-63.0,-70.0,-68.0,-67.0,-63.0,-69.0,-68.0,-77.0,-85.0,-77.0,-85.0,9.0,22.0,7.0,17.0,1
7021,F8:59:71:5A:E0:3D,3419177,704240991,199117,297523631,3220060,406717360,0,197405,255405914,192556,254826546,4849,579368,174864,16,201832,3332,0,562,130000.0,39000.0,-65.0,-71.0,-63.0,-71.0,-66.0,-72.0,-63.0,-68.0,-77.0,-85.0,-77.0,-85.0,12.0,14.0,14.0,14.0,1
7022,CC:2F:71:3E:C5:1F,3231512,408118289,11452,1400929,3220060,406717360,6,48843,4091003,40356,3085383,8487,1005620,12076,34,16417,186,6,832,130000.0,39000.0,-69.0,-70.0,-67.0,-60.0,-68.0,-71.0,-66.0,-61.0,-77.0,-85.0,-77.0,-85.0,8.0,15.0,10.0,25.0,1
7023,CC:2F:71:3F:1F:24,10063701,10872396694,6843641,10465679334,3220060,406717360,88,1564233,916718598,1555655,915688468,8578,1030130,1510508,619,6848361,699080,88,6077,130000.0,43333.0,-68.0,-63.0,-70.0,-68.0,-67.0,-63.0,-69.0,-68.0,-77.0,-85.0,-77.0,-85.0,9.0,22.0,7.0,17.0,1
7024,F8:59:71:5A:E0:3D,3419185,704241965,199117,297523631,3220068,406718334,0,197405,255405914,192556,254826546,4849,579368,174864,16,201832,3332,0,562,130000.0,39000.0,-65.0,-71.0,-63.0,-71.0,-66.0,-72.0,-63.0,-68.0,-77.0,-85.0,-77.0,-85.0,12.0,14.0,14.0,14.0,1
7025,CC:2F:71:3E:C5:1F,3231520,408119263,11452,1400929,3220068,406718334,6,48843,4091003,40356,3085383,8487,1005620,12076,34,16417,186,6,832,130000.0,39000.0,-69.0,-70.0,-67.0,-60.0,-68.0,-71.0,-66.0,-61.0,-77.0,-85.0,-77.0,-85.0,8.0,15.0,10.0,25.0,1
7026,CC:2F:71:3F:1F:24,10065043,10874454924,6844975,10467736590,3220068,406718334,88,1564413,916741041,1555835,915710911,8578,1030130,1510688,619,6849695,699149,88,6077,130000.0,43333.0,-68.0,-63.0,-70.0,-68.0,-68.0,-63.0,-70.0,-68.0,-77.0,-85.0,-77.0,-85.0,9.0,22.0,7.0,17.0,1
7027,F8:59:71:5A:E0:3D,3419188,704242227,199117,297523631,3220071,406718596,0,197405,255405914,192556,254826546,4849,579368,174864,16,201832,3332,0,562,130000.0,39000.0,-65.0,-71.0,-63.0,-71.0,-66.0,-72.0,-63.0,-68.0,-77.0,-85.0,-77.0,-85.0,12.0,14.0,14.0,14.0,1
7028,CC:2F:71:3E:C5:1F,3231523,408119525,11452,1400929,3220071,406718596,6,48843,4091003,40356,3085383,8487,1005620,12076,34,16417,186,6,832,130000.0,39000.0,-69.0,-70.0,-67.0,-60.0,-68.0,-71.0,-66.0,-61.0,-77.0,-85.0,-77.0,-85.0,8.0,15.0,10.0,25.0,1
7029,CC:2F:71:3F:1F:24,10066078,10876045130,6846007,10469326534,3220071,406718596,88,1564585,916762281,1556007,915732151,8578,1030130,1510860,619,6850727,699192,88,6077,130000.0,43333.0,-68.0,-63.0,-69.0,-68.0,-68.0,-63.0,-69.0,-68.0,-77.0,-85.0,-77.0,-85.0,9.0,22.0,8.0,17.0,1
7030,F8:59:71:5A:E0:3D,3419192,704242631,199117,297523631,3220075,406719000,0,197405,255405914,192556,254826546,4849,579368,174864,16,201832,3332,0,562,130000.0,39000.0,-65.0,-71.0,-63.0,-71.0,-66.0,-72.0,-63.0,-68.0,-77.0,-85.0,-77.0,-85.0,12.0,14.0,14.0,14.0,1
7031,CC:2F:71:3E:C5:1F,3231529,408120131,11452,1400929,3220077,406719202,6,48843,4091003,40356,3085383,8487,1005620,12076,34,16417,186,6,832,130000.0,39000.0,-69.0,-70.0,-67.0,-60.0,-68.0,-71.0,-66.0,-61.0,-77.0,-85.0,-77.0,-85.0,8.0,15.0,10.0,25.0,1
7032,CC:2F:71:3F:1F:24,10066839,10877198574,6846762,10470479372,3220077,406719202,88,1564731,916780385,1556153,915750255,8578,1030130,1511006,619,6851482,699198,88,6077,130000.0,43333.0,-68.0,-63.0,-70.0,-68.0,-67.0,-63.0,-69.0,-68.0,-77.0,-85.0,-77.0,-85.0,9.0,22.0,7.0,17.0,1
7033,F8:59:71:5A:E0:3D,3419196,704243035,199117,297523631,3220079,406719404,0,197405,255405914,192556,254826546,4849,579368,174864,16,201832,3332,0,562,130000.0,39000.0,-65.0,-71.0,-63.0,-71.0,-66.0,-72.0,-63.0,-68.0,-77.0,-85.0,-77.0,-85.0,12.0,14.0,14.0,14.0,1
7034,CC:2F:71:3E:C5:1F,3231531,408120333,11452,1400929,3220079,406719404,6,48843,4091003,40356,3085383,8487,1005620,12076,34,16417,186,6,832,130000.0,39000.0,-69.0,-70.0,-67.0,-60.0,-68.0,-71.0,-66.0,-61.0,-77.0,-85.0,-77.0,-85.0,8.0,15.0,10.0,25.0,1
7035,CC:2F:71:3F:1F:24,10067894,10878821634,6847815,10472102230,3220079,406719404,88,1564907,916801997,1556329,915771867,8578,1030130,1511182,619,6852535,699274,88,6077,130000.0,43333.0,-68.0,-63.0,-70.0,-68.0,-68.0,-63.0,-69.0,-68.0,-77.0,-85.0,-77.0,-85.0,9.0,22.0,7.0,17.0,1
7036,F8:59:71:5A:E0:3D,3419199,704243297,199117,297523631,3220082,406719666,0,197405,255405914,192556,254826546,4849,579368,174864,16,201832,3332,0,562,130000.0,39000.0,-65.0,-71.0,-63.0,-71.0,-66.0,-72.0,-63.0,-68.0,-77.0,-85.0,-77.0,-85.0,12.0,14.0,14.0,14.0,1
7037,CC:2F:71:3E:C5:1F,3231534,408120595,11452,1400929,3220082,406719666,6,48843,4091003,40356,3085383,8487,1005620,12076,34,16417,186,6,832,130000.0,39000.0,-69.0,-70.0,-67.0,-60.0,-68.0,-71.0,-66.0,-61.0,-77.0,-85.0,-77.0,-85.0,8.0,15.0,10.0,25.0,1
7038,CC:2F:71:3F:1F:24,10068801,10880202284,6848719,10473482618,3220082,406719666,88,1565093,916825228,1556515,915795098,8578,1030130,1511368,619,6853439,699289,88,6077,130000.0,43333.0,-66.0,-63.0,-69.0,-68.0,-66.0,-63.0,-68.0,-67.0,-77.0,-85.0,-77.0,-85.0,11.0,22.0,8.0,17.0,1
7039,F8:59:71:5A:E0:3D,3419203,704243701,199117,297523631,3220086,406720070,0,197405,255405914,192556,254826546,4849,579368,174864,16,201832,3332,0,562,130000.0,39000.0,-65.0,-71.0,-63.0,-71.0,-66.0,-72.0,-63.0,-68.0,-77.0,-85.0,-77.0,-85.0,12.0,14.0,14.0,14.0,1
7040,CC:2F:71:3E:C5:1F,3231538,408120999,11452,1400929,3220086,406720070,6,48843,4091003,40356,3085383,8487,1005620,12076,34,16417,186,6,832,130000.0,39000.0,-69.0,-70.0,-67.0,-60.0,-68.0,-71.0,-66.0,-61.0,-77.0,-85.0,-77.0,-85.0,8.0,15.0,10.0,25.0,1
7041,CC:2F:71:3F:1F:24,10070343,10882587754,6850255,10475867482,3220088,406720272,88,1565330,916853888,1556752,915823758,8578,1030130,1511605,619,6854962,699524,88,6077,130000.0,39000.0,-68.0,-64.0,-70.0,-69.0,-67.0,-63.0,-69.0,-69.0,-77.0,-85.0,-77.0,-85.0,9.0,21.0,7.0,16.0,1
7042,F8:59:71:5A:E0:3D,3419205,704243903,199117,297523631,3220088,406720272,0,197405,255405914,192556,254826546,4849,579368,174864,16,201832,3332,0,562,130000.0,39000.0,-65.0,-71.0,-63.0,-71.0,-66.0,-72.0,-63.0,-68.0,-77.0,-85.0,-77.0,-85.0,12.0,14.0,14.0,14.0,1
7043,CC:2F:71:3E:C5:1F,3231542,408121403,11452,1400929,3220090,406720474,6,48843,4091003,40356,3085383,8487,1005620,12076,34,16417,186,6,832,130000.0,39000.0,-69.0,-70.0,-67.0,-60.0,-68.0,-71.0,-66.0,-61.0,-77.0,-85.0,-77.0,-85.0,8.0,15.0,10.0,25.0,1
7044,CC:2F:71:3F:1F:24,10071421,10884247052,6851331,10477526578,3220090,406720474,88,1565543,916879788,1556965,915849658,8578,1030130,1511818,619,6856051,699770,88,6077,130000.0,43333.0,-67.0,-64.0,-70.0,-69.0,-67.0,-63.0,-69.0,-68.0,-77.0,-85.0,-77.0,-85.0,10.0,21.0,7.0,16.0,1
7045,F8:59:71:5A:E0:3D,3419212,704244569,199117,297523631,3220095,406720938,0,197405,255405914,192556,254826546,4849,579368,174864,16,201832,3332,0,562,130000.0,39000.0,-65.0,-71.0,-63.0,-71.0,-66.0,-72.0,-63.0,-68.0,-77.0,-85.0,-77.0,-85.0,12.0,14.0,14.0,14.0,1
7046,CC:2F:71:3E:C5:1F,3231547,408121867,11452,1400929,3220095,406720938,6,48843,4091003,40356,3085383,8487,1005620,12076,34,16417,186,6,832,130000.0,39000.0,-69.0,-70.0,-67.0,-60.0,-68.0,-71.0,-66.0,-61.0,-77.0,-85.0,-77.0,-85.0,8.0,15.0,10.0,25.0,1
7047,CC:2F:71:3F:1F:24,10072615,10886085206,6852520,10479364268,3220095,406720938,88,1565729,916902570,1557151,915872440,8578,1030130,1512002,619,6857240,699809,88,6077,130000.0,43333.0,-67.0,-64.0,-70.0,-68.0,-66.0,-64.0,-69.0,-68.0,-77.0,-85.0,-77.0,-85.0,10.0,21.0,7.0,17.0,1
7048,F8:59:71:5A:E0:3D,3419216,704245895,199117,297523631,3220099,406722264,0,197405,255405914,192556,254826546,4849,579368,174864,16,201832,3332,0,562,130000.0,39000.0,-65.0,-71.0,-63.0,-71.0,-66.0,-72.0,-63.0,-68.0,-77.0,-85.0,-77.0,-85.0,12.0,14.0,14.0,14.0,1
7049,CC:2F:71:3E:C5:1F,3231551,408123193,11452,1400929,3220099,406722264,6,48843,4091003,40356,3085383,8487,1005620,12076,34,16417,186,6,832,130000.0,39000.0,-69.0,-70.0,-67.0,-60.0,-68.0,-71.0,-66.0,-61.0,-77.0,-85.0,-77.0,-85.0,8.0,15.0,10.0,25.0,1
7050,CC:2F:71:3F:1F:24,10073994,10888208710,6853895,10481486446,3220099,406722264,88,1565919,916926299,1557341,915896169,8578,1030130,1512192,619,6858615,699851,88,6077,130000.0,43333.0,-66.0,-64.0,-70.0,-69.0,-66.0,-64.0,-70.0,-68.0,-77.0,-85.0,-77.0,-85.0,11.0,21.0,7.0,16.0,1
7051,F8:59:71:5A:E0:3D,3419222,704246501,199117,297523631,3220105,406722870,0,197405,255405914,192556,254826546,4849,579368,174864,16,201832,3332,0,562,130000.0,39000.0,-65.0,-71.0,-63.0,-71.0,-66.0,-72.0,-63.0,-68.0,-77.0,-85.0,-77.0,-85.0,12.0,14.0,14.0,14.0,1
7052,CC:2F:71:3E:C5:1F,3231559,408124132,11452,1400929,3220107,406723203,6,48843,4091003,40356,3085383,8487,1005620,12076,34,16417,186,6,832,130000.0,39000.0,-69.0,-70.0,-67.0,-60.0,-68.0,-71.0,-66.0,-61.0,-77.0,-85.0,-77.0,-85.0,8.0,15.0,10.0,25.0,1
7053,CC:2F:71:3F:1F:24,10075487,10890512755,6855380,10483789552,3220107,406723203,88,1566093,916947763,1557515,915917633,8578,1030130,1512366,619,6860100,700026,88,6077,130000.0,43333.0,-67.0,-64.0,-70.0,-69.0,-66.0,-64.0,-70.0,-68.0,-77.0,-85.0,-77.0,-85.0,10.0,21.0,7.0,16.0,1
7054,F8:59:71:5A:E0:3D,3419229,704248286,199117,297523631,3220112,406724655,0,197405,255405914,192556,254826546,4849,579368,174864,16,201832,3332,0,562,130000.0,39000.0,-65.0,-71.0,-63.0,-71.0,-66.0,-72.0,-63.0,-68.0,-77.0,-85.0,-77.0,-85.0,12.0,14.0,14.0,14.0,1
7055,CC:2F:71:3E:C5:1F,3231564,408125584,11452,1400929,3220112,406724655,6,48843,4091003,40356,3085383,8487,1005620,12076,34,16417,186,6,832,130000.0,39000.0,-69.0,-70.0,-67.0,-60.0,-68.0,-71.0,-66.0,-61.0,-77.0,-85.0,-77.0,-85.0,8.0,15.0,10.0,25.0,1
7056,CC:2F:71:3F:1F:24,10076398,10891903651,6856286,10485178996,3220112,406724655,88,1566254,916967547,1557676,915937417,8578,1030130,1512527,619,6861006,700128,88,6077,130000.0,43333.0,-67.0,-64.0,-71.0,-68.0,-66.0,-64.0,-70.0,-68.0,-77.0,-85.0,-77.0,-85.0,10.0,21.0,6.0,17.0,1
7057,F8:59:71:5A:E0:3D,3419235,704248892,199117,297523631,3220118,406725261,0,197405,255405914,192556,254826546,4849,579368,174864,16,201832,3332,0,562,130000.0,39000.0,-65.0,-71.0,-63.0,-71.0,-66.0,-72.0,-63.0,-68.0,-77.0,-85.0,-77.0,-85.0,12.0,14.0,14.0,14.0,1
7058,CC:2F:71:3E:C5:1F,3231570,408126190,11452,1400929,3220118,406725261,6,48843,4091003,40356,3085383,8487,1005620,12076,34,16417,186,6,832,130000.0,39000.0,-69.0,-70.0,-67.0,-60.0,-68.0,-71.0,-66.0,-61.0,-77.0,-85.0,-77.0,-85.0,8.0,15.0,10.0,25.0,1
7059,CC:2F:71:3F:1F:24,10077683,10893881791,6857565,10487156530,3220118,406725261,88,1566498,916997015,1557920,915966885,8578,1030130,1512771,619,6862285,700374,88,6077,115556.0,28889.0,-67.0,-64.0,-70.0,-68.0,-66.0,-64.0,-70.0,-68.0,-77.0,-85.0,-77.0,-85.0,10.0,21.0,7.0,17.0,1
7060,F8:59:71:5A:E0:3D,3419240,704250278,199117,297523631,3220123,406726647,0,197405,255405914,192556,254826546,4849,579368,174864,16,201832,3332,0,562,130000.0,39000.0,-65.0,-71.0,-63.0,-71.0,-66.0,-72.0,-63.0,-68.0,-77.0,-85.0,-77.0,-85.0,12.0,14.0,14.0,14.0,1
7061,CC:2F:71:3E:C5:1F,3231575,408127576,11452,1400929,3220123,406726647,6,48843,4091003,40356,3085383,8487,1005620,12076,34,16417,186,6,832,130000.0,39000.0,-69.0,-70.0,-67.0,-60.0,-68.0,-71.0,-66.0,-61.0,-77.0,-85.0,-77.0,-85.0,8.0,15.0,10.0,25.0,1
7062,CC:2F:71:3F:1F:24,10079002,10895916669,6858879,10489190022,3220123,406726647,88,1566710,917022949,1558132,915992819,8578,1030130,1512983,619,6863597,700516,88,6077,115556.0,28889.0,-67.0,-64.0,-71.0,-68.0,-67.0,-64.0,-70.0,-68.0,-77.0,-85.0,-77.0,-85.0,10.0,21.0,6.0,17.0,1
7063,F8:59:71:5A:E0:3D,3419244,704250682,199117,297523631,3220127,406727051,0,197405,255405914,192556,254826546,4849,579368,174864,16,201832,3332,0,562,130000.0,39000.0,-65.0,-71.0,-63.0,-71.0,-66.0,-72.0,-63.0,-68.0,-77.0,-85.0,-77.0,-85.0,12.0,14.0,14.0,14.0,1
7064,CC:2F:71:3E:C5:1F,3231581,408128182,11452,1400929,3220129,406727253,6,48843,4091003,40356,3085383,8487,1005620,12076,34,16417,186,6,832,130000.0,39000.0,-69.0,-70.0,-67.0,-60.0,-68.0,-71.0,-66.0,-61.0,-77.0,-85.0,-77.0,-85.0,8.0,15.0,10.0,25.0,1
7065,CC:2F:71:3F:1F:24,10079876,10897240633,6859747,10490513380,3220129,406727253,88,1566881,917044540,1558303,916014410,8578,1030130,1513154,619,6864467,700590,88,6077,115556.0,28889.0,-67.0,-64.0,-70.0,-68.0,-67.0,-64.0,-70.0,-68.0,-77.0,-85.0,-77.0,-85.0,10.0,21.0,7.0,17.0,1
7066,F8:59:71:5A:E0:3D,3419249,704251202,199118,297523747,3220131,406727455,0,197407,255406054,192558,254826686,4849,579368,174864,16,201833,3332,0,562,130000.0,39000.0,-66.0,-72.0,-63.0,-72.0,-65.0,-71.0,-63.0,-69.0,-77.0,-85.0,-77.0,-85.0,11.0,13.0,14.0,13.0,1
7067,CC:2F:71:3E:C5:1F,3231584,408128500,11453,1401045,3220131,406727455,6,48845,4091143,40358,3085523,8487,1005620,12076,34,16418,186,6,832,130000.0,39000.0,-69.0,-71.0,-68.0,-60.0,-69.0,-73.0,-67.0,-62.0,-77.0,-85.0,-77.0,-85.0,8.0,14.0,9.0,25.0,1
7068,CC:2F:71:3F:1F:24,10080922,10898848253,6860791,10492120798,3220131,406727455,88,1567081,917068860,1558503,916038730,8578,1030130,1513354,619,6865500,700610,88,6077,115556.0,28889.0,-66.0,-64.0,-70.0,-69.0,-66.0,-63.0,-70.0,-68.0,-77.0,-85.0,-77.0,-85.0,11.0,21.0,7.0,16.0,1
7069,F8:59:71:5A:E0:3D,3419254,704251666,199118,297523747,3220136,406727919,0,197407,255406054,192558,254826686,4849,579368,174864,16,201833,3332,0,562,130000.0,39000.0,-66.0,-72.0,-63.0,-72.0,-65.0,-71.0,-63.0,-69.0,-77.0,-85.0,-77.0,-85.0,11.0,13.0,14.0,13.0,1
7070,CC:2F:71:3E:C5:1F,3231589,408128964,11453,1401045,3220136,406727919,6,48845,4091143,40358,3085523,8487,1005620,12076,34,16418,186,6,832,130000.0,39000.0,-69.0,-71.0,-68.0,-60.0,-69.0,-73.0,-67.0,-62.0,-77.0,-85.0,-77.0,-85.0,8.0,14.0,9.0,25.0,1
7071,CC:2F:71:3F:1F:24,10082045,10900574369,6861909,10493846450,3220136,406727919,88,1567247,917089326,1558669,916059196,8578,1030130,1513520,619,6866597,700638,88,6077,115556.0,28889.0,-66.0,-64.0,-70.0,-69.0,-66.0,-64.0,-70.0,-68.0,-77.0,-85.0,-77.0,-85.0,11.0,21.0,7.0,16.0,1
7072,F8:59:71:5A:E0:3D,3419258,704252070,199118,297523747,3220140,406728323,0,197407,255406054,192558,254826686,4849,579368,174864,16,201833,3332,0,562,130000.0,39000.0,-66.0,-72.0,-63.0,-72.0,-65.0,-71.0,-63.0,-69.0,-77.0,-85.0,-77.0,-85.0,11.0,13.0,14.0,13.0,1
7073,CC:2F:71:3E:C5:1F,3231593,408129368,11453,1401045,3220140,406728323,6,48845,4091143,40358,3085523,8487,1005620,12076,34,16418,186,6,832,130000.0,39000.0,-69.0,-71.0,-68.0,-60.0,-69.0,-73.0,-67.0,-62.0,-77.0,-85.0,-77.0,-85.0,8.0,14.0,9.0,25.0,1
7074,CC:2F:71:3F:1F:24,10083054,10902121719,6862914,10495393396,3220140,406728323,88,1567414,917109974,1558836,916079844,8578,1030130,1513687,619,6867634,700670,88,6077,130000.0,43333.0,-67.0,-64.0,-70.0,-68.0,-66.0,-64.0,-69.0,-68.0,-77.0,-85.0,-77.0,-85.0,10.0,21.0,7.0,17.0,1
7075,F8:59:71:5A:E0:3D,3419260,704252272,199118,297523747,3220142,406728525,0,197407,255406054,192558,254826686,4849,579368,174864,16,201833,3332,0,562,130000.0,39000.0,-66.0,-72.0,-63.0,-72.0,-65.0,-71.0,-63.0,-69.0,-77.0,-85.0,-77.0,-85.0,11.0,13.0,14.0,13.0,1
7076,CC:2F:71:3E:C5:1F,3231595,408129570,11453,1401045,3220142,406728525,6,48845,4091143,40358,3085523,8487,1005620,12076,34,16418,186,6,832,130000.0,39000.0,-69.0,-71.0,-68.0,-60.0,-69.0,-73.0,-67.0,-62.0,-77.0,-85.0,-77.0,-85.0,8.0,14.0,9.0,25.0,1
7077,CC:2F:71:3F:1F:24,10084034,10903617637,6863891,10496888978,3220143,406728659,88,1567571,917129889,1558993,916099759,8578,1030130,1513844,619,6868611,700677,88,6077,130000.0,43333.0,-67.0,-64.0,-69.0,-68.0,-66.0,-64.0,-69.0,-67.0,-77.0,-85.0,-77.0,-85.0,10.0,21.0,8.0,17.0,1
7078,F8:59:71:5A:E0:3D,3419267,704252938,199118,297523747,3220149,406729191,0,197407,255406054,192558,254826686,4849,579368,174864,16,201833,3332,0,562,130000.0,39000.0,-66.0,-72.0,-63.0,-72.0,-65.0,-71.0,-63.0,-69.0,-77.0,-85.0,-77.0,-85.0,11.0,13.0,14.0,13.0,1
7079,CC:2F:71:3E:C5:1F,3231602,408130236,11453,1401045,3220149,406729191,6,48845,4091143,40358,3085523,8487,1005620,12076,34,16418,186,6,832,130000.0,39000.0,-69.0,-71.0,-68.0,-60.0,-69.0,-73.0,-67.0,-62.0,-77.0,-85.0,-77.0,-85.0,8.0,14.0,9.0,25.0,1
7080,CC:2F:71:3F:1F:24,10085438,10905784285,6865289,10499055094,3220149,406729191,88,1567752,917152067,1559174,916121937,8578,1030130,1514025,619,6869996,700687,88,6077,130000.0,39000.0,-67.0,-64.0,-70.0,-67.0,-66.0,-64.0,-70.0,-67.0,-77.0,-85.0,-77.0,-85.0,10.0,21.0,7.0,18.0,1
7081,F8:59:71:5A:E0:3D,3419269,704253140,199118,297523747,3220151,406729393,0,197407,255406054,192558,254826686,4849,579368,174864,16,201833,3332,0,562,130000.0,39000.0,-66.0,-72.0,-63.0,-72.0,-65.0,-71.0,-63.0,-69.0,-77.0,-85.0,-77.0,-85.0,11.0,13.0,14.0,13.0,1
7082,CC:2F:71:3E:C5:1F,3231604,408130438,11453,1401045,3220151,406729393,6,48845,4091143,40358,3085523,8487,1005620,12076,34,16418,186,6,832,130000.0,39000.0,-69.0,-71.0,-68.0,-60.0,-69.0,-73.0,-67.0,-62.0,-77.0,-85.0,-77.0,-85.0,8.0,14.0,9.0,25.0,1
7083,CC:2F:71:3F:1F:24,10086870,10908002363,6866719,10501272970,3220151,406729393,88,1567950,917176309,1559372,916146179,8578,1030130,1514223,619,6871439,700724,88,6077,144444.0,43333.0,-67.0,-64.0,-71.0,-67.0,-67.0,-64.0,-70.0,-67.0,-77.0,-85.0,-77.0,-85.0,10.0,21.0,6.0,18.0,1
7084,F8:59:71:5A:E0:3D,3419274,704253604,199118,297523747,3220156,406729857,0,197409,255406194,192560,254826826,4849,579368,174864,16,201834,3332,0,562,130000.0,39000.0,-66.0,-72.0,-63.0,-71.0,-65.0,-71.0,-63.0,-69.0,-77.0,-85.0,-77.0,-85.0,11.0,13.0,14.0,14.0,1
7085,CC:2F:71:3E:C5:1F,3231611,408131104,11453,1401045,3220158,406730059,6,48847,4091283,40360,3085663,8487,1005620,12076,34,16419,186,6,832,130000.0,39000.0,-63.0,-68.0,-61.0,-60.0,-68.0,-71.0,-67.0,-61.0,-77.0,-85.0,-77.0,-85.0,14.0,17.0,16.0,25.0,1
7086,CC:2F:71:3F:1F:24,10088098,10909891047,6867940,10503160988,3220158,406730059,88,1568128,917198235,1559550,916168105,8578,1030130,1514401,619,6872660,700942,88,6078,130000.0,39000.0,-69.0,-63.0,-71.0,-69.0,-68.0,-63.0,-70.0,-69.0,-77.0,-85.0,-77.0,-85.0,8.0,22.0,6.0,16.0,1
7087,F8:59:71:5A:E0:3D,3419282,704254252,199118,297523747,3220164,406730505,0,197409,255406194,192560,254826826,4849,579368,174864,16,201834,3332,0,562,130000.0,39000.0,-66.0,-72.0,-63.0,-71.0,-65.0,-71.0,-63.0,-69.0,-77.0,-85.0,-77.0,-85.0,11.0,13.0,14.0,14.0,1
7088,CC:2F:71:3E:C5:1F,3231617,408131550,11453,1401045,3220164,406730505,6,48849,4091471,40361,3085733,8488,1005738,12077,34,16419,186,6,832,130000.0,39000.0,-68.0,-71.0,-67.0,-60.0,-68.0,-71.0,-67.0,-61.0,-77.0,-85.0,-77.0,-85.0,9.0,14.0,10.0,25.0,1
7089,CC:2F:71:3F:1F:24,10089081,10911385067,6868917,10504654562,3220164,406730505,88,1568318,917222048,1559739,916191800,8579,1030248,1514591,619,6873637,701081,88,6078,130000.0,43333.0,-70.0,-63.0,-72.0,-70.0,-69.0,-62.0,-71.0,-69.0,-77.0,-85.0,-77.0,-85.0,7.0,22.0,5.0,15.0,1
7090,F8:59:71:5A:E0:3D,3419286,704254656,199118,297523747,3220168,406730909,0,197409,255406194,192560,254826826,4849,579368,174864,16,201834,3332,0,562,130000.0,39000.0,-66.0,-72.0,-63.0,-71.0,-65.0,-71.0,-63.0,-69.0,-77.0,-85.0,-77.0,-85.0,11.0,13.0,14.0,14.0,1
7091,CC:2F:71:3E:C5:1F,3231621,408131954,11453,1401045,3220168,406730909,6,48849,4091471,40361,3085733,8488,1005738,12077,34,16419,186,6,832,130000.0,39000.0,-68.0,-71.0,-67.0,-60.0,-68.0,-71.0,-67.0,-61.0,-77.0,-85.0,-77.0,-85.0,9.0,14.0,10.0,25.0,1
7092,CC:2F:71:3F:1F:24,10089950,10912708935,6869780,10505977824,3220170,406731111,88,1568472,917241248,1559893,916211000,8579,1030248,1514745,619,6874500,701213,88,6079,130000.0,43333.0,-67.0,-63.0,-69.0,-68.0,-67.0,-63.0,-69.0,-67.0,-77.0,-85.0,-77.0,-85.0,10.0,22.0,8.0,17.0,1
7093,F8:59:71:5A:E0:3D,3419289,704254918,199118,297523747,3220171,406731171,0,197409,255406194,192560,254826826,4849,579368,174864,16,201834,3332,0,562,130000.0,39000.0,-66.0,-72.0,-63.0,-71.0,-65.0,-71.0,-63.0,-69.0,-77.0,-85.0,-77.0,-85.0,11.0,13.0,14.0,14.0,1
7094,CC:2F:71:3E:C5:1F,3231626,408132549,11453,1401045,3220173,406731504,6,48849,4091471,40361,3085733,8488,1005738,12077,34,16419,186,6,832,130000.0,39000.0,-68.0,-71.0,-67.0,-60.0,-68.0,-71.0,-67.0,-61.0,-77.0,-85.0,-77.0,-85.0,9.0,14.0,10.0,25.0,1
7095,CC:2F:71:3F:1F:24,10091221,10914670232,6871048,10507938728,3220173,406731504,88,1568667,917265030,1560088,916234782,8579,1030248,1514940,619,6875768,701281,88,6079,130000.0,43333.0,-68.0,-63.0,-70.0,-69.0,-67.0,-63.0,-69.0,-69.0,-77.0,-85.0,-77.0,-85.0,9.0,22.0,7.0,16.0,1
7096,F8:59:71:5A:E0:3D,3419297,704255857,199118,297523747,3220179,406732110,0,197409,255406194,192560,254826826,4849,579368,174864,16,201834,3332,0,562,130000.0,39000.0,-66.0,-72.0,-63.0,-71.0,-65.0,-71.0,-63.0,-69.0,-77.0,-85.0,-77.0,-85.0,11.0,13.0,14.0,14.0,1
7097,CC:2F:71:3E:C5:1F,3231632,408133155,11453,1401045,3220179,406732110,6,48849,4091471,40361,3085733,8488,1005738,12077,34,16419,186,6,832,130000.0,39000.0,-68.0,-71.0,-67.0,-60.0,-68.0,-71.0,-67.0,-61.0,-77.0,-85.0,-77.0,-85.0,9.0,14.0,10.0,25.0,1
7098,CC:2F:71:3F:1F:24,10092705,10916964234,6872526,10510232124,3220179,406732110,88,1568843,917286566,1560264,916256318,8579,1030248,1515116,619,6877246,701517,88,6079,130000.0,39000.0,-67.0,-64.0,-69.0,-67.0,-67.0,-64.0,-68.0,-67.0,-77.0,-85.0,-77.0,-85.0,10.0,21.0,8.0,18.0,1
7099,F8:59:71:5A:E0:3D,3419299,704256059,199118,297523747,3220181,406732312,0,197409,255406194,192560,254826826,4849,579368,174864,16,201834,3332,0,562,130000.0,39000.0,-66.0,-72.0,-63.0,-71.0,-65.0,-71.0,-63.0,-69.0,-77.0,-85.0,-77.0,-85.0,11.0,13.0,14.0,14.0,1
7100,CC:2F:71:3E:C5:1F,3231634,408133357,11453,1401045,3220181,406732312,6,48849,4091471,40361,3085733,8488,1005738,12077,34,16419,186,6,832,130000.0,39000.0,-68.0,-71.0,-67.0,-60.0,-68.0,-71.0,-67.0,-61.0,-77.0,-85.0,-77.0,-85.0,9.0,14.0,10.0,25.0,1
7101,CC:2F:71:3F:1F:24,10094019,10918986864,6873838,10512254552,3220181,406732312,88,1569028,917310097,1560449,916279849,8579,1030248,1515301,619,6878558,701715,88,6079,130000.0,43333.0,-67.0,-64.0,-68.0,-67.0,-68.0,-64.0,-68.0,-67.0,-77.0,-85.0,-77.0,-85.0,10.0,21.0,9.0,18.0,1
7102,F8:59:71:5A:E0:3D,3419304,704256523,199118,297523747,3220186,406732776,0,197409,255406194,192560,254826826,4849,579368,174864,16,201834,3332,0,562,130000.0,39000.0,-66.0,-72.0,-63.0,-71.0,-65.0,-71.0,-63.0,-69.0,-77.0,-85.0,-77.0,-85.0,11.0,13.0,14.0,14.0,1
7103,CC:2F:71:3E:C5:1F,3231639,408133821,11453,1401045,3220186,406732776,6,48849,4091471,40361,3085733,8488,1005738,12077,34,16419,186,6,832,130000.0,39000.0,-68.0,-71.0,-67.0,-60.0,-68.0,-71.0,-67.0,-61.0,-77.0,-85.0,-77.0,-85.0,9.0,14.0,10.0,25.0,1
7104,CC:2F:71:3F:1F:24,10094933,10920370422,6874747,10513637646,3220186,406732776,88,1569181,917329464,1560602,916299216,8579,1030248,1515454,619,6879467,701781,88,6079,130000.0,43333.0,-68.0,-64.0,-69.0,-67.0,-67.0,-64.0,-68.0,-67.0,-77.0,-85.0,-77.0,-85.0,9.0,21.0,8.0,18.0,1
7105,F8:59:71:5A:E0:3D,3419308,704256927,199118,297523747,3220190,406733180,0,197409,255406194,192560,254826826,4849,579368,174864,16,201834,3332,0,562,130000.0,39000.0,-66.0,-72.0,-63.0,-71.0,-65.0,-71.0,-63.0,-69.0,-77.0,-85.0,-77.0,-85.0,11.0,13.0,14.0,14.0,1
7106,CC:2F:71:3E:C5:1F,3231643,408134225,11453,1401045,3220190,406733180,6,48849,4091471,40361,3085733,8488,1005738,12077,34,16419,186,6,832,130000.0,39000.0,-68.0,-71.0,-67.0,-60.0,-68.0,-71.0,-67.0,-61.0,-77.0,-85.0,-77.0,-85.0,9.0,14.0,10.0,25.0,1
7107,CC:2F:71:3F:1F:24,10095952,10921932092,6875761,10515198850,3220191,406733242,88,1569313,917346010,1560734,916315762,8579,1030248,1515586,619,6880481,701928,88,6079,117000.0,39000.0,-68.0,-64.0,-69.0,-67.0,-68.0,-64.0,-68.0,-67.0,-77.0,-85.0,-77.0,-85.0,9.0,21.0,8.0,18.0,1
7108,F8:59:71:5A:E0:3D,3419311,704257191,199118,297523747,3220193,406733444,0,197411,255406382,192561,254826896,4850,579486,174865,16,201834,3332,0,562,130000.0,39000.0,-65.0,-72.0,-64.0,-72.0,-65.0,-71.0,-63.0,-71.0,-77.0,-85.0,-77.0,-85.0,12.0,13.0,13.0,13.0,1
7109,CC:2F:71:3E:C5:1F,3231646,408134489,11453,1401045,3220193,406733444,6,48849,4091471,40361,3085733,8488,1005738,12077,34,16419,186,6,832,130000.0,39000.0,-68.0,-71.0,-67.0,-60.0,-68.0,-71.0,-67.0,-61.0,-77.0,-85.0,-77.0,-85.0,9.0,14.0,10.0,25.0,1
7110,CC:2F:71:3F:1F:24,10096917,10923410290,6876722,10516676644,3220195,406733646,88,1569465,917364786,1560886,916334538,8579,1030248,1515738,619,6881418,701963,88,6079,130000.0,43333.0,-68.0,-64.0,-68.0,-67.0,-67.0,-64.0,-68.0,-67.0,-77.0,-85.0,-77.0,-85.0,9.0,21.0,9.0,18.0,1
7111,F8:59:71:5A:E0:3D,3419318,704257857,199118,297523747,3220200,406734110,0,197411,255406382,192561,254826896,4850,579486,174865,16,201834,3332,0,562,130000.0,39000.0,-65.0,-72.0,-64.0,-72.0,-65.0,-71.0,-63.0,-71.0,-77.0,-85.0,-77.0,-85.0,12.0,13.0,13.0,13.0,1
7112,CC:2F:71:3E:C5:1F,3231653,408135155,11453,1401045,3220200,406734110,6,48849,4091471,40361,3085733,8488,1005738,12077,34,16419,186,6,832,130000.0,39000.0,-68.0,-71.0,-67.0,-60.0,-68.0,-71.0,-67.0,-61.0,-77.0,-85.0,-77.0,-85.0,9.0,14.0,10.0,25.0,1
7113,CC:2F:71:3F:1F:24,10097757,10924689832,6877557,10517955722,3220200,406734110,88,1569611,917383056,1561032,916352808,8579,1030248,1515884,619,6882277,702035,88,6079,130000.0,43333.0,-68.0,-64.0,-69.0,-67.0,-68.0,-64.0,-68.0,-67.0,-77.0,-85.0,-77.0,-85.0,9.0,21.0,8.0,18.0,1
7114,F8:59:71:5A:E0:3D,3419320,704258059,199118,297523747,3220202,406734312,0,197411,255406382,192561,254826896,4850,579486,174865,16,201834,3332,0,562,130000.0,39000.0,-65.0,-72.0,-64.0,-72.0,-65.0,-71.0,-63.0,-71.0,-77.0,-85.0,-77.0,-85.0,12.0,13.0,13.0,13.0,1
7115,CC:2F:71:3E:C5:1F,3231655,408135357,11453,1401045,3220202,406734312,6,48849,4091471,40361,3085733,8488,1005738,12077,34,16419,186,6,832,130000.0,39000.0,-68.0,-71.0,-67.0,-60.0,-68.0,-71.0,-67.0,-61.0,-77.0,-85.0,-77.0,-85.0,9.0,14.0,10.0,25.0,1
7116,CC:2F:71:3F:1F:24,10098517,10925838362,6878315,10519104050,3220202,406734312,88,1569774,917403666,1561195,916373418,8579,1030248,1516047,619,6883035,702055,88,6079,130000.0,43333.0,-69.0,-64.0,-68.0,-67.0,-68.0,-64.0,-68.0,-67.0,-77.0,-85.0,-77.0,-85.0,8.0,21.0,9.0,18.0,1
7117,F8:59:71:5A:E0:3D,3419326,704258665,199118,297523747,3220208,406734918,0,197411,255406382,192561,254826896,4850,579486,174865,16,201834,3332,0,562,130000.0,39000.0,-65.0,-72.0,-64.0,-72.0,-65.0,-71.0,-63.0,-71.0,-77.0,-85.0,-77.0,-85.0,12.0,13.0,13.0,13.0,1
7118,CC:2F:71:3E:C5:1F,3231661,408135963,11453,1401045,3220208,406734918,6,48849,4091471,40361,3085733,8488,1005738,12077,34,16419,186,6,832,130000.0,39000.0,-68.0,-71.0,-67.0,-60.0,-68.0,-71.0,-67.0,-61.0,-77.0,-85.0,-77.0,-85.0,9.0,14.0,10.0,25.0,1
7119,CC:2F:71:3F:1F:24,10099204,10926874922,6878996,10520140004,3220208,406734918,88,1569880,917416806,1561301,916386558,8579,1030248,1516147,619,6883683,702172,88,6079,117000.0,39000.0,-68.0,-64.0,-69.0,-67.0,-68.0,-64.0,-68.0,-67.0,-77.0,-85.0,-77.0,-85.0,9.0,21.0,8.0,18.0,1
7120,F8:59:71:5A:E0:3D,3419329,704258927,199118,297523747,3220211,406735180,0,197411,255406382,192561,254826896,4850,579486,174865,16,201834,3332,0,562,130000.0,39000.0,-65.0,-72.0,-64.0,-72.0,-65.0,-71.0,-63.0,-71.0,-77.0,-85.0,-77.0,-85.0,12.0,13.0,13.0,13.0,1
7121,CC:2F:71:3E:C5:1F,3231664,408136225,11453,1401045,3220211,406735180,6,48849,4091471,40361,3085733,8488,1005738,12077,34,16419,186,6,832,130000.0,39000.0,-68.0,-71.0,-67.0,-60.0,-68.0,-71.0,-67.0,-61.0,-77.0,-85.0,-77.0,-85.0,9.0,14.0,10.0,25.0,1
7122,CC:2F:71:3F:1F:24,10100080,10928212666,6879869,10521477486,3220211,406735180,88,1570016,917433300,1561437,916403052,8579,1030248,1516274,619,6884589,702207,88,6079,130000.0,43333.0,-68.0,-64.0,-68.0,-67.0,-68.0,-64.0,-68.0,-67.0,-77.0,-85.0,-77.0,-85.0,9.0,21.0,9.0,18.0,1
7123,F8:59:71:5A:E0:3D,3419335,704259533,199118,297523747,3220217,406735786,0,197411,255406382,192561,254826896,4850,579486,174865,16,201834,3332,0,562,130000.0,39000.0,-65.0,-72.0,-64.0,-72.0,-65.0,-71.0,-63.0,-71.0,-77.0,-85.0,-77.0,-85.0,12.0,13.0,13.0,13.0,1
7124,CC:2F:71:3E:C5:1F,3231670,408136831,11453,1401045,3220217,406735786,6,48849,4091471,40361,3085733,8488,1005738,12077,34,16419,186,6,832,130000.0,39000.0,-68.0,-71.0,-67.0,-60.0,-68.0,-71.0,-67.0,-61.0,-77.0,-85.0,-77.0,-85.0,9.0,14.0,10.0,25.0,1
7125,CC:2F:71:3F:1F:24,10101143,10929840994,6880926,10523105208,3220217,406735786,88,1570189,917454524,1561610,916424276,8579,1030248,1516447,619,6885646,702321,88,6079,130000.0,43333.0,-68.0,-64.0,-68.0,-67.0,-68.0,-64.0,-68.0,-67.0,-77.0,-85.0,-77.0,-85.0,9.0,21.0,9.0,18.0,1
7126,F8:59:71:5A:E0:3D,3419335,704259533,199118,297523747,3220217,406735786,0,197411,255406382,192561,254826896,4850,579486,174865,16,201834,3332,0,562,130000.0,39000.0,-65.0,-72.0,-64.0,-72.0,-65.0,-71.0,-63.0,-71.0,-77.0,-85.0,-77.0,-85.0,12.0,13.0,13.0,13.0,1
7127,CC:2F:71:3E:C5:1F,3231672,408137033,11453,1401045,3220219,406735988,6,48849,4091471,40361,3085733,8488,1005738,12077,34,16419,186,6,832,130000.0,39000.0,-68.0,-71.0,-67.0,-60.0,-68.0,-71.0,-67.0,-61.0,-77.0,-85.0,-77.0,-85.0,9.0,14.0,10.0,25.0,1
7128,CC:2F:71:3F:1F:24,10102151,10931382538,6881932,10524646550,3220219,406735988,88,1570391,917479644,1561812,916449396,8579,1030248,1516646,619,6886652,702338,88,6079,130000.0,43333.0,-68.0,-64.0,-69.0,-67.0,-68.0,-64.0,-68.0,-67.0,-77.0,-85.0,-77.0,-85.0,9.0,21.0,8.0,18.0,1
7129,F8:59:71:5A:E0:3D,3419344,704260401,199118,297523747,3220226,406736654,0,197411,255406382,192561,254826896,4850,579486,174865,16,201834,3332,0,562,130000.0,39000.0,-65.0,-72.0,-64.0,-72.0,-65.0,-71.0,-63.0,-71.0,-77.0,-85.0,-77.0,-85.0,12.0,13.0,13.0,13.0,1
7130,CC:2F:71:3E:C5:1F,3231679,408137699,11453,1401045,3220226,406736654,6,48849,4091471,40361,3085733,8488,1005738,12077,34,16419,186,6,832,130000.0,39000.0,-68.0,-71.0,-67.0,-60.0,-68.0,-71.0,-67.0,-61.0,-77.0,-85.0,-77.0,-85.0,9.0,14.0,10.0,25.0,1
7131,CC:2F:71:3F:1F:24,10103347,10933220726,6883121,10526484072,3220226,406736654,88,1570610,917506270,1562031,916476022,8579,1030248,1516865,619,6887841,702418,88,6079,130000.0,43333.0,-68.0,-64.0,-69.0,-68.0,-68.0,-64.0,-68.0,-67.0,-77.0,-85.0,-77.0,-85.0,9.0,21.0,8.0,17.0,1
7132,F8:59:71:5A:E0:3D,3419344,704260401,199118,297523747,3220226,406736654,0,197411,255406382,192561,254826896,4850,579486,174865,16,201834,3332,0,562,130000.0,39000.0,-65.0,-72.0,-64.0,-72.0,-65.0,-71.0,-63.0,-71.0,-77.0,-85.0,-77.0,-85.0,12.0,13.0,13.0,13.0,1
7133,CC:2F:71:3E:C5:1F,3231679,408137699,11453,1401045,3220226,406736654,6,48849,4091471,40361,3085733,8488,1005738,12077,34,16419,186,6,832,130000.0,39000.0,-68.0,-71.0,-67.0,-60.0,-68.0,-71.0,-67.0,-61.0,-77.0,-85.0,-77.0,-85.0,9.0,14.0,10.0,25.0,1
7134,CC:2F:71:3F:1F:24,10104455,10934928982,6884229,10528192328,3220226,406736654,88,1570791,917528532,1562212,916498284,8579,1030248,1517045,619,6888949,702520,88,6080,130000.0,43333.0,-68.0,-63.0,-69.0,-67.0,-68.0,-63.0,-68.0,-67.0,-77.0,-85.0,-77.0,-85.0,9.0,22.0,8.0,18.0,1
7135,F8:59:71:5A:E0:3D,3419350,704261007,199118,297523747,3220232,406737260,0,197411,255406382,192561,254826896,4850,579486,174865,16,201834,3332,0,562,130000.0,39000.0,-65.0,-72.0,-64.0,-72.0,-65.0,-71.0,-63.0,-71.0,-77.0,-85.0,-77.0,-85.0,12.0,13.0,13.0,13.0,1
7136,CC:2F:71:3E:C5:1F,3231687,408138507,11453,1401045,3220234,406737462,6,48849,4091471,40361,3085733,8488,1005738,12077,34,16419,186,6,832,130000.0,39000.0,-68.0,-71.0,-67.0,-60.0,-68.0,-71.0,-67.0,-61.0,-77.0,-85.0,-77.0,-85.0,9.0,14.0,10.0,25.0,1
7137,CC:2F:71:3F:1F:24,10105335,10936267254,6885101,10529529792,3220234,406737462,88,1570949,917548230,1562370,916517982,8579,1030248,1517199,619,6889802,702543,88,6080,130000.0,43333.0,-68.0,-64.0,-68.0,-68.0,-68.0,-64.0,-68.0,-67.0,-77.0,-85.0,-77.0,-85.0,9.0,21.0,9.0,17.0,1
7138,F8:59:71:5A:E0:3D,3419354,704261542,199118,297523747,3220236,406737795,0,197411,255406382,192561,254826896,4850,579486,174865,16,201834,3332,0,562,130000.0,39000.0,-65.0,-72.0,-64.0,-72.0,-65.0,-71.0,-63.0,-71.0,-77.0,-85.0,-77.0,-85.0,12.0,13.0,13.0,13.0,1
7139,CC:2F:71:3E:C5:1F,3231689,408138840,11453,1401045,3220236,406737795,6,48849,4091471,40361,3085733,8488,1005738,12077,34,16419,186,6,832,130000.0,39000.0,-68.0,-71.0,-67.0,-60.0,-68.0,-71.0,-67.0,-61.0,-77.0,-85.0,-77.0,-85.0,9.0,14.0,10.0,25.0,1
7140,CC:2F:71:3F:1F:24,10106103,10937431433,6885867,10530693638,3220236,406737795,88,1571100,917567501,1562521,916537253,8579,1030248,1517350,619,6890576,702595,88,6080,130000.0,43333.0,-68.0,-64.0,-69.0,-68.0,-68.0,-64.0,-68.0,-67.0,-77.0,-85.0,-77.0,-85.0,9.0,21.0,8.0,17.0,1
7141,F8:59:71:5A:E0:3D,3419358,704261946,199118,297523747,3220240,406738199,0,197411,255406382,192561,254826896,4850,579486,174865,16,201834,3332,0,562,130000.0,39000.0,-65.0,-72.0,-64.0,-72.0,-65.0,-71.0,-63.0,-71.0,-77.0,-85.0,-77.0,-85.0,12.0,13.0,13.0,13.0,1
7142,CC:2F:71:3E:C5:1F,3231693,408139244,11453,1401045,3220240,406738199,6,48849,4091471,40361,3085733,8488,1005738,12077,34,16419,186,6,832,130000.0,39000.0,-68.0,-71.0,-67.0,-60.0,-68.0,-71.0,-67.0,-61.0,-77.0,-85.0,-77.0,-85.0,9.0,14.0,10.0,25.0,1
7143,CC:2F:71:3F:1F:24,10106872,10938600455,6886632,10531862256,3220240,406738199,88,1571252,917586241,1562673,916555993,8579,1030248,1517502,619,6891342,702631,88,6080,130000.0,43333.0,-68.0,-64.0,-68.0,-67.0,-68.0,-64.0,-68.0,-67.0,-77.0,-85.0,-77.0,-85.0,9.0,21.0,9.0,18.0,1
7144,F8:59:71:5A:E0:3D,3419362,704262350,199118,297523747,3220244,406738603,0,197411,255406382,192561,254826896,4850,579486,174865,16,201834,3332,0,562,130000.0,39000.0,-65.0,-72.0,-64.0,-72.0,-65.0,-71.0,-63.0,-71.0,-77.0,-85.0,-77.0,-85.0,12.0,13.0,13.0,13.0,1
7145,CC:2F:71:3E:C5:1F,3231697,408139648,11453,1401045,3220244,406738603,6,48849,4091471,40361,3085733,8488,1005738,12077,34,16419,186,6,832,130000.0,39000.0,-68.0,-71.0,-67.0,-60.0,-68.0,-71.0,-67.0,-61.0,-77.0,-85.0,-77.0,-85.0,9.0,14.0,10.0,25.0,1
7146,CC:2F:71:3F:1F:24,10108096,10940485725,6887851,10533747062,3220245,406738663,88,1571459,917611537,1562880,916581289,8579,1030248,1517709,619,6892559,702779,88,6080,130000.0,43333.0,-68.0,-64.0,-69.0,-68.0,-68.0,-64.0,-68.0,-67.0,-77.0,-85.0,-77.0,-85.0,9.0,21.0,8.0,17.0,1
7147,F8:59:71:5A:E0:3D,3419365,704262612,199118,297523747,3220247,406738865,0,197411,255406382,192561,254826896,4850,579486,174865,16,201834,3332,0,562,130000.0,39000.0,-65.0,-72.0,-64.0,-72.0,-65.0,-71.0,-63.0,-71.0,-77.0,-85.0,-77.0,-85.0,12.0,13.0,13.0,13.0,1
7148,CC:2F:71:3E:C5:1F,3231702,408140112,11453,1401045,3220249,406739067,6,48849,4091471,40361,3085733,8488,1005738,12077,34,16419,186,6,832,130000.0,39000.0,-68.0,-71.0,-67.0,-60.0,-68.0,-71.0,-67.0,-61.0,-77.0,-85.0,-77.0,-85.0,9.0,14.0,10.0,25.0,1
7149,CC:2F:71:3F:1F:24,10108917,10941736523,6888668,10534997456,3220249,406739067,88,1571589,917627815,1563010,916597567,8579,1030248,1517836,619,6893388,702899,88,6080,130000.0,39000.0,-68.0,-64.0,-69.0,-68.0,-68.0,-64.0,-68.0,-68.0,-77.0,-85.0,-77.0,-85.0,9.0,21.0,8.0,17.0,1
7150,F8:59:71:5A:E0:3D,3419372,704263334,199119,297523863,3220253,406739471,0,197412,255406452,192562,254826966,4850,579486,174865,16,201835,3332,0,562,130000.0,39000.0,-65.0,-72.0,-63.0,-71.0,-65.0,-71.0,-63.0,-71.0,-77.0,-85.0,-77.0,-85.0,12.0,13.0,14.0,14.0,1
7151,CC:2F:71:3E:C5:1F,3231707,408140632,11454,1401161,3220253,406739471,6,48850,4091541,40362,3085803,8488,1005738,12077,34,16420,186,6,832,130000.0,39000.0,-68.0,-71.0,-67.0,-61.0,-68.0,-71.0,-67.0,-61.0,-77.0,-85.0,-77.0,-85.0,9.0,14.0,10.0,24.0,1
7152,CC:2F:71:3F:1F:24,10109927,10943285437,6889674,10536545966,3220253,406739471,88,1571728,917645059,1563149,916614811,8579,1030248,1517975,619,6894367,702980,88,6080,130000.0,43333.0,-68.0,-64.0,-67.0,-68.0,-67.0,-64.0,-67.0,-67.0,-77.0,-85.0,-77.0,-85.0,9.0,21.0,10.0,17.0,1
7153,F8:59:71:5A:E0:3D,3419377,704263964,199119,297523863,3220258,406740101,0,197413,255406522,192563,254827036,4850,579486,174865,16,201835,3332,0,562,130000.0,39000.0,-66.0,-72.0,-63.0,-71.0,-65.0,-71.0,-63.0,-71.0,-77.0,-85.0,-77.0,-85.0,11.0,13.0,14.0,14.0,1
7154,CC:2F:71:3E:C5:1F,3231712,408141262,11454,1401161,3220258,406740101,6,48851,4091611,40363,3085873,8488,1005738,12077,34,16420,186,6,832,130000.0,39000.0,-67.0,-72.0,-67.0,-61.0,-68.0,-72.0,-67.0,-61.0,-77.0,-85.0,-77.0,-85.0,10.0,13.0,10.0,24.0,1
7155,CC:2F:71:3F:1F:24,10111199,10945238875,6890941,10538498774,3220258,406740101,88,1571924,917669497,1563345,916639249,8579,1030248,1518171,619,6895661,703501,88,6080,115556.0,28889.0,-69.0,-63.0,-69.0,-70.0,-68.0,-63.0,-68.0,-70.0,-77.0,-85.0,-77.0,-85.0,8.0,22.0,8.0,15.0,1
7156,F8:59:71:5A:E0:3D,3419383,704264570,199119,297523863,3220264,406740707,0,197413,255406522,192563,254827036,4850,579486,174865,16,201835,3332,0,562,130000.0,39000.0,-66.0,-72.0,-63.0,-71.0,-65.0,-71.0,-63.0,-71.0,-77.0,-85.0,-77.0,-85.0,11.0,13.0,14.0,14.0,1
7157,CC:2F:71:3E:C5:1F,3231718,408141868,11454,1401161,3220264,406740707,6,48851,4091611,40363,3085873,8488,1005738,12077,34,16420,186,6,832,130000.0,39000.0,-67.0,-72.0,-67.0,-61.0,-68.0,-72.0,-67.0,-61.0,-77.0,-85.0,-77.0,-85.0,10.0,13.0,10.0,24.0,1
7158,CC:2F:71:3F:1F:24,10112245,10946841825,6891981,10540101118,3220264,406740707,88,1572110,917692301,1563531,916662053,8579,1030248,1518357,619,6896697,703871,88,6080,115556.0,28889.0,-69.0,-63.0,-68.0,-70.0,-68.0,-63.0,-68.0,-69.0,-77.0,-85.0,-77.0,-85.0,8.0,22.0,9.0,15.0,1
7159,F8:59:71:5A:E0:3D,3419383,704264570,199119,297523863,3220264,406740707,0,197413,255406522,192563,254827036,4850,579486,174865,16,201835,3332,0,562,130000.0,39000.0,-66.0,-72.0,-63.0,-71.0,-65.0,-71.0,-63.0,-71.0,-77.0,-85.0,-77.0,-85.0,11.0,13.0,14.0,14.0,1
7160,CC:2F:71:3E:C5:1F,3231718,408141868,11454,1401161,3220264,406740707,6,48851,4091611,40363,3085873,8488,1005738,12077,34,16420,186,6,832,130000.0,39000.0,-67.0,-72.0,-67.0,-61.0,-68.0,-72.0,-67.0,-61.0,-77.0,-85.0,-77.0,-85.0,10.0,13.0,10.0,24.0,1
7161,CC:2F:71:3F:1F:24,10113061,10948089361,6892797,10541348654,3220264,406740707,88,1572277,917712829,1563698,916682581,8579,1030248,1518524,619,6897509,703997,88,6080,104000.0,26000.0,-68.0,-63.0,-68.0,-69.0,-68.0,-63.0,-69.0,-69.0,-77.0,-85.0,-77.0,-85.0,9.0,22.0,9.0,16.0,1
7162,F8:59:71:5A:E0:3D,3419393,704265500,199119,297523863,3220274,406741637,0,197413,255406522,192563,254827036,4850,579486,174865,16,201835,3332,0,562,130000.0,39000.0,-66.0,-72.0,-63.0,-71.0,-65.0,-71.0,-63.0,-71.0,-77.0,-85.0,-77.0,-85.0,11.0,13.0,14.0,14.0,1
7163,CC:2F:71:3E:C5:1F,3231728,408142798,11454,1401161,3220274,406741637,6,48851,4091611,40363,3085873,8488,1005738,12077,34,16420,186,6,832,130000.0,39000.0,-67.0,-72.0,-67.0,-61.0,-68.0,-72.0,-67.0,-61.0,-77.0,-85.0,-77.0,-85.0,10.0,13.0,10.0,24.0,1
7164,CC:2F:71:3F:1F:24,10114128,10949717901,6893854,10542976264,3220274,406741637,88,1572439,917732803,1563859,916702437,8580,1030366,1518686,619,6898541,704065,88,6080,115556.0,28889.0,-68.0,-63.0,-70.0,-69.0,-68.0,-63.0,-69.0,-69.0,-77.0,-85.0,-77.0,-85.0,9.0,22.0,7.0,16.0,1
7165,F8:59:71:5A:E0:3D,3419393,704265500,199119,297523863,3220274,406741637,0,197413,255406522,192563,254827036,4850,579486,174865,16,201835,3332,0,562,130000.0,39000.0,-66.0,-72.0,-63.0,-71.0,-65.0,-71.0,-63.0,-71.0,-77.0,-85.0,-77.0,-85.0,11.0,13.0,14.0,14.0,1
7166,CC:2F:71:3E:C5:1F,3231728,408142798,11454,1401161,3220274,406741637,6,48851,4091611,40363,3085873,8488,1005738,12077,34,16420,186,6,832,130000.0,39000.0,-67.0,-72.0,-67.0,-61.0,-68.0,-72.0,-67.0,-61.0,-77.0,-85.0,-77.0,-85.0,10.0,13.0,10.0,24.0,1
7167,CC:2F:71:3F:1F:24,10115098,10951202439,6894824,10544460802,3220274,406741637,88,1572581,917750966,1564001,916720600,8580,1030366,1518827,619,6899544,704113,88,6080,115556.0,28889.0,-69.0,-63.0,-69.0,-69.0,-68.0,-63.0,-69.0,-69.0,-77.0,-85.0,-77.0,-85.0,8.0,22.0,8.0,16.0,1
7168,F8:59:71:5A:E0:3D,3419399,704266106,199119,297523863,3220280,406742243,0,197413,255406522,192563,254827036,4850,579486,174865,16,201835,3332,0,562,130000.0,39000.0,-66.0,-72.0,-63.0,-71.0,-65.0,-71.0,-63.0,-71.0,-77.0,-85.0,-77.0,-85.0,11.0,13.0,14.0,14.0,1
7169,CC:2F:71:3E:C5:1F,3231736,408143606,11454,1401161,3220282,406742445,6,48851,4091611,40363,3085873,8488,1005738,12077,34,16420,186,6,832,130000.0,39000.0,-67.0,-72.0,-67.0,-61.0,-68.0,-72.0,-67.0,-61.0,-77.0,-85.0,-77.0,-85.0,10.0,13.0,10.0,24.0,1
7170,CC:2F:71:3F:1F:24,10116258,10952980935,6895976,10546238490,3220282,406742445,88,1572776,917774842,1564196,916744476,8580,1030366,1519022,619,6900696,704216,88,6080,115556.0,26000.0,-68.0,-63.0,-69.0,-70.0,-68.0,-63.0,-69.0,-69.0,-77.0,-85.0,-77.0,-85.0,9.0,22.0,8.0,15.0,1
7171,F8:59:71:5A:E0:3D,3419402,704266368,199119,297523863,3220283,406742505,0,197415,255406662,192565,254827176,4850,579486,174865,16,201836,3332,0,562,130000.0,39000.0,-66.0,-72.0,-63.0,-71.0,-65.0,-71.0,-62.0,-70.0,-77.0,-85.0,-77.0,-85.0,11.0,13.0,14.0,14.0,1
7172,CC:2F:71:3E:C5:1F,3231737,408143666,11454,1401161,3220283,406742505,6,48853,4091751,40365,3086013,8488,1005738,12077,34,16421,186,6,832,130000.0,39000.0,-69.0,-71.0,-66.0,-60.0,-67.0,-70.0,-66.0,-60.0,-77.0,-85.0,-77.0,-85.0,8.0,14.0,11.0,25.0,1
7173,CC:2F:71:3F:1F:24,10117558,10954991985,6897275,10548249480,3220283,406742505,88,1572986,917800434,1564406,916770068,8580,1030366,1519232,619,6901995,704330,88,6080,115556.0,28889.0,-69.0,-63.0,-69.0,-69.0,-68.0,-63.0,-69.0,-69.0,-77.0,-85.0,-77.0,-85.0,8.0,22.0,8.0,16.0,1
7174,F8:59:71:5A:E0:3D,3419428,704277620,199119,297523863,3220309,406753757,0,197415,255406662,192565,254827176,4850,579486,174865,16,201836,3332,0,562,130000.0,39000.0,-66.0,-72.0,-63.0,-71.0,-65.0,-71.0,-62.0,-70.0,-77.0,-85.0,-77.0,-85.0,11.0,13.0,14.0,14.0,1
7175,CC:2F:71:3E:C5:1F,3231765,408155120,11454,1401161,3220311,406753959,6,48853,4091751,40365,3086013,8488,1005738,12077,34,16421,186,6,832,130000.0,39000.0,-69.0,-71.0,-66.0,-60.0,-67.0,-70.0,-66.0,-60.0,-77.0,-85.0,-77.0,-85.0,8.0,14.0,11.0,25.0,1
7176,CC:2F:71:3F:1F:24,10118902,10957040087,6898591,10550286128,3220311,406753959,88,1573171,917823026,1564591,916792660,8580,1030366,1519417,619,6903296,704451,88,6080,115556.0,28889.0,-69.0,-63.0,-69.0,-69.0,-69.0,-63.0,-68.0,-69.0,-77.0,-85.0,-77.0,-85.0,8.0,22.0,8.0,16.0,1
7177,F8:59:71:5A:E0:3D,3419433,704278086,199119,297523863,3220314,406754223,0,197417,255406850,192566,254827246,4851,579604,174866,16,201836,3332,0,562,130000.0,39000.0,-66.0,-72.0,-63.0,-71.0,-65.0,-71.0,-62.0,-70.0,-77.0,-85.0,-77.0,-85.0,11.0,13.0,14.0,14.0,1
7178,CC:2F:71:3E:C5:1F,3231768,408155384,11454,1401161,3220314,406754223,6,48853,4091751,40365,3086013,8488,1005738,12077,34,16421,186,6,832,130000.0,39000.0,-69.0,-71.0,-66.0,-60.0,-67.0,-70.0,-66.0,-60.0,-77.0,-85.0,-77.0,-85.0,8.0,14.0,11.0,25.0,1
7179,CC:2F:71:3F:1F:24,10120210,10959047565,6899896,10552293342,3220314,406754223,88,1573389,917850242,1564809,916819876,8580,1030366,1519635,619,6904602,704520,88,6080,115556.0,28889.0,-69.0,-63.0,-69.0,-69.0,-69.0,-63.0,-69.0,-68.0,-77.0,-85.0,-77.0,-85.0,8.0,22.0,8.0,16.0,1
7180,F8:59:71:5A:E0:3D,3419440,704278885,199119,297523863,3220321,406755022,0,197417,255406850,192566,254827246,4851,579604,174866,16,201836,3332,0,562,130000.0,39000.0,-66.0,-72.0,-63.0,-71.0,-65.0,-71.0,-62.0,-70.0,-77.0,-85.0,-77.0,-85.0,11.0,13.0,14.0,14.0,1
7181,CC:2F:71:3E:C5:1F,3231775,408156183,11454,1401161,3220321,406755022,6,48855,4091939,40366,3086083,8489,1005856,12078,34,16421,186,6,832,130000.0,39000.0,-69.0,-72.0,-67.0,-60.0,-68.0,-71.0,-66.0,-60.0,-77.0,-85.0,-77.0,-85.0,8.0,13.0,10.0,25.0,1
7182,CC:2F:71:3F:1F:24,10121689,10961331180,6901368,10554576158,3220321,406755022,88,1573614,917877450,1565034,916847084,8580,1030366,1519860,619,6906074,704541,88,6080,115556.0,28889.0,-66.0,-63.0,-70.0,-69.0,-66.0,-63.0,-70.0,-69.0,-77.0,-85.0,-77.0,-85.0,11.0,22.0,7.0,16.0,1
7183,F8:59:71:5A:E0:3D,3419444,704279289,199119,297523863,3220325,406755426,0,197417,255406850,192566,254827246,4851,579604,174866,16,201836,3332,0,562,130000.0,39000.0,-66.0,-72.0,-63.0,-71.0,-65.0,-71.0,-62.0,-70.0,-77.0,-85.0,-77.0,-85.0,11.0,13.0,14.0,14.0,1
7184,CC:2F:71:3E:C5:1F,3231779,408156587,11454,1401161,3220325,406755426,6,48855,4091939,40366,3086083,8489,1005856,12078,34,16421,186,6,832,130000.0,39000.0,-69.0,-72.0,-67.0,-60.0,-68.0,-71.0,-66.0,-60.0,-77.0,-85.0,-77.0,-85.0,8.0,13.0,10.0,25.0,1
7185,CC:2F:71:3F:1F:24,10123216,10963694374,6902891,10556938948,3220325,406755426,88,1573831,917903874,1565251,916873508,8580,1030366,1520073,619,6907572,704673,88,6081,117000.0,39000.0,-71.0,-63.0,-71.0,-68.0,-70.0,-63.0,-70.0,-68.0,-77.0,-85.0,-77.0,-85.0,6.0,22.0,6.0,17.0,1
7186,F8:59:71:5A:E0:3D,3419444,704279289,199119,297523863,3220325,406755426,0,197417,255406850,192566,254827246,4851,579604,174866,16,201836,3332,0,562,130000.0,39000.0,-66.0,-72.0,-63.0,-71.0,-65.0,-71.0,-62.0,-70.0,-77.0,-85.0,-77.0,-85.0,11.0,13.0,14.0,14.0,1
7187,CC:2F:71:3E:C5:1F,3231779,408156587,11454,1401161,3220325,406755426,6,48855,4091939,40366,3086083,8489,1005856,12078,34,16421,186,6,832,130000.0,39000.0,-69.0,-72.0,-67.0,-60.0,-68.0,-71.0,-66.0,-60.0,-77.0,-85.0,-77.0,-85.0,8.0,13.0,10.0,25.0,1
7188,CC:2F:71:3F:1F:24,10124518,10965705696,6904191,10558950068,3220327,406755628,88,1574026,917927776,1565446,916897410,8580,1030366,1520267,619,6908898,704890,88,6081,104000.0,26000.0,-70.0,-64.0,-71.0,-69.0,-70.0,-64.0,-71.0,-68.0,-77.0,-85.0,-77.0,-85.0,7.0,21.0,6.0,16.0,1
7189,F8:59:71:5A:E0:3D,3419453,704280157,199119,297523863,3220334,406756294,0,197417,255406850,192566,254827246,4851,579604,174866,16,201836,3332,0,562,130000.0,39000.0,-66.0,-72.0,-63.0,-71.0,-65.0,-71.0,-62.0,-70.0,-77.0,-85.0,-77.0,-85.0,11.0,13.0,14.0,14.0,1
7190,CC:2F:71:3E:C5:1F,3231788,408157455,11454,1401161,3220334,406756294,6,48855,4091939,40366,3086083,8489,1005856,12078,34,16421,186,6,832,130000.0,39000.0,-69.0,-72.0,-67.0,-60.0,-68.0,-71.0,-66.0,-60.0,-77.0,-85.0,-77.0,-85.0,8.0,13.0,10.0,25.0,1
7191,CC:2F:71:3F:1F:24,10125455,10967136518,6905121,10560380224,3220334,406756294,88,1574193,917948362,1565613,916917996,8580,1030366,1520433,619,6909841,705082,88,6081,104000.0,26000.0,-69.0,-65.0,-73.0,-69.0,-68.0,-65.0,-72.0,-69.0,-77.0,-85.0,-77.0,-85.0,8.0,20.0,4.0,16.0,1
7192,F8:59:71:5A:E0:3D,3419453,704280157,199119,297523863,3220334,406756294,0,197417,255406850,192566,254827246,4851,579604,174866,16,201836,3332,0,562,130000.0,39000.0,-66.0,-72.0,-63.0,-71.0,-65.0,-71.0,-62.0,-70.0,-77.0,-85.0,-77.0,-85.0,11.0,13.0,14.0,14.0,1
7193,CC:2F:71:3E:C5:1F,3231788,408157455,11454,1401161,3220334,406756294,6,48855,4091939,40366,3086083,8489,1005856,12078,34,16421,186,6,832,130000.0,39000.0,-69.0,-72.0,-67.0,-60.0,-68.0,-71.0,-66.0,-60.0,-77.0,-85.0,-77.0,-85.0,8.0,13.0,10.0,25.0,1
7194,CC:2F:71:3F:1F:24,10126425,10968618656,6906091,10561862362,3220334,406756294,88,1574424,917976956,1565844,916946590,8580,1030366,1520664,619,6910799,705155,88,6082,86667.0,14444.0,-68.0,-64.0,-71.0,-68.0,-69.0,-64.0,-71.0,-68.0,-77.0,-85.0,-77.0,-85.0,9.0,21.0,6.0,17.0,1
7195,F8:59:71:5A:E0:3D,3419461,704280965,199119,297523863,3220342,406757102,0,197417,255406850,192566,254827246,4851,579604,174866,16,201836,3332,0,562,130000.0,39000.0,-66.0,-72.0,-63.0,-71.0,-65.0,-71.0,-62.0,-70.0,-77.0,-85.0,-77.0,-85.0,11.0,13.0,14.0,14.0,1
7196,CC:2F:71:3E:C5:1F,3231796,408158263,11454,1401161,3220342,406757102,6,48855,4091939,40366,3086083,8489,1005856,12078,34,16421,186,6,832,130000.0,39000.0,-69.0,-72.0,-67.0,-60.0,-68.0,-71.0,-66.0,-60.0,-77.0,-85.0,-77.0,-85.0,8.0,13.0,10.0,25.0,1
7197,CC:2F:71:3F:1F:24,10127179,10969757484,6906837,10563000382,3220342,406757102,88,1574590,917997604,1566010,916967238,8580,1030366,1520829,619,6911542,705199,88,6082,86667.0,14444.0,-70.0,-64.0,-70.0,-67.0,-70.0,-64.0,-69.0,-67.0,-77.0,-85.0,-77.0,-85.0,7.0,21.0,7.0,18.0,1
7198,F8:59:71:5A:E0:3D,3419462,704281025,199119,297523863,3220343,406757162,0,197417,255406850,192566,254827246,4851,579604,174866,16,201836,3332,0,562,130000.0,39000.0,-66.0,-72.0,-63.0,-71.0,-65.0,-71.0,-62.0,-70.0,-77.0,-85.0,-77.0,-85.0,11.0,13.0,14.0,14.0,1
7199,CC:2F:71:3E:C5:1F,3231797,408158323,11454,1401161,3220343,406757162,6,48855,4091939,40366,3086083,8489,1005856,12078,34,16421,186,6,832,130000.0,39000.0,-69.0,-72.0,-67.0,-60.0,-68.0,-71.0,-66.0,-60.0,-77.0,-85.0,-77.0,-85.0,8.0,13.0,10.0,25.0,1
7200,CC:2F:71:3F:1F:24,10128045,10971083402,6907702,10564326240,3220343,406757162,88,1574764,918018924,1566184,916988558,8580,1030366,1521003,619,6912422,705258,88,6082,115556.0,26000.0,-69.0,-65.0,-69.0,-69.0,-69.0,-65.0,-69.0,-69.0,-77.0,-85.0,-77.0,-85.0,8.0,20.0,8.0,16.0,1
7201,F8:59:71:5A:E0:3D,3419470,704281833,199119,297523863,3220351,406757970,0,197417,255406850,192566,254827246,4851,579604,174866,16,201836,3332,0,562,130000.0,39000.0,-66.0,-72.0,-63.0,-71.0,-65.0,-71.0,-62.0,-70.0,-77.0,-85.0,-77.0,-85.0,11.0,13.0,14.0,14.0,1
7202,CC:2F:71:3E:C5:1F,3231805,408159131,11454,1401161,3220351,406757970,6,48855,4091939,40366,3086083,8489,1005856,12078,34,16421,186,6,832,130000.0,39000.0,-69.0,-72.0,-67.0,-60.0,-68.0,-71.0,-66.0,-60.0,-77.0,-85.0,-77.0,-85.0,8.0,13.0,10.0,25.0,1
7203,CC:2F:71:3F:1F:24,10129083,10972669102,6908732,10565911132,3220351,406757970,88,1574900,918035994,1566320,917005628,8580,1030366,1521139,619,6913452,705497,88,6082,130000.0,43333.0,-71.0,-66.0,-70.0,-68.0,-70.0,-65.0,-70.0,-68.0,-77.0,-85.0,-77.0,-85.0,6.0,19.0,7.0,17.0,1
7204,F8:59:71:5A:E0:3D,3419470,704281833,199119,297523863,3220351,406757970,0,197417,255406850,192566,254827246,4851,579604,174866,16,201836,3332,0,562,130000.0,39000.0,-66.0,-72.0,-63.0,-71.0,-65.0,-71.0,-62.0,-70.0,-77.0,-85.0,-77.0,-85.0,11.0,13.0,14.0,14.0,1
7205,CC:2F:71:3E:C5:1F,3231805,408159131,11454,1401161,3220351,406757970,6,48855,4091939,40366,3086083,8489,1005856,12078,34,16421,186,6,832,130000.0,39000.0,-69.0,-72.0,-67.0,-60.0,-68.0,-71.0,-66.0,-60.0,-77.0,-85.0,-77.0,-85.0,8.0,13.0,10.0,25.0,1
7206,CC:2F:71:3F:1F:24,10130815,10975355726,6910463,10568597696,3220352,406758030,88,1575152,918066916,1566572,917036550,8580,1030366,1521391,619,6915183,705680,88,6082,115556.0,28889.0,-69.0,-64.0,-69.0,-67.0,-69.0,-64.0,-69.0,-67.0,-77.0,-85.0,-77.0,-85.0,8.0,21.0,8.0,18.0,1
7207,F8:59:71:5A:E0:3D,3419477,704282499,199119,297523863,3220358,406758636,0,197417,255406850,192566,254827246,4851,579604,174866,16,201836,3332,0,562,130000.0,39000.0,-66.0,-72.0,-63.0,-71.0,-65.0,-71.0,-62.0,-70.0,-77.0,-85.0,-77.0,-85.0,11.0,13.0,14.0,14.0,1
7208,CC:2F:71:3E:C5:1F,3231812,408159797,11454,1401161,3220358,406758636,6,48855,4091939,40366,3086083,8489,1005856,12078,34,16421,186,6,832,130000.0,39000.0,-69.0,-72.0,-67.0,-60.0,-68.0,-71.0,-66.0,-60.0,-77.0,-85.0,-77.0,-85.0,8.0,13.0,10.0,25.0,1
7209,CC:2F:71:3F:1F:24,10132502,10977968670,6912144,10571210034,3220358,406758636,88,1575368,918093248,1566788,917062882,8580,1030366,1521607,619,6916864,705965,88,6082,117000.0,39000.0,-70.0,-64.0,-70.0,-68.0,-69.0,-64.0,-70.0,-68.0,-77.0,-85.0,-77.0,-85.0,7.0,21.0,7.0,17.0,1
7210,F8:59:71:5A:E0:3D,3419479,704282701,199119,297523863,3220360,406758838,0,197417,255406850,192566,254827246,4851,579604,174866,16,201836,3332,0,562,130000.0,39000.0,-66.0,-72.0,-63.0,-71.0,-65.0,-71.0,-62.0,-70.0,-77.0,-85.0,-77.0,-85.0,11.0,13.0,14.0,14.0,1
7211,CC:2F:71:3E:C5:1F,3231814,408159999,11454,1401161,3220360,406758838,6,48855,4091939,40366,3086083,8489,1005856,12078,34,16421,186,6,832,130000.0,39000.0,-69.0,-72.0,-67.0,-60.0,-68.0,-71.0,-66.0,-60.0,-77.0,-85.0,-77.0,-85.0,8.0,13.0,10.0,25.0,1
7212,CC:2F:71:3F:1F:24,10133838,10980033644,6913478,10573274806,3220360,406758838,88,1575535,918113854,1566955,917083488,8580,1030366,1521774,619,6918198,706273,88,6082,115556.0,28889.0,-69.0,-65.0,-70.0,-69.0,-69.0,-65.0,-70.0,-68.0,-77.0,-85.0,-77.0,-85.0,8.0,20.0,7.0,16.0,1
7213,F8:59:71:5A:E0:3D,3419483,704283105,199119,297523863,3220364,406759242,0,197417,255406850,192566,254827246,4851,579604,174866,16,201836,3332,0,562,130000.0,39000.0,-66.0,-72.0,-63.0,-71.0,-65.0,-71.0,-62.0,-70.0,-77.0,-85.0,-77.0,-85.0,11.0,13.0,14.0,14.0,1
7214,CC:2F:71:3E:C5:1F,3231821,408160665,11454,1401161,3220367,406759504,6,48855,4091939,40366,3086083,8489,1005856,12078,34,16421,186,6,832,130000.0,39000.0,-69.0,-72.0,-67.0,-60.0,-68.0,-71.0,-66.0,-60.0,-77.0,-85.0,-77.0,-85.0,8.0,13.0,10.0,25.0,1
7215,CC:2F:71:3F:1F:24,10134700,10981344780,6914333,10574585276,3220367,406759504,88,1575688,918132836,1567108,917102470,8580,1030366,1521927,619,6919043,706358,88,6082,115556.0,28889.0,-69.0,-65.0,-69.0,-68.0,-68.0,-65.0,-70.0,-68.0,-77.0,-85.0,-77.0,-85.0,8.0,20.0,8.0,17.0,1
7216,F8:59:71:5A:E0:3D,3419488,704283569,199119,297523863,3220369,406759706,0,197417,255406850,192566,254827246,4851,579604,174866,16,201836,3332,0,562,130000.0,39000.0,-66.0,-72.0,-63.0,-71.0,-65.0,-71.0,-62.0,-70.0,-77.0,-85.0,-77.0,-85.0,11.0,13.0,14.0,14.0,1
7217,CC:2F:71:3E:C5:1F,3231823,408160867,11454,1401161,3220369,406759706,6,48855,4091939,40366,3086083,8489,1005856,12078,34,16421,186,6,832,130000.0,39000.0,-69.0,-72.0,-67.0,-60.0,-68.0,-71.0,-66.0,-60.0,-77.0,-85.0,-77.0,-85.0,8.0,13.0,10.0,25.0,1
7218,CC:2F:71:3F:1F:24,10135729,10982916346,6915360,10576156640,3220369,406759706,88,1575836,918151675,1567256,917121309,8580,1030366,1522075,619,6920080,706367,88,6082,117000.0,39000.0,-69.0,-65.0,-70.0,-69.0,-68.0,-65.0,-70.0,-68.0,-77.0,-85.0,-77.0,-85.0,8.0,20.0,7.0,16.0,1
7219,F8:59:71:5A:E0:3D,3419490,704283771,199119,297523863,3220371,406759908,0,197417,255406850,192566,254827246,4851,579604,174866,16,201836,3332,0,562,130000.0,39000.0,-66.0,-72.0,-63.0,-71.0,-65.0,-71.0,-62.0,-70.0,-77.0,-85.0,-77.0,-85.0,11.0,13.0,14.0,14.0,1
7220,CC:2F:71:3E:C5:1F,3231825,408161069,11454,1401161,3220371,406759908,6,48855,4091939,40366,3086083,8489,1005856,12078,34,16421,186,6,832,130000.0,39000.0,-69.0,-72.0,-67.0,-60.0,-68.0,-71.0,-66.0,-60.0,-77.0,-85.0,-77.0,-85.0,8.0,13.0,10.0,25.0,1
7221,CC:2F:71:3F:1F:24,10136842,10984629370,6916471,10577869462,3220371,406759908,88,1576035,918175891,1567455,917145525,8580,1030366,1522274,619,6921191,706422,88,6082,130000.0,43333.0,-69.0,-65.0,-71.0,-69.0,-68.0,-65.0,-70.0,-69.0,-77.0,-85.0,-77.0,-85.0,8.0,20.0,6.0,16.0,1
7222,F8:59:71:5A:E0:3D,3419497,704284437,199119,297523863,3220378,406760574,0,197417,255406850,192566,254827246,4851,579604,174866,16,201836,3332,0,562,130000.0,39000.0,-66.0,-72.0,-63.0,-71.0,-65.0,-71.0,-62.0,-70.0,-77.0,-85.0,-77.0,-85.0,11.0,13.0,14.0,14.0,1
7223,CC:2F:71:3E:C5:1F,3231833,408162008,11454,1401161,3220379,406760847,6,48855,4091939,40366,3086083,8489,1005856,12078,34,16421,186,6,832,130000.0,39000.0,-69.0,-72.0,-67.0,-60.0,-68.0,-71.0,-66.0,-60.0,-77.0,-85.0,-77.0,-85.0,8.0,13.0,10.0,25.0,1
7224,CC:2F:71:3F:1F:24,10137617,10985802083,6917238,10579041236,3220379,406760847,88,1576173,918193071,1567593,917162705,8580,1030366,1522412,619,6921950,706427,88,6082,130000.0,43333.0,-69.0,-65.0,-71.0,-69.0,-68.0,-65.0,-70.0,-69.0,-77.0,-85.0,-77.0,-85.0,8.0,20.0,6.0,16.0,1
7225,F8:59:71:5A:E0:3D,3419498,704284710,199119,297523863,3220379,406760847,0,197417,255406850,192566,254827246,4851,579604,174866,16,201836,3332,0,562,130000.0,39000.0,-66.0,-72.0,-63.0,-71.0,-65.0,-71.0,-62.0,-70.0,-77.0,-85.0,-77.0,-85.0,11.0,13.0,14.0,14.0,1
7226,CC:2F:71:3E:C5:1F,3231833,408162008,11454,1401161,3220379,406760847,6,48855,4091939,40366,3086083,8489,1005856,12078,34,16421,186,6,832,130000.0,39000.0,-69.0,-72.0,-67.0,-60.0,-68.0,-71.0,-66.0,-60.0,-77.0,-85.0,-77.0,-85.0,8.0,13.0,10.0,25.0,1
7227,CC:2F:71:3F:1F:24,10138612,10987330463,6918231,10580569414,3220381,406761049,88,1576343,918214169,1567763,917183803,8580,1030366,1522580,619,6922943,706479,88,6083,130000.0,43333.0,-69.0,-65.0,-71.0,-69.0,-68.0,-65.0,-70.0,-68.0,-77.0,-85.0,-77.0,-85.0,8.0,20.0,6.0,16.0,1
7228,F8:59:71:5A:E0:3D,3419506,704285518,199119,297523863,3220387,406761655,0,197417,255406850,192566,254827246,4851,579604,174866,16,201836,3332,0,562,130000.0,39000.0,-66.0,-72.0,-63.0,-71.0,-65.0,-71.0,-62.0,-70.0,-77.0,-85.0,-77.0,-85.0,11.0,13.0,14.0,14.0,1
7229,CC:2F:71:3E:C5:1F,3231841,408162816,11454,1401161,3220387,406761655,6,48855,4091939,40366,3086083,8489,1005856,12078,34,16421,186,6,832,130000.0,39000.0,-69.0,-72.0,-67.0,-60.0,-68.0,-71.0,-66.0,-60.0,-77.0,-85.0,-77.0,-85.0,8.0,13.0,10.0,25.0,1
7230,CC:2F:71:3F:1F:24,10139736,10989056665,6919349,10582295010,3220387,406761655,88,1576528,918236851,1567948,917206485,8580,1030366,1522765,619,6924069,706495,88,6083,130000.0,39000.0,-69.0,-65.0,-70.0,-69.0,-68.0,-65.0,-70.0,-68.0,-77.0,-85.0,-77.0,-85.0,8.0,20.0,7.0,16.0,1
7231,F8:59:71:5A:E0:3D,3419507,704285578,199119,297523863,3220388,406761715,0,197417,255406850,192566,254827246,4851,579604,174866,16,201836,3332,0,562,130000.0,39000.0,-66.0,-72.0,-63.0,-71.0,-65.0,-71.0,-62.0,-70.0,-77.0,-85.0,-77.0,-85.0,11.0,13.0,14.0,14.0,1
7232,CC:2F:71:3E:C5:1F,3231842,408162876,11454,1401161,3220388,406761715,6,48855,4091939,40366,3086083,8489,1005856,12078,34,16421,186,6,832,130000.0,39000.0,-69.0,-72.0,-67.0,-60.0,-68.0,-71.0,-66.0,-60.0,-77.0,-85.0,-77.0,-85.0,8.0,13.0,10.0,25.0,1
