sample,station,tx_total_pkts,tx_total_bytes,tx_ucast_pkts,tx_ucast_bytes,tx_mcast_bcast_pkts,tx_mcast_bcast_bytes,tx_failures,rx_data_pkts,rx_data_bytes,rx_ucast_pkts,rx_ucast_bytes,rx_mcast_bcast_pkts,rx_mcast_bcast_bytes,rx_decrypt_succeeds,tx_data_pkts_retried,tx_total_pkts_sent,tx_pkts_retries,tx_pkts_retry_exhausted,rx_total_pkts_retried,rate_last_tx_pkt_min,rate_last_tx_pkt_max,per_antenna_rssi_last_rx_data_frame_1,per_antenna_rssi_last_rx_data_frame_2,per_antenna_rssi_last_rx_data_frame_3,per_antenna_rssi_last_rx_data_frame_4,per_antenna_avg_rssi_rx_data_frames_1,per_antenna_avg_rssi_rx_data_frames_2,per_antenna_avg_rssi_rx_data_frames_3,per_antenna_avg_rssi_rx_data_frames_4,per_antenna_noise_floor_1,per_antenna_noise_floor_2,per_antenna_noise_floor_3,per_antenna_noise_floor_4,sinr_per_antenna_1,sinr_per_antenna_2,sinr_per_antenna_3,sinr_per_antenna_4,attack
1,62:47:05:9D:EB:15,3841901,486705379,2089,2416262,3839812,484289117,0,4173,3001170,4142,2996189,31,4981,2038,0,2130,53,0,105,216660.0,130000.0,-50.0,-44.0,-39.0,-47.0,-47.0,-46.0,-40.0,-48.0,-88.0,-89.0,-85.0,-88.0,38.0,45.0,46.0,41.0,1
2,3C:55:76:E8:8F:1F,3908854,656935511,69040,172646192,3839814,484289319,25,32969,6889846,32532,6814278,437,75568,14084,35,69113,7032,25,421,286760.0,172050.0,-45.0,-54.0,-52.0,-41.0,-43.0,-52.0,-51.0,-39.0,-88.0,-89.0,-85.0,-88.0,43.0,35.0,33.0,47.0,1
3,92:69:1D:31:68:E9,3843776,487919737,3962,3630418,3839814,484289319,0,4989,1121677,4835,1086819,154,34858,2145,11,4187,91,0,50,229410.0,130000.0,-52.0,-48.0,-44.0,-47.0,-52.0,-47.0,-43.0,-47.0,-88.0,-89.0,-85.0,-88.0,36.0,41.0,41.0,41.0,1
4,CC:2F:71:3F:1F:24,4761257,1504915477,921443,1020626158,3839814,484289319,37,759865,827636922,759113,827546518,752,90404,733447,15,921700,96282,34,574,130000.0,43333.0,-67.0,-72.0,-67.0,-73.0,-67.0,-72.0,-67.0,-73.0,-88.0,-89.0,-85.0,-88.0,21.0,17.0,18.0,15.0,1
5,CC:2F:71:3E:C5:1F,3840733,484401773,918,112181,3839815,484289592,0,3827,321463,3158,242077,669,79386,972,11,1319,25,0,47,144444.0,39000.0,-72.0,-72.0,-69.0,-60.0,-71.0,-71.0,-68.0,-60.0,-88.0,-89.0,-85.0,-88.0,16.0,17.0,16.0,28.0,1
6,BA:8C:B9:54:50:24,3844683,490475955,4868,6186363,3839815,484289592,0,9217,1714733,9195,1711238,22,3495,2351,16,5334,40,0,62,216660.0,130000.0,-48.0,-35.0,-43.0,-45.0,-47.0,-34.0,-42.0,-45.0,-88.0,-89.0,-85.0,-88.0,40.0,54.0,42.0,43.0,1
7,62:47:05:9D:EB:15,3841906,486706056,2089,2416262,3839817,484289794,0,4173,3001170,4142,2996189,31,4981,2038,0,2130,53,0,105,216660.0,130000.0,-50.0,-44.0,-39.0,-47.0,-47.0,-46.0,-40.0,-48.0,-88.0,-89.0,-85.0,-88.0,38.0,45.0,46.0,41.0,1
8,3C:55:76:E8:8F:1F,3908857,656935986,69040,172646192,3839817,484289794,25,32969,6889846,32532,6814278,437,75568,14084,35,69113,7032,25,421,286760.0,172050.0,-45.0,-54.0,-52.0,-41.0,-43.0,-52.0,-51.0,-39.0,-88.0,-89.0,-85.0,-88.0,43.0,35.0,33.0,47.0,1
9,92:69:1D:31:68:E9,3843779,487920212,3962,3630418,3839817,484289794,0,4992,1121881,4838,1087023,154,34858,2145,11,4187,91,0,51,229410.0,130000.0,-53.0,-46.0,-42.0,-48.0,-52.0,-47.0,-43.0,-48.0,-88.0,-89.0,-85.0,-88.0,35.0,43.0,43.0,40.0,1
10,CC:2F:71:3F:1F:24,4761472,1505182136,921655,1020892342,3839817,484289794,37,760054,827888800,759302,827798396,752,90404,733633,15,921912,96287,34,574,130000.0,43333.0,-67.0,-71.0,-66.0,-73.0,-67.0,-71.0,-66.0,-73.0,-88.0,-89.0,-85.0,-88.0,21.0,18.0,19.0,15.0,1
11,CC:2F:71:3E:C5:1F,3840735,484401975,918,112181,3839817,484289794,0,3827,321463,3158,242077,669,79386,972,11,1319,25,0,47,144444.0,39000.0,-72.0,-72.0,-69.0,-60.0,-71.0,-71.0,-68.0,-60.0,-88.0,-89.0,-85.0,-88.0,16.0,17.0,16.0,28.0,1
12,BA:8C:B9:54:50:24,3844685,490476157,4868,6186363,3839817,484289794,0,9217,1714733,9195,1711238,22,3495,2351,16,5334,40,0,62,216660.0,130000.0,-48.0,-35.0,-43.0,-45.0,-47.0,-34.0,-42.0,-45.0,-88.0,-89.0,-85.0,-88.0,40.0,54.0,42.0,43.0,1
13,62:47:05:9D:EB:15,3841913,486706722,2089,2416262,3839824,484290460,0,4173,3001170,4142,2996189,31,4981,2038,0,2130,53,0,105,216660.0,130000.0,-50.0,-44.0,-39.0,-47.0,-47.0,-46.0,-40.0,-48.0,-88.0,-89.0,-85.0,-88.0,38.0,45.0,46.0,41.0,1
14,3C:55:76:E8:8F:1F,3908864,656936652,69040,172646192,3839824,484290460,25,32969,6889846,32532,6814278,437,75568,14084,35,69113,7032,25,421,286760.0,172050.0,-45.0,-54.0,-52.0,-41.0,-43.0,-52.0,-51.0,-39.0,-88.0,-89.0,-85.0,-88.0,43.0,35.0,33.0,47.0,1
15,92:69:1D:31:68:E9,3843786,487920878,3962,3630418,3839824,484290460,0,4992,1121881,4838,1087023,154,34858,2145,11,4187,91,0,51,229410.0,130000.0,-53.0,-46.0,-42.0,-48.0,-52.0,-47.0,-43.0,-48.0,-88.0,-89.0,-85.0,-88.0,35.0,43.0,43.0,40.0,1
16,CC:2F:71:3F:1F:24,4761690,1505446232,921866,1021155772,3839824,484290460,37,760243,828138000,759491,828047596,752,90404,733816,15,922123,96288,34,574,130000.0,43333.0,-68.0,-71.0,-66.0,-73.0,-67.0,-71.0,-66.0,-73.0,-88.0,-89.0,-85.0,-88.0,20.0,18.0,19.0,15.0,1
17,CC:2F:71:3E:C5:1F,3840742,484402641,918,112181,3839824,484290460,0,3827,321463,3158,242077,669,79386,972,11,1319,25,0,47,144444.0,39000.0,-72.0,-72.0,-69.0,-60.0,-71.0,-71.0,-68.0,-60.0,-88.0,-89.0,-85.0,-88.0,16.0,17.0,16.0,28.0,1
18,BA:8C:B9:54:50:24,3844692,490476823,4868,6186363,3839824,484290460,0,9217,1714733,9195,1711238,22,3495,2351,16,5334,40,0,62,216660.0,130000.0,-48.0,-35.0,-43.0,-45.0,-47.0,-34.0,-42.0,-45.0,-88.0,-89.0,-85.0,-88.0,40.0,54.0,42.0,43.0,1
19,62:47:05:9D:EB:15,3841917,486707292,2089,2416262,3839828,484291030,0,4173,3001170,4142,2996189,31,4981,2038,0,2130,53,0,105,216660.0,130000.0,-50.0,-44.0,-39.0,-47.0,-47.0,-46.0,-40.0,-48.0,-88.0,-89.0,-85.0,-88.0,38.0,45.0,46.0,41.0,1
20,3C:55:76:E8:8F:1F,3908868,656937222,69040,172646192,3839828,484291030,25,32969,6889846,32532,6814278,437,75568,14084,35,69113,7032,25,421,286760.0,172050.0,-45.0,-54.0,-52.0,-41.0,-43.0,-52.0,-51.0,-39.0,-88.0,-89.0,-85.0,-88.0,43.0,35.0,33.0,47.0,1
21,92:69:1D:31:68:E9,3843790,487921448,3962,3630418,3839828,484291030,0,4992,1121881,4838,1087023,154,34858,2145,11,4187,91,0,51,229410.0,130000.0,-53.0,-46.0,-42.0,-48.0,-52.0,-47.0,-43.0,-48.0,-88.0,-89.0,-85.0,-88.0,35.0,43.0,43.0,40.0,1
22,CC:2F:71:3F:1F:24,4761907,1505714668,922079,1021423638,3839828,484291030,37,760433,828388384,759681,828297980,752,90404,734006,15,922336,96295,34,575,130000.0,43333.0,-67.0,-71.0,-67.0,-73.0,-67.0,-71.0,-66.0,-73.0,-88.0,-89.0,-85.0,-88.0,21.0,18.0,18.0,15.0,1
23,CC:2F:71:3E:C5:1F,3840746,484403211,918,112181,3839828,484291030,0,3827,321463,3158,242077,669,79386,972,11,1319,25,0,47,144444.0,39000.0,-72.0,-72.0,-69.0,-60.0,-71.0,-71.0,-68.0,-60.0,-88.0,-89.0,-85.0,-88.0,16.0,17.0,16.0,28.0,1
24,BA:8C:B9:54:50:24,3844696,490477393,4868,6186363,3839828,484291030,0,9217,1714733,9195,1711238,22,3495,2351,16,5334,40,0,62,216660.0,130000.0,-48.0,-35.0,-43.0,-45.0,-47.0,-34.0,-42.0,-45.0,-88.0,-89.0,-85.0,-88.0,40.0,54.0,42.0,43.0,1
25,62:47:05:9D:EB:15,3841924,486707958,2089,2416262,3839835,484291696,0,4173,3001170,4142,2996189,31,4981,2038,0,2130,53,0,105,216660.0,130000.0,-50.0,-44.0,-39.0,-47.0,-47.0,-46.0,-40.0,-48.0,-88.0,-89.0,-85.0,-88.0,38.0,45.0,46.0,41.0,1
26,3C:55:76:E8:8F:1F,3908875,656937888,69040,172646192,3839835,484291696,25,32969,6889846,32532,6814278,437,75568,14084,35,69113,7032,25,421,286760.0,172050.0,-45.0,-54.0,-52.0,-41.0,-43.0,-52.0,-51.0,-39.0,-88.0,-89.0,-85.0,-88.0,43.0,35.0,33.0,47.0,1
27,92:69:1D:31:68:E9,3843797,487922114,3962,3630418,3839835,484291696,0,4992,1121881,4838,1087023,154,34858,2145,11,4187,91,0,51,229410.0,130000.0,-53.0,-46.0,-42.0,-48.0,-52.0,-47.0,-43.0,-48.0,-88.0,-89.0,-85.0,-88.0,35.0,43.0,43.0,40.0,1
28,CC:2F:71:3F:1F:24,4762123,1505978490,922288,1021686794,3839835,484291696,37,760621,828634212,759868,828543694,753,90518,734194,15,922545,96296,34,575,130000.0,43333.0,-67.0,-71.0,-67.0,-72.0,-67.0,-71.0,-67.0,-72.0,-88.0,-89.0,-85.0,-88.0,21.0,18.0,18.0,16.0,1
29,CC:2F:71:3E:C5:1F,3840753,484403877,918,112181,3839835,484291696,0,3827,321463,3158,242077,669,79386,972,11,1319,25,0,47,144444.0,39000.0,-72.0,-72.0,-69.0,-60.0,-71.0,-71.0,-68.0,-60.0,-88.0,-89.0,-85.0,-88.0,16.0,17.0,16.0,28.0,1
30,BA:8C:B9:54:50:24,3844704,490478119,4868,6186363,3839836,484291756,0,9217,1714733,9195,1711238,22,3495,2351,16,5334,40,0,62,216660.0,130000.0,-48.0,-35.0,-43.0,-45.0,-47.0,-34.0,-42.0,-45.0,-88.0,-89.0,-85.0,-88.0,40.0,54.0,42.0,43.0,1
31,62:47:05:9D:EB:15,3841930,486708506,2089,2416262,3839841,484292244,0,4173,3001170,4142,2996189,31,4981,2038,0,2130,53,0,105,216660.0,130000.0,-50.0,-44.0,-39.0,-47.0,-47.0,-46.0,-40.0,-48.0,-88.0,-89.0,-85.0,-88.0,38.0,45.0,46.0,41.0,1
32,3C:55:76:E8:8F:1F,3908883,656938963,69042,172646719,3839841,484292244,25,32984,6891301,32547,6815733,437,75568,14088,35,69115,7032,25,421,270830.0,162500.0,-50.0,-59.0,-45.0,-46.0,-49.0,-57.0,-45.0,-45.0,-88.0,-89.0,-85.0,-88.0,38.0,30.0,40.0,42.0,1
33,92:69:1D:31:68:E9,3843803,487922662,3962,3630418,3839841,484292244,0,4992,1121881,4838,1087023,154,34858,2145,11,4187,91,0,51,229410.0,130000.0,-53.0,-46.0,-42.0,-48.0,-52.0,-47.0,-43.0,-48.0,-88.0,-89.0,-85.0,-88.0,35.0,43.0,43.0,40.0,1
34,CC:2F:71:3F:1F:24,4762348,1506247043,922505,1021954597,3839843,484292446,37,760819,828884658,760063,828793686,756,90972,734392,15,922762,96305,34,575,130000.0,39000.0,-67.0,-71.0,-66.0,-73.0,-67.0,-71.0,-66.0,-73.0,-88.0,-89.0,-85.0,-88.0,21.0,18.0,19.0,15.0,1
35,CC:2F:71:3E:C5:1F,3840761,484404627,918,112181,3839843,484292446,0,3827,321463,3158,242077,669,79386,972,11,1319,25,0,47,144444.0,39000.0,-72.0,-72.0,-69.0,-60.0,-71.0,-71.0,-68.0,-60.0,-88.0,-89.0,-85.0,-88.0,16.0,17.0,16.0,28.0,1
36,BA:8C:B9:54:50:24,3844715,490479213,4868,6186363,3839847,484292850,0,9217,1714733,9195,1711238,22,3495,2351,16,5334,40,0,62,216660.0,130000.0,-48.0,-35.0,-43.0,-45.0,-47.0,-34.0,-42.0,-45.0,-88.0,-89.0,-85.0,-88.0,40.0,54.0,42.0,43.0,1
37,62:47:05:9D:EB:15,3841936,486709112,2089,2416262,3839847,484292850,0,4173,3001170,4142,2996189,31,4981,2038,0,2130,53,0,105,216660.0,130000.0,-50.0,-44.0,-39.0,-47.0,-47.0,-46.0,-40.0,-48.0,-88.0,-89.0,-85.0,-88.0,38.0,45.0,46.0,41.0,1
38,3C:55:76:E8:8F:1F,3908889,656939569,69042,172646719,3839847,484292850,25,32984,6891301,32547,6815733,437,75568,14088,35,69115,7032,25,421,270830.0,162500.0,-50.0,-59.0,-45.0,-46.0,-49.0,-57.0,-45.0,-45.0,-88.0,-89.0,-85.0,-88.0,38.0,30.0,40.0,42.0,1
39,92:69:1D:31:68:E9,3843809,487923268,3962,3630418,3839847,484292850,0,4992,1121881,4838,1087023,154,34858,2145,11,4187,91,0,51,229410.0,130000.0,-53.0,-46.0,-42.0,-48.0,-52.0,-47.0,-43.0,-48.0,-88.0,-89.0,-85.0,-88.0,35.0,43.0,43.0,40.0,1
40,CC:2F:71:3F:1F:24,4762565,1506513593,922718,1022220743,3839847,484292850,37,761007,829133346,760251,829042374,756,90972,734580,15,922975,96320,34,575,130000.0,43333.0,-68.0,-71.0,-67.0,-73.0,-67.0,-71.0,-66.0,-73.0,-88.0,-89.0,-85.0,-88.0,20.0,18.0,18.0,15.0,1
41,CC:2F:71:3E:C5:1F,3840766,484405165,918,112181,3839848,484292984,0,3827,321463,3158,242077,669,79386,972,11,1319,25,0,47,144444.0,39000.0,-72.0,-72.0,-69.0,-60.0,-71.0,-71.0,-68.0,-60.0,-88.0,-89.0,-85.0,-88.0,16.0,17.0,16.0,28.0,1
42,BA:8C:B9:54:50:24,3844717,490479415,4868,6186363,3839849,484293052,0,9217,1714733,9195,1711238,22,3495,2351,16,5334,40,0,62,216660.0,130000.0,-48.0,-35.0,-43.0,-45.0,-47.0,-34.0,-42.0,-45.0,-88.0,-89.0,-85.0,-88.0,40.0,54.0,42.0,43.0,1
43,62:47:05:9D:EB:15,3841941,486709576,2089,2416262,3839852,484293314,0,4173,3001170,4142,2996189,31,4981,2038,0,2130,53,0,105,216660.0,130000.0,-50.0,-44.0,-39.0,-47.0,-47.0,-46.0,-40.0,-48.0,-88.0,-89.0,-85.0,-88.0,38.0,45.0,46.0,41.0,1
44,3C:55:76:E8:8F:1F,3908900,656940700,69044,172646982,3839856,484293718,25,32989,6895105,32552,6819537,437,75568,14090,35,69117,7032,25,421,270830.0,162500.0,-45.0,-56.0,-52.0,-41.0,-47.0,-56.0,-47.0,-43.0,-88.0,-89.0,-85.0,-88.0,43.0,33.0,33.0,47.0,1
45,92:69:1D:31:68:E9,3843818,487924136,3962,3630418,3839856,484293718,0,4992,1121881,4838,1087023,154,34858,2145,11,4187,91,0,51,229410.0,130000.0,-53.0,-46.0,-42.0,-48.0,-52.0,-47.0,-43.0,-48.0,-88.0,-89.0,-85.0,-88.0,35.0,43.0,43.0,40.0,1
46,CC:2F:71:3F:1F:24,4762781,1506774523,922925,1022480805,3839856,484293718,37,761193,829376106,760437,829285134,756,90972,734766,15,923182,96320,34,575,130000.0,43333.0,-68.0,-71.0,-66.0,-73.0,-67.0,-71.0,-66.0,-72.0,-88.0,-89.0,-85.0,-88.0,20.0,18.0,19.0,15.0,1
47,CC:2F:71:3E:C5:1F,3840774,484405899,918,112181,3839856,484293718,0,3827,321463,3158,242077,669,79386,972,11,1319,25,0,47,144444.0,39000.0,-72.0,-72.0,-69.0,-60.0,-71.0,-71.0,-68.0,-60.0,-88.0,-89.0,-85.0,-88.0,16.0,17.0,16.0,28.0,1
48,BA:8C:B9:54:50:24,3844724,490480081,4868,6186363,3839856,484293718,0,9217,1714733,9195,1711238,22,3495,2351,16,5334,40,0,62,216660.0,130000.0,-48.0,-35.0,-43.0,-45.0,-47.0,-34.0,-42.0,-45.0,-88.0,-89.0,-85.0,-88.0,40.0,54.0,42.0,43.0,1
49,62:47:05:9D:EB:15,3841945,486709980,2089,2416262,3839856,484293718,0,4173,3001170,4142,2996189,31,4981,2038,0,2130,53,0,105,216660.0,130000.0,-50.0,-44.0,-39.0,-47.0,-47.0,-46.0,-40.0,-48.0,-88.0,-89.0,-85.0,-88.0,38.0,45.0,46.0,41.0,1
50,3C:55:76:E8:8F:1F,3908904,656943542,69047,172649690,3839857,484293852,25,33002,6896315,32565,6820747,437,75568,14093,35,69120,7032,25,421,270830.0,162500.0,-45.0,-56.0,-51.0,-41.0,-45.0,-55.0,-50.0,-41.0,-88.0,-89.0,-85.0,-88.0,43.0,33.0,34.0,47.0,1
51,92:69:1D:31:68:E9,3843819,487924270,3962,3630418,3839857,484293852,0,4992,1121881,4838,1087023,154,34858,2145,11,4187,91,0,51,229410.0,130000.0,-53.0,-46.0,-42.0,-48.0,-52.0,-47.0,-43.0,-48.0,-88.0,-89.0,-85.0,-88.0,35.0,43.0,43.0,40.0,1
52,CC:2F:71:3F:1F:24,4762997,1507045569,923139,1022751649,3839858,484293920,37,761385,829629556,760629,829538584,756,90972,734957,15,923396,96335,34,575,130000.0,43333.0,-67.0,-71.0,-66.0,-73.0,-67.0,-71.0,-66.0,-72.0,-88.0,-89.0,-85.0,-88.0,21.0,18.0,19.0,15.0,1
53,CC:2F:71:3E:C5:1F,3840776,484406101,918,112181,3839858,484293920,0,3827,321463,3158,242077,669,79386,972,11,1319,25,0,47,144444.0,39000.0,-72.0,-72.0,-69.0,-60.0,-71.0,-71.0,-68.0,-60.0,-88.0,-89.0,-85.0,-88.0,16.0,17.0,16.0,28.0,1
54,BA:8C:B9:54:50:24,3844726,490480283,4868,6186363,3839858,484293920,0,9217,1714733,9195,1711238,22,3495,2351,16,5334,40,0,62,216660.0,130000.0,-48.0,-35.0,-43.0,-45.0,-47.0,-34.0,-42.0,-45.0,-88.0,-89.0,-85.0,-88.0,40.0,54.0,42.0,43.0,1
55,62:47:05:9D:EB:15,3841954,486710848,2089,2416262,3839865,484294586,0,4174,3001238,4143,2996257,31,4981,2038,0,2130,53,0,105,216660.0,130000.0,-49.0,-44.0,-39.0,-46.0,-47.0,-45.0,-40.0,-48.0,-88.0,-89.0,-85.0,-88.0,39.0,45.0,46.0,42.0,1
56,3C:55:76:E8:8F:1F,3908913,656945489,69048,172650903,3839865,484294586,25,33011,6896967,32574,6821399,437,75568,14094,35,69121,7032,25,421,270830.0,162500.0,-50.0,-59.0,-45.0,-46.0,-48.0,-57.0,-44.0,-44.0,-88.0,-89.0,-85.0,-88.0,38.0,30.0,40.0,42.0,1
57,92:69:1D:31:68:E9,3843827,487925004,3962,3630418,3839865,484294586,0,4992,1121881,4838,1087023,154,34858,2145,11,4187,91,0,51,229410.0,130000.0,-53.0,-46.0,-42.0,-48.0,-52.0,-47.0,-43.0,-48.0,-88.0,-89.0,-85.0,-88.0,35.0,43.0,43.0,40.0,1
58,CC:2F:71:3F:1F:24,4763213,1507310605,923348,1023016019,3839865,484294586,37,761572,829878238,760816,829787266,756,90972,735143,15,923605,96365,34,575,130000.0,43333.0,-68.0,-71.0,-67.0,-73.0,-67.0,-71.0,-67.0,-72.0,-88.0,-89.0,-85.0,-88.0,20.0,18.0,18.0,15.0,1
59,CC:2F:71:3E:C5:1F,3840783,484406767,918,112181,3839865,484294586,0,3827,321463,3158,242077,669,79386,972,11,1319,25,0,47,144444.0,39000.0,-72.0,-72.0,-69.0,-60.0,-71.0,-71.0,-68.0,-60.0,-88.0,-89.0,-85.0,-88.0,16.0,17.0,16.0,28.0,1
60,BA:8C:B9:54:50:24,3844733,490480949,4868,6186363,3839865,484294586,0,9217,1714733,9195,1711238,22,3495,2351,16,5334,40,0,62,216660.0,130000.0,-48.0,-35.0,-43.0,-45.0,-47.0,-34.0,-42.0,-45.0,-88.0,-89.0,-85.0,-88.0,40.0,54.0,42.0,43.0,1
61,62:47:05:9D:EB:15,3841956,486711050,2089,2416262,3839867,484294788,0,4174,3001238,4143,2996257,31,4981,2038,0,2130,53,0,105,216660.0,130000.0,-49.0,-44.0,-39.0,-46.0,-47.0,-45.0,-40.0,-48.0,-88.0,-89.0,-85.0,-88.0,39.0,45.0,46.0,42.0,1
62,3C:55:76:E8:8F:1F,3908916,656945807,69049,172651019,3839867,484294788,25,33019,6897515,32582,6821947,437,75568,14094,35,69122,7032,25,421,270830.0,162500.0,-45.0,-56.0,-52.0,-41.0,-43.0,-54.0,-51.0,-39.0,-88.0,-89.0,-85.0,-88.0,43.0,33.0,33.0,47.0,1
63,92:69:1D:31:68:E9,3843830,487925322,3963,3630534,3839867,484294788,0,4994,1122017,4840,1087159,154,34858,2145,11,4188,91,0,51,229410.0,137640.0,-53.0,-46.0,-42.0,-49.0,-52.0,-47.0,-43.0,-48.0,-88.0,-89.0,-85.0,-88.0,35.0,43.0,43.0,39.0,1
64,CC:2F:71:3F:1F:24,4763431,1507576010,923564,1023281222,3839867,484294788,37,761778,830144163,761022,830053191,756,90972,735334,15,923821,96366,34,575,130000.0,43333.0,-68.0,-71.0,-67.0,-73.0,-67.0,-71.0,-67.0,-73.0,-88.0,-89.0,-85.0,-88.0,20.0,18.0,18.0,15.0,1
65,CC:2F:71:3E:C5:1F,3840786,484407085,919,112297,3839867,484294788,0,3829,321603,3160,242217,669,79386,972,11,1320,25,0,47,144444.0,39000.0,-71.0,-72.0,-69.0,-60.0,-71.0,-71.0,-68.0,-60.0,-88.0,-89.0,-85.0,-88.0,17.0,17.0,16.0,28.0,1
66,BA:8C:B9:54:50:24,3844736,490481267,4869,6186479,3839867,484294788,0,9222,1715073,9200,1711578,22,3495,2351,16,5335,40,0,62,216660.0,130000.0,-39.0,-36.0,-46.0,-51.0,-43.0,-35.0,-43.0,-47.0,-88.0,-89.0,-85.0,-88.0,49.0,53.0,39.0,37.0,1
67,62:47:05:9D:EB:15,3841963,486711772,2090,2416378,3839873,484295394,0,4176,3001374,4145,2996393,31,4981,2038,0,2131,53,0,105,216660.0,130000.0,-44.0,-46.0,-38.0,-47.0,-47.0,-45.0,-39.0,-47.0,-89.0,-89.0,-86.0,-89.0,45.0,43.0,48.0,42.0,1
68,3C:55:76:E8:8F:1F,3908922,656946413,69049,172651019,3839873,484295394,25,33019,6897515,32582,6821947,437,75568,14094,35,69122,7032,25,421,270830.0,162500.0,-45.0,-56.0,-52.0,-41.0,-43.0,-54.0,-51.0,-39.0,-89.0,-89.0,-86.0,-89.0,44.0,33.0,34.0,48.0,1
69,92:69:1D:31:68:E9,3843836,487925928,3963,3630534,3839873,484295394,0,4994,1122017,4840,1087159,154,34858,2145,11,4188,91,0,51,229410.0,137640.0,-53.0,-46.0,-42.0,-49.0,-52.0,-47.0,-43.0,-48.0,-89.0,-89.0,-86.0,-89.0,36.0,43.0,44.0,40.0,1
70,CC:2F:71:3F:1F:24,4763650,1507844286,923776,1023548830,3839874,484295456,37,761972,830403647,761216,830312675,756,90972,735522,15,924033,96378,34,575,130000.0,43333.0,-67.0,-71.0,-67.0,-73.0,-67.0,-71.0,-67.0,-72.0,-89.0,-89.0,-86.0,-89.0,22.0,18.0,19.0,16.0,1
71,CC:2F:71:3E:C5:1F,3840794,484407813,919,112297,3839875,484295516,0,3831,321791,3161,242287,670,79504,973,11,1320,25,0,47,144444.0,39000.0,-71.0,-72.0,-69.0,-60.0,-71.0,-72.0,-69.0,-60.0,-89.0,-89.0,-86.0,-89.0,18.0,17.0,17.0,29.0,1
72,BA:8C:B9:54:50:24,3844744,490481995,4869,6186479,3839875,484295516,0,9222,1715073,9200,1711578,22,3495,2351,16,5335,40,0,62,216660.0,130000.0,-39.0,-36.0,-46.0,-51.0,-43.0,-35.0,-43.0,-47.0,-89.0,-89.0,-86.0,-89.0,50.0,53.0,40.0,38.0,1
73,62:47:05:9D:EB:15,3841968,486712369,2090,2416378,3839878,484295991,0,4176,3001374,4145,2996393,31,4981,2038,0,2131,53,0,105,216660.0,130000.0,-44.0,-46.0,-38.0,-47.0,-47.0,-45.0,-39.0,-47.0,-89.0,-89.0,-86.0,-89.0,45.0,43.0,48.0,42.0,1
74,3C:55:76:E8:8F:1F,3908927,656947010,69049,172651019,3839878,484295991,25,33019,6897515,32582,6821947,437,75568,14094,35,69122,7032,25,421,270830.0,162500.0,-45.0,-56.0,-52.0,-41.0,-43.0,-54.0,-51.0,-39.0,-89.0,-89.0,-86.0,-89.0,44.0,33.0,34.0,48.0,1
75,92:69:1D:31:68:E9,3843843,487926727,3963,3630534,3839880,484296193,0,4994,1122017,4840,1087159,154,34858,2145,11,4188,91,0,51,229410.0,137640.0,-53.0,-46.0,-42.0,-49.0,-52.0,-47.0,-43.0,-48.0,-89.0,-89.0,-86.0,-89.0,36.0,43.0,44.0,40.0,1
76,CC:2F:71:3F:1F:24,4763877,1508123769,923997,1023827576,3839880,484296193,37,762183,830684193,761427,830593221,756,90972,735718,15,924254,96389,34,576,130000.0,43333.0,-67.0,-71.0,-67.0,-73.0,-67.0,-71.0,-67.0,-72.0,-89.0,-89.0,-86.0,-89.0,22.0,18.0,19.0,16.0,1
77,CC:2F:71:3E:C5:1F,3840799,484408490,919,112297,3839880,484296193,0,3831,321791,3161,242287,670,79504,973,11,1320,25,0,47,144444.0,39000.0,-71.0,-72.0,-69.0,-60.0,-71.0,-72.0,-69.0,-60.0,-89.0,-89.0,-86.0,-89.0,18.0,17.0,17.0,29.0,1
78,BA:8C:B9:54:50:24,3844751,490482874,4869,6186479,3839882,484296395,0,9223,1715141,9201,1711646,22,3495,2351,16,5335,40,0,62,216660.0,130000.0,-39.0,-37.0,-45.0,-52.0,-42.0,-35.0,-43.0,-47.0,-89.0,-89.0,-86.0,-89.0,50.0,52.0,41.0,37.0,1
79,62:47:05:9D:EB:15,3841974,486712975,2090,2416378,3839884,484296597,0,4176,3001374,4145,2996393,31,4981,2038,0,2131,53,0,105,216660.0,130000.0,-44.0,-46.0,-38.0,-47.0,-47.0,-45.0,-39.0,-47.0,-89.0,-89.0,-86.0,-89.0,45.0,43.0,48.0,42.0,1
80,3C:55:76:E8:8F:1F,3908933,656947616,69049,172651019,3839884,484296597,25,33019,6897515,32582,6821947,437,75568,14094,35,69122,7032,25,421,270830.0,162500.0,-45.0,-56.0,-52.0,-41.0,-43.0,-54.0,-51.0,-39.0,-89.0,-89.0,-86.0,-89.0,44.0,33.0,34.0,48.0,1
81,92:69:1D:31:68:E9,3843847,487927131,3963,3630534,3839884,484296597,0,4994,1122017,4840,1087159,154,34858,2145,11,4188,91,0,51,229410.0,137640.0,-53.0,-46.0,-42.0,-49.0,-52.0,-47.0,-43.0,-48.0,-89.0,-89.0,-86.0,-89.0,36.0,43.0,44.0,40.0,1
82,CC:2F:71:3F:1F:24,4764091,1508386049,924207,1024089452,3839884,484296597,37,762376,830940977,761620,830850005,756,90972,735901,15,924464,96394,34,576,130000.0,43333.0,-67.0,-71.0,-67.0,-72.0,-67.0,-70.0,-66.0,-72.0,-89.0,-89.0,-86.0,-89.0,22.0,18.0,19.0,17.0,1
83,CC:2F:71:3E:C5:1F,3840803,484408894,919,112297,3839884,484296597,0,3831,321791,3161,242287,670,79504,973,11,1320,25,0,47,144444.0,39000.0,-71.0,-72.0,-69.0,-60.0,-71.0,-72.0,-69.0,-60.0,-89.0,-89.0,-86.0,-89.0,18.0,17.0,17.0,29.0,1
84,BA:8C:B9:54:50:24,3844753,490483076,4869,6186479,3839884,484296597,0,9223,1715141,9201,1711646,22,3495,2351,16,5335,40,0,62,216660.0,130000.0,-39.0,-37.0,-45.0,-52.0,-42.0,-35.0,-43.0,-47.0,-89.0,-89.0,-86.0,-89.0,50.0,52.0,41.0,37.0,1
85,62:47:05:9D:EB:15,3841980,486713501,2090,2416378,3839890,484297123,0,4176,3001374,4145,2996393,31,4981,2038,0,2131,53,0,105,216660.0,130000.0,-44.0,-46.0,-38.0,-47.0,-47.0,-45.0,-39.0,-47.0,-89.0,-89.0,-86.0,-89.0,45.0,43.0,48.0,42.0,1
86,3C:55:76:E8:8F:1F,3908941,656948344,69049,172651019,3839892,484297325,25,33025,6897975,32587,6822289,438,75686,14095,35,69122,7032,25,421,270830.0,162500.0,-46.0,-56.0,-43.0,-42.0,-45.0,-55.0,-45.0,-42.0,-89.0,-89.0,-86.0,-89.0,43.0,33.0,43.0,47.0,1
87,92:69:1D:31:68:E9,3843855,487927859,3963,3630534,3839892,484297325,0,4994,1122017,4840,1087159,154,34858,2145,11,4188,91,0,51,229410.0,137640.0,-53.0,-46.0,-42.0,-49.0,-52.0,-47.0,-43.0,-48.0,-89.0,-89.0,-86.0,-89.0,36.0,43.0,44.0,40.0,1
88,CC:2F:71:3F:1F:24,4764318,1508654952,924426,1024357627,3839892,484297325,37,762575,831194642,761819,831103670,756,90972,736093,15,924682,96409,34,576,130000.0,43333.0,-67.0,-71.0,-67.0,-72.0,-67.0,-71.0,-67.0,-72.0,-89.0,-89.0,-86.0,-89.0,22.0,18.0,19.0,17.0,1
89,CC:2F:71:3E:C5:1F,3840811,484409622,919,112297,3839892,484297325,0,3831,321791,3161,242287,670,79504,973,11,1320,25,0,47,144444.0,39000.0,-71.0,-72.0,-69.0,-60.0,-71.0,-72.0,-69.0,-60.0,-89.0,-89.0,-86.0,-89.0,18.0,17.0,17.0,29.0,1
90,BA:8C:B9:54:50:24,3844761,490483804,4869,6186479,3839892,484297325,0,9223,1715141,9201,1711646,22,3495,2351,16,5335,40,0,62,216660.0,130000.0,-39.0,-37.0,-45.0,-52.0,-42.0,-35.0,-43.0,-47.0,-89.0,-89.0,-86.0,-89.0,50.0,52.0,41.0,37.0,1
91,62:47:05:9D:EB:15,3841985,486713975,2090,2416378,3839895,484297597,0,4176,3001374,4145,2996393,31,4981,2038,0,2131,53,0,105,216660.0,130000.0,-44.0,-46.0,-38.0,-47.0,-47.0,-45.0,-39.0,-47.0,-89.0,-89.0,-86.0,-89.0,45.0,43.0,48.0,42.0,1
92,3C:55:76:E8:8F:1F,3908944,656948616,69049,172651019,3839895,484297597,25,33037,6898855,32598,6823043,439,75812,14096,35,69122,7032,25,421,270830.0,162500.0,-51.0,-59.0,-46.0,-46.0,-47.0,-56.0,-43.0,-43.0,-89.0,-89.0,-86.0,-89.0,38.0,30.0,40.0,43.0,1
93,92:69:1D:31:68:E9,3843858,487928131,3963,3630534,3839895,484297597,0,4994,1122017,4840,1087159,154,34858,2145,11,4188,91,0,51,229410.0,137640.0,-53.0,-46.0,-42.0,-49.0,-52.0,-47.0,-43.0,-48.0,-89.0,-89.0,-86.0,-89.0,36.0,43.0,44.0,40.0,1
94,CC:2F:71:3F:1F:24,4764533,1508915654,924636,1024617855,3839897,484297799,37,762766,831448020,762010,831357048,756,90972,736279,15,924893,96437,34,576,130000.0,43333.0,-68.0,-71.0,-67.0,-72.0,-68.0,-71.0,-67.0,-72.0,-89.0,-89.0,-86.0,-89.0,21.0,18.0,19.0,17.0,1
95,CC:2F:71:3E:C5:1F,3840816,484410096,919,112297,3839897,484297799,0,3831,321791,3161,242287,670,79504,973,11,1320,25,0,47,144444.0,39000.0,-71.0,-72.0,-69.0,-60.0,-71.0,-72.0,-69.0,-60.0,-89.0,-89.0,-86.0,-89.0,18.0,17.0,17.0,29.0,1
96,BA:8C:B9:54:50:24,3844766,490484278,4869,6186479,3839897,484297799,0,9223,1715141,9201,1711646,22,3495,2351,16,5335,40,0,62,216660.0,130000.0,-39.0,-37.0,-45.0,-52.0,-42.0,-35.0,-43.0,-47.0,-89.0,-89.0,-86.0,-89.0,50.0,52.0,41.0,37.0,1
97,62:47:05:9D:EB:15,3841992,486714641,2090,2416378,3839902,484298263,0,4176,3001374,4145,2996393,31,4981,2038,0,2131,53,0,105,216660.0,130000.0,-44.0,-46.0,-38.0,-47.0,-47.0,-45.0,-39.0,-47.0,-89.0,-89.0,-86.0,-89.0,45.0,43.0,48.0,42.0,1
98,3C:55:76:E8:8F:1F,3908951,656949282,69049,172651019,3839902,484298263,25,33037,6898855,32598,6823043,439,75812,14096,35,69122,7032,25,421,270830.0,162500.0,-51.0,-59.0,-46.0,-46.0,-47.0,-56.0,-43.0,-43.0,-89.0,-89.0,-86.0,-89.0,38.0,30.0,40.0,43.0,1
99,92:69:1D:31:68:E9,3843865,487928797,3963,3630534,3839902,484298263,0,4994,1122017,4840,1087159,154,34858,2145,11,4188,91,0,51,229410.0,137640.0,-53.0,-46.0,-42.0,-49.0,-52.0,-47.0,-43.0,-48.0,-89.0,-89.0,-86.0,-89.0,36.0,43.0,44.0,40.0,1
100,CC:2F:71:3F:1F:24,4764753,1509183160,924848,1024884633,3839905,484298527,37,762967,831709992,762209,831618784,758,91208,736468,15,925105,96437,34,577,130000.0,43333.0,-68.0,-71.0,-67.0,-72.0,-67.0,-71.0,-67.0,-72.0,-89.0,-89.0,-86.0,-89.0,21.0,18.0,19.0,17.0,1
101,CC:2F:71:3E:C5:1F,3840824,484410824,919,112297,3839905,484298527,0,3831,321791,3161,242287,670,79504,973,11,1320,25,0,47,144444.0,39000.0,-71.0,-72.0,-69.0,-60.0,-71.0,-72.0,-69.0,-60.0,-89.0,-89.0,-86.0,-89.0,18.0,17.0,17.0,29.0,1
102,BA:8C:B9:54:50:24,3844774,490485006,4869,6186479,3839905,484298527,0,9223,1715141,9201,1711646,22,3495,2351,16,5335,40,0,62,216660.0,130000.0,-39.0,-37.0,-45.0,-52.0,-42.0,-35.0,-43.0,-47.0,-89.0,-89.0,-86.0,-89.0,50.0,52.0,41.0,37.0,1
103,62:47:05:9D:EB:15,3841997,486715107,2090,2416378,3839907,484298729,0,4176,3001374,4145,2996393,31,4981,2038,0,2131,53,0,105,216660.0,130000.0,-44.0,-46.0,-38.0,-47.0,-47.0,-45.0,-39.0,-47.0,-89.0,-89.0,-86.0,-89.0,45.0,43.0,48.0,42.0,1
104,3C:55:76:E8:8F:1F,3908958,656950052,69051,172651323,3839907,484298729,25,33053,6900110,32614,6824298,439,75812,14099,35,69124,7032,25,421,270830.0,1000.0,-45.0,-56.0,-52.0,-41.0,-45.0,-55.0,-50.0,-41.0,-89.0,-89.0,-86.0,-89.0,44.0,33.0,34.0,48.0,1
105,92:69:1D:31:68:E9,3843870,487929263,3963,3630534,3839907,484298729,0,4994,1122017,4840,1087159,154,34858,2145,11,4188,91,0,51,229410.0,137640.0,-53.0,-46.0,-42.0,-49.0,-52.0,-47.0,-43.0,-48.0,-89.0,-89.0,-86.0,-89.0,36.0,43.0,44.0,40.0,1
106,CC:2F:71:3F:1F:24,4764975,1509461978,925068,1025163249,3839907,484298729,37,763168,831980348,762410,831889140,758,91208,736663,15,925325,96478,34,577,130000.0,43333.0,-67.0,-71.0,-67.0,-73.0,-67.0,-71.0,-67.0,-72.0,-89.0,-89.0,-86.0,-89.0,22.0,18.0,19.0,16.0,1
107,CC:2F:71:3E:C5:1F,3840828,484411228,919,112297,3839909,484298931,0,3831,321791,3161,242287,670,79504,973,11,1320,25,0,47,144444.0,39000.0,-71.0,-72.0,-69.0,-60.0,-71.0,-72.0,-69.0,-60.0,-89.0,-89.0,-86.0,-89.0,18.0,17.0,17.0,29.0,1
108,BA:8C:B9:54:50:24,3844778,490485410,4869,6186479,3839909,484298931,0,9223,1715141,9201,1711646,22,3495,2351,16,5335,40,0,62,216660.0,130000.0,-39.0,-37.0,-45.0,-52.0,-42.0,-35.0,-43.0,-47.0,-89.0,-89.0,-86.0,-89.0,50.0,52.0,41.0,37.0,1
109,62:47:05:9D:EB:15,3842003,486715713,2090,2416378,3839913,484299335,0,4176,3001374,4145,2996393,31,4981,2038,0,2131,53,0,105,216660.0,130000.0,-44.0,-46.0,-38.0,-47.0,-47.0,-45.0,-39.0,-47.0,-89.0,-89.0,-86.0,-89.0,45.0,43.0,48.0,42.0,1
110,3C:55:76:E8:8F:1F,3908965,656950718,69051,172651323,3839914,484299395,25,33053,6900110,32614,6824298,439,75812,14099,35,69124,7032,25,421,270830.0,1000.0,-45.0,-56.0,-52.0,-41.0,-45.0,-55.0,-50.0,-41.0,-89.0,-89.0,-86.0,-89.0,44.0,33.0,34.0,48.0,1
111,92:69:1D:31:68:E9,3843877,487929929,3963,3630534,3839914,484299395,0,4994,1122017,4840,1087159,154,34858,2145,11,4188,91,0,51,229410.0,137640.0,-53.0,-46.0,-42.0,-49.0,-52.0,-47.0,-43.0,-48.0,-89.0,-89.0,-86.0,-89.0,36.0,43.0,44.0,40.0,1
112,CC:2F:71:3F:1F:24,4765199,1509727991,925285,1025428596,3839914,484299395,37,763361,832225943,762603,832134735,758,91208,736854,15,925541,96499,34,577,130000.0,43333.0,-67.0,-71.0,-67.0,-73.0,-67.0,-71.0,-67.0,-72.0,-89.0,-89.0,-86.0,-89.0,22.0,18.0,19.0,16.0,1
113,CC:2F:71:3E:C5:1F,3840833,484411692,919,112297,3839914,484299395,0,3831,321791,3161,242287,670,79504,973,11,1320,25,0,47,144444.0,39000.0,-71.0,-72.0,-69.0,-60.0,-71.0,-72.0,-69.0,-60.0,-89.0,-89.0,-86.0,-89.0,18.0,17.0,17.0,29.0,1
114,BA:8C:B9:54:50:24,3844783,490485874,4869,6186479,3839914,484299395,0,9223,1715141,9201,1711646,22,3495,2351,16,5335,40,0,62,216660.0,130000.0,-39.0,-37.0,-45.0,-52.0,-42.0,-35.0,-43.0,-47.0,-89.0,-89.0,-86.0,-89.0,50.0,52.0,41.0,37.0,1
115,62:47:05:9D:EB:15,3842008,486716177,2090,2416378,3839918,484299799,0,4178,3001510,4147,2996529,31,4981,2038,0,2132,53,0,105,216660.0,130000.0,-49.0,-45.0,-39.0,-47.0,-47.0,-44.0,-38.0,-46.0,-89.0,-89.0,-86.0,-89.0,40.0,44.0,47.0,42.0,1
116,3C:55:76:E8:8F:1F,3908970,656951232,69052,172651433,3839918,484299799,25,33063,6900925,32624,6825113,439,75812,14101,35,69125,7034,25,421,270830.0,1000.0,-45.0,-55.0,-52.0,-41.0,-44.0,-54.0,-50.0,-41.0,-89.0,-89.0,-86.0,-89.0,44.0,34.0,34.0,48.0,1
117,92:69:1D:31:68:E9,3843881,487930333,3963,3630534,3839918,484299799,0,4996,1122153,4842,1087295,154,34858,2145,11,4189,91,0,52,229410.0,137640.0,-53.0,-46.0,-42.0,-49.0,-52.0,-46.0,-42.0,-47.0,-89.0,-89.0,-86.0,-89.0,36.0,43.0,44.0,40.0,1
118,CC:2F:71:3F:1F:24,4765413,1509994263,925495,1025694464,3839918,484299799,37,763550,832476387,762792,832385179,758,91208,737041,15,925751,96507,34,577,130000.0,39000.0,-67.0,-71.0,-66.0,-73.0,-67.0,-71.0,-66.0,-72.0,-89.0,-89.0,-86.0,-89.0,22.0,18.0,20.0,16.0,1
119,CC:2F:71:3E:C5:1F,3840837,484412096,919,112297,3839918,484299799,0,3833,321931,3163,242427,670,79504,973,11,1321,25,0,47,144444.0,39000.0,-81.0,-83.0,-75.0,-71.0,-72.0,-73.0,-69.0,-61.0,-89.0,-89.0,-86.0,-89.0,8.0,6.0,11.0,18.0,1
120,BA:8C:B9:54:50:24,3844787,490486278,4869,6186479,3839918,484299799,0,9225,1715277,9203,1711782,22,3495,2351,16,5336,40,0,62,216660.0,130000.0,-48.0,-35.0,-43.0,-45.0,-40.0,-35.0,-44.0,-48.0,-89.0,-89.0,-86.0,-89.0,41.0,54.0,43.0,44.0,1
121,62:47:05:9D:EB:15,3842012,486716581,2090,2416378,3839922,484300203,0,4178,3001510,4147,2996529,31,4981,2038,0,2132,53,0,105,216660.0,130000.0,-49.0,-45.0,-39.0,-47.0,-47.0,-44.0,-38.0,-46.0,-89.0,-89.0,-86.0,-89.0,40.0,44.0,47.0,42.0,1
122,3C:55:76:E8:8F:1F,3908974,656951636,69052,172651433,3839922,484300203,25,33063,6900925,32624,6825113,439,75812,14101,35,69125,7034,25,421,270830.0,1000.0,-45.0,-55.0,-52.0,-41.0,-44.0,-54.0,-50.0,-41.0,-89.0,-89.0,-86.0,-89.0,44.0,34.0,34.0,48.0,1
123,92:69:1D:31:68:E9,3843885,487930737,3963,3630534,3839922,484300203,0,4996,1122153,4842,1087295,154,34858,2145,11,4189,91,0,52,229410.0,137640.0,-53.0,-46.0,-42.0,-49.0,-52.0,-46.0,-42.0,-47.0,-89.0,-89.0,-86.0,-89.0,36.0,43.0,44.0,40.0,1
124,CC:2F:71:3F:1F:24,4765627,1510258887,925705,1025958684,3839922,484300203,37,763739,832725191,762981,832633983,758,91208,737230,15,925962,96556,34,577,130000.0,39000.0,-67.0,-72.0,-67.0,-73.0,-67.0,-72.0,-66.0,-72.0,-89.0,-89.0,-86.0,-89.0,22.0,17.0,19.0,16.0,1
125,CC:2F:71:3E:C5:1F,3840841,484412500,919,112297,3839922,484300203,0,3833,321931,3163,242427,670,79504,973,11,1321,25,0,47,144444.0,39000.0,-81.0,-83.0,-75.0,-71.0,-72.0,-73.0,-69.0,-61.0,-89.0,-89.0,-86.0,-89.0,8.0,6.0,11.0,18.0,1
126,BA:8C:B9:54:50:24,3844791,490486682,4869,6186479,3839922,484300203,0,9225,1715277,9203,1711782,22,3495,2351,16,5336,40,0,62,216660.0,130000.0,-48.0,-35.0,-43.0,-45.0,-40.0,-35.0,-44.0,-48.0,-89.0,-89.0,-86.0,-89.0,41.0,54.0,43.0,44.0,1
127,62:47:05:9D:EB:15,3842017,486717045,2090,2416378,3839927,484300667,0,4178,3001510,4147,2996529,31,4981,2038,0,2132,53,0,105,216660.0,130000.0,-49.0,-45.0,-39.0,-47.0,-47.0,-44.0,-38.0,-46.0,-89.0,-89.0,-86.0,-89.0,40.0,44.0,47.0,42.0,1
128,3C:55:76:E8:8F:1F,3908979,656952100,69052,172651433,3839927,484300667,25,33063,6900925,32624,6825113,439,75812,14101,35,69125,7034,25,421,270830.0,1000.0,-45.0,-55.0,-52.0,-41.0,-44.0,-54.0,-50.0,-41.0,-89.0,-89.0,-86.0,-89.0,44.0,34.0,34.0,48.0,1
129,92:69:1D:31:68:E9,3843890,487931201,3963,3630534,3839927,484300667,0,4996,1122153,4842,1087295,154,34858,2145,11,4189,91,0,52,229410.0,137640.0,-53.0,-46.0,-42.0,-49.0,-52.0,-46.0,-42.0,-47.0,-89.0,-89.0,-86.0,-89.0,36.0,43.0,44.0,40.0,1
130,CC:2F:71:3F:1F:24,4765851,1510525598,925924,1026224931,3839927,484300667,37,763934,832973829,763176,832882621,758,91208,737424,15,926181,96633,34,577,130000.0,43333.0,-68.0,-71.0,-68.0,-73.0,-68.0,-71.0,-68.0,-73.0,-89.0,-89.0,-86.0,-89.0,21.0,18.0,18.0,16.0,1
131,CC:2F:71:3E:C5:1F,3840848,484413166,919,112297,3839929,484300869,0,3833,321931,3163,242427,670,79504,973,11,1321,25,0,47,144444.0,39000.0,-81.0,-83.0,-75.0,-71.0,-72.0,-73.0,-69.0,-61.0,-89.0,-89.0,-86.0,-89.0,8.0,6.0,11.0,18.0,1
132,BA:8C:B9:54:50:24,3844798,490487348,4869,6186479,3839929,484300869,0,9225,1715277,9203,1711782,22,3495,2351,16,5336,40,0,62,216660.0,130000.0,-48.0,-35.0,-43.0,-45.0,-40.0,-35.0,-44.0,-48.0,-89.0,-89.0,-86.0,-89.0,41.0,54.0,43.0,44.0,1
133,62:47:05:9D:EB:15,3842021,486717449,2090,2416378,3839931,484301071,0,4178,3001510,4147,2996529,31,4981,2038,0,2132,53,0,105,216660.0,130000.0,-49.0,-45.0,-39.0,-47.0,-47.0,-44.0,-38.0,-46.0,-89.0,-89.0,-86.0,-89.0,40.0,44.0,47.0,42.0,1
134,3C:55:76:E8:8F:1F,3908986,656952870,69055,172651799,3839931,484301071,25,33074,6901798,32635,6825986,439,75812,14103,35,69128,7036,25,421,243750.0,1000.0,-44.0,-55.0,-51.0,-40.0,-44.0,-54.0,-50.0,-40.0,-89.0,-89.0,-86.0,-89.0,45.0,34.0,35.0,49.0,1
135,92:69:1D:31:68:E9,3843896,487931807,3963,3630534,3839933,484301273,0,4996,1122153,4842,1087295,154,34858,2145,11,4189,91,0,52,229410.0,137640.0,-53.0,-46.0,-42.0,-49.0,-52.0,-46.0,-42.0,-47.0,-89.0,-89.0,-86.0,-89.0,36.0,43.0,44.0,40.0,1
136,CC:2F:71:3F:1F:24,4766071,1510795552,926138,1026494279,3839933,484301273,37,764134,833237259,763376,833146051,758,91208,737614,15,926395,96682,34,577,130000.0,39000.0,-68.0,-72.0,-67.0,-73.0,-68.0,-71.0,-67.0,-73.0,-89.0,-89.0,-86.0,-89.0,21.0,17.0,19.0,16.0,1
137,CC:2F:71:3E:C5:1F,3840852,484413570,919,112297,3839933,484301273,0,3833,321931,3163,242427,670,79504,973,11,1321,25,0,47,144444.0,39000.0,-81.0,-83.0,-75.0,-71.0,-72.0,-73.0,-69.0,-61.0,-89.0,-89.0,-86.0,-89.0,8.0,6.0,11.0,18.0,1
138,BA:8C:B9:54:50:24,3844802,490487752,4869,6186479,3839933,484301273,0,9225,1715277,9203,1711782,22,3495,2351,16,5336,40,0,62,216660.0,130000.0,-48.0,-35.0,-43.0,-45.0,-40.0,-35.0,-44.0,-48.0,-89.0,-89.0,-86.0,-89.0,41.0,54.0,43.0,44.0,1
139,62:47:05:9D:EB:15,3842027,486717991,2090,2416378,3839937,484301613,0,4178,3001510,4147,2996529,31,4981,2038,0,2132,53,0,105,216660.0,130000.0,-49.0,-45.0,-39.0,-47.0,-47.0,-44.0,-38.0,-46.0,-89.0,-89.0,-86.0,-89.0,40.0,44.0,47.0,42.0,1
140,3C:55:76:E8:8F:1F,3908995,656953730,69056,172651915,3839939,484301815,25,33082,6902386,32643,6826574,439,75812,14104,35,69129,7036,25,421,243750.0,1000.0,-44.0,-56.0,-51.0,-40.0,-43.0,-54.0,-50.0,-39.0,-89.0,-89.0,-86.0,-89.0,45.0,33.0,35.0,49.0,1
141,92:69:1D:31:68:E9,3843902,487932349,3963,3630534,3839939,484301815,0,4996,1122153,4842,1087295,154,34858,2145,11,4189,91,0,52,229410.0,137640.0,-53.0,-46.0,-42.0,-49.0,-52.0,-46.0,-42.0,-47.0,-89.0,-89.0,-86.0,-89.0,36.0,43.0,44.0,40.0,1
142,CC:2F:71:3F:1F:24,4766882,1511832107,926942,1027530019,3839940,484302088,37,764573,833531174,763815,833439966,758,91208,738044,15,927190,96704,34,577,130000.0,43333.0,-68.0,-71.0,-67.0,-73.0,-68.0,-71.0,-67.0,-73.0,-89.0,-89.0,-86.0,-89.0,21.0,18.0,19.0,16.0,1
143,CC:2F:71:3E:C5:1F,3840861,484414587,919,112297,3839942,484302290,0,3833,321931,3163,242427,670,79504,973,11,1321,25,0,47,144444.0,39000.0,-81.0,-83.0,-75.0,-71.0,-72.0,-73.0,-69.0,-61.0,-89.0,-89.0,-86.0,-89.0,8.0,6.0,11.0,18.0,1
144,BA:8C:B9:54:50:24,3844811,490488769,4869,6186479,3839942,484302290,0,9225,1715277,9203,1711782,22,3495,2351,16,5336,40,0,62,216660.0,130000.0,-48.0,-35.0,-43.0,-45.0,-40.0,-35.0,-44.0,-48.0,-89.0,-89.0,-86.0,-89.0,41.0,54.0,43.0,44.0,1
145,62:47:05:9D:EB:15,3842034,486718870,2090,2416378,3839944,484302492,0,4178,3001510,4147,2996529,31,4981,2038,0,2132,53,0,105,216660.0,130000.0,-49.0,-45.0,-39.0,-47.0,-47.0,-44.0,-38.0,-46.0,-89.0,-89.0,-86.0,-89.0,40.0,44.0,47.0,42.0,1
146,3C:55:76:E8:8F:1F,3909000,656954407,69056,172651915,3839944,484302492,25,33082,6902386,32643,6826574,439,75812,14104,35,69129,7036,25,421,243750.0,1000.0,-44.0,-56.0,-51.0,-40.0,-43.0,-54.0,-50.0,-39.0,-89.0,-89.0,-86.0,-89.0,45.0,33.0,35.0,49.0,1
147,92:69:1D:31:68:E9,3843907,487933026,3963,3630534,3839944,484302492,0,4996,1122153,4842,1087295,154,34858,2145,11,4189,91,0,52,229410.0,137640.0,-53.0,-46.0,-42.0,-49.0,-52.0,-46.0,-42.0,-47.0,-89.0,-89.0,-86.0,-89.0,36.0,43.0,44.0,40.0,1
148,CC:2F:71:3F:1F:24,4767385,1512427030,927439,1028124336,3839946,484302694,37,764941,833815140,764183,833723932,758,91208,738399,15,927696,96749,34,577,130000.0,43333.0,-68.0,-72.0,-67.0,-73.0,-68.0,-71.0,-67.0,-73.0,-89.0,-89.0,-86.0,-89.0,21.0,17.0,19.0,16.0,1
149,CC:2F:71:3E:C5:1F,3840865,484414991,919,112297,3839946,484302694,0,3833,321931,3163,242427,670,79504,973,11,1321,25,0,47,144444.0,39000.0,-81.0,-83.0,-75.0,-71.0,-72.0,-73.0,-69.0,-61.0,-89.0,-89.0,-86.0,-89.0,8.0,6.0,11.0,18.0,1
150,BA:8C:B9:54:50:24,3844815,490489173,4869,6186479,3839946,484302694,0,9225,1715277,9203,1711782,22,3495,2351,16,5336,40,0,62,216660.0,130000.0,-48.0,-35.0,-43.0,-45.0,-40.0,-35.0,-44.0,-48.0,-89.0,-89.0,-86.0,-89.0,41.0,54.0,43.0,44.0,1
151,62:47:05:9D:EB:15,3842041,486719536,2090,2416378,3839951,484303158,0,4178,3001510,4147,2996529,31,4981,2038,0,2132,53,0,105,216660.0,130000.0,-49.0,-45.0,-39.0,-47.0,-47.0,-44.0,-38.0,-46.0,-89.0,-89.0,-86.0,-89.0,40.0,44.0,47.0,42.0,1
152,3C:55:76:E8:8F:1F,3909007,656955073,69056,172651915,3839951,484303158,25,33082,6902386,32643,6826574,439,75812,14104,35,69129,7036,25,421,243750.0,1000.0,-44.0,-56.0,-51.0,-40.0,-43.0,-54.0,-50.0,-39.0,-89.0,-89.0,-86.0,-89.0,45.0,33.0,35.0,49.0,1
153,92:69:1D:31:68:E9,3843914,487933692,3963,3630534,3839951,484303158,0,4996,1122153,4842,1087295,154,34858,2145,11,4189,91,0,52,229410.0,137640.0,-53.0,-46.0,-42.0,-49.0,-52.0,-46.0,-42.0,-47.0,-89.0,-89.0,-86.0,-89.0,36.0,43.0,44.0,40.0,1
154,CC:2F:71:3F:1F:24,4767766,1512898518,927815,1028595360,3839951,484303158,37,765210,834080574,764452,833989366,758,91208,738660,15,928072,96775,34,577,130000.0,43333.0,-68.0,-72.0,-68.0,-73.0,-68.0,-71.0,-67.0,-73.0,-89.0,-89.0,-86.0,-89.0,21.0,17.0,18.0,16.0,1
155,CC:2F:71:3E:C5:1F,3840870,484415455,919,112297,3839951,484303158,0,3833,321931,3163,242427,670,79504,973,11,1321,25,0,47,144444.0,39000.0,-81.0,-83.0,-75.0,-71.0,-72.0,-73.0,-69.0,-61.0,-89.0,-89.0,-86.0,-89.0,8.0,6.0,11.0,18.0,1
156,BA:8C:B9:54:50:24,3844820,490489637,4869,6186479,3839951,484303158,0,9225,1715277,9203,1711782,22,3495,2351,16,5336,40,0,62,216660.0,130000.0,-48.0,-35.0,-43.0,-45.0,-40.0,-35.0,-44.0,-48.0,-89.0,-89.0,-86.0,-89.0,41.0,54.0,43.0,44.0,1
157,62:47:05:9D:EB:15,3842045,486719940,2090,2416378,3839955,484303562,0,4178,3001510,4147,2996529,31,4981,2038,0,2132,53,0,105,216660.0,130000.0,-49.0,-45.0,-39.0,-47.0,-47.0,-44.0,-38.0,-46.0,-89.0,-89.0,-86.0,-89.0,40.0,44.0,47.0,42.0,1
158,3C:55:76:E8:8F:1F,3909011,656955477,69056,172651915,3839955,484303562,25,33082,6902386,32643,6826574,439,75812,14104,35,69129,7036,25,421,243750.0,1000.0,-44.0,-56.0,-51.0,-40.0,-43.0,-54.0,-50.0,-39.0,-89.0,-89.0,-86.0,-89.0,45.0,33.0,35.0,49.0,1
159,92:69:1D:31:68:E9,3843918,487934096,3963,3630534,3839955,484303562,0,4996,1122153,4842,1087295,154,34858,2145,11,4189,91,0,52,229410.0,137640.0,-53.0,-46.0,-42.0,-49.0,-52.0,-46.0,-42.0,-47.0,-89.0,-89.0,-86.0,-89.0,36.0,43.0,44.0,40.0,1
160,CC:2F:71:3F:1F:24,4767979,1513160444,928024,1028856882,3839955,484303562,37,765400,834330850,764642,834239642,758,91208,738842,15,928281,96790,34,577,130000.0,43333.0,-68.0,-71.0,-67.0,-73.0,-68.0,-71.0,-67.0,-73.0,-89.0,-89.0,-86.0,-89.0,21.0,18.0,19.0,16.0,1
161,CC:2F:71:3E:C5:1F,3840874,484415859,919,112297,3839955,484303562,0,3833,321931,3163,242427,670,79504,973,11,1321,25,0,47,144444.0,39000.0,-81.0,-83.0,-75.0,-71.0,-72.0,-73.0,-69.0,-61.0,-89.0,-89.0,-86.0,-89.0,8.0,6.0,11.0,18.0,1
162,BA:8C:B9:54:50:24,3844824,490490041,4869,6186479,3839955,484303562,0,9225,1715277,9203,1711782,22,3495,2351,16,5336,40,0,62,216660.0,130000.0,-48.0,-35.0,-43.0,-45.0,-40.0,-35.0,-44.0,-48.0,-89.0,-89.0,-86.0,-89.0,41.0,54.0,43.0,44.0,1
163,62:47:05:9D:EB:15,3842049,486720344,2090,2416378,3839959,484303966,0,4178,3001510,4147,2996529,31,4981,2038,0,2132,53,0,105,216660.0,130000.0,-49.0,-45.0,-39.0,-47.0,-47.0,-44.0,-38.0,-46.0,-89.0,-89.0,-86.0,-89.0,40.0,44.0,47.0,42.0,1
164,3C:55:76:E8:8F:1F,3909016,656956030,69057,172652064,3839959,484303966,25,33091,6903107,32652,6827295,439,75812,14106,35,69130,7036,25,421,243750.0,146250.0,-50.0,-59.0,-45.0,-46.0,-48.0,-56.0,-44.0,-44.0,-89.0,-89.0,-86.0,-89.0,39.0,30.0,41.0,43.0,1
165,92:69:1D:31:68:E9,3843922,487934500,3963,3630534,3839959,484303966,0,4996,1122153,4842,1087295,154,34858,2145,11,4189,91,0,52,229410.0,137640.0,-53.0,-46.0,-42.0,-49.0,-52.0,-46.0,-42.0,-47.0,-89.0,-89.0,-86.0,-89.0,36.0,43.0,44.0,40.0,1
166,CC:2F:71:3F:1F:24,4768191,1513419392,928232,1029115426,3839959,484303966,37,765595,834583190,764837,834491982,758,91208,739029,15,928489,96806,34,577,130000.0,43333.0,-68.0,-71.0,-67.0,-73.0,-68.0,-71.0,-67.0,-73.0,-89.0,-89.0,-86.0,-89.0,21.0,18.0,19.0,16.0,1
167,CC:2F:71:3E:C5:1F,3840878,484416263,919,112297,3839959,484303966,0,3833,321931,3163,242427,670,79504,973,11,1321,25,0,47,144444.0,39000.0,-81.0,-83.0,-75.0,-71.0,-72.0,-73.0,-69.0,-61.0,-89.0,-89.0,-86.0,-89.0,8.0,6.0,11.0,18.0,1
168,BA:8C:B9:54:50:24,3844829,490490505,4869,6186479,3839960,484304026,0,9225,1715277,9203,1711782,22,3495,2351,16,5336,40,0,62,216660.0,130000.0,-48.0,-35.0,-43.0,-45.0,-40.0,-35.0,-44.0,-48.0,-89.0,-89.0,-86.0,-89.0,41.0,54.0,43.0,44.0,1
169,62:47:05:9D:EB:15,3842054,486720808,2090,2416378,3839964,484304430,0,4178,3001510,4147,2996529,31,4981,2038,0,2132,53,0,105,216660.0,130000.0,-49.0,-45.0,-39.0,-47.0,-47.0,-44.0,-38.0,-46.0,-89.0,-89.0,-86.0,-89.0,40.0,44.0,47.0,42.0,1
170,3C:55:76:E8:8F:1F,3909022,656956612,69058,172652182,3839964,484304430,25,33107,6904325,32668,6828513,439,75812,14108,35,69131,7036,25,421,243750.0,146250.0,-45.0,-55.0,-51.0,-41.0,-44.0,-54.0,-50.0,-40.0,-89.0,-89.0,-86.0,-89.0,44.0,34.0,35.0,48.0,1
171,92:69:1D:31:68:E9,3843927,487934964,3963,3630534,3839964,484304430,0,4996,1122153,4842,1087295,154,34858,2145,11,4189,91,0,52,229410.0,137640.0,-53.0,-46.0,-42.0,-49.0,-52.0,-46.0,-42.0,-47.0,-89.0,-89.0,-86.0,-89.0,36.0,43.0,44.0,40.0,1
172,CC:2F:71:3F:1F:24,4768412,1513683201,928448,1029378771,3839964,484304430,37,765805,834852247,765047,834761039,758,91208,739222,15,928705,96822,34,577,130000.0,43333.0,-67.0,-71.0,-67.0,-73.0,-67.0,-71.0,-67.0,-73.0,-89.0,-89.0,-86.0,-89.0,22.0,18.0,19.0,16.0,1
173,CC:2F:71:3E:C5:1F,3840883,484416727,919,112297,3839964,484304430,0,3833,321931,3163,242427,670,79504,973,11,1321,25,0,47,144444.0,39000.0,-81.0,-83.0,-75.0,-71.0,-72.0,-73.0,-69.0,-61.0,-89.0,-89.0,-86.0,-89.0,8.0,6.0,11.0,18.0,1
174,BA:8C:B9:54:50:24,3844833,490490909,4869,6186479,3839964,484304430,0,9225,1715277,9203,1711782,22,3495,2351,16,5336,40,0,62,216660.0,130000.0,-48.0,-35.0,-43.0,-45.0,-40.0,-35.0,-44.0,-48.0,-89.0,-89.0,-86.0,-89.0,41.0,54.0,43.0,44.0,1
175,62:47:05:9D:EB:15,3842059,486721338,2090,2416378,3839969,484304960,0,4178,3001510,4147,2996529,31,4981,2038,0,2132,53,0,105,216660.0,130000.0,-49.0,-45.0,-39.0,-47.0,-47.0,-44.0,-38.0,-46.0,-89.0,-89.0,-86.0,-89.0,40.0,44.0,47.0,42.0,1
176,3C:55:76:E8:8F:1F,3909027,656957142,69058,172652182,3839969,484304960,25,33110,6904531,32671,6828719,439,75812,14108,35,69131,7036,25,421,243750.0,146250.0,-45.0,-56.0,-51.0,-41.0,-44.0,-55.0,-50.0,-41.0,-89.0,-89.0,-86.0,-89.0,44.0,33.0,35.0,48.0,1
177,92:69:1D:31:68:E9,3843932,487935494,3963,3630534,3839969,484304960,0,4996,1122153,4842,1087295,154,34858,2145,11,4189,91,0,52,229410.0,137640.0,-53.0,-46.0,-42.0,-49.0,-52.0,-46.0,-42.0,-47.0,-89.0,-89.0,-86.0,-89.0,36.0,43.0,44.0,40.0,1
178,CC:2F:71:3F:1F:24,4768765,1514148951,928796,1029843991,3839969,484304960,37,766040,835106141,765282,835014933,758,91208,739450,15,929052,96834,34,577,130000.0,43333.0,-68.0,-71.0,-67.0,-73.0,-68.0,-71.0,-67.0,-72.0,-89.0,-89.0,-86.0,-89.0,21.0,18.0,19.0,16.0,1
179,CC:2F:71:3E:C5:1F,3840888,484417257,919,112297,3839969,484304960,0,3833,321931,3163,242427,670,79504,973,11,1321,25,0,47,144444.0,39000.0,-81.0,-83.0,-75.0,-71.0,-72.0,-73.0,-69.0,-61.0,-89.0,-89.0,-86.0,-89.0,8.0,6.0,11.0,18.0,1
180,BA:8C:B9:54:50:24,3844840,490491641,4869,6186479,3839971,484305162,0,9225,1715277,9203,1711782,22,3495,2351,16,5336,40,0,62,216660.0,130000.0,-48.0,-35.0,-43.0,-45.0,-40.0,-35.0,-44.0,-48.0,-89.0,-89.0,-86.0,-89.0,41.0,54.0,43.0,44.0,1
181,62:47:05:9D:EB:15,3842066,486722012,2090,2416378,3839976,484305634,0,4178,3001510,4147,2996529,31,4981,2038,0,2132,53,0,105,216660.0,130000.0,-49.0,-45.0,-39.0,-47.0,-47.0,-44.0,-38.0,-46.0,-89.0,-89.0,-86.0,-89.0,40.0,44.0,47.0,42.0,1
182,3C:55:76:E8:8F:1F,3909034,656957816,69058,172652182,3839976,484305634,25,33110,6904531,32671,6828719,439,75812,14108,35,69131,7036,25,421,243750.0,146250.0,-45.0,-56.0,-51.0,-41.0,-44.0,-55.0,-50.0,-41.0,-89.0,-89.0,-86.0,-89.0,44.0,33.0,35.0,48.0,1
183,92:69:1D:31:68:E9,3843941,487936370,3963,3630534,3839978,484305836,0,4997,1122221,4843,1087363,154,34858,2145,11,4189,91,0,52,229410.0,137640.0,-52.0,-48.0,-45.0,-47.0,-52.0,-46.0,-43.0,-47.0,-89.0,-89.0,-86.0,-89.0,37.0,41.0,41.0,42.0,1
184,CC:2F:71:3F:1F:24,4769365,1514889236,929387,1030583400,3839978,484305836,37,766425,835394973,765667,835303765,758,91208,739824,15,929644,96902,34,577,130000.0,43333.0,-68.0,-71.0,-67.0,-73.0,-68.0,-71.0,-66.0,-72.0,-89.0,-89.0,-86.0,-89.0,21.0,18.0,19.0,16.0,1
185,CC:2F:71:3E:C5:1F,3840897,484418133,919,112297,3839978,484305836,0,3833,321931,3163,242427,670,79504,973,11,1321,25,0,47,144444.0,39000.0,-81.0,-83.0,-75.0,-71.0,-72.0,-73.0,-69.0,-61.0,-89.0,-89.0,-86.0,-89.0,8.0,6.0,11.0,18.0,1
186,BA:8C:B9:54:50:24,3844847,490492315,4869,6186479,3839978,484305836,0,9225,1715277,9203,1711782,22,3495,2351,16,5336,40,0,62,216660.0,130000.0,-48.0,-35.0,-43.0,-45.0,-40.0,-35.0,-44.0,-48.0,-89.0,-89.0,-86.0,-89.0,41.0,54.0,43.0,44.0,1
187,62:47:05:9D:EB:15,3842070,486722416,2090,2416378,3839980,484306038,0,4181,3001714,4150,2996733,31,4981,2038,0,2132,53,0,105,216660.0,130000.0,-49.0,-45.0,-39.0,-46.0,-48.0,-44.0,-38.0,-46.0,-89.0,-89.0,-86.0,-89.0,40.0,44.0,47.0,43.0,1
188,3C:55:76:E8:8F:1F,3909040,656958422,69058,172652182,3839982,484306240,25,33110,6904531,32671,6828719,439,75812,14108,35,69131,7036,25,421,243750.0,146250.0,-45.0,-56.0,-51.0,-41.0,-44.0,-55.0,-50.0,-41.0,-89.0,-89.0,-86.0,-89.0,44.0,33.0,35.0,48.0,1
189,92:69:1D:31:68:E9,3843947,487936976,3963,3630534,3839984,484306442,0,4997,1122221,4843,1087363,154,34858,2145,11,4189,91,0,52,229410.0,137640.0,-52.0,-48.0,-45.0,-47.0,-52.0,-46.0,-43.0,-47.0,-89.0,-89.0,-86.0,-89.0,37.0,41.0,41.0,42.0,1
190,CC:2F:71:3F:1F:24,4769983,1515657132,929999,1031350690,3839984,484306442,37,766807,835685332,766049,835594124,758,91208,740198,15,930256,96965,34,577,130000.0,43333.0,-68.0,-71.0,-67.0,-73.0,-68.0,-71.0,-66.0,-72.0,-89.0,-89.0,-86.0,-89.0,21.0,18.0,19.0,16.0,1
191,CC:2F:71:3E:C5:1F,3840903,484418739,919,112297,3839984,484306442,0,3833,321931,3163,242427,670,79504,973,11,1321,25,0,47,144444.0,39000.0,-81.0,-83.0,-75.0,-71.0,-72.0,-73.0,-69.0,-61.0,-89.0,-89.0,-86.0,-89.0,8.0,6.0,11.0,18.0,1
192,BA:8C:B9:54:50:24,3844853,490492921,4869,6186479,3839984,484306442,0,9225,1715277,9203,1711782,22,3495,2351,16,5336,40,0,62,216660.0,130000.0,-48.0,-35.0,-43.0,-45.0,-40.0,-35.0,-44.0,-48.0,-89.0,-89.0,-86.0,-89.0,41.0,54.0,43.0,44.0,1
193,62:47:05:9D:EB:15,3842077,486723082,2090,2416378,3839987,484306704,0,4181,3001714,4150,2996733,31,4981,2038,0,2132,53,0,105,216660.0,130000.0,-49.0,-45.0,-39.0,-46.0,-48.0,-44.0,-38.0,-46.0,-89.0,-89.0,-86.0,-89.0,40.0,44.0,47.0,43.0,1
194,3C:55:76:E8:8F:1F,3909045,656958886,69058,172652182,3839987,484306704,25,33110,6904531,32671,6828719,439,75812,14108,35,69131,7036,25,421,243750.0,146250.0,-45.0,-56.0,-51.0,-41.0,-44.0,-55.0,-50.0,-41.0,-89.0,-89.0,-86.0,-89.0,44.0,33.0,35.0,48.0,1
195,92:69:1D:31:68:E9,3843952,487937440,3963,3630534,3839989,484306906,0,4997,1122221,4843,1087363,154,34858,2145,11,4189,91,0,52,229410.0,137640.0,-52.0,-48.0,-45.0,-47.0,-52.0,-46.0,-43.0,-47.0,-89.0,-89.0,-86.0,-89.0,37.0,41.0,41.0,42.0,1
196,CC:2F:71:3F:1F:24,4770252,1515963157,930263,1031656251,3839989,484306906,37,767044,835948484,766286,835857276,758,91208,740428,15,930520,96989,34,578,130000.0,43333.0,-68.0,-71.0,-67.0,-72.0,-68.0,-71.0,-66.0,-72.0,-89.0,-89.0,-86.0,-89.0,21.0,18.0,19.0,17.0,1
197,CC:2F:71:3E:C5:1F,3840908,484419203,919,112297,3839989,484306906,0,3833,321931,3163,242427,670,79504,973,11,1321,25,0,47,144444.0,39000.0,-81.0,-83.0,-75.0,-71.0,-72.0,-73.0,-69.0,-61.0,-89.0,-89.0,-86.0,-89.0,8.0,6.0,11.0,18.0,1
198,BA:8C:B9:54:50:24,3844858,490493385,4869,6186479,3839989,484306906,0,9225,1715277,9203,1711782,22,3495,2351,16,5336,40,0,62,216660.0,130000.0,-48.0,-35.0,-43.0,-45.0,-40.0,-35.0,-44.0,-48.0,-89.0,-89.0,-86.0,-89.0,41.0,54.0,43.0,44.0,1
199,62:47:05:9D:EB:15,3842083,486723688,2090,2416378,3839993,484307310,0,4181,3001714,4150,2996733,31,4981,2038,0,2132,53,0,105,216660.0,130000.0,-49.0,-45.0,-39.0,-46.0,-48.0,-44.0,-38.0,-46.0,-89.0,-89.0,-86.0,-89.0,40.0,44.0,47.0,43.0,1
200,3C:55:76:E8:8F:1F,3909058,656963515,69065,172656205,3839993,484307310,25,33132,6909761,32693,6833949,439,75812,14115,35,69138,7037,25,421,243750.0,146250.0,-49.0,-57.0,-45.0,-47.0,-49.0,-56.0,-45.0,-46.0,-89.0,-89.0,-86.0,-89.0,40.0,32.0,41.0,42.0,1
201,92:69:1D:31:68:E9,3843957,487937904,3964,3630594,3839993,484307310,0,4999,1122357,4845,1087499,154,34858,2145,11,4190,91,0,52,216660.0,130000.0,-53.0,-46.0,-42.0,-49.0,-52.0,-47.0,-43.0,-47.0,-89.0,-89.0,-86.0,-89.0,36.0,43.0,44.0,40.0,1
202,CC:2F:71:3F:1F:24,4770469,1516227013,930476,1031919703,3839993,484307310,37,767239,836203906,766481,836112698,758,91208,740616,15,930733,97015,34,578,130000.0,43333.0,-68.0,-71.0,-67.0,-72.0,-67.0,-71.0,-66.0,-72.0,-89.0,-89.0,-86.0,-89.0,21.0,18.0,19.0,17.0,1
203,CC:2F:71:3E:C5:1F,3840913,484419723,920,112413,3839993,484307310,0,3835,322071,3165,242567,670,79504,973,11,1322,25,0,47,144444.0,39000.0,-71.0,-72.0,-69.0,-60.0,-72.0,-73.0,-69.0,-61.0,-89.0,-89.0,-86.0,-89.0,18.0,17.0,17.0,29.0,1
204,BA:8C:B9:54:50:24,3844863,490493905,4870,6186595,3839993,484307310,0,9227,1715413,9205,1711918,22,3495,2351,16,5337,40,0,62,216660.0,130000.0,-59.0,-36.0,-45.0,-44.0,-43.0,-36.0,-44.0,-48.0,-89.0,-89.0,-86.0,-89.0,30.0,53.0,41.0,45.0,1
205,62:47:05:9D:EB:15,3842088,486724208,2091,2416494,3839997,484307714,0,4183,3001850,4152,2996869,31,4981,2038,0,2133,53,0,105,216660.0,130000.0,-48.0,-45.0,-39.0,-46.0,-47.0,-45.0,-38.0,-46.0,-89.0,-89.0,-86.0,-89.0,41.0,44.0,47.0,43.0,1
206,3C:55:76:E8:8F:1F,3909064,656964111,69066,172656335,3839998,484307776,25,33141,6910414,32702,6834602,439,75812,14116,35,69139,7037,25,421,243750.0,146250.0,-45.0,-54.0,-52.0,-40.0,-43.0,-53.0,-51.0,-39.0,-89.0,-89.0,-86.0,-89.0,44.0,35.0,34.0,49.0,1
207,92:69:1D:31:68:E9,3843962,487938370,3964,3630594,3839998,484307776,0,4999,1122357,4845,1087499,154,34858,2145,11,4190,91,0,52,216660.0,130000.0,-53.0,-46.0,-42.0,-49.0,-52.0,-47.0,-43.0,-47.0,-89.0,-89.0,-86.0,-89.0,36.0,43.0,44.0,40.0,1
208,CC:2F:71:3F:1F:24,4770687,1516491007,930689,1032183231,3839998,484307776,37,767439,836460096,766681,836368888,758,91208,740808,15,930946,97055,34,578,115556.0,26000.0,-67.0,-72.0,-66.0,-71.0,-67.0,-71.0,-66.0,-71.0,-89.0,-89.0,-86.0,-89.0,22.0,17.0,20.0,18.0,1
209,CC:2F:71:3E:C5:1F,3840919,484420249,920,112413,3839999,484307836,0,3837,322259,3166,242637,671,79622,974,11,1322,25,0,47,144444.0,39000.0,-65.0,-68.0,-63.0,-60.0,-71.0,-72.0,-69.0,-61.0,-89.0,-89.0,-86.0,-89.0,24.0,21.0,23.0,29.0,1
210,BA:8C:B9:54:50:24,3844870,490494501,4870,6186595,3840000,484307906,0,9227,1715413,9205,1711918,22,3495,2351,16,5337,40,0,62,216660.0,130000.0,-59.0,-36.0,-45.0,-44.0,-43.0,-36.0,-44.0,-48.0,-89.0,-89.0,-86.0,-89.0,30.0,53.0,41.0,45.0,1
211,62:47:05:9D:EB:15,3842096,486725077,2091,2416494,3840005,484308583,0,4183,3001850,4152,2996869,31,4981,2038,0,2133,53,0,105,216660.0,130000.0,-48.0,-45.0,-39.0,-46.0,-47.0,-45.0,-38.0,-46.0,-89.0,-89.0,-86.0,-89.0,41.0,44.0,47.0,43.0,1
212,3C:55:76:E8:8F:1F,3909071,656964918,69066,172656335,3840005,484308583,25,33141,6910414,32702,6834602,439,75812,14116,35,69139,7037,25,421,243750.0,146250.0,-45.0,-54.0,-52.0,-40.0,-43.0,-53.0,-51.0,-39.0,-89.0,-89.0,-86.0,-89.0,44.0,35.0,34.0,49.0,1
213,92:69:1D:31:68:E9,3843969,487939177,3964,3630594,3840005,484308583,0,4999,1122357,4845,1087499,154,34858,2145,11,4190,91,0,52,216660.0,130000.0,-53.0,-46.0,-42.0,-49.0,-52.0,-47.0,-43.0,-47.0,-89.0,-89.0,-86.0,-89.0,36.0,43.0,44.0,40.0,1
214,CC:2F:71:3F:1F:24,4770913,1516758793,930908,1032450210,3840005,484308583,37,767638,836714893,766880,836623685,758,91208,741002,15,931165,97055,34,578,115556.0,28889.0,-68.0,-72.0,-66.0,-73.0,-67.0,-72.0,-66.0,-72.0,-89.0,-89.0,-86.0,-89.0,21.0,17.0,20.0,16.0,1
215,CC:2F:71:3E:C5:1F,3840925,484420996,920,112413,3840005,484308583,0,3837,322259,3166,242637,671,79622,974,11,1322,25,0,47,144444.0,39000.0,-65.0,-68.0,-63.0,-60.0,-71.0,-72.0,-69.0,-61.0,-89.0,-89.0,-86.0,-89.0,24.0,21.0,23.0,29.0,1
216,BA:8C:B9:54:50:24,3844877,490495380,4870,6186595,3840007,484308785,0,9227,1715413,9205,1711918,22,3495,2351,16,5337,40,0,62,216660.0,130000.0,-59.0,-36.0,-45.0,-44.0,-43.0,-36.0,-44.0,-48.0,-89.0,-89.0,-86.0,-89.0,30.0,53.0,41.0,45.0,1
217,62:47:05:9D:EB:15,3842100,486725481,2091,2416494,3840009,484308987,0,4183,3001850,4152,2996869,31,4981,2038,0,2133,53,0,105,216660.0,130000.0,-48.0,-45.0,-39.0,-46.0,-47.0,-45.0,-38.0,-46.0,-89.0,-89.0,-86.0,-89.0,41.0,44.0,47.0,43.0,1
218,3C:55:76:E8:8F:1F,3909075,656965322,69066,172656335,3840009,484308987,25,33141,6910414,32702,6834602,439,75812,14116,35,69139,7037,25,421,243750.0,146250.0,-45.0,-54.0,-52.0,-40.0,-43.0,-53.0,-51.0,-39.0,-89.0,-89.0,-86.0,-89.0,44.0,35.0,34.0,49.0,1
219,92:69:1D:31:68:E9,3843973,487939581,3964,3630594,3840009,484308987,0,4999,1122357,4845,1087499,154,34858,2145,11,4190,91,0,52,216660.0,130000.0,-53.0,-46.0,-42.0,-49.0,-52.0,-47.0,-43.0,-47.0,-89.0,-89.0,-86.0,-89.0,36.0,43.0,44.0,40.0,1
220,CC:2F:71:3F:1F:24,4771297,1517238325,931288,1032929338,3840009,484308987,37,767897,836980637,767139,836889429,758,91208,741255,15,931545,97071,34,578,130000.0,43333.0,-68.0,-71.0,-66.0,-72.0,-67.0,-71.0,-66.0,-72.0,-89.0,-89.0,-86.0,-89.0,21.0,18.0,20.0,17.0,1
221,CC:2F:71:3E:C5:1F,3840929,484421400,920,112413,3840009,484308987,0,3837,322259,3166,242637,671,79622,974,11,1322,25,0,47,144444.0,39000.0,-65.0,-68.0,-63.0,-60.0,-71.0,-72.0,-69.0,-61.0,-89.0,-89.0,-86.0,-89.0,24.0,21.0,23.0,29.0,1
222,BA:8C:B9:54:50:24,3844881,490495784,4870,6186595,3840011,484309189,0,9227,1715413,9205,1711918,22,3495,2351,16,5337,40,0,62,216660.0,130000.0,-59.0,-36.0,-45.0,-44.0,-43.0,-36.0,-44.0,-48.0,-89.0,-89.0,-86.0,-89.0,30.0,53.0,41.0,45.0,1
223,62:47:05:9D:EB:15,3842106,486726007,2091,2416494,3840015,484309513,0,4183,3001850,4152,2996869,31,4981,2038,0,2133,53,0,105,216660.0,130000.0,-48.0,-45.0,-39.0,-46.0,-47.0,-45.0,-38.0,-46.0,-89.0,-89.0,-86.0,-89.0,41.0,44.0,47.0,43.0,1
224,3C:55:76:E8:8F:1F,3909085,656966256,69066,172656335,3840019,484309921,25,33159,6911876,32717,6835628,442,76248,14119,35,69139,7037,25,422,243750.0,146250.0,-47.0,-55.0,-43.0,-42.0,-48.0,-56.0,-45.0,-44.0,-89.0,-89.0,-86.0,-89.0,42.0,34.0,43.0,47.0,1
225,92:69:1D:31:68:E9,3843983,487940515,3964,3630594,3840019,484309921,0,4999,1122357,4845,1087499,154,34858,2145,11,4190,91,0,52,216660.0,130000.0,-53.0,-46.0,-42.0,-49.0,-52.0,-47.0,-43.0,-47.0,-89.0,-89.0,-86.0,-89.0,36.0,43.0,44.0,40.0,1
226,CC:2F:71:3F:1F:24,4771784,1517800753,931765,1033490832,3840019,484309921,37,768226,837260473,767468,837169265,758,91208,741579,15,932022,97079,34,578,130000.0,43333.0,-68.0,-71.0,-67.0,-72.0,-68.0,-71.0,-67.0,-72.0,-89.0,-89.0,-86.0,-89.0,21.0,18.0,19.0,17.0,1
227,CC:2F:71:3E:C5:1F,3840939,484422334,920,112413,3840019,484309921,0,3837,322259,3166,242637,671,79622,974,11,1322,25,0,47,144444.0,39000.0,-65.0,-68.0,-63.0,-60.0,-71.0,-72.0,-69.0,-61.0,-89.0,-89.0,-86.0,-89.0,24.0,21.0,23.0,29.0,1
228,BA:8C:B9:54:50:24,3844891,490496884,4870,6186595,3840021,484310289,0,9227,1715413,9205,1711918,22,3495,2351,16,5337,40,0,62,216660.0,130000.0,-59.0,-36.0,-45.0,-44.0,-43.0,-36.0,-44.0,-48.0,-89.0,-89.0,-86.0,-89.0,30.0,53.0,41.0,45.0,1
229,62:47:05:9D:EB:15,3842116,486727117,2091,2416494,3840025,484310623,0,4183,3001850,4152,2996869,31,4981,2038,0,2133,53,0,105,216660.0,130000.0,-48.0,-45.0,-39.0,-46.0,-47.0,-45.0,-38.0,-46.0,-89.0,-89.0,-86.0,-89.0,41.0,44.0,47.0,43.0,1
230,3C:55:76:E8:8F:1F,3909093,656967160,69066,172656335,3840027,484310825,25,33173,6912892,32730,6836518,443,76374,14120,35,69139,7037,25,422,243750.0,146250.0,-45.0,-56.0,-51.0,-41.0,-44.0,-54.0,-49.0,-40.0,-89.0,-89.0,-86.0,-89.0,44.0,33.0,35.0,48.0,1
231,92:69:1D:31:68:E9,3843993,487941621,3964,3630594,3840029,484311027,0,4999,1122357,4845,1087499,154,34858,2145,11,4190,91,0,52,216660.0,130000.0,-53.0,-46.0,-42.0,-49.0,-52.0,-47.0,-43.0,-47.0,-89.0,-89.0,-86.0,-89.0,36.0,43.0,44.0,40.0,1
232,CC:2F:71:3F:1F:24,4772197,1518313912,932166,1034002679,3840031,484311233,37,768506,837525415,767747,837434089,759,91326,741850,15,932423,97096,34,578,130000.0,39000.0,-68.0,-72.0,-67.0,-73.0,-68.0,-71.0,-67.0,-73.0,-89.0,-89.0,-86.0,-89.0,21.0,17.0,19.0,16.0,1
233,CC:2F:71:3E:C5:1F,3840951,484423646,920,112413,3840031,484311233,0,3837,322259,3166,242637,671,79622,974,11,1322,25,0,47,144444.0,39000.0,-65.0,-68.0,-63.0,-60.0,-71.0,-72.0,-69.0,-61.0,-89.0,-89.0,-86.0,-89.0,24.0,21.0,23.0,29.0,1
234,BA:8C:B9:54:50:24,3844901,490497828,4870,6186595,3840031,484311233,0,9227,1715413,9205,1711918,22,3495,2351,16,5337,40,0,62,216660.0,130000.0,-59.0,-36.0,-45.0,-44.0,-43.0,-36.0,-44.0,-48.0,-89.0,-89.0,-86.0,-89.0,30.0,53.0,41.0,45.0,1
235,62:47:05:9D:EB:15,3842125,486727989,2091,2416494,3840034,484311495,0,4183,3001850,4152,2996869,31,4981,2038,0,2133,53,0,105,216660.0,130000.0,-48.0,-45.0,-39.0,-46.0,-47.0,-45.0,-38.0,-46.0,-89.0,-89.0,-86.0,-89.0,41.0,44.0,47.0,43.0,1
236,3C:55:76:E8:8F:1F,3909103,656968293,69069,172656798,3840034,484311495,25,33187,6914401,32742,6837709,445,76692,14125,35,69142,7037,25,422,243750.0,146250.0,-46.0,-54.0,-46.0,-43.0,-47.0,-56.0,-44.0,-43.0,-89.0,-89.0,-86.0,-89.0,43.0,35.0,40.0,46.0,1
237,92:69:1D:31:68:E9,3843998,487942089,3964,3630594,3840034,484311495,0,4999,1122357,4845,1087499,154,34858,2145,11,4190,91,0,52,216660.0,130000.0,-53.0,-46.0,-42.0,-49.0,-52.0,-47.0,-43.0,-47.0,-89.0,-89.0,-86.0,-89.0,36.0,43.0,44.0,40.0,1
238,CC:2F:71:3F:1F:24,4772415,1518579058,932379,1034267361,3840036,484311697,37,768698,837781757,767939,837690431,759,91326,742037,15,932636,97122,34,578,130000.0,43333.0,-68.0,-71.0,-67.0,-73.0,-68.0,-71.0,-67.0,-72.0,-89.0,-89.0,-86.0,-89.0,21.0,18.0,19.0,16.0,1
239,CC:2F:71:3E:C5:1F,3840956,484424110,920,112413,3840036,484311697,0,3837,322259,3166,242637,671,79622,974,11,1322,25,0,47,144444.0,39000.0,-65.0,-68.0,-63.0,-60.0,-71.0,-72.0,-69.0,-61.0,-89.0,-89.0,-86.0,-89.0,24.0,21.0,23.0,29.0,1
240,BA:8C:B9:54:50:24,3844906,490498292,4870,6186595,3840036,484311697,0,9227,1715413,9205,1711918,22,3495,2351,16,5337,40,0,62,216660.0,130000.0,-59.0,-36.0,-45.0,-44.0,-43.0,-36.0,-44.0,-48.0,-89.0,-89.0,-86.0,-89.0,30.0,53.0,41.0,45.0,1
241,62:47:05:9D:EB:15,3842131,486728595,2091,2416494,3840040,484312101,0,4183,3001850,4152,2996869,31,4981,2038,0,2133,53,0,105,216660.0,130000.0,-48.0,-45.0,-39.0,-46.0,-47.0,-45.0,-38.0,-46.0,-89.0,-89.0,-86.0,-89.0,41.0,44.0,47.0,43.0,1
242,3C:55:76:E8:8F:1F,3909110,656969073,69070,172656972,3840040,484312101,25,33204,6915685,32759,6838993,445,76692,14127,35,69143,7037,25,422,243750.0,146250.0,-51.0,-59.0,-45.0,-46.0,-50.0,-58.0,-45.0,-46.0,-89.0,-89.0,-86.0,-89.0,38.0,30.0,41.0,43.0,1
243,92:69:1D:31:68:E9,3844004,487942695,3964,3630594,3840040,484312101,0,4999,1122357,4845,1087499,154,34858,2145,11,4190,91,0,52,216660.0,130000.0,-53.0,-46.0,-42.0,-49.0,-52.0,-47.0,-43.0,-47.0,-89.0,-89.0,-86.0,-89.0,36.0,43.0,44.0,40.0,1
244,CC:2F:71:3F:1F:24,4772631,1518843022,932591,1034530921,3840040,484312101,37,768892,838038429,768133,837947103,759,91326,742223,15,932848,97129,34,578,130000.0,43333.0,-68.0,-71.0,-67.0,-73.0,-68.0,-71.0,-67.0,-72.0,-89.0,-89.0,-86.0,-89.0,21.0,18.0,19.0,16.0,1
245,CC:2F:71:3E:C5:1F,3840960,484424514,920,112413,3840040,484312101,0,3837,322259,3166,242637,671,79622,974,11,1322,25,0,47,144444.0,39000.0,-65.0,-68.0,-63.0,-60.0,-71.0,-72.0,-69.0,-61.0,-89.0,-89.0,-86.0,-89.0,24.0,21.0,23.0,29.0,1
246,BA:8C:B9:54:50:24,3844910,490498696,4870,6186595,3840040,484312101,0,9227,1715413,9205,1711918,22,3495,2351,16,5337,40,0,62,216660.0,130000.0,-59.0,-36.0,-45.0,-44.0,-43.0,-36.0,-44.0,-48.0,-89.0,-89.0,-86.0,-89.0,30.0,53.0,41.0,45.0,1
247,62:47:05:9D:EB:15,3842135,486728999,2091,2416494,3840044,484312505,0,4183,3001850,4152,2996869,31,4981,2038,0,2133,53,0,105,216660.0,130000.0,-48.0,-45.0,-39.0,-46.0,-47.0,-45.0,-38.0,-46.0,-89.0,-89.0,-86.0,-89.0,41.0,44.0,47.0,43.0,1
248,3C:55:76:E8:8F:1F,3909115,656969537,69070,172656972,3840045,484312565,25,33204,6915685,32759,6838993,445,76692,14127,35,69143,7037,25,422,243750.0,146250.0,-51.0,-59.0,-45.0,-46.0,-50.0,-58.0,-45.0,-46.0,-89.0,-89.0,-86.0,-89.0,38.0,30.0,41.0,43.0,1
249,92:69:1D:31:68:E9,3844009,487943159,3964,3630594,3840045,484312565,0,4999,1122357,4845,1087499,154,34858,2145,11,4190,91,0,52,216660.0,130000.0,-53.0,-46.0,-42.0,-49.0,-52.0,-47.0,-43.0,-47.0,-89.0,-89.0,-86.0,-89.0,36.0,43.0,44.0,40.0,1
250,CC:2F:71:3F:1F:24,4772888,1519159412,932843,1034846847,3840045,484312565,37,769126,838341574,768367,838250248,759,91326,742452,15,933098,97144,34,579,130000.0,43333.0,-68.0,-71.0,-66.0,-73.0,-67.0,-71.0,-66.0,-72.0,-89.0,-89.0,-86.0,-89.0,21.0,18.0,20.0,16.0,1
251,CC:2F:71:3E:C5:1F,3840969,484425382,920,112413,3840049,484312969,0,3837,322259,3166,242637,671,79622,974,11,1322,25,0,47,144444.0,39000.0,-65.0,-68.0,-63.0,-60.0,-71.0,-72.0,-69.0,-61.0,-89.0,-89.0,-86.0,-89.0,24.0,21.0,23.0,29.0,1
252,BA:8C:B9:54:50:24,3844919,490499564,4870,6186595,3840049,484312969,0,9227,1715413,9205,1711918,22,3495,2351,16,5337,40,0,62,216660.0,130000.0,-59.0,-36.0,-45.0,-44.0,-43.0,-36.0,-44.0,-48.0,-89.0,-89.0,-86.0,-89.0,30.0,53.0,41.0,45.0,1
253,62:47:05:9D:EB:15,3842142,486729665,2091,2416494,3840051,484313171,0,4183,3001850,4152,2996869,31,4981,2038,0,2133,53,0,105,216660.0,130000.0,-48.0,-45.0,-39.0,-46.0,-47.0,-45.0,-38.0,-46.0,-89.0,-89.0,-86.0,-89.0,41.0,44.0,47.0,43.0,1
254,3C:55:76:E8:8F:1F,3909122,656970273,69071,172657102,3840051,484313171,25,33227,6917294,32782,6840602,445,76692,14128,35,69144,7040,25,422,258080.0,146250.0,-45.0,-57.0,-51.0,-41.0,-44.0,-56.0,-51.0,-41.0,-89.0,-89.0,-86.0,-89.0,44.0,32.0,35.0,48.0,1
255,92:69:1D:31:68:E9,3844017,487943967,3964,3630594,3840053,484313373,0,5001,1122493,4847,1087635,154,34858,2145,11,4191,91,0,52,216660.0,130000.0,-52.0,-48.0,-44.0,-47.0,-52.0,-47.0,-43.0,-47.0,-89.0,-89.0,-86.0,-89.0,37.0,41.0,42.0,42.0,1
256,CC:2F:71:3F:1F:24,4773175,1519525226,933122,1035211853,3840053,484313373,37,769390,838704738,768631,838613412,759,91326,742703,15,933379,97148,34,579,130000.0,43333.0,-68.0,-71.0,-66.0,-71.0,-67.0,-71.0,-66.0,-71.0,-89.0,-89.0,-86.0,-89.0,21.0,18.0,20.0,18.0,1
257,CC:2F:71:3E:C5:1F,3840973,484425786,920,112413,3840053,484313373,0,3839,322399,3168,242777,671,79622,974,11,1323,25,0,47,144444.0,39000.0,-71.0,-72.0,-69.0,-60.0,-71.0,-72.0,-69.0,-61.0,-89.0,-89.0,-86.0,-89.0,18.0,17.0,17.0,29.0,1
258,BA:8C:B9:54:50:24,3844923,490499968,4870,6186595,3840053,484313373,0,9229,1715549,9207,1712054,22,3495,2351,16,5338,40,0,62,216660.0,130000.0,-40.0,-37.0,-46.0,-51.0,-43.0,-36.0,-45.0,-49.0,-89.0,-89.0,-86.0,-89.0,49.0,52.0,40.0,38.0,1
259,62:47:05:9D:EB:15,3842149,486730331,2091,2416494,3840058,484313837,0,4186,3002054,4155,2997073,31,4981,2038,0,2134,53,0,105,216660.0,130000.0,-48.0,-45.0,-39.0,-46.0,-47.0,-45.0,-38.0,-46.0,-89.0,-89.0,-86.0,-89.0,41.0,44.0,47.0,43.0,1
260,3C:55:76:E8:8F:1F,3909129,656970939,69071,172657102,3840058,484313837,25,33227,6917294,32782,6840602,445,76692,14128,35,69144,7040,25,422,258080.0,146250.0,-45.0,-57.0,-51.0,-41.0,-44.0,-56.0,-51.0,-41.0,-89.0,-89.0,-86.0,-89.0,44.0,32.0,35.0,48.0,1
261,92:69:1D:31:68:E9,3844022,487944431,3964,3630594,3840058,484313837,0,5001,1122493,4847,1087635,154,34858,2145,11,4191,91,0,52,216660.0,130000.0,-52.0,-48.0,-44.0,-47.0,-52.0,-47.0,-43.0,-47.0,-89.0,-89.0,-86.0,-89.0,37.0,41.0,42.0,42.0,1
262,CC:2F:71:3F:1F:24,4773598,1520063121,933540,1035749284,3840058,484313837,37,769678,838989645,768919,838898319,759,91326,742987,15,933796,97176,34,579,130000.0,43333.0,-68.0,-71.0,-66.0,-71.0,-67.0,-70.0,-66.0,-71.0,-89.0,-89.0,-86.0,-89.0,21.0,18.0,20.0,18.0,1
263,CC:2F:71:3E:C5:1F,3840978,484426250,920,112413,3840058,484313837,0,3839,322399,3168,242777,671,79622,974,11,1323,25,0,47,144444.0,39000.0,-71.0,-72.0,-69.0,-60.0,-71.0,-72.0,-69.0,-61.0,-89.0,-89.0,-86.0,-89.0,18.0,17.0,17.0,29.0,1
264,BA:8C:B9:54:50:24,3844928,490500432,4870,6186595,3840058,484313837,0,9229,1715549,9207,1712054,22,3495,2351,16,5338,40,0,62,216660.0,130000.0,-40.0,-37.0,-46.0,-51.0,-43.0,-36.0,-45.0,-49.0,-89.0,-89.0,-86.0,-89.0,49.0,52.0,40.0,38.0,1
265,62:47:05:9D:EB:15,3842153,486730735,2091,2416494,3840062,484314241,0,4186,3002054,4155,2997073,31,4981,2038,0,2134,53,0,105,216660.0,130000.0,-48.0,-45.0,-39.0,-46.0,-47.0,-45.0,-38.0,-46.0,-89.0,-89.0,-86.0,-89.0,41.0,44.0,47.0,43.0,1
266,3C:55:76:E8:8F:1F,3909134,656971563,69072,172657322,3840062,484314241,25,33242,6918491,32797,6841799,445,76692,14130,35,69145,7040,25,422,258080.0,146250.0,-51.0,-58.0,-45.0,-46.0,-50.0,-56.0,-44.0,-46.0,-89.0,-89.0,-86.0,-89.0,38.0,31.0,41.0,43.0,1
267,92:69:1D:31:68:E9,3844026,487944835,3964,3630594,3840062,484314241,0,5001,1122493,4847,1087635,154,34858,2145,11,4191,91,0,52,216660.0,130000.0,-52.0,-48.0,-44.0,-47.0,-52.0,-47.0,-43.0,-47.0,-89.0,-89.0,-86.0,-89.0,37.0,41.0,42.0,42.0,1
268,CC:2F:71:3F:1F:24,4774191,1520817069,934129,1036502828,3840062,484314241,37,770046,839273142,769287,839181816,759,91326,743351,15,934380,97347,34,579,130000.0,43333.0,-67.0,-72.0,-66.0,-69.0,-67.0,-71.0,-65.0,-71.0,-89.0,-89.0,-86.0,-89.0,22.0,17.0,20.0,20.0,1
269,CC:2F:71:3E:C5:1F,3840982,484426654,920,112413,3840062,484314241,0,3839,322399,3168,242777,671,79622,974,11,1323,25,0,47,144444.0,39000.0,-71.0,-72.0,-69.0,-60.0,-71.0,-72.0,-69.0,-61.0,-89.0,-89.0,-86.0,-89.0,18.0,17.0,17.0,29.0,1
270,BA:8C:B9:54:50:24,3844934,490501038,4870,6186595,3840064,484314443,0,9229,1715549,9207,1712054,22,3495,2351,16,5338,40,0,62,216660.0,130000.0,-40.0,-37.0,-46.0,-51.0,-43.0,-36.0,-45.0,-49.0,-89.0,-89.0,-86.0,-89.0,49.0,52.0,40.0,38.0,1
271,62:47:05:9D:EB:15,3842158,486731199,2091,2416494,3840067,484314705,0,4186,3002054,4155,2997073,31,4981,2038,0,2134,53,0,105,216660.0,130000.0,-48.0,-45.0,-39.0,-46.0,-47.0,-45.0,-38.0,-46.0,-89.0,-89.0,-86.0,-89.0,41.0,44.0,47.0,43.0,1
272,3C:55:76:E8:8F:1F,3909139,656972027,69072,172657322,3840067,484314705,25,33242,6918491,32797,6841799,445,76692,14130,35,69145,7040,25,422,258080.0,146250.0,-51.0,-58.0,-45.0,-46.0,-50.0,-56.0,-44.0,-46.0,-89.0,-89.0,-86.0,-89.0,38.0,31.0,41.0,43.0,1
273,92:69:1D:31:68:E9,3844033,487945501,3964,3630594,3840069,484314907,0,5001,1122493,4847,1087635,154,34858,2145,11,4191,91,0,52,216660.0,130000.0,-52.0,-48.0,-44.0,-47.0,-52.0,-47.0,-43.0,-47.0,-89.0,-89.0,-86.0,-89.0,37.0,41.0,42.0,42.0,1
274,CC:2F:71:3F:1F:24,4774908,1521713009,934839,1037398102,3840069,484314907,37,770490,839629058,769731,839537732,759,91326,743789,15,935094,97373,34,579,115556.0,28889.0,-68.0,-72.0,-66.0,-72.0,-67.0,-71.0,-66.0,-71.0,-89.0,-89.0,-86.0,-89.0,21.0,17.0,20.0,17.0,1
275,CC:2F:71:3E:C5:1F,3840992,484427795,920,112413,3840072,484315382,0,3839,322399,3168,242777,671,79622,974,11,1323,25,0,47,144444.0,39000.0,-71.0,-72.0,-69.0,-60.0,-71.0,-72.0,-69.0,-61.0,-88.0,-89.0,-86.0,-89.0,17.0,17.0,17.0,29.0,1
276,BA:8C:B9:54:50:24,3844942,490501977,4870,6186595,3840072,484315382,0,9230,1715617,9208,1712122,22,3495,2351,16,5338,40,0,62,216660.0,130000.0,-40.0,-37.0,-46.0,-51.0,-43.0,-36.0,-45.0,-49.0,-88.0,-89.0,-86.0,-89.0,48.0,52.0,40.0,38.0,1
277,62:47:05:9D:EB:15,3842167,486732280,2091,2416494,3840076,484315786,0,4186,3002054,4155,2997073,31,4981,2038,0,2134,53,0,105,216660.0,130000.0,-48.0,-45.0,-39.0,-46.0,-47.0,-45.0,-38.0,-46.0,-88.0,-89.0,-86.0,-89.0,40.0,44.0,47.0,43.0,1
278,3C:55:76:E8:8F:1F,3909153,656973572,69072,172657322,3840081,484316250,25,33242,6918491,32797,6841799,445,76692,14130,35,69145,7040,25,422,258080.0,146250.0,-51.0,-58.0,-45.0,-46.0,-50.0,-56.0,-44.0,-46.0,-88.0,-89.0,-86.0,-89.0,37.0,31.0,41.0,43.0,1
279,92:69:1D:31:68:E9,3844045,487946844,3964,3630594,3840081,484316250,0,5001,1122493,4847,1087635,154,34858,2145,11,4191,91,0,52,216660.0,130000.0,-52.0,-48.0,-44.0,-47.0,-52.0,-47.0,-43.0,-47.0,-88.0,-89.0,-86.0,-89.0,36.0,41.0,42.0,42.0,1
280,CC:2F:71:3F:1F:24,4775701,1522805426,935617,1038488840,3840084,484316586,37,771063,840291373,770304,840200047,759,91326,744351,15,935869,97561,34,579,130000.0,39000.0,-67.0,-70.0,-67.0,-70.0,-67.0,-70.0,-67.0,-70.0,-88.0,-89.0,-86.0,-89.0,21.0,19.0,19.0,19.0,1
281,CC:2F:71:3E:C5:1F,3841005,484429067,920,112413,3840085,484316654,0,3839,322399,3168,242777,671,79622,974,11,1323,25,0,47,144444.0,39000.0,-71.0,-72.0,-69.0,-60.0,-71.0,-72.0,-69.0,-61.0,-88.0,-89.0,-86.0,-89.0,17.0,17.0,17.0,29.0,1
282,BA:8C:B9:54:50:24,3844955,490503249,4870,6186595,3840085,484316654,0,9230,1715617,9208,1712122,22,3495,2351,16,5338,40,0,62,216660.0,130000.0,-40.0,-37.0,-46.0,-51.0,-43.0,-36.0,-45.0,-49.0,-88.0,-89.0,-86.0,-89.0,48.0,52.0,40.0,38.0,1
283,62:47:05:9D:EB:15,3842180,486733552,2091,2416494,3840089,484317058,0,4186,3002054,4155,2997073,31,4981,2038,0,2134,53,0,105,216660.0,130000.0,-48.0,-45.0,-39.0,-46.0,-47.0,-45.0,-38.0,-46.0,-88.0,-89.0,-86.0,-89.0,40.0,44.0,47.0,43.0,1
284,3C:55:76:E8:8F:1F,3909161,656974380,69072,172657322,3840089,484317058,25,33242,6918491,32797,6841799,445,76692,14130,35,69145,7040,25,422,258080.0,146250.0,-51.0,-58.0,-45.0,-46.0,-50.0,-56.0,-44.0,-46.0,-88.0,-89.0,-86.0,-89.0,37.0,31.0,41.0,43.0,1
285,92:69:1D:31:68:E9,3844053,487947652,3964,3630594,3840089,484317058,0,5001,1122493,4847,1087635,154,34858,2145,11,4191,91,0,52,216660.0,130000.0,-52.0,-48.0,-44.0,-47.0,-52.0,-47.0,-43.0,-47.0,-88.0,-89.0,-86.0,-89.0,36.0,41.0,42.0,42.0,1
286,CC:2F:71:3F:1F:24,4776346,1523672429,936255,1039355169,3840091,484317260,37,771451,840672713,770692,840581387,759,91326,744733,15,936510,97594,34,579,117000.0,39000.0,-67.0,-70.0,-67.0,-70.0,-66.0,-70.0,-67.0,-70.0,-88.0,-89.0,-86.0,-89.0,21.0,19.0,19.0,19.0,1
287,CC:2F:71:3E:C5:1F,3841012,484429733,920,112413,3840092,484317320,0,3839,322399,3168,242777,671,79622,974,11,1323,25,0,47,144444.0,39000.0,-71.0,-72.0,-69.0,-60.0,-71.0,-72.0,-69.0,-61.0,-88.0,-89.0,-86.0,-89.0,17.0,17.0,17.0,29.0,1
288,BA:8C:B9:54:50:24,3844962,490503915,4870,6186595,3840092,484317320,0,9230,1715617,9208,1712122,22,3495,2351,16,5338,40,0,62,216660.0,130000.0,-40.0,-37.0,-46.0,-51.0,-43.0,-36.0,-45.0,-49.0,-88.0,-89.0,-86.0,-89.0,48.0,52.0,40.0,38.0,1
289,62:47:05:9D:EB:15,3842185,486734016,2091,2416494,3840094,484317522,0,4186,3002054,4155,2997073,31,4981,2038,0,2134,53,0,105,216660.0,130000.0,-48.0,-45.0,-39.0,-46.0,-47.0,-45.0,-38.0,-46.0,-88.0,-89.0,-86.0,-89.0,40.0,44.0,47.0,43.0,1
290,3C:55:76:E8:8F:1F,3909170,656975411,69074,172657687,3840096,484317724,25,33260,6919885,32815,6843193,445,76692,14133,35,69147,7044,25,422,258080.0,146250.0,-50.0,-59.0,-47.0,-47.0,-48.0,-57.0,-46.0,-45.0,-88.0,-89.0,-86.0,-89.0,38.0,30.0,39.0,42.0,1
291,92:69:1D:31:68:E9,3844060,487948318,3964,3630594,3840096,484317724,0,5001,1122493,4847,1087635,154,34858,2145,11,4191,91,0,52,216660.0,130000.0,-52.0,-48.0,-44.0,-47.0,-52.0,-47.0,-43.0,-47.0,-88.0,-89.0,-86.0,-89.0,36.0,41.0,42.0,42.0,1
292,CC:2F:71:3F:1F:24,4776799,1524236622,936703,1039918898,3840096,484317724,37,771762,840983878,771003,840892552,759,91326,745039,15,936960,97594,34,579,130000.0,43333.0,-67.0,-70.0,-67.0,-71.0,-66.0,-70.0,-67.0,-70.0,-88.0,-89.0,-86.0,-89.0,21.0,19.0,19.0,18.0,1
293,CC:2F:71:3E:C5:1F,3841016,484430137,920,112413,3840096,484317724,0,3839,322399,3168,242777,671,79622,974,11,1323,25,0,47,144444.0,39000.0,-71.0,-72.0,-69.0,-60.0,-71.0,-72.0,-69.0,-61.0,-88.0,-89.0,-86.0,-89.0,17.0,17.0,17.0,29.0,1
294,BA:8C:B9:54:50:24,3844968,490504521,4870,6186595,3840098,484317926,0,9230,1715617,9208,1712122,22,3495,2351,16,5338,40,0,62,216660.0,130000.0,-40.0,-37.0,-46.0,-51.0,-43.0,-36.0,-45.0,-49.0,-88.0,-89.0,-86.0,-89.0,48.0,52.0,40.0,38.0,1
295,62:47:05:9D:EB:15,3842191,486734622,2091,2416494,3840100,484318128,0,4186,3002054,4155,2997073,31,4981,2038,0,2134,53,0,105,216660.0,130000.0,-48.0,-45.0,-39.0,-46.0,-47.0,-45.0,-38.0,-46.0,-88.0,-89.0,-86.0,-89.0,40.0,44.0,47.0,43.0,1
296,3C:55:76:E8:8F:1F,3909174,656975815,69074,172657687,3840100,484318128,25,33260,6919885,32815,6843193,445,76692,14133,35,69147,7044,25,422,258080.0,146250.0,-50.0,-59.0,-47.0,-47.0,-48.0,-57.0,-46.0,-45.0,-88.0,-89.0,-86.0,-89.0,38.0,30.0,39.0,42.0,1
297,92:69:1D:31:68:E9,3844064,487948722,3964,3630594,3840100,484318128,0,5001,1122493,4847,1087635,154,34858,2145,11,4191,91,0,52,216660.0,130000.0,-52.0,-48.0,-44.0,-47.0,-52.0,-47.0,-43.0,-47.0,-88.0,-89.0,-86.0,-89.0,36.0,41.0,42.0,42.0,1
298,CC:2F:71:3F:1F:24,4777208,1524746329,937108,1040428201,3840100,484318128,37,772033,841246364,771274,841155038,759,91326,745306,15,937365,97613,34,579,130000.0,43333.0,-67.0,-70.0,-67.0,-71.0,-66.0,-69.0,-67.0,-70.0,-88.0,-89.0,-86.0,-89.0,21.0,19.0,19.0,18.0,1
299,CC:2F:71:3E:C5:1F,3841020,484430541,920,112413,3840100,484318128,0,3839,322399,3168,242777,671,79622,974,11,1323,25,0,47,144444.0,39000.0,-71.0,-72.0,-69.0,-60.0,-71.0,-72.0,-69.0,-61.0,-88.0,-89.0,-86.0,-89.0,17.0,17.0,17.0,29.0,1
300,BA:8C:B9:54:50:24,3844970,490504723,4870,6186595,3840100,484318128,0,9230,1715617,9208,1712122,22,3495,2351,16,5338,40,0,62,216660.0,130000.0,-40.0,-37.0,-46.0,-51.0,-43.0,-36.0,-45.0,-49.0,-88.0,-89.0,-86.0,-89.0,48.0,52.0,40.0,38.0,1
301,62:47:05:9D:EB:15,3842196,486735086,2091,2416494,3840105,484318592,0,4189,3002258,4158,2997277,31,4981,2038,0,2134,53,0,105,216660.0,130000.0,-51.0,-45.0,-39.0,-47.0,-48.0,-45.0,-38.0,-46.0,-88.0,-89.0,-86.0,-89.0,37.0,44.0,47.0,42.0,1
302,3C:55:76:E8:8F:1F,3909181,656976481,69074,172657687,3840107,484318794,25,33260,6919885,32815,6843193,445,76692,14133,35,69147,7044,25,422,258080.0,146250.0,-50.0,-59.0,-47.0,-47.0,-48.0,-57.0,-46.0,-45.0,-88.0,-89.0,-86.0,-89.0,38.0,30.0,39.0,42.0,1
303,92:69:1D:31:68:E9,3844071,487949388,3964,3630594,3840107,484318794,0,5001,1122493,4847,1087635,154,34858,2145,11,4191,91,0,52,216660.0,130000.0,-52.0,-48.0,-44.0,-47.0,-52.0,-47.0,-43.0,-47.0,-88.0,-89.0,-86.0,-89.0,36.0,41.0,42.0,42.0,1
304,CC:2F:71:3F:1F:24,4777458,1525058585,937351,1040739791,3840107,484318794,37,772260,841551106,771501,841459780,759,91326,745526,15,937607,97630,34,579,130000.0,43333.0,-67.0,-70.0,-67.0,-71.0,-66.0,-70.0,-67.0,-70.0,-88.0,-89.0,-86.0,-89.0,21.0,19.0,19.0,18.0,1
305,CC:2F:71:3E:C5:1F,3841029,484431409,920,112413,3840109,484318996,0,3839,322399,3168,242777,671,79622,974,11,1323,25,0,47,144444.0,39000.0,-71.0,-72.0,-69.0,-60.0,-71.0,-72.0,-69.0,-61.0,-88.0,-89.0,-86.0,-89.0,17.0,17.0,17.0,29.0,1
306,BA:8C:B9:54:50:24,3844979,490505591,4870,6186595,3840109,484318996,0,9230,1715617,9208,1712122,22,3495,2351,16,5338,40,0,62,216660.0,130000.0,-40.0,-37.0,-46.0,-51.0,-43.0,-36.0,-45.0,-49.0,-88.0,-89.0,-86.0,-89.0,48.0,52.0,40.0,38.0,1
307,62:47:05:9D:EB:15,3842202,486735692,2091,2416494,3840111,484319198,0,4189,3002258,4158,2997277,31,4981,2038,0,2134,53,0,105,216660.0,130000.0,-51.0,-45.0,-39.0,-47.0,-48.0,-45.0,-38.0,-46.0,-88.0,-89.0,-86.0,-89.0,37.0,44.0,47.0,42.0,1
308,3C:55:76:E8:8F:1F,3909188,656977147,69074,172657687,3840114,484319460,25,33260,6919885,32815,6843193,445,76692,14133,35,69147,7044,25,422,258080.0,146250.0,-50.0,-59.0,-47.0,-47.0,-48.0,-57.0,-46.0,-45.0,-88.0,-89.0,-86.0,-89.0,38.0,30.0,39.0,42.0,1
309,92:69:1D:31:68:E9,3844080,487950256,3964,3630594,3840116,484319662,0,5001,1122493,4847,1087635,154,34858,2145,11,4191,91,0,52,216660.0,130000.0,-52.0,-48.0,-44.0,-47.0,-52.0,-47.0,-43.0,-47.0,-88.0,-89.0,-86.0,-89.0,36.0,41.0,42.0,42.0,1
310,CC:2F:71:3F:1F:24,4777863,1525590064,937745,1041270200,3840118,484319864,37,772646,842081575,771887,841990249,759,91326,745895,15,938000,97688,34,579,130000.0,43333.0,-66.0,-70.0,-66.0,-70.0,-66.0,-69.0,-67.0,-70.0,-88.0,-89.0,-86.0,-89.0,22.0,19.0,20.0,19.0,1
311,CC:2F:71:3E:C5:1F,3841041,484432595,921,112529,3840120,484320066,0,3841,322539,3170,242917,671,79622,974,11,1324,25,0,47,144444.0,39000.0,-70.0,-71.0,-68.0,-60.0,-70.0,-71.0,-68.0,-60.0,-88.0,-89.0,-86.0,-89.0,18.0,18.0,18.0,29.0,1
312,BA:8C:B9:54:50:24,3844998,490507443,4871,6186711,3840127,484320732,0,9242,1716433,9220,1712938,22,3495,2351,16,5339,40,0,62,216660.0,130000.0,-48.0,-35.0,-43.0,-45.0,-45.0,-36.0,-44.0,-48.0,-88.0,-89.0,-86.0,-89.0,40.0,54.0,43.0,44.0,1
313,62:47:05:9D:EB:15,3842222,486737817,2092,2416610,3840130,484321207,0,4192,3002462,4161,2997481,31,4981,2038,0,2135,53,0,105,216660.0,130000.0,-44.0,-46.0,-38.0,-49.0,-47.0,-45.0,-38.0,-47.0,-88.0,-89.0,-86.0,-89.0,44.0,43.0,48.0,40.0,1
314,3C:55:76:E8:8F:1F,3909212,656979914,69080,172658505,3840132,484321409,25,33279,6921317,32834,6844625,445,76692,14136,35,69153,7050,25,424,243750.0,1000.0,-44.0,-53.0,-52.0,-41.0,-44.0,-52.0,-51.0,-40.0,-88.0,-89.0,-86.0,-89.0,44.0,36.0,34.0,48.0,1
315,92:69:1D:31:68:E9,3844099,487952265,3965,3630654,3840134,484321611,0,5006,1122833,4852,1087975,154,34858,2145,11,4192,91,0,53,216660.0,130000.0,-51.0,-48.0,-45.0,-47.0,-51.0,-47.0,-44.0,-47.0,-88.0,-89.0,-86.0,-89.0,37.0,41.0,41.0,42.0,1
316,CC:2F:71:3F:1F:24,4778681,1526655237,938547,1042333626,3840134,484321611,37,773327,842910929,772568,842819603,759,91326,746557,15,938802,98036,34,579,130000.0,43333.0,-66.0,-70.0,-67.0,-70.0,-66.0,-69.0,-66.0,-69.0,-88.0,-89.0,-86.0,-89.0,22.0,19.0,19.0,19.0,1
317,CC:2F:71:3E:C5:1F,3841057,484434342,921,112529,3840136,484321813,0,3841,322539,3170,242917,671,79622,974,11,1324,25,0,47,144444.0,39000.0,-70.0,-71.0,-68.0,-60.0,-70.0,-71.0,-68.0,-60.0,-88.0,-89.0,-86.0,-89.0,18.0,18.0,18.0,29.0,1
318,BA:8C:B9:54:50:24,3845007,490508524,4871,6186711,3840136,484321813,0,9242,1716433,9220,1712938,22,3495,2351,16,5339,40,0,62,216660.0,130000.0,-48.0,-35.0,-43.0,-45.0,-45.0,-36.0,-44.0,-48.0,-88.0,-89.0,-86.0,-89.0,40.0,54.0,43.0,44.0,1
319,62:47:05:9D:EB:15,3842231,486738685,2092,2416610,3840139,484322075,0,4192,3002462,4161,2997481,31,4981,2038,0,2135,53,0,105,216660.0,130000.0,-44.0,-46.0,-38.0,-49.0,-47.0,-45.0,-38.0,-47.0,-88.0,-89.0,-86.0,-89.0,44.0,43.0,48.0,40.0,1
320,3C:55:76:E8:8F:1F,3909219,656980580,69080,172658505,3840139,484322075,25,33279,6921317,32834,6844625,445,76692,14136,35,69153,7050,25,424,243750.0,1000.0,-44.0,-53.0,-52.0,-41.0,-44.0,-52.0,-51.0,-40.0,-88.0,-89.0,-86.0,-89.0,44.0,36.0,34.0,48.0,1
321,92:69:1D:31:68:E9,3844104,487952729,3965,3630654,3840139,484322075,0,5006,1122833,4852,1087975,154,34858,2145,11,4192,91,0,53,216660.0,130000.0,-51.0,-48.0,-45.0,-47.0,-51.0,-47.0,-44.0,-47.0,-88.0,-89.0,-86.0,-89.0,37.0,41.0,41.0,42.0,1
322,CC:2F:71:3F:1F:24,4779266,1527407450,939127,1043085375,3840139,484322075,37,773704,843225377,772945,843134051,759,91326,746912,15,939384,98076,34,579,130000.0,43333.0,-66.0,-70.0,-66.0,-70.0,-66.0,-69.0,-66.0,-69.0,-88.0,-89.0,-86.0,-89.0,22.0,19.0,20.0,19.0,1
323,CC:2F:71:3E:C5:1F,3841060,484434604,921,112529,3840139,484322075,0,3841,322539,3170,242917,671,79622,974,11,1324,25,0,47,144444.0,39000.0,-70.0,-71.0,-68.0,-60.0,-70.0,-71.0,-68.0,-60.0,-88.0,-89.0,-86.0,-89.0,18.0,18.0,18.0,29.0,1
324,BA:8C:B9:54:50:24,3845010,490508786,4871,6186711,3840139,484322075,0,9242,1716433,9220,1712938,22,3495,2351,16,5339,40,0,62,216660.0,130000.0,-48.0,-35.0,-43.0,-45.0,-45.0,-36.0,-44.0,-48.0,-88.0,-89.0,-86.0,-89.0,40.0,54.0,43.0,44.0,1
325,62:47:05:9D:EB:15,3842238,486739353,2092,2416610,3840146,484322743,0,4192,3002462,4161,2997481,31,4981,2038,0,2135,53,0,105,216660.0,130000.0,-44.0,-46.0,-38.0,-49.0,-47.0,-45.0,-38.0,-47.0,-88.0,-89.0,-86.0,-89.0,44.0,43.0,48.0,40.0,1
326,3C:55:76:E8:8F:1F,3909226,656981248,69080,172658505,3840146,484322743,25,33280,6921385,32835,6844693,445,76692,14136,35,69153,7050,25,424,243750.0,1000.0,-46.0,-56.0,-44.0,-43.0,-44.0,-53.0,-50.0,-41.0,-88.0,-89.0,-86.0,-89.0,42.0,33.0,42.0,46.0,1
327,92:69:1D:31:68:E9,3844111,487953397,3965,3630654,3840146,484322743,0,5006,1122833,4852,1087975,154,34858,2145,11,4192,91,0,53,216660.0,130000.0,-51.0,-48.0,-45.0,-47.0,-51.0,-47.0,-44.0,-47.0,-88.0,-89.0,-86.0,-89.0,37.0,41.0,41.0,42.0,1
328,CC:2F:71:3F:1F:24,4779897,1528173963,939751,1043851220,3840146,484322743,37,774095,843512712,773336,843421386,759,91326,747294,15,940008,98102,34,579,130000.0,43333.0,-66.0,-69.0,-67.0,-70.0,-66.0,-69.0,-65.0,-69.0,-88.0,-89.0,-86.0,-89.0,22.0,20.0,19.0,19.0,1
329,CC:2F:71:3E:C5:1F,3841069,484435474,921,112529,3840148,484322945,0,3843,322727,3171,242987,672,79740,975,11,1324,25,0,48,144444.0,39000.0,-71.0,-71.0,-68.0,-60.0,-70.0,-70.0,-67.0,-60.0,-88.0,-89.0,-86.0,-89.0,17.0,18.0,18.0,29.0,1
330,BA:8C:B9:54:50:24,3845021,490509778,4871,6186711,3840150,484323067,0,9242,1716433,9220,1712938,22,3495,2351,16,5339,40,0,62,216660.0,130000.0,-48.0,-35.0,-43.0,-45.0,-45.0,-36.0,-44.0,-48.0,-88.0,-89.0,-86.0,-89.0,40.0,54.0,43.0,44.0,1
331,62:47:05:9D:EB:15,3842261,486743188,2093,2418383,3840168,484324805,0,4196,3002734,4165,2997753,31,4981,2038,0,2135,53,0,105,216660.0,130000.0,-44.0,-46.0,-38.0,-48.0,-47.0,-45.0,-38.0,-47.0,-88.0,-89.0,-86.0,-89.0,44.0,43.0,48.0,41.0,1
332,3C:55:76:E8:8F:1F,3909255,656984570,69086,172659703,3840169,484324867,25,33346,6926764,32899,6849836,447,76928,14147,35,69159,7064,25,427,216660.0,1000.0,-49.0,-59.0,-46.0,-46.0,-45.0,-54.0,-48.0,-42.0,-88.0,-89.0,-86.0,-89.0,39.0,30.0,40.0,43.0,1
333,92:69:1D:31:68:E9,3844134,487955521,3965,3630654,3840169,484324867,0,5010,1123105,4856,1088247,154,34858,2145,11,4192,91,0,53,216660.0,130000.0,-52.0,-48.0,-45.0,-47.0,-51.0,-47.0,-43.0,-47.0,-88.0,-89.0,-86.0,-89.0,36.0,41.0,41.0,42.0,1
334,CC:2F:71:3F:1F:24,4781008,1529689776,940835,1045364505,3840173,484325271,68,775107,844781273,774347,844689829,760,91444,748258,15,941060,98394,65,581,130000.0,43333.0,-66.0,-70.0,-66.0,-70.0,-66.0,-69.0,-66.0,-69.0,-88.0,-89.0,-86.0,-89.0,22.0,19.0,20.0,19.0,1
335,CC:2F:71:3E:C5:1F,3841096,484438002,921,112529,3840175,484325473,0,3843,322727,3171,242987,672,79740,975,11,1324,25,0,48,144444.0,39000.0,-71.0,-71.0,-68.0,-60.0,-70.0,-70.0,-67.0,-60.0,-88.0,-89.0,-86.0,-89.0,17.0,18.0,18.0,29.0,1
336,BA:8C:B9:54:50:24,3845046,490512184,4871,6186711,3840175,484325473,0,9247,1716773,9225,1713278,22,3495,2351,16,5339,40,0,62,216660.0,130000.0,-41.0,-39.0,-48.0,-52.0,-40.0,-37.0,-45.0,-51.0,-88.0,-89.0,-86.0,-89.0,47.0,50.0,38.0,37.0,1
337,62:47:05:9D:EB:15,3842271,486744118,2093,2418383,3840178,484325735,0,4200,3003134,4169,2998153,31,4981,2039,0,2136,53,0,105,229410.0,130000.0,-44.0,-46.0,-38.0,-48.0,-47.0,-45.0,-38.0,-47.0,-88.0,-89.0,-86.0,-89.0,44.0,43.0,48.0,41.0,1
338,3C:55:76:E8:8F:1F,3909264,656985438,69086,172659703,3840178,484325735,25,33346,6926764,32899,6849836,447,76928,14147,35,69159,7064,25,427,216660.0,1000.0,-49.0,-59.0,-46.0,-46.0,-45.0,-54.0,-48.0,-42.0,-88.0,-89.0,-86.0,-89.0,39.0,30.0,40.0,43.0,1
339,92:69:1D:31:68:E9,3844143,487956389,3965,3630654,3840178,484325735,0,5010,1123105,4856,1088247,154,34858,2145,11,4192,91,0,53,216660.0,130000.0,-52.0,-48.0,-45.0,-47.0,-51.0,-47.0,-43.0,-47.0,-88.0,-89.0,-86.0,-89.0,36.0,41.0,41.0,42.0,1
340,CC:2F:71:3F:1F:24,4781279,1530034804,941101,1045709069,3840178,484325735,68,775356,845118373,774596,845026929,760,91444,748497,15,941327,98408,65,581,117000.0,39000.0,-67.0,-70.0,-66.0,-69.0,-66.0,-69.0,-66.0,-69.0,-88.0,-89.0,-86.0,-89.0,21.0,19.0,20.0,20.0,1
341,CC:2F:71:3E:C5:1F,3841099,484438264,921,112529,3840178,484325735,0,3843,322727,3171,242987,672,79740,975,11,1324,25,0,48,144444.0,39000.0,-71.0,-71.0,-68.0,-60.0,-70.0,-70.0,-67.0,-60.0,-88.0,-89.0,-86.0,-89.0,17.0,18.0,18.0,29.0,1
342,BA:8C:B9:54:50:24,3845049,490512446,4871,6186711,3840178,484325735,0,9247,1716773,9225,1713278,22,3495,2351,16,5339,40,0,62,216660.0,130000.0,-41.0,-39.0,-48.0,-52.0,-40.0,-37.0,-45.0,-51.0,-88.0,-89.0,-86.0,-89.0,47.0,50.0,38.0,37.0,1
343,62:47:05:9D:EB:15,3842300,486755747,2093,2418383,3840207,484337364,0,4200,3003134,4169,2998153,31,4981,2039,0,2136,53,0,105,229410.0,130000.0,-44.0,-46.0,-38.0,-48.0,-47.0,-45.0,-38.0,-47.0,-88.0,-89.0,-86.0,-89.0,44.0,43.0,48.0,41.0,1
344,3C:55:76:E8:8F:1F,3909293,656997067,69086,172659703,3840207,484337364,25,33346,6926764,32899,6849836,447,76928,14147,35,69159,7064,25,427,216660.0,1000.0,-49.0,-59.0,-46.0,-46.0,-45.0,-54.0,-48.0,-42.0,-88.0,-89.0,-86.0,-89.0,39.0,30.0,40.0,43.0,1
345,92:69:1D:31:68:E9,3844172,487968018,3965,3630654,3840207,484337364,0,5013,1123476,4858,1088383,155,35093,2146,11,4192,91,0,53,216660.0,130000.0,-53.0,-47.0,-42.0,-48.0,-51.0,-47.0,-43.0,-48.0,-88.0,-89.0,-86.0,-89.0,35.0,42.0,44.0,41.0,1
346,CC:2F:71:3F:1F:24,4781702,1530556972,941495,1046219608,3840207,484337364,68,775619,845380166,774859,845288722,760,91444,748757,15,941720,98434,65,581,115556.0,28889.0,-66.0,-69.0,-67.0,-69.0,-66.0,-69.0,-66.0,-69.0,-88.0,-89.0,-86.0,-89.0,22.0,20.0,19.0,20.0,1
347,CC:2F:71:3E:C5:1F,3841128,484449893,921,112529,3840207,484337364,0,3843,322727,3171,242987,672,79740,975,11,1324,25,0,48,144444.0,39000.0,-71.0,-71.0,-68.0,-60.0,-70.0,-70.0,-67.0,-60.0,-88.0,-89.0,-86.0,-89.0,17.0,18.0,18.0,29.0,1
348,BA:8C:B9:54:50:24,3845078,490524075,4871,6186711,3840207,484337364,0,9247,1716773,9225,1713278,22,3495,2351,16,5339,40,0,62,216660.0,130000.0,-41.0,-39.0,-48.0,-52.0,-40.0,-37.0,-45.0,-51.0,-88.0,-89.0,-86.0,-89.0,47.0,50.0,38.0,37.0,1
349,62:47:05:9D:EB:15,3842305,486756131,2094,2418443,3840211,484337688,0,4202,3003312,4171,2998331,31,4981,2040,0,2137,53,0,105,229410.0,130000.0,-49.0,-47.0,-40.0,-49.0,-47.0,-46.0,-38.0,-48.0,-88.0,-89.0,-86.0,-89.0,39.0,42.0,46.0,40.0,1
350,3C:55:76:E8:8F:1F,3909304,656998270,69086,172659703,3840218,484338567,25,33355,6927430,32907,6850384,448,77046,14148,35,69159,7064,25,428,216660.0,1000.0,-50.0,-60.0,-46.0,-46.0,-48.0,-58.0,-45.0,-44.0,-88.0,-89.0,-86.0,-89.0,38.0,29.0,40.0,43.0,1
351,92:69:1D:31:68:E9,3844185,487969423,3965,3630654,3840220,484338769,0,5013,1123476,4858,1088383,155,35093,2146,11,4192,91,0,53,216660.0,130000.0,-53.0,-47.0,-42.0,-48.0,-51.0,-47.0,-43.0,-48.0,-88.0,-89.0,-86.0,-89.0,35.0,42.0,44.0,41.0,1
352,CC:2F:71:3F:1F:24,4782609,1531835924,942375,1047495506,3840234,484340418,108,776469,846566739,775708,846475028,761,91711,749572,15,942468,98442,105,581,130000.0,39000.0,-66.0,-69.0,-66.0,-69.0,-66.0,-69.0,-66.0,-69.0,-88.0,-89.0,-86.0,-89.0,22.0,20.0,20.0,20.0,1
353,CC:2F:71:3E:C5:1F,3841159,484453351,921,112529,3840238,484340822,0,3843,322727,3171,242987,672,79740,975,11,1324,25,0,48,144444.0,39000.0,-71.0,-71.0,-68.0,-60.0,-70.0,-70.0,-67.0,-60.0,-88.0,-89.0,-86.0,-89.0,17.0,18.0,18.0,29.0,1
354,BA:8C:B9:54:50:24,3845112,490527795,4871,6186711,3840241,484341084,0,9247,1716773,9225,1713278,22,3495,2351,16,5339,40,0,62,216660.0,130000.0,-41.0,-39.0,-48.0,-52.0,-40.0,-37.0,-45.0,-51.0,-88.0,-89.0,-86.0,-89.0,47.0,50.0,38.0,37.0,1
355,62:47:05:9D:EB:15,3842339,486760054,2094,2418443,3840245,484341611,0,4203,3003380,4172,2998399,31,4981,2040,0,2137,53,0,105,229410.0,130000.0,-51.0,-45.0,-39.0,-47.0,-47.0,-46.0,-38.0,-48.0,-88.0,-89.0,-86.0,-89.0,37.0,44.0,47.0,42.0,1
356,3C:55:76:E8:8F:1F,3909347,657004719,69099,172662838,3840248,484341881,30,33426,6933883,32978,6856837,448,77046,14163,37,69169,7085,30,431,216660.0,1000.0,-44.0,-53.0,-52.0,-41.0,-43.0,-52.0,-51.0,-40.0,-88.0,-89.0,-86.0,-89.0,44.0,36.0,34.0,48.0,1
357,92:69:1D:31:68:E9,3844213,487972535,3965,3630654,3840248,484341881,0,5013,1123476,4858,1088383,155,35093,2146,11,4192,91,0,53,216660.0,130000.0,-53.0,-47.0,-42.0,-48.0,-51.0,-47.0,-43.0,-48.0,-88.0,-89.0,-86.0,-89.0,35.0,42.0,44.0,41.0,1
358,CC:2F:71:3F:1F:24,4783153,1532547067,942905,1048205186,3840248,484341881,108,776932,847128429,776170,847036471,762,91958,750025,15,943093,98537,105,581,130000.0,43333.0,-66.0,-70.0,-67.0,-70.0,-66.0,-69.0,-66.0,-69.0,-88.0,-89.0,-86.0,-89.0,22.0,19.0,19.0,19.0,1
359,CC:2F:71:3E:C5:1F,3841169,484454410,921,112529,3840248,484341881,0,3843,322727,3171,242987,672,79740,975,11,1324,25,0,48,144444.0,39000.0,-71.0,-71.0,-68.0,-60.0,-70.0,-70.0,-67.0,-60.0,-88.0,-89.0,-86.0,-89.0,17.0,18.0,18.0,29.0,1
360,BA:8C:B9:54:50:24,3845119,490528592,4871,6186711,3840248,484341881,0,9247,1716773,9225,1713278,22,3495,2351,16,5339,40,0,62,216660.0,130000.0,-41.0,-39.0,-48.0,-52.0,-40.0,-37.0,-45.0,-51.0,-88.0,-89.0,-86.0,-89.0,47.0,50.0,38.0,37.0,1
361,62:47:05:9D:EB:15,3842345,486760586,2094,2418443,3840251,484342143,0,4203,3003380,4172,2998399,31,4981,2040,0,2137,53,0,105,229410.0,130000.0,-51.0,-45.0,-39.0,-47.0,-47.0,-46.0,-38.0,-48.0,-88.0,-89.0,-86.0,-89.0,37.0,44.0,47.0,42.0,1
362,3C:55:76:E8:8F:1F,3909350,657004981,69099,172662838,3840251,484342143,30,33435,6934645,32987,6857599,448,77046,14165,37,69169,7085,30,432,216660.0,1000.0,-44.0,-54.0,-52.0,-41.0,-44.0,-53.0,-51.0,-41.0,-88.0,-89.0,-86.0,-89.0,44.0,35.0,34.0,48.0,1
363,92:69:1D:31:68:E9,3844216,487972797,3965,3630654,3840251,484342143,0,5013,1123476,4858,1088383,155,35093,2146,11,4192,91,0,53,216660.0,130000.0,-53.0,-47.0,-42.0,-48.0,-51.0,-47.0,-43.0,-48.0,-88.0,-89.0,-86.0,-89.0,35.0,42.0,44.0,41.0,1
364,CC:2F:71:3F:1F:24,4783368,1532810889,943117,1048468746,3840251,484342143,108,777131,847388563,776369,847296605,762,91958,750213,15,943304,98548,105,581,130000.0,43333.0,-67.0,-69.0,-67.0,-69.0,-66.0,-69.0,-66.0,-69.0,-88.0,-89.0,-86.0,-89.0,21.0,20.0,19.0,20.0,1
365,CC:2F:71:3E:C5:1F,3841172,484454672,921,112529,3840251,484342143,0,3843,322727,3171,242987,672,79740,975,11,1324,25,0,48,144444.0,39000.0,-71.0,-71.0,-68.0,-60.0,-70.0,-70.0,-67.0,-60.0,-88.0,-89.0,-86.0,-89.0,17.0,18.0,18.0,29.0,1
366,BA:8C:B9:54:50:24,3845122,490528854,4871,6186711,3840251,484342143,0,9247,1716773,9225,1713278,22,3495,2351,16,5339,40,0,62,216660.0,130000.0,-41.0,-39.0,-48.0,-52.0,-40.0,-37.0,-45.0,-51.0,-88.0,-89.0,-86.0,-89.0,47.0,50.0,38.0,37.0,1
367,62:47:05:9D:EB:15,3842353,486761394,2094,2418443,3840259,484342951,0,4204,3003448,4173,2998467,31,4981,2040,0,2137,53,0,105,229410.0,130000.0,-44.0,-46.0,-38.0,-48.0,-46.0,-46.0,-38.0,-48.0,-88.0,-89.0,-86.0,-89.0,44.0,43.0,48.0,41.0,1
368,3C:55:76:E8:8F:1F,3909361,657006051,69099,172662838,3840262,484343213,30,33435,6934645,32987,6857599,448,77046,14165,37,69169,7085,30,432,216660.0,1000.0,-44.0,-54.0,-52.0,-41.0,-44.0,-53.0,-51.0,-41.0,-88.0,-89.0,-86.0,-89.0,44.0,35.0,34.0,48.0,1
369,92:69:1D:31:68:E9,3844231,487974271,3965,3630654,3840266,484343617,0,5013,1123476,4858,1088383,155,35093,2146,11,4192,91,0,53,216660.0,130000.0,-53.0,-47.0,-42.0,-48.0,-51.0,-47.0,-43.0,-48.0,-88.0,-89.0,-86.0,-89.0,35.0,42.0,44.0,41.0,1
370,CC:2F:71:3F:1F:24,4783862,1533477148,943596,1049133531,3840266,484343617,108,777607,848056030,776845,847964072,762,91958,750672,15,943784,98552,105,581,130000.0,43333.0,-66.0,-69.0,-67.0,-70.0,-66.0,-69.0,-66.0,-69.0,-88.0,-89.0,-86.0,-89.0,22.0,20.0,19.0,19.0,1
371,CC:2F:71:3E:C5:1F,3841187,484456146,921,112529,3840266,484343617,0,3843,322727,3171,242987,672,79740,975,11,1324,25,0,48,144444.0,39000.0,-71.0,-71.0,-68.0,-60.0,-70.0,-70.0,-67.0,-60.0,-88.0,-89.0,-86.0,-89.0,17.0,18.0,18.0,29.0,1
372,BA:8C:B9:54:50:24,3845137,490530328,4871,6186711,3840266,484343617,0,9249,1716909,9227,1713414,22,3495,2351,16,5339,40,0,62,216660.0,130000.0,-48.0,-35.0,-43.0,-46.0,-42.0,-37.0,-45.0,-49.0,-88.0,-89.0,-86.0,-89.0,40.0,54.0,43.0,43.0,1
373,62:47:05:9D:EB:15,3842362,486762262,2094,2418443,3840268,484343819,0,4204,3003448,4173,2998467,31,4981,2040,0,2137,53,0,105,229410.0,130000.0,-44.0,-46.0,-38.0,-48.0,-46.0,-46.0,-38.0,-48.0,-88.0,-89.0,-86.0,-89.0,44.0,43.0,48.0,41.0,1
374,3C:55:76:E8:8F:1F,3909368,657006773,69100,172662954,3840268,484343819,30,33441,6935055,32993,6858009,448,77046,14165,37,69170,7085,30,433,195000.0,1000.0,-49.0,-58.0,-46.0,-46.0,-45.0,-55.0,-46.0,-43.0,-88.0,-89.0,-86.0,-89.0,39.0,31.0,40.0,43.0,1
375,92:69:1D:31:68:E9,3844234,487974589,3966,3630770,3840268,484343819,0,5015,1123612,4860,1088519,155,35093,2146,11,4193,91,0,54,216660.0,130000.0,-51.0,-48.0,-45.0,-49.0,-52.0,-47.0,-43.0,-48.0,-88.0,-89.0,-86.0,-89.0,37.0,41.0,41.0,40.0,1
376,CC:2F:71:3F:1F:24,4784079,1533743518,943811,1049399699,3840268,484343819,108,777806,848320374,777044,848228416,762,91958,750861,15,943999,98580,105,581,130000.0,39000.0,-67.0,-69.0,-66.0,-69.0,-66.0,-69.0,-66.0,-69.0,-88.0,-89.0,-86.0,-89.0,21.0,20.0,20.0,20.0,1
377,CC:2F:71:3E:C5:1F,3841190,484456464,922,112645,3840268,484343819,0,3845,322867,3173,243127,672,79740,975,11,1325,25,0,48,144444.0,39000.0,-70.0,-71.0,-69.0,-60.0,-70.0,-71.0,-68.0,-60.0,-88.0,-89.0,-86.0,-89.0,18.0,18.0,17.0,29.0,1
378,BA:8C:B9:54:50:24,3845142,490530848,4872,6186827,3840270,484344021,0,9253,1717181,9231,1713686,22,3495,2351,16,5340,40,0,62,229410.0,130000.0,-48.0,-35.0,-43.0,-45.0,-45.0,-36.0,-44.0,-47.0,-88.0,-89.0,-86.0,-89.0,40.0,54.0,43.0,44.0,1
379,62:47:05:9D:EB:15,3842370,486763044,2095,2418559,3840275,484344485,0,4206,3003584,4175,2998603,31,4981,2040,0,2138,53,0,105,229410.0,130000.0,-44.0,-46.0,-38.0,-49.0,-46.0,-46.0,-38.0,-48.0,-88.0,-89.0,-86.0,-89.0,44.0,43.0,48.0,40.0,1
380,3C:55:76:E8:8F:1F,3909376,657007499,69101,172663014,3840275,484344485,30,33445,6935369,32997,6858323,448,77046,14166,37,69171,7085,30,433,195000.0,97500.0,-46.0,-57.0,-53.0,-44.0,-46.0,-56.0,-45.0,-44.0,-88.0,-89.0,-86.0,-89.0,42.0,32.0,33.0,45.0,1
381,92:69:1D:31:68:E9,3844241,487975255,3966,3630770,3840275,484344485,0,5015,1123612,4860,1088519,155,35093,2146,11,4193,91,0,54,216660.0,130000.0,-51.0,-48.0,-45.0,-49.0,-52.0,-47.0,-43.0,-48.0,-88.0,-89.0,-86.0,-89.0,37.0,41.0,41.0,40.0,1
382,CC:2F:71:3F:1F:24,4784298,1534008832,944023,1049664347,3840275,484344485,108,777999,848578298,777237,848486340,762,91958,751048,15,944211,98620,105,581,115556.0,28889.0,-66.0,-70.0,-65.0,-69.0,-66.0,-69.0,-65.0,-69.0,-88.0,-89.0,-86.0,-89.0,22.0,19.0,21.0,20.0,1
383,CC:2F:71:3E:C5:1F,3841197,484457130,922,112645,3840275,484344485,0,3845,322867,3173,243127,672,79740,975,11,1325,25,0,48,144444.0,39000.0,-70.0,-71.0,-69.0,-60.0,-70.0,-71.0,-68.0,-60.0,-88.0,-89.0,-86.0,-89.0,18.0,18.0,17.0,29.0,1
384,BA:8C:B9:54:50:24,3845147,490531312,4872,6186827,3840275,484344485,0,9254,1717249,9232,1713754,22,3495,2351,16,5340,40,0,62,229410.0,130000.0,-40.0,-37.0,-46.0,-52.0,-45.0,-36.0,-44.0,-47.0,-88.0,-89.0,-86.0,-89.0,48.0,52.0,40.0,37.0,1
385,62:47:05:9D:EB:15,3842373,486763519,2095,2418559,3840278,484344960,0,4206,3003584,4175,2998603,31,4981,2040,0,2138,53,0,105,229410.0,130000.0,-44.0,-46.0,-38.0,-49.0,-46.0,-46.0,-38.0,-48.0,-88.0,-89.0,-86.0,-89.0,44.0,43.0,48.0,40.0,1
386,3C:55:76:E8:8F:1F,3909379,657007974,69101,172663014,3840278,484344960,30,33446,6935439,32998,6858393,448,77046,14166,37,69171,7085,30,433,195000.0,97500.0,-49.0,-59.0,-46.0,-46.0,-47.0,-57.0,-46.0,-44.0,-88.0,-89.0,-86.0,-89.0,39.0,30.0,40.0,43.0,1
387,92:69:1D:31:68:E9,3844246,487975932,3966,3630770,3840280,484345162,0,5015,1123612,4860,1088519,155,35093,2146,11,4193,91,0,54,216660.0,130000.0,-51.0,-48.0,-45.0,-49.0,-52.0,-47.0,-43.0,-48.0,-88.0,-89.0,-86.0,-89.0,37.0,41.0,41.0,40.0,1
388,CC:2F:71:3F:1F:24,4784514,1534272939,944234,1049927777,3840280,484345162,108,778197,848836802,777435,848744844,762,91958,751238,15,944422,98622,105,581,115556.0,28889.0,-66.0,-70.0,-66.0,-70.0,-66.0,-69.0,-66.0,-69.0,-88.0,-89.0,-86.0,-89.0,22.0,19.0,20.0,19.0,1
389,CC:2F:71:3E:C5:1F,3841202,484457807,922,112645,3840280,484345162,0,3845,322867,3173,243127,672,79740,975,11,1325,25,0,48,144444.0,39000.0,-70.0,-71.0,-69.0,-60.0,-70.0,-71.0,-68.0,-60.0,-88.0,-89.0,-86.0,-89.0,18.0,18.0,17.0,29.0,1
390,BA:8C:B9:54:50:24,3845152,490531989,4872,6186827,3840280,484345162,0,9254,1717249,9232,1713754,22,3495,2351,16,5340,40,0,62,229410.0,130000.0,-40.0,-37.0,-46.0,-52.0,-45.0,-36.0,-44.0,-47.0,-88.0,-89.0,-86.0,-89.0,48.0,52.0,40.0,37.0,1
391,62:47:05:9D:EB:15,3842382,486764389,2095,2418559,3840287,484345830,0,4206,3003584,4175,2998603,31,4981,2040,0,2138,53,0,105,229410.0,130000.0,-44.0,-46.0,-38.0,-49.0,-46.0,-46.0,-38.0,-48.0,-88.0,-89.0,-86.0,-89.0,44.0,43.0,48.0,40.0,1
392,3C:55:76:E8:8F:1F,3909389,657008904,69101,172663014,3840288,484345890,30,33446,6935439,32998,6858393,448,77046,14166,37,69171,7085,30,433,195000.0,97500.0,-49.0,-59.0,-46.0,-46.0,-47.0,-57.0,-46.0,-44.0,-88.0,-89.0,-86.0,-89.0,39.0,30.0,40.0,43.0,1
393,92:69:1D:31:68:E9,3844254,487976660,3966,3630770,3840288,484345890,0,5015,1123612,4860,1088519,155,35093,2146,11,4193,91,0,54,216660.0,130000.0,-51.0,-48.0,-45.0,-49.0,-52.0,-47.0,-43.0,-48.0,-88.0,-89.0,-86.0,-89.0,37.0,41.0,41.0,40.0,1
394,CC:2F:71:3F:1F:24,4784940,1534845614,944648,1050499320,3840292,484346294,108,778619,849425451,777856,849333375,763,92076,751636,15,944828,98665,105,581,117000.0,39000.0,-67.0,-69.0,-66.0,-69.0,-66.0,-69.0,-66.0,-69.0,-88.0,-89.0,-86.0,-89.0,21.0,20.0,20.0,20.0,1
395,CC:2F:71:3E:C5:1F,3841218,484459343,922,112645,3840296,484346698,0,3845,322867,3173,243127,672,79740,975,11,1325,25,0,48,144444.0,39000.0,-70.0,-71.0,-69.0,-60.0,-70.0,-71.0,-68.0,-60.0,-88.0,-89.0,-86.0,-89.0,18.0,18.0,17.0,29.0,1
396,BA:8C:B9:54:50:24,3845168,490533525,4872,6186827,3840296,484346698,0,9257,1717453,9235,1713958,22,3495,2351,16,5340,40,0,62,229410.0,130000.0,-48.0,-35.0,-43.0,-45.0,-46.0,-35.0,-43.0,-46.0,-88.0,-89.0,-86.0,-89.0,40.0,54.0,43.0,44.0,1
397,62:47:05:9D:EB:15,3842399,486766132,2096,2418768,3840303,484347364,0,4209,3003840,4178,2998859,31,4981,2041,0,2139,53,0,105,229410.0,130000.0,-44.0,-47.0,-38.0,-49.0,-46.0,-46.0,-38.0,-48.0,-88.0,-89.0,-86.0,-89.0,44.0,42.0,48.0,40.0,1
398,3C:55:76:E8:8F:1F,3909404,657010378,69101,172663014,3840303,484347364,30,33446,6935439,32998,6858393,448,77046,14166,37,69171,7085,30,433,195000.0,97500.0,-49.0,-59.0,-46.0,-46.0,-47.0,-57.0,-46.0,-44.0,-88.0,-89.0,-86.0,-89.0,39.0,30.0,40.0,43.0,1
399,92:69:1D:31:68:E9,3844269,487978134,3966,3630770,3840303,484347364,0,5015,1123612,4860,1088519,155,35093,2146,11,4193,91,0,54,216660.0,130000.0,-51.0,-48.0,-45.0,-49.0,-52.0,-47.0,-43.0,-48.0,-88.0,-89.0,-86.0,-89.0,37.0,41.0,41.0,40.0,1
400,CC:2F:71:3F:1F:24,4785559,1535643020,945256,1051295656,3840303,484347364,108,779124,849997260,778361,849905184,763,92076,752115,15,945444,98761,105,581,130000.0,43333.0,-66.0,-70.0,-65.0,-69.0,-66.0,-69.0,-65.0,-68.0,-88.0,-89.0,-86.0,-89.0,22.0,19.0,21.0,20.0,1
401,CC:2F:71:3E:C5:1F,3841225,484460009,922,112645,3840303,484347364,0,3845,322867,3173,243127,672,79740,975,11,1325,25,0,48,144444.0,39000.0,-70.0,-71.0,-69.0,-60.0,-70.0,-71.0,-68.0,-60.0,-88.0,-89.0,-86.0,-89.0,18.0,18.0,17.0,29.0,1
402,BA:8C:B9:54:50:24,3845177,490534393,4872,6186827,3840305,484347566,0,9257,1717453,9235,1713958,22,3495,2351,16,5340,40,0,62,229410.0,130000.0,-48.0,-35.0,-43.0,-45.0,-46.0,-35.0,-43.0,-46.0,-88.0,-89.0,-86.0,-89.0,40.0,54.0,43.0,44.0,1
403,62:47:05:9D:EB:15,3842404,486766598,2096,2418768,3840308,484347830,0,4209,3003840,4178,2998859,31,4981,2041,0,2139,53,0,105,229410.0,130000.0,-44.0,-47.0,-38.0,-49.0,-46.0,-46.0,-38.0,-48.0,-88.0,-89.0,-86.0,-89.0,44.0,42.0,48.0,40.0,1
404,3C:55:76:E8:8F:1F,3909409,657010844,69101,172663014,3840308,484347830,30,33446,6935439,32998,6858393,448,77046,14166,37,69171,7085,30,433,195000.0,97500.0,-49.0,-59.0,-46.0,-46.0,-47.0,-57.0,-46.0,-44.0,-88.0,-89.0,-86.0,-89.0,39.0,30.0,40.0,43.0,1
405,92:69:1D:31:68:E9,3844274,487978600,3966,3630770,3840308,484347830,0,5015,1123612,4860,1088519,155,35093,2146,11,4193,91,0,54,216660.0,130000.0,-51.0,-48.0,-45.0,-49.0,-52.0,-47.0,-43.0,-48.0,-88.0,-89.0,-86.0,-89.0,37.0,41.0,41.0,40.0,1
406,CC:2F:71:3F:1F:24,4785970,1536150296,945662,1051802466,3840308,484347830,108,779406,850263788,778643,850171712,763,92076,752390,15,945850,98765,105,581,130000.0,43333.0,-66.0,-69.0,-66.0,-68.0,-66.0,-69.0,-65.0,-69.0,-88.0,-89.0,-86.0,-89.0,22.0,20.0,20.0,21.0,1
407,CC:2F:71:3E:C5:1F,3841230,484460475,922,112645,3840308,484347830,0,3847,323055,3174,243197,673,79858,976,11,1325,25,0,48,144444.0,39000.0,-70.0,-71.0,-67.0,-60.0,-70.0,-71.0,-68.0,-60.0,-88.0,-89.0,-86.0,-89.0,18.0,18.0,19.0,29.0,1
408,BA:8C:B9:54:50:24,3845180,490534657,4872,6186827,3840308,484347830,0,9257,1717453,9235,1713958,22,3495,2351,16,5340,40,0,62,229410.0,130000.0,-48.0,-35.0,-43.0,-45.0,-46.0,-35.0,-43.0,-46.0,-88.0,-89.0,-86.0,-89.0,40.0,54.0,43.0,44.0,1
409,62:47:05:9D:EB:15,3842409,486767062,2096,2418768,3840313,484348294,0,4209,3003840,4178,2998859,31,4981,2041,0,2139,53,0,105,229410.0,130000.0,-44.0,-47.0,-38.0,-49.0,-46.0,-46.0,-38.0,-48.0,-88.0,-89.0,-86.0,-89.0,44.0,42.0,48.0,40.0,1
410,3C:55:76:E8:8F:1F,3909416,657011510,69101,172663014,3840315,484348496,30,33446,6935439,32998,6858393,448,77046,14166,37,69171,7085,30,433,195000.0,97500.0,-49.0,-59.0,-46.0,-46.0,-47.0,-57.0,-46.0,-44.0,-88.0,-89.0,-86.0,-89.0,39.0,30.0,40.0,43.0,1
411,92:69:1D:31:68:E9,3844281,487979266,3966,3630770,3840315,484348496,0,5015,1123612,4860,1088519,155,35093,2146,11,4193,91,0,54,216660.0,130000.0,-51.0,-48.0,-45.0,-49.0,-52.0,-47.0,-43.0,-48.0,-88.0,-89.0,-86.0,-89.0,37.0,41.0,41.0,40.0,1
412,CC:2F:71:3F:1F:24,4786382,1536668042,946067,1052319546,3840315,484348496,108,779698,850538719,778935,850446643,763,92076,752669,15,946255,98791,105,581,130000.0,43333.0,-66.0,-69.0,-65.0,-68.0,-66.0,-69.0,-65.0,-68.0,-88.0,-89.0,-86.0,-89.0,22.0,20.0,21.0,21.0,1
413,CC:2F:71:3E:C5:1F,3841237,484461141,922,112645,3840315,484348496,0,3847,323055,3174,243197,673,79858,976,11,1325,25,0,48,144444.0,39000.0,-70.0,-71.0,-67.0,-60.0,-70.0,-71.0,-68.0,-60.0,-88.0,-89.0,-86.0,-89.0,18.0,18.0,19.0,29.0,1
414,BA:8C:B9:54:50:24,3845187,490535323,4872,6186827,3840315,484348496,0,9257,1717453,9235,1713958,22,3495,2351,16,5340,40,0,62,229410.0,130000.0,-48.0,-35.0,-43.0,-45.0,-46.0,-35.0,-43.0,-46.0,-88.0,-89.0,-86.0,-89.0,40.0,54.0,43.0,44.0,1
415,62:47:05:9D:EB:15,3842413,486767466,2096,2418768,3840317,484348698,0,4210,3003908,4179,2998927,31,4981,2041,0,2140,53,0,105,229410.0,130000.0,-44.0,-46.0,-39.0,-49.0,-45.0,-46.0,-38.0,-48.0,-88.0,-89.0,-86.0,-89.0,44.0,43.0,47.0,40.0,1
416,3C:55:76:E8:8F:1F,3909418,657011712,69101,172663014,3840317,484348698,30,33446,6935439,32998,6858393,448,77046,14166,38,69172,7091,30,433,195000.0,97500.0,-49.0,-59.0,-46.0,-46.0,-47.0,-57.0,-46.0,-44.0,-88.0,-89.0,-86.0,-89.0,39.0,30.0,40.0,43.0,1
417,92:69:1D:31:68:E9,3844283,487979468,3966,3630770,3840317,484348698,0,5017,1123748,4862,1088655,155,35093,2146,11,4194,91,0,54,216660.0,130000.0,-53.0,-47.0,-42.0,-49.0,-52.0,-47.0,-43.0,-48.0,-88.0,-89.0,-86.0,-89.0,35.0,42.0,44.0,40.0,1
418,CC:2F:71:3F:1F:24,4786596,1536933214,946279,1052584516,3840317,484348698,108,779894,850798561,779131,850706485,763,92076,752855,15,946467,98794,105,581,130000.0,43333.0,-67.0,-69.0,-66.0,-68.0,-66.0,-69.0,-65.0,-67.0,-88.0,-89.0,-86.0,-89.0,21.0,20.0,20.0,21.0,1
419,CC:2F:71:3E:C5:1F,3841241,484461545,922,112645,3840319,484348900,0,3847,323055,3174,243197,673,79858,976,11,1325,25,0,48,144444.0,39000.0,-70.0,-71.0,-67.0,-60.0,-70.0,-71.0,-68.0,-60.0,-88.0,-89.0,-86.0,-89.0,18.0,18.0,19.0,29.0,1
420,BA:8C:B9:54:50:24,3845191,490535727,4872,6186827,3840319,484348900,0,9257,1717453,9235,1713958,22,3495,2351,16,5340,40,0,62,229410.0,130000.0,-48.0,-35.0,-43.0,-45.0,-46.0,-35.0,-43.0,-46.0,-88.0,-89.0,-86.0,-89.0,40.0,54.0,43.0,44.0,1
421,62:47:05:9D:EB:15,3842420,486768132,2096,2418768,3840324,484349364,0,4211,3003976,4180,2998995,31,4981,2041,0,2140,53,0,105,229410.0,130000.0,-51.0,-45.0,-39.0,-47.0,-45.0,-46.0,-38.0,-48.0,-88.0,-89.0,-86.0,-89.0,37.0,44.0,47.0,42.0,1
422,3C:55:76:E8:8F:1F,3909425,657012378,69101,172663014,3840324,484349364,30,33446,6935439,32998,6858393,448,77046,14166,38,69172,7091,30,433,195000.0,97500.0,-49.0,-59.0,-46.0,-46.0,-47.0,-57.0,-46.0,-44.0,-88.0,-89.0,-86.0,-89.0,39.0,30.0,40.0,43.0,1
423,92:69:1D:31:68:E9,3844290,487980134,3966,3630770,3840324,484349364,0,5017,1123748,4862,1088655,155,35093,2146,11,4194,91,0,54,216660.0,130000.0,-53.0,-47.0,-42.0,-49.0,-52.0,-47.0,-43.0,-48.0,-88.0,-89.0,-86.0,-89.0,35.0,42.0,44.0,40.0,1
424,CC:2F:71:3F:1F:24,4786868,1537276576,946542,1052927010,3840326,484349566,108,780156,851154353,779393,851062277,763,92076,753099,15,946728,98803,105,581,130000.0,43333.0,-66.0,-70.0,-66.0,-69.0,-66.0,-69.0,-66.0,-69.0,-88.0,-89.0,-86.0,-89.0,22.0,19.0,20.0,20.0,1
425,CC:2F:71:3E:C5:1F,3841248,484462211,922,112645,3840326,484349566,0,3847,323055,3174,243197,673,79858,976,11,1325,25,0,48,144444.0,39000.0,-70.0,-71.0,-67.0,-60.0,-70.0,-71.0,-68.0,-60.0,-88.0,-89.0,-86.0,-89.0,18.0,18.0,19.0,29.0,1
426,BA:8C:B9:54:50:24,3845198,490536393,4872,6186827,3840326,484349566,0,9257,1717453,9235,1713958,22,3495,2351,16,5340,40,0,62,229410.0,130000.0,-48.0,-35.0,-43.0,-45.0,-46.0,-35.0,-43.0,-46.0,-88.0,-89.0,-86.0,-89.0,40.0,54.0,43.0,44.0,1
427,62:47:05:9D:EB:15,3842426,486768738,2096,2418768,3840330,484349970,0,4211,3003976,4180,2998995,31,4981,2041,0,2140,53,0,105,229410.0,130000.0,-51.0,-45.0,-39.0,-47.0,-45.0,-46.0,-38.0,-48.0,-88.0,-89.0,-86.0,-89.0,37.0,44.0,47.0,42.0,1
428,3C:55:76:E8:8F:1F,3909433,657013186,69101,172663014,3840332,484350172,30,33446,6935439,32998,6858393,448,77046,14166,38,69172,7091,30,433,195000.0,97500.0,-49.0,-59.0,-46.0,-46.0,-47.0,-57.0,-46.0,-44.0,-88.0,-89.0,-86.0,-89.0,39.0,30.0,40.0,43.0,1
429,92:69:1D:31:68:E9,3844298,487980942,3966,3630770,3840332,484350172,0,5017,1123748,4862,1088655,155,35093,2146,11,4194,91,0,54,216660.0,130000.0,-53.0,-47.0,-42.0,-49.0,-52.0,-47.0,-43.0,-48.0,-88.0,-89.0,-86.0,-89.0,35.0,42.0,44.0,40.0,1
430,CC:2F:71:3F:1F:24,4787154,1537640081,946822,1053289909,3840332,484350172,108,780427,851518818,779664,851426742,763,92076,753354,15,947004,98821,105,581,130000.0,39000.0,-67.0,-69.0,-66.0,-69.0,-66.0,-69.0,-66.0,-69.0,-88.0,-89.0,-86.0,-89.0,21.0,20.0,20.0,20.0,1
431,CC:2F:71:3E:C5:1F,3841254,484462817,922,112645,3840332,484350172,0,3847,323055,3174,243197,673,79858,976,11,1325,25,0,48,144444.0,39000.0,-70.0,-71.0,-67.0,-60.0,-70.0,-71.0,-68.0,-60.0,-88.0,-89.0,-86.0,-89.0,18.0,18.0,19.0,29.0,1
432,BA:8C:B9:54:50:24,3845207,490537261,4872,6186827,3840335,484350434,0,9257,1717453,9235,1713958,22,3495,2351,16,5340,40,0,62,229410.0,130000.0,-48.0,-35.0,-43.0,-45.0,-46.0,-35.0,-43.0,-46.0,-88.0,-89.0,-86.0,-89.0,40.0,54.0,43.0,44.0,1
433,62:47:05:9D:EB:15,3842438,486770081,2096,2418768,3840342,484351313,0,4211,3003976,4180,2998995,31,4981,2041,0,2140,53,0,105,229410.0,130000.0,-51.0,-45.0,-39.0,-47.0,-45.0,-46.0,-38.0,-48.0,-88.0,-89.0,-86.0,-89.0,37.0,44.0,47.0,42.0,1
434,3C:55:76:E8:8F:1F,3909443,657014327,69101,172663014,3840342,484351313,30,33446,6935439,32998,6858393,448,77046,14166,38,69172,7091,30,433,195000.0,97500.0,-49.0,-59.0,-46.0,-46.0,-47.0,-57.0,-46.0,-44.0,-88.0,-89.0,-86.0,-89.0,39.0,30.0,40.0,43.0,1
435,92:69:1D:31:68:E9,3844308,487982083,3966,3630770,3840342,484351313,0,5017,1123748,4862,1088655,155,35093,2146,11,4194,91,0,54,216660.0,130000.0,-53.0,-47.0,-42.0,-49.0,-52.0,-47.0,-43.0,-48.0,-88.0,-89.0,-86.0,-89.0,35.0,42.0,44.0,40.0,1
436,CC:2F:71:3F:1F:24,4787516,1538124958,947174,1053773645,3840342,484351313,108,780767,851996002,780004,851903926,763,92076,753686,15,947362,98840,105,581,130000.0,43333.0,-66.0,-68.0,-67.0,-69.0,-66.0,-68.0,-65.0,-68.0,-88.0,-89.0,-86.0,-89.0,22.0,21.0,19.0,20.0,1
437,CC:2F:71:3E:C5:1F,3841266,484464160,922,112645,3840344,484351515,0,3847,323055,3174,243197,673,79858,976,11,1325,25,0,48,144444.0,39000.0,-70.0,-71.0,-67.0,-60.0,-70.0,-71.0,-68.0,-60.0,-88.0,-89.0,-86.0,-89.0,18.0,18.0,19.0,29.0,1
438,BA:8C:B9:54:50:24,3845216,490538342,4872,6186827,3840344,484351515,0,9257,1717453,9235,1713958,22,3495,2351,16,5340,40,0,62,229410.0,130000.0,-48.0,-35.0,-43.0,-45.0,-46.0,-35.0,-43.0,-46.0,-88.0,-89.0,-86.0,-89.0,40.0,54.0,43.0,44.0,1
439,62:47:05:9D:EB:15,3842441,486770343,2096,2418768,3840345,484351575,0,4211,3003976,4180,2998995,31,4981,2041,0,2140,53,0,105,229410.0,130000.0,-51.0,-45.0,-39.0,-47.0,-45.0,-46.0,-38.0,-48.0,-88.0,-89.0,-86.0,-89.0,37.0,44.0,47.0,42.0,1
440,3C:55:76:E8:8F:1F,3909448,657014791,69101,172663014,3840347,484351777,30,33446,6935439,32998,6858393,448,77046,14166,38,69172,7091,30,433,195000.0,97500.0,-49.0,-59.0,-46.0,-46.0,-47.0,-57.0,-46.0,-44.0,-88.0,-89.0,-86.0,-89.0,39.0,30.0,40.0,43.0,1
441,92:69:1D:31:68:E9,3844313,487982547,3966,3630770,3840347,484351777,0,5017,1123748,4862,1088655,155,35093,2146,11,4194,91,0,54,216660.0,130000.0,-53.0,-47.0,-42.0,-49.0,-52.0,-47.0,-43.0,-48.0,-88.0,-89.0,-86.0,-89.0,35.0,42.0,44.0,40.0,1
442,CC:2F:71:3F:1F:24,4787736,1538392162,947387,1054040183,3840349,484351979,108,780960,852252568,780197,852160492,763,92076,753872,15,947575,98841,105,581,130000.0,43333.0,-66.0,-69.0,-65.0,-69.0,-66.0,-69.0,-65.0,-68.0,-88.0,-89.0,-86.0,-89.0,22.0,20.0,21.0,20.0,1
443,CC:2F:71:3E:C5:1F,3841271,484464624,922,112645,3840349,484351979,0,3847,323055,3174,243197,673,79858,976,11,1325,25,0,48,144444.0,39000.0,-70.0,-71.0,-67.0,-60.0,-70.0,-71.0,-68.0,-60.0,-88.0,-89.0,-86.0,-89.0,18.0,18.0,19.0,29.0,1
444,BA:8C:B9:54:50:24,3845221,490538806,4872,6186827,3840349,484351979,0,9257,1717453,9235,1713958,22,3495,2351,16,5340,40,0,62,229410.0,130000.0,-48.0,-35.0,-43.0,-45.0,-46.0,-35.0,-43.0,-46.0,-88.0,-89.0,-86.0,-89.0,40.0,54.0,43.0,44.0,1
445,62:47:05:9D:EB:15,3842449,486771151,2096,2418768,3840353,484352383,0,4211,3003976,4180,2998995,31,4981,2041,0,2140,53,0,105,229410.0,130000.0,-51.0,-45.0,-39.0,-47.0,-45.0,-46.0,-38.0,-48.0,-88.0,-89.0,-86.0,-89.0,37.0,44.0,47.0,42.0,1
446,3C:55:76:E8:8F:1F,3909454,657015397,69101,172663014,3840353,484352383,30,33446,6935439,32998,6858393,448,77046,14166,38,69172,7091,30,433,195000.0,97500.0,-49.0,-59.0,-46.0,-46.0,-47.0,-57.0,-46.0,-44.0,-88.0,-89.0,-86.0,-89.0,39.0,30.0,40.0,43.0,1
447,92:69:1D:31:68:E9,3844319,487983153,3966,3630770,3840353,484352383,0,5017,1123748,4862,1088655,155,35093,2146,11,4194,91,0,54,216660.0,130000.0,-53.0,-47.0,-42.0,-49.0,-52.0,-47.0,-43.0,-48.0,-88.0,-89.0,-86.0,-89.0,35.0,42.0,44.0,40.0,1
448,CC:2F:71:3F:1F:24,4787960,1538658141,947607,1054305758,3840353,484352383,108,781157,852498675,780394,852406599,763,92076,754068,15,947795,98849,105,581,130000.0,43333.0,-66.0,-69.0,-66.0,-69.0,-66.0,-68.0,-65.0,-68.0,-88.0,-89.0,-86.0,-89.0,22.0,20.0,20.0,20.0,1
449,CC:2F:71:3E:C5:1F,3841275,484465028,922,112645,3840353,484352383,0,3847,323055,3174,243197,673,79858,976,11,1325,25,0,48,144444.0,39000.0,-70.0,-71.0,-67.0,-60.0,-70.0,-71.0,-68.0,-60.0,-88.0,-89.0,-86.0,-89.0,18.0,18.0,19.0,29.0,1
450,BA:8C:B9:54:50:24,3845225,490539210,4872,6186827,3840353,484352383,0,9257,1717453,9235,1713958,22,3495,2351,16,5340,40,0,62,229410.0,130000.0,-48.0,-35.0,-43.0,-45.0,-46.0,-35.0,-43.0,-46.0,-88.0,-89.0,-86.0,-89.0,40.0,54.0,43.0,44.0,1
451,62:47:05:9D:EB:15,3842453,486771563,2096,2418768,3840357,484352795,0,4211,3003976,4180,2998995,31,4981,2041,0,2140,53,0,105,229410.0,130000.0,-51.0,-45.0,-39.0,-47.0,-45.0,-46.0,-38.0,-48.0,-88.0,-89.0,-86.0,-89.0,37.0,44.0,47.0,42.0,1
452,3C:55:76:E8:8F:1F,3909461,657016071,69101,172663014,3840360,484353057,30,33446,6935439,32998,6858393,448,77046,14166,38,69172,7091,30,433,195000.0,97500.0,-49.0,-59.0,-46.0,-46.0,-47.0,-57.0,-46.0,-44.0,-88.0,-89.0,-86.0,-89.0,39.0,30.0,40.0,43.0,1
453,92:69:1D:31:68:E9,3844326,487983827,3966,3630770,3840360,484353057,0,5017,1123748,4862,1088655,155,35093,2146,11,4194,91,0,54,216660.0,130000.0,-53.0,-47.0,-42.0,-49.0,-52.0,-47.0,-43.0,-48.0,-88.0,-89.0,-86.0,-89.0,35.0,42.0,44.0,40.0,1
454,CC:2F:71:3F:1F:24,4788178,1538921959,947817,1054568834,3840361,484353125,108,781346,852744879,780583,852652803,763,92076,754253,15,948005,98856,105,581,130000.0,43333.0,-67.0,-69.0,-65.0,-68.0,-66.0,-68.0,-65.0,-68.0,-88.0,-89.0,-86.0,-89.0,21.0,20.0,21.0,21.0,1
455,CC:2F:71:3E:C5:1F,3841284,484465904,922,112645,3840362,484353259,0,3850,323447,3175,243267,675,80180,978,11,1325,25,0,48,144444.0,39000.0,-71.0,-70.0,-66.0,-59.0,-70.0,-71.0,-67.0,-59.0,-88.0,-89.0,-86.0,-89.0,17.0,19.0,20.0,30.0,1
456,BA:8C:B9:54:50:24,3845234,490540086,4872,6186827,3840362,484353259,0,9257,1717453,9235,1713958,22,3495,2351,16,5340,40,0,62,229410.0,130000.0,-48.0,-35.0,-43.0,-45.0,-46.0,-35.0,-43.0,-46.0,-88.0,-89.0,-86.0,-89.0,40.0,54.0,43.0,44.0,1
457,62:47:05:9D:EB:15,3842460,486772229,2096,2418768,3840364,484353461,0,4211,3003976,4180,2998995,31,4981,2041,0,2140,53,0,105,229410.0,130000.0,-51.0,-45.0,-39.0,-47.0,-45.0,-46.0,-38.0,-48.0,-88.0,-89.0,-86.0,-89.0,37.0,44.0,47.0,42.0,1
458,3C:55:76:E8:8F:1F,3909465,657016475,69101,172663014,3840364,484353461,30,33446,6935439,32998,6858393,448,77046,14166,38,69172,7091,30,433,195000.0,97500.0,-49.0,-59.0,-46.0,-46.0,-47.0,-57.0,-46.0,-44.0,-88.0,-89.0,-86.0,-89.0,39.0,30.0,40.0,43.0,1
459,92:69:1D:31:68:E9,3844330,487984231,3966,3630770,3840364,484353461,0,5017,1123748,4862,1088655,155,35093,2146,11,4194,91,0,54,216660.0,130000.0,-53.0,-47.0,-42.0,-49.0,-52.0,-47.0,-43.0,-48.0,-88.0,-89.0,-86.0,-89.0,35.0,42.0,44.0,40.0,1
460,CC:2F:71:3F:1F:24,4788499,1539343243,948130,1054989252,3840369,484353991,108,781646,853164789,780883,853072713,763,92076,754542,15,948316,98860,105,581,130000.0,43333.0,-67.0,-69.0,-67.0,-69.0,-66.0,-69.0,-66.0,-69.0,-88.0,-89.0,-86.0,-89.0,21.0,20.0,19.0,20.0,1
461,CC:2F:71:3E:C5:1F,3841293,484466838,922,112645,3840371,484354193,0,3850,323447,3175,243267,675,80180,978,11,1325,25,0,48,144444.0,39000.0,-71.0,-70.0,-66.0,-59.0,-70.0,-71.0,-67.0,-59.0,-88.0,-89.0,-86.0,-89.0,17.0,19.0,20.0,30.0,1
462,BA:8C:B9:54:50:24,3845246,490541282,4872,6186827,3840374,484354455,0,9257,1717453,9235,1713958,22,3495,2351,16,5340,40,0,62,229410.0,130000.0,-48.0,-35.0,-43.0,-45.0,-46.0,-35.0,-43.0,-46.0,-88.0,-89.0,-86.0,-89.0,40.0,54.0,43.0,44.0,1
463,62:47:05:9D:EB:15,3842478,486774031,2096,2418768,3840382,484355263,0,4211,3003976,4180,2998995,31,4981,2041,0,2140,53,0,105,229410.0,130000.0,-51.0,-45.0,-39.0,-47.0,-45.0,-46.0,-38.0,-48.0,-88.0,-89.0,-86.0,-89.0,37.0,44.0,47.0,42.0,1
464,3C:55:76:E8:8F:1F,3909483,657018277,69101,172663014,3840382,484355263,30,33446,6935439,32998,6858393,448,77046,14166,38,69172,7091,30,433,195000.0,97500.0,-49.0,-59.0,-46.0,-46.0,-47.0,-57.0,-46.0,-44.0,-88.0,-89.0,-86.0,-89.0,39.0,30.0,40.0,43.0,1
465,92:69:1D:31:68:E9,3844348,487986033,3966,3630770,3840382,484355263,0,5018,1123816,4863,1088723,155,35093,2146,11,4194,91,0,54,216660.0,130000.0,-53.0,-46.0,-42.0,-49.0,-52.0,-47.0,-43.0,-48.0,-88.0,-89.0,-86.0,-89.0,35.0,43.0,44.0,40.0,1
466,CC:2F:71:3F:1F:24,4789419,1540597839,949036,1056242516,3840383,484355323,108,782285,853919843,781522,853827767,763,92076,755173,15,949203,99528,105,581,115556.0,26000.0,-66.0,-70.0,-65.0,-70.0,-67.0,-70.0,-65.0,-69.0,-88.0,-89.0,-86.0,-89.0,22.0,19.0,21.0,19.0,1
467,CC:2F:71:3E:C5:1F,3841305,484467968,922,112645,3840383,484355323,0,3850,323447,3175,243267,675,80180,978,11,1325,25,0,48,144444.0,39000.0,-71.0,-70.0,-66.0,-59.0,-70.0,-71.0,-67.0,-59.0,-88.0,-89.0,-86.0,-89.0,17.0,19.0,20.0,30.0,1
468,BA:8C:B9:54:50:24,3845255,490542150,4872,6186827,3840383,484355323,0,9257,1717453,9235,1713958,22,3495,2351,16,5340,40,0,62,229410.0,130000.0,-48.0,-35.0,-43.0,-45.0,-46.0,-35.0,-43.0,-46.0,-88.0,-89.0,-86.0,-89.0,40.0,54.0,43.0,44.0,1
469,62:47:05:9D:EB:15,3842483,486774495,2096,2418768,3840387,484355727,0,4211,3003976,4180,2998995,31,4981,2041,0,2140,53,0,105,229410.0,130000.0,-51.0,-45.0,-39.0,-47.0,-45.0,-46.0,-38.0,-48.0,-88.0,-89.0,-86.0,-89.0,37.0,44.0,47.0,42.0,1
470,3C:55:76:E8:8F:1F,3909489,657018801,69102,172663074,3840387,484355727,30,33446,6935439,32998,6858393,448,77046,14166,38,69173,7091,30,433,195000.0,97500.0,-49.0,-59.0,-46.0,-46.0,-47.0,-57.0,-46.0,-44.0,-88.0,-89.0,-86.0,-89.0,39.0,30.0,40.0,43.0,1
471,92:69:1D:31:68:E9,3844356,487986815,3967,3630886,3840389,484355929,0,5020,1123952,4865,1088859,155,35093,2146,11,4195,91,0,54,216660.0,130000.0,-52.0,-48.0,-44.0,-46.0,-52.0,-47.0,-43.0,-47.0,-88.0,-89.0,-86.0,-89.0,36.0,41.0,42.0,43.0,1
472,CC:2F:71:3F:1F:24,4789836,1541121994,949447,1056766065,3840389,484355929,108,782570,854187785,781807,854095709,763,92076,755453,15,949635,99537,105,581,115556.0,28889.0,-67.0,-71.0,-65.0,-69.0,-66.0,-70.0,-64.0,-68.0,-88.0,-89.0,-86.0,-89.0,21.0,18.0,21.0,20.0,1
473,CC:2F:71:3E:C5:1F,3841312,484468690,923,112761,3840389,484355929,0,3852,323587,3177,243407,675,80180,978,11,1326,25,0,48,144444.0,39000.0,-71.0,-70.0,-67.0,-60.0,-70.0,-70.0,-67.0,-59.0,-88.0,-89.0,-86.0,-89.0,17.0,19.0,19.0,29.0,1
474,BA:8C:B9:54:50:24,3845262,490542816,4873,6186887,3840389,484355929,0,9259,1717589,9237,1714094,22,3495,2351,16,5341,40,0,62,229410.0,130000.0,-48.0,-35.0,-43.0,-46.0,-47.0,-35.0,-43.0,-46.0,-88.0,-89.0,-86.0,-89.0,40.0,54.0,43.0,43.0,1
475,62:47:05:9D:EB:15,3842488,486775015,2097,2418884,3840391,484356131,0,4213,3004112,4182,2999131,31,4981,2041,0,2141,53,0,105,229410.0,130000.0,-48.0,-44.0,-39.0,-46.0,-46.0,-45.0,-38.0,-48.0,-88.0,-89.0,-86.0,-89.0,40.0,45.0,47.0,43.0,1
476,3C:55:76:E8:8F:1F,3909493,657019205,69102,172663074,3840391,484356131,30,33446,6935439,32998,6858393,448,77046,14166,38,69173,7091,30,433,195000.0,97500.0,-49.0,-59.0,-46.0,-46.0,-47.0,-57.0,-46.0,-44.0,-88.0,-89.0,-86.0,-89.0,39.0,30.0,40.0,43.0,1
477,92:69:1D:31:68:E9,3844358,487987017,3967,3630886,3840391,484356131,0,5020,1123952,4865,1088859,155,35093,2146,11,4195,91,0,54,216660.0,130000.0,-52.0,-48.0,-44.0,-46.0,-52.0,-47.0,-43.0,-47.0,-88.0,-89.0,-86.0,-89.0,36.0,41.0,42.0,43.0,1
478,CC:2F:71:3F:1F:24,4790274,1541645062,949883,1057288931,3840391,484356131,108,782870,854453510,782107,854361434,763,92076,755753,15,950069,99547,105,581,115556.0,28889.0,-67.0,-70.0,-65.0,-69.0,-67.0,-70.0,-65.0,-69.0,-88.0,-89.0,-86.0,-89.0,21.0,19.0,21.0,20.0,1
479,CC:2F:71:3E:C5:1F,3841316,484469094,923,112761,3840393,484356333,0,3852,323587,3177,243407,675,80180,978,11,1326,25,0,48,144444.0,39000.0,-71.0,-70.0,-67.0,-60.0,-70.0,-70.0,-67.0,-59.0,-88.0,-89.0,-86.0,-89.0,17.0,19.0,19.0,29.0,1
480,BA:8C:B9:54:50:24,3845266,490543220,4873,6186887,3840393,484356333,0,9259,1717589,9237,1714094,22,3495,2351,16,5341,40,0,62,229410.0,130000.0,-48.0,-35.0,-43.0,-46.0,-47.0,-35.0,-43.0,-46.0,-88.0,-89.0,-86.0,-89.0,40.0,54.0,43.0,43.0,1
481,62:47:05:9D:EB:15,3842496,486775954,2097,2418884,3840399,484357070,0,4213,3004112,4182,2999131,31,4981,2041,0,2141,53,0,105,229410.0,130000.0,-48.0,-44.0,-39.0,-46.0,-46.0,-45.0,-38.0,-48.0,-88.0,-89.0,-86.0,-89.0,40.0,45.0,47.0,43.0,1
482,3C:55:76:E8:8F:1F,3909501,657020144,69102,172663074,3840399,484357070,30,33446,6935439,32998,6858393,448,77046,14166,38,69173,7091,30,433,195000.0,97500.0,-49.0,-59.0,-46.0,-46.0,-47.0,-57.0,-46.0,-44.0,-88.0,-89.0,-86.0,-89.0,39.0,30.0,40.0,43.0,1
483,92:69:1D:31:68:E9,3844369,487988220,3967,3630886,3840402,484357334,0,5020,1123952,4865,1088859,155,35093,2146,11,4195,91,0,54,216660.0,130000.0,-52.0,-48.0,-44.0,-46.0,-52.0,-47.0,-43.0,-47.0,-88.0,-89.0,-86.0,-88.0,36.0,41.0,42.0,42.0,1
484,CC:2F:71:3F:1F:24,4790525,1541943671,950123,1057586337,3840402,484357334,108,783075,854708484,782312,854616408,763,92076,755955,15,950311,99549,105,581,115556.0,28889.0,-67.0,-70.0,-65.0,-70.0,-67.0,-69.0,-65.0,-69.0,-88.0,-89.0,-86.0,-88.0,21.0,19.0,21.0,18.0,1
485,CC:2F:71:3E:C5:1F,3841325,484470095,923,112761,3840402,484357334,0,3854,323775,3178,243477,676,80298,979,11,1326,25,0,48,144444.0,39000.0,-71.0,-70.0,-67.0,-60.0,-70.0,-70.0,-67.0,-59.0,-88.0,-89.0,-86.0,-88.0,17.0,19.0,19.0,28.0,1
486,BA:8C:B9:54:50:24,3845275,490544221,4873,6186887,3840402,484357334,0,9259,1717589,9237,1714094,22,3495,2351,16,5341,40,0,62,229410.0,130000.0,-48.0,-35.0,-43.0,-46.0,-47.0,-35.0,-43.0,-46.0,-88.0,-89.0,-86.0,-88.0,40.0,54.0,43.0,42.0,1
487,62:47:05:9D:EB:15,3842499,486776218,2097,2418884,3840402,484357334,0,4213,3004112,4182,2999131,31,4981,2041,0,2141,53,0,105,229410.0,130000.0,-48.0,-44.0,-39.0,-46.0,-46.0,-45.0,-38.0,-48.0,-88.0,-89.0,-86.0,-88.0,40.0,45.0,47.0,42.0,1
488,3C:55:76:E8:8F:1F,3909504,657020408,69102,172663074,3840402,484357334,30,33446,6935439,32998,6858393,448,77046,14166,38,69173,7091,30,433,195000.0,97500.0,-49.0,-59.0,-46.0,-46.0,-47.0,-57.0,-46.0,-44.0,-88.0,-89.0,-86.0,-88.0,39.0,30.0,40.0,42.0,1
489,92:69:1D:31:68:E9,3844373,487988624,3967,3630886,3840406,484357738,0,5020,1123952,4865,1088859,155,35093,2146,11,4195,91,0,54,216660.0,130000.0,-52.0,-48.0,-44.0,-46.0,-52.0,-47.0,-43.0,-47.0,-88.0,-89.0,-86.0,-88.0,36.0,41.0,42.0,42.0,1
490,CC:2F:71:3F:1F:24,4790854,1542374509,950442,1058016245,3840412,484358264,108,783425,855197088,782661,855104894,764,92194,756291,15,950627,99596,105,581,117000.0,39000.0,-67.0,-69.0,-66.0,-69.0,-66.0,-69.0,-65.0,-69.0,-88.0,-89.0,-86.0,-88.0,21.0,20.0,20.0,19.0,1
491,CC:2F:71:3E:C5:1F,3841335,484471025,923,112761,3840412,484358264,0,3854,323775,3178,243477,676,80298,979,11,1326,25,0,48,144444.0,39000.0,-71.0,-70.0,-67.0,-60.0,-70.0,-70.0,-67.0,-59.0,-88.0,-89.0,-86.0,-88.0,17.0,19.0,19.0,28.0,1
492,BA:8C:B9:54:50:24,3845287,490545519,4873,6186887,3840414,484358632,0,9259,1717589,9237,1714094,22,3495,2351,16,5341,40,0,62,229410.0,130000.0,-48.0,-35.0,-43.0,-46.0,-47.0,-35.0,-43.0,-46.0,-88.0,-89.0,-86.0,-88.0,40.0,54.0,43.0,42.0,1
493,62:47:05:9D:EB:15,3842531,486778972,2097,2418884,3840434,484360088,0,4213,3004112,4182,2999131,31,4981,2041,0,2141,53,0,105,229410.0,130000.0,-48.0,-44.0,-39.0,-46.0,-46.0,-45.0,-38.0,-48.0,-88.0,-89.0,-86.0,-88.0,40.0,45.0,47.0,42.0,1
494,3C:55:76:E8:8F:1F,3909556,657027528,69122,172667440,3840434,484360088,30,33492,6940954,33033,6862718,459,78236,14199,38,69193,7091,30,437,195000.0,97500.0,-52.0,-60.0,-44.0,-45.0,-50.0,-59.0,-44.0,-44.0,-88.0,-89.0,-86.0,-88.0,36.0,29.0,42.0,43.0,1
495,92:69:1D:31:68:E9,3844403,487991176,3967,3630886,3840436,484360290,0,5020,1123952,4865,1088859,155,35093,2146,11,4195,91,0,54,216660.0,130000.0,-52.0,-48.0,-44.0,-46.0,-52.0,-47.0,-43.0,-47.0,-88.0,-89.0,-86.0,-88.0,36.0,41.0,42.0,42.0,1
496,CC:2F:71:3F:1F:24,4791237,1542843031,950801,1058482741,3840436,484360290,108,783731,855600824,782967,855508630,764,92194,756583,15,950989,99665,105,581,130000.0,43333.0,-67.0,-71.0,-66.0,-69.0,-67.0,-71.0,-65.0,-71.0,-88.0,-89.0,-86.0,-88.0,21.0,18.0,20.0,19.0,1
497,CC:2F:71:3E:C5:1F,3841359,484473051,923,112761,3840436,484360290,0,3854,323775,3178,243477,676,80298,979,11,1326,25,0,48,144444.0,39000.0,-71.0,-70.0,-67.0,-60.0,-70.0,-70.0,-67.0,-59.0,-88.0,-89.0,-86.0,-88.0,17.0,19.0,19.0,28.0,1
498,BA:8C:B9:54:50:24,3845309,490547177,4873,6186887,3840436,484360290,0,9259,1717589,9237,1714094,22,3495,2351,16,5341,40,0,62,229410.0,130000.0,-48.0,-35.0,-43.0,-46.0,-47.0,-35.0,-43.0,-46.0,-88.0,-89.0,-86.0,-88.0,40.0,54.0,43.0,42.0,1
499,62:47:05:9D:EB:15,3842536,486779501,2098,2419089,3840438,484360412,0,4216,3004368,4185,2999387,31,4981,2042,0,2142,53,0,105,229410.0,130000.0,-49.0,-44.0,-39.0,-46.0,-47.0,-45.0,-39.0,-47.0,-88.0,-89.0,-86.0,-88.0,39.0,45.0,47.0,42.0,1
500,3C:55:76:E8:8F:1F,3909564,657028581,69124,172667967,3840440,484360614,30,33518,6943243,33058,6864889,460,78354,14205,38,69195,7091,30,438,195000.0,97500.0,-51.0,-59.0,-44.0,-45.0,-50.0,-59.0,-44.0,-44.0,-88.0,-89.0,-86.0,-88.0,37.0,30.0,42.0,43.0,1
501,92:69:1D:31:68:E9,3844409,487991702,3967,3630886,3840442,484360816,0,5020,1123952,4865,1088859,155,35093,2146,11,4195,91,0,54,216660.0,130000.0,-52.0,-48.0,-44.0,-46.0,-52.0,-47.0,-43.0,-47.0,-88.0,-89.0,-86.0,-88.0,36.0,41.0,42.0,42.0,1
502,CC:2F:71:3F:1F:24,4791483,1543153309,951041,1058792493,3840442,484360816,108,783956,855908056,783192,855815862,764,92194,756798,15,951229,99709,105,581,130000.0,39000.0,-67.0,-70.0,-66.0,-70.0,-67.0,-70.0,-66.0,-71.0,-88.0,-89.0,-86.0,-88.0,21.0,19.0,20.0,18.0,1
503,CC:2F:71:3E:C5:1F,3841365,484473577,923,112761,3840442,484360816,0,3854,323775,3178,243477,676,80298,979,11,1326,25,0,48,144444.0,39000.0,-71.0,-70.0,-67.0,-60.0,-70.0,-70.0,-67.0,-59.0,-88.0,-89.0,-86.0,-88.0,17.0,19.0,19.0,28.0,1
504,BA:8C:B9:54:50:24,3845315,490547703,4873,6186887,3840442,484360816,0,9259,1717589,9237,1714094,22,3495,2351,16,5341,40,0,62,229410.0,130000.0,-48.0,-35.0,-43.0,-46.0,-47.0,-35.0,-43.0,-46.0,-88.0,-89.0,-86.0,-88.0,40.0,54.0,43.0,42.0,1
505,62:47:05:9D:EB:15,3842544,486780309,2098,2419089,3840446,484361220,0,4216,3004368,4185,2999387,31,4981,2042,0,2142,53,0,105,229410.0,130000.0,-49.0,-44.0,-39.0,-46.0,-47.0,-45.0,-39.0,-47.0,-88.0,-89.0,-86.0,-88.0,39.0,45.0,47.0,42.0,1
506,3C:55:76:E8:8F:1F,3909571,657029249,69125,172668029,3840446,484361220,30,33527,6943898,33067,6865544,460,78354,14206,38,69196,7091,30,438,195000.0,97500.0,-51.0,-60.0,-45.0,-45.0,-50.0,-59.0,-44.0,-43.0,-88.0,-89.0,-86.0,-88.0,37.0,29.0,41.0,43.0,1
507,92:69:1D:31:68:E9,3844413,487992106,3967,3630886,3840446,484361220,0,5020,1123952,4865,1088859,155,35093,2146,11,4195,91,0,54,216660.0,130000.0,-52.0,-48.0,-44.0,-46.0,-52.0,-47.0,-43.0,-47.0,-88.0,-89.0,-86.0,-88.0,36.0,41.0,42.0,42.0,1
508,CC:2F:71:3F:1F:24,4791704,1543426131,951258,1059064911,3840446,484361220,108,784156,856172664,783392,856080470,764,92194,756990,15,951446,99731,105,581,115556.0,28889.0,-68.0,-71.0,-66.0,-70.0,-67.0,-70.0,-66.0,-71.0,-88.0,-89.0,-86.0,-88.0,20.0,18.0,20.0,18.0,1
509,CC:2F:71:3E:C5:1F,3841369,484473981,923,112761,3840446,484361220,0,3854,323775,3178,243477,676,80298,979,11,1326,25,0,48,144444.0,39000.0,-71.0,-70.0,-67.0,-60.0,-70.0,-70.0,-67.0,-59.0,-88.0,-89.0,-86.0,-88.0,17.0,19.0,19.0,28.0,1
510,BA:8C:B9:54:50:24,3845319,490548107,4873,6186887,3840446,484361220,0,9259,1717589,9237,1714094,22,3495,2351,16,5341,40,0,62,229410.0,130000.0,-48.0,-35.0,-43.0,-46.0,-47.0,-35.0,-43.0,-46.0,-88.0,-89.0,-86.0,-88.0,40.0,54.0,43.0,42.0,1
511,62:47:05:9D:EB:15,3842551,486781222,2098,2419089,3840453,484362133,0,4216,3004368,4185,2999387,31,4981,2042,0,2142,53,0,105,229410.0,130000.0,-49.0,-44.0,-39.0,-46.0,-47.0,-45.0,-39.0,-47.0,-88.0,-89.0,-86.0,-88.0,39.0,45.0,47.0,42.0,1
512,3C:55:76:E8:8F:1F,3909580,657030463,69127,172668330,3840453,484362133,30,33538,6945177,33076,6866262,462,78915,14209,38,69198,7091,30,438,195000.0,97500.0,-43.0,-60.0,-49.0,-40.0,-45.0,-59.0,-47.0,-41.0,-88.0,-89.0,-86.0,-88.0,45.0,29.0,37.0,48.0,1
513,92:69:1D:31:68:E9,3844420,487993019,3967,3630886,3840453,484362133,0,5020,1123952,4865,1088859,155,35093,2146,11,4195,91,0,54,216660.0,130000.0,-52.0,-48.0,-44.0,-46.0,-52.0,-47.0,-43.0,-47.0,-88.0,-89.0,-86.0,-88.0,36.0,41.0,42.0,42.0,1
514,CC:2F:71:3F:1F:24,4791933,1543695895,951478,1059333560,3840455,484362335,108,784358,856426494,783594,856334300,764,92194,757186,15,951665,99734,105,581,115556.0,28889.0,-68.0,-71.0,-66.0,-71.0,-67.0,-70.0,-66.0,-70.0,-88.0,-89.0,-86.0,-88.0,20.0,18.0,20.0,17.0,1
515,CC:2F:71:3E:C5:1F,3841378,484475096,923,112761,3840455,484362335,0,3854,323775,3178,243477,676,80298,979,11,1326,25,0,48,144444.0,39000.0,-71.0,-70.0,-67.0,-60.0,-70.0,-70.0,-67.0,-59.0,-88.0,-89.0,-86.0,-88.0,17.0,19.0,19.0,28.0,1
516,BA:8C:B9:54:50:24,3845330,490549424,4873,6186887,3840457,484362537,0,9259,1717589,9237,1714094,22,3495,2351,16,5341,40,0,62,229410.0,130000.0,-48.0,-35.0,-43.0,-46.0,-47.0,-35.0,-43.0,-46.0,-88.0,-89.0,-86.0,-88.0,40.0,54.0,43.0,42.0,1
517,62:47:05:9D:EB:15,3842557,486782075,2098,2419089,3840459,484362986,0,4216,3004368,4185,2999387,31,4981,2042,0,2142,53,0,105,229410.0,130000.0,-49.0,-44.0,-39.0,-46.0,-47.0,-45.0,-39.0,-47.0,-88.0,-89.0,-86.0,-88.0,39.0,45.0,47.0,42.0,1
518,3C:55:76:E8:8F:1F,3909587,657031482,69128,172668496,3840459,484362986,30,33551,6946623,33087,6867147,464,79476,14213,38,69199,7091,30,438,195000.0,1000.0,-49.0,-60.0,-44.0,-45.0,-48.0,-59.0,-46.0,-44.0,-88.0,-89.0,-86.0,-88.0,39.0,29.0,42.0,43.0,1
519,92:69:1D:31:68:E9,3844426,487993872,3967,3630886,3840459,484362986,0,5022,1124088,4867,1088995,155,35093,2146,11,4196,91,0,54,216660.0,130000.0,-52.0,-46.0,-42.0,-49.0,-52.0,-47.0,-43.0,-47.0,-88.0,-89.0,-86.0,-88.0,36.0,43.0,44.0,39.0,1
520,CC:2F:71:3F:1F:24,4792148,1543958328,951689,1059595342,3840459,484362986,108,784542,856671870,783778,856579676,764,92194,757370,15,951877,99745,105,581,115556.0,28889.0,-68.0,-70.0,-66.0,-71.0,-67.0,-70.0,-66.0,-70.0,-88.0,-89.0,-86.0,-88.0,20.0,19.0,20.0,17.0,1
521,CC:2F:71:3E:C5:1F,3841382,484475747,923,112761,3840459,484362986,0,3856,323915,3180,243617,676,80298,979,11,1327,25,0,48,144444.0,39000.0,-66.0,-69.0,-64.0,-60.0,-70.0,-70.0,-66.0,-59.0,-88.0,-89.0,-86.0,-88.0,22.0,20.0,22.0,28.0,1
522,BA:8C:B9:54:50:24,3845332,490549873,4873,6186887,3840459,484362986,0,9261,1717725,9239,1714230,22,3495,2351,17,5342,41,0,62,229410.0,130000.0,-51.0,-35.0,-43.0,-45.0,-47.0,-35.0,-43.0,-46.0,-88.0,-89.0,-86.0,-88.0,37.0,54.0,43.0,43.0,1
523,62:47:05:9D:EB:15,3842565,486782966,2098,2419089,3840467,484363877,0,4217,3004436,4186,2999455,31,4981,2042,0,2142,53,0,105,229410.0,130000.0,-45.0,-46.0,-38.0,-48.0,-48.0,-45.0,-39.0,-47.0,-88.0,-89.0,-86.0,-88.0,43.0,43.0,48.0,40.0,1
524,3C:55:76:E8:8F:1F,3909596,657032597,69128,172668496,3840468,484364101,30,33559,6947596,33093,6867559,466,80037,14215,38,69199,7091,30,438,195000.0,1000.0,-46.0,-55.0,-48.0,-42.0,-46.0,-58.0,-48.0,-43.0,-88.0,-89.0,-86.0,-88.0,42.0,34.0,38.0,46.0,1
525,92:69:1D:31:68:E9,3844437,487995189,3967,3630886,3840470,484364303,0,5022,1124088,4867,1088995,155,35093,2146,11,4196,91,0,54,216660.0,130000.0,-52.0,-46.0,-42.0,-49.0,-52.0,-47.0,-43.0,-47.0,-88.0,-89.0,-86.0,-88.0,36.0,43.0,44.0,39.0,1
526,CC:2F:71:3F:1F:24,4792372,1544227623,951902,1059863320,3840470,484364303,108,784731,856922098,783967,856829904,764,92194,757559,15,952089,99746,105,581,115556.0,28889.0,-67.0,-69.0,-66.0,-70.0,-66.0,-69.0,-66.0,-69.0,-88.0,-89.0,-86.0,-88.0,21.0,20.0,20.0,18.0,1
527,CC:2F:71:3E:C5:1F,3841393,484477064,923,112761,3840470,484364303,0,3856,323915,3180,243617,676,80298,979,11,1327,25,0,48,144444.0,39000.0,-66.0,-69.0,-64.0,-60.0,-70.0,-70.0,-66.0,-59.0,-88.0,-89.0,-86.0,-88.0,22.0,20.0,22.0,28.0,1
528,BA:8C:B9:54:50:24,3845343,490551190,4873,6186887,3840470,484364303,0,9261,1717725,9239,1714230,22,3495,2351,17,5342,41,0,62,229410.0,130000.0,-51.0,-35.0,-43.0,-45.0,-47.0,-35.0,-43.0,-46.0,-88.0,-89.0,-86.0,-88.0,37.0,54.0,43.0,43.0,1
529,62:47:05:9D:EB:15,3842568,486783392,2098,2419089,3840470,484364303,0,4217,3004436,4186,2999455,31,4981,2042,0,2142,53,0,105,229410.0,130000.0,-45.0,-46.0,-38.0,-48.0,-48.0,-45.0,-39.0,-47.0,-88.0,-89.0,-86.0,-88.0,43.0,43.0,48.0,40.0,1
530,3C:55:76:E8:8F:1F,3909601,657033158,69130,172668630,3840471,484364528,30,33580,6949320,33113,6869002,467,80318,14218,38,69201,7091,30,438,195000.0,97500.0,-48.0,-57.0,-50.0,-45.0,-47.0,-57.0,-46.0,-44.0,-88.0,-89.0,-86.0,-88.0,40.0,32.0,36.0,43.0,1
531,92:69:1D:31:68:E9,3844439,487995638,3967,3630886,3840472,484364752,0,5022,1124088,4867,1088995,155,35093,2146,11,4196,91,0,54,216660.0,130000.0,-52.0,-46.0,-42.0,-49.0,-52.0,-47.0,-43.0,-47.0,-88.0,-89.0,-86.0,-88.0,36.0,43.0,44.0,39.0,1
532,CC:2F:71:3F:1F:24,4792588,1544498804,952116,1060134052,3840472,484364752,108,784921,857175290,784157,857083096,764,92194,757749,15,952304,99757,105,581,115556.0,28889.0,-67.0,-70.0,-66.0,-70.0,-67.0,-69.0,-65.0,-71.0,-88.0,-89.0,-86.0,-88.0,21.0,19.0,20.0,18.0,1
533,CC:2F:71:3E:C5:1F,3841397,484477715,923,112761,3840474,484364954,0,3856,323915,3180,243617,676,80298,979,11,1327,25,0,48,144444.0,39000.0,-66.0,-69.0,-64.0,-60.0,-70.0,-70.0,-66.0,-59.0,-88.0,-89.0,-86.0,-88.0,22.0,20.0,22.0,28.0,1
534,BA:8C:B9:54:50:24,3845347,490551841,4873,6186887,3840474,484364954,0,9261,1717725,9239,1714230,22,3495,2351,17,5342,41,0,62,229410.0,130000.0,-51.0,-35.0,-43.0,-45.0,-47.0,-35.0,-43.0,-46.0,-88.0,-89.0,-86.0,-88.0,37.0,54.0,43.0,43.0,1
535,62:47:05:9D:EB:15,3842578,486784649,2098,2419089,3840480,484365560,0,4217,3004436,4186,2999455,31,4981,2042,0,2142,53,0,105,229410.0,130000.0,-45.0,-46.0,-38.0,-48.0,-48.0,-45.0,-39.0,-47.0,-88.0,-89.0,-86.0,-88.0,43.0,43.0,48.0,40.0,1
536,3C:55:76:E8:8F:1F,3909610,657034190,69130,172668630,3840480,484365560,30,33586,6949942,33118,6869344,468,80598,14219,38,69201,7091,30,438,195000.0,97500.0,-50.0,-59.0,-46.0,-46.0,-49.0,-58.0,-46.0,-45.0,-88.0,-89.0,-86.0,-88.0,38.0,30.0,40.0,42.0,1
537,92:69:1D:31:68:E9,3844447,487996446,3967,3630886,3840480,484365560,0,5022,1124088,4867,1088995,155,35093,2146,11,4196,91,0,54,216660.0,130000.0,-52.0,-46.0,-42.0,-49.0,-52.0,-47.0,-43.0,-47.0,-88.0,-89.0,-86.0,-88.0,36.0,43.0,44.0,39.0,1
538,CC:2F:71:3F:1F:24,4792818,1544772423,952337,1060406803,3840481,484365620,108,785123,857436263,784359,857344069,764,92194,757945,15,952525,99767,105,581,115556.0,28889.0,-67.0,-70.0,-66.0,-71.0,-67.0,-70.0,-66.0,-71.0,-88.0,-89.0,-86.0,-88.0,21.0,19.0,20.0,17.0,1
539,CC:2F:71:3E:C5:1F,3841404,484478381,923,112761,3840481,484365620,0,3856,323915,3180,243617,676,80298,979,11,1327,25,0,48,144444.0,39000.0,-66.0,-69.0,-64.0,-60.0,-70.0,-70.0,-66.0,-59.0,-88.0,-89.0,-86.0,-88.0,22.0,20.0,22.0,28.0,1
540,BA:8C:B9:54:50:24,3845354,490552507,4873,6186887,3840481,484365620,0,9261,1717725,9239,1714230,22,3495,2351,17,5342,41,0,62,229410.0,130000.0,-51.0,-35.0,-43.0,-45.0,-47.0,-35.0,-43.0,-46.0,-88.0,-89.0,-86.0,-88.0,37.0,54.0,43.0,43.0,1
541,62:47:05:9D:EB:15,3842582,486785184,2098,2419089,3840484,484366095,0,4217,3004436,4186,2999455,31,4981,2042,0,2142,53,0,105,229410.0,130000.0,-45.0,-46.0,-38.0,-48.0,-48.0,-45.0,-39.0,-47.0,-88.0,-89.0,-86.0,-88.0,43.0,43.0,48.0,40.0,1
542,3C:55:76:E8:8F:1F,3909614,657034725,69130,172668630,3840484,484366095,30,33586,6949942,33118,6869344,468,80598,14219,38,69201,7091,30,438,195000.0,97500.0,-50.0,-59.0,-46.0,-46.0,-49.0,-58.0,-46.0,-45.0,-88.0,-89.0,-86.0,-88.0,38.0,30.0,40.0,42.0,1
543,92:69:1D:31:68:E9,3844451,487996981,3967,3630886,3840484,484366095,0,5022,1124088,4867,1088995,155,35093,2146,11,4196,91,0,54,216660.0,130000.0,-52.0,-46.0,-42.0,-49.0,-52.0,-47.0,-43.0,-47.0,-88.0,-89.0,-86.0,-88.0,36.0,43.0,44.0,39.0,1
544,CC:2F:71:3F:1F:24,4793037,1545045522,952553,1060679427,3840484,484366095,108,785326,857701299,784562,857609105,764,92194,758140,15,952740,99767,105,581,115556.0,28889.0,-67.0,-69.0,-66.0,-70.0,-67.0,-69.0,-66.0,-70.0,-88.0,-89.0,-86.0,-88.0,21.0,20.0,20.0,18.0,1
545,CC:2F:71:3E:C5:1F,3841409,484479058,923,112761,3840486,484366297,0,3856,323915,3180,243617,676,80298,979,11,1327,25,0,48,144444.0,39000.0,-66.0,-69.0,-64.0,-60.0,-70.0,-70.0,-66.0,-59.0,-88.0,-89.0,-86.0,-88.0,22.0,20.0,22.0,28.0,1
546,BA:8C:B9:54:50:24,3845359,490553184,4873,6186887,3840486,484366297,0,9262,1717793,9240,1714298,22,3495,2351,17,5342,41,0,62,229410.0,130000.0,-49.0,-35.0,-43.0,-46.0,-48.0,-35.0,-43.0,-45.0,-88.0,-89.0,-86.0,-88.0,39.0,54.0,43.0,42.0,1
547,62:47:05:9D:EB:15,3842588,486785790,2098,2419089,3840490,484366701,0,4217,3004436,4186,2999455,31,4981,2042,0,2142,53,0,105,229410.0,130000.0,-45.0,-46.0,-38.0,-48.0,-48.0,-45.0,-39.0,-47.0,-88.0,-89.0,-86.0,-88.0,43.0,43.0,48.0,40.0,1
548,3C:55:76:E8:8F:1F,3909620,657035331,69130,172668630,3840490,484366701,30,33586,6949942,33118,6869344,468,80598,14219,38,69201,7091,30,438,195000.0,97500.0,-50.0,-59.0,-46.0,-46.0,-49.0,-58.0,-46.0,-45.0,-88.0,-89.0,-86.0,-88.0,38.0,30.0,40.0,42.0,1
549,92:69:1D:31:68:E9,3844457,487997587,3967,3630886,3840490,484366701,0,5022,1124088,4867,1088995,155,35093,2146,11,4196,91,0,54,216660.0,130000.0,-52.0,-46.0,-42.0,-49.0,-52.0,-47.0,-43.0,-47.0,-88.0,-89.0,-86.0,-88.0,36.0,43.0,44.0,39.0,1
550,CC:2F:71:3F:1F:24,4793255,1545312256,952765,1060945555,3840490,484366701,108,785524,857965665,784760,857873471,764,92194,758327,15,952953,99775,105,581,117000.0,39000.0,-67.0,-70.0,-66.0,-70.0,-66.0,-70.0,-66.0,-70.0,-88.0,-89.0,-86.0,-88.0,21.0,19.0,20.0,18.0,1
551,CC:2F:71:3E:C5:1F,3841413,484479462,923,112761,3840490,484366701,0,3856,323915,3180,243617,676,80298,979,11,1327,25,0,48,144444.0,39000.0,-66.0,-69.0,-64.0,-60.0,-70.0,-70.0,-66.0,-59.0,-88.0,-89.0,-86.0,-88.0,22.0,20.0,22.0,28.0,1
552,BA:8C:B9:54:50:24,3845363,490553588,4873,6186887,3840490,484366701,0,9262,1717793,9240,1714298,22,3495,2351,17,5342,41,0,62,229410.0,130000.0,-49.0,-35.0,-43.0,-46.0,-48.0,-35.0,-43.0,-45.0,-88.0,-89.0,-86.0,-88.0,39.0,54.0,43.0,42.0,1
553,62:47:05:9D:EB:15,3842593,486786254,2098,2419089,3840495,484367165,0,4217,3004436,4186,2999455,31,4981,2042,0,2142,53,0,105,229410.0,130000.0,-45.0,-46.0,-38.0,-48.0,-48.0,-45.0,-39.0,-47.0,-88.0,-89.0,-86.0,-88.0,43.0,43.0,48.0,40.0,1
554,3C:55:76:E8:8F:1F,3909627,657036071,69132,172668906,3840495,484367165,30,33593,6950543,33125,6869945,468,80598,14221,38,69203,7091,30,438,195000.0,97500.0,-44.0,-55.0,-52.0,-41.0,-45.0,-54.0,-49.0,-41.0,-88.0,-89.0,-86.0,-88.0,44.0,34.0,34.0,47.0,1
555,92:69:1D:31:68:E9,3844464,487998253,3967,3630886,3840497,484367367,0,5022,1124088,4867,1088995,155,35093,2146,11,4196,91,0,54,216660.0,130000.0,-52.0,-46.0,-42.0,-49.0,-52.0,-47.0,-43.0,-47.0,-88.0,-89.0,-86.0,-88.0,36.0,43.0,44.0,39.0,1
556,CC:2F:71:3F:1F:24,4793479,1545579133,952982,1061211766,3840497,484367367,108,785717,858215453,784953,858123259,764,92194,758518,15,953169,99810,105,581,130000.0,43333.0,-67.0,-70.0,-66.0,-70.0,-67.0,-69.0,-65.0,-70.0,-88.0,-89.0,-86.0,-88.0,21.0,19.0,20.0,18.0,1
557,CC:2F:71:3E:C5:1F,3841422,484480330,923,112761,3840499,484367569,0,3856,323915,3180,243617,676,80298,979,11,1327,25,0,48,144444.0,39000.0,-66.0,-69.0,-64.0,-60.0,-70.0,-70.0,-66.0,-59.0,-88.0,-89.0,-86.0,-88.0,22.0,20.0,22.0,28.0,1
558,BA:8C:B9:54:50:24,3845372,490554456,4873,6186887,3840499,484367569,0,9262,1717793,9240,1714298,22,3495,2351,17,5342,41,0,62,229410.0,130000.0,-49.0,-35.0,-43.0,-46.0,-48.0,-35.0,-43.0,-45.0,-88.0,-89.0,-86.0,-88.0,39.0,54.0,43.0,42.0,1
559,62:47:05:9D:EB:15,3842597,486786658,2098,2419089,3840499,484367569,0,4217,3004436,4186,2999455,31,4981,2042,0,2142,53,0,105,229410.0,130000.0,-45.0,-46.0,-38.0,-48.0,-48.0,-45.0,-39.0,-47.0,-88.0,-89.0,-86.0,-88.0,43.0,43.0,48.0,40.0,1
560,3C:55:76:E8:8F:1F,3909631,657036475,69132,172668906,3840499,484367569,30,33597,6950817,33129,6870219,468,80598,14221,38,69203,7091,30,438,195000.0,97500.0,-44.0,-55.0,-52.0,-41.0,-44.0,-55.0,-51.0,-41.0,-88.0,-89.0,-86.0,-88.0,44.0,34.0,34.0,47.0,1
561,92:69:1D:31:68:E9,3844466,487998455,3967,3630886,3840499,484367569,0,5022,1124088,4867,1088995,155,35093,2146,11,4196,91,0,54,216660.0,130000.0,-52.0,-46.0,-42.0,-49.0,-52.0,-47.0,-43.0,-47.0,-88.0,-89.0,-86.0,-88.0,36.0,43.0,44.0,39.0,1
562,CC:2F:71:3F:1F:24,4793691,1545842299,953192,1061474730,3840499,484367569,108,785904,858465491,785140,858373297,764,92194,758702,15,953380,99858,105,581,130000.0,43333.0,-67.0,-69.0,-67.0,-70.0,-67.0,-69.0,-65.0,-70.0,-88.0,-89.0,-86.0,-88.0,21.0,20.0,19.0,18.0,1
563,CC:2F:71:3E:C5:1F,3841422,484480330,923,112761,3840499,484367569,0,3856,323915,3180,243617,676,80298,979,11,1327,25,0,48,144444.0,39000.0,-66.0,-69.0,-64.0,-60.0,-70.0,-70.0,-66.0,-59.0,-88.0,-89.0,-86.0,-88.0,22.0,20.0,22.0,28.0,1
564,BA:8C:B9:54:50:24,3845372,490554456,4873,6186887,3840499,484367569,0,9262,1717793,9240,1714298,22,3495,2351,17,5342,41,0,62,229410.0,130000.0,-49.0,-35.0,-43.0,-46.0,-48.0,-35.0,-43.0,-45.0,-88.0,-89.0,-86.0,-88.0,39.0,54.0,43.0,42.0,1
565,62:47:05:9D:EB:15,3842606,486787526,2098,2419089,3840508,484368437,0,4217,3004436,4186,2999455,31,4981,2042,0,2142,53,0,105,229410.0,130000.0,-45.0,-46.0,-38.0,-48.0,-48.0,-45.0,-39.0,-47.0,-88.0,-89.0,-86.0,-88.0,43.0,43.0,48.0,40.0,1
566,3C:55:76:E8:8F:1F,3909640,657037343,69132,172668906,3840508,484368437,30,33597,6950817,33129,6870219,468,80598,14221,38,69203,7091,30,438,195000.0,97500.0,-44.0,-55.0,-52.0,-41.0,-44.0,-55.0,-51.0,-41.0,-88.0,-89.0,-86.0,-88.0,44.0,34.0,34.0,47.0,1
567,92:69:1D:31:68:E9,3844475,487999323,3967,3630886,3840508,484368437,0,5022,1124088,4867,1088995,155,35093,2146,11,4196,91,0,54,216660.0,130000.0,-52.0,-46.0,-42.0,-49.0,-52.0,-47.0,-43.0,-47.0,-88.0,-89.0,-86.0,-88.0,36.0,43.0,44.0,39.0,1
568,CC:2F:71:3F:1F:24,4793908,1546103359,953400,1061734922,3840508,484368437,108,786093,858714483,785329,858622289,764,92194,758885,15,953588,99895,105,582,130000.0,43333.0,-67.0,-70.0,-66.0,-70.0,-67.0,-69.0,-65.0,-70.0,-88.0,-89.0,-86.0,-88.0,21.0,19.0,20.0,18.0,1
569,CC:2F:71:3E:C5:1F,3841431,484481198,923,112761,3840508,484368437,0,3856,323915,3180,243617,676,80298,979,11,1327,25,0,48,144444.0,39000.0,-66.0,-69.0,-64.0,-60.0,-70.0,-70.0,-66.0,-59.0,-88.0,-89.0,-86.0,-88.0,22.0,20.0,22.0,28.0,1
570,BA:8C:B9:54:50:24,3845381,490555324,4873,6186887,3840508,484368437,0,9262,1717793,9240,1714298,22,3495,2351,17,5342,41,0,62,229410.0,130000.0,-49.0,-35.0,-43.0,-46.0,-48.0,-35.0,-43.0,-45.0,-88.0,-89.0,-86.0,-88.0,39.0,54.0,43.0,42.0,1
571,62:47:05:9D:EB:15,3842607,486787825,2099,2419388,3840508,484368437,0,4218,3004504,4187,2999523,31,4981,2042,0,2143,53,0,105,229410.0,130000.0,-50.0,-44.0,-39.0,-47.0,-48.0,-44.0,-39.0,-46.0,-88.0,-89.0,-86.0,-88.0,38.0,45.0,47.0,41.0,1
572,3C:55:76:E8:8F:1F,3909656,657046104,69148,172677667,3840508,484368437,30,33631,6962389,33163,6881791,468,80598,14235,38,69219,7093,30,438,195000.0,1000.0,-45.0,-55.0,-52.0,-41.0,-44.0,-54.0,-50.0,-40.0,-88.0,-89.0,-86.0,-88.0,43.0,34.0,34.0,47.0,1
573,92:69:1D:31:68:E9,3844475,487999323,3967,3630886,3840508,484368437,0,5022,1124088,4867,1088995,155,35093,2146,11,4196,91,0,54,216660.0,130000.0,-52.0,-46.0,-42.0,-49.0,-52.0,-47.0,-43.0,-47.0,-88.0,-89.0,-86.0,-88.0,36.0,43.0,44.0,39.0,1
574,CC:2F:71:3F:1F:24,4794114,1546363067,953606,1061994630,3840508,484368437,108,786284,858967889,785520,858875695,764,92194,759069,15,953794,99940,105,582,130000.0,43333.0,-67.0,-70.0,-66.0,-71.0,-66.0,-70.0,-65.0,-70.0,-88.0,-89.0,-86.0,-88.0,21.0,19.0,20.0,17.0,1
575,CC:2F:71:3E:C5:1F,3841431,484481198,923,112761,3840508,484368437,0,3856,323915,3180,243617,676,80298,979,11,1327,25,0,48,144444.0,39000.0,-66.0,-69.0,-64.0,-60.0,-70.0,-70.0,-66.0,-59.0,-88.0,-89.0,-86.0,-88.0,22.0,20.0,22.0,28.0,1
576,BA:8C:B9:54:50:24,3845381,490555324,4873,6186887,3840508,484368437,0,9262,1717793,9240,1714298,22,3495,2351,17,5342,41,0,62,229410.0,130000.0,-49.0,-35.0,-43.0,-46.0,-48.0,-35.0,-43.0,-45.0,-88.0,-89.0,-86.0,-88.0,39.0,54.0,43.0,42.0,1
577,62:47:05:9D:EB:15,3842617,486788932,2101,2419687,3840516,484369245,0,4222,3004997,4191,3000016,31,4981,2044,0,2145,53,0,105,229410.0,130000.0,-50.0,-44.0,-39.0,-47.0,-48.0,-45.0,-39.0,-47.0,-88.0,-89.0,-86.0,-88.0,38.0,45.0,47.0,41.0,1
578,3C:55:76:E8:8F:1F,3909664,657046912,69148,172677667,3840516,484369245,30,33631,6962389,33163,6881791,468,80598,14235,38,69219,7093,30,438,195000.0,1000.0,-45.0,-55.0,-52.0,-41.0,-44.0,-54.0,-50.0,-40.0,-88.0,-89.0,-86.0,-88.0,43.0,34.0,34.0,47.0,1
579,92:69:1D:31:68:E9,3844484,488000191,3967,3630886,3840517,484369305,0,5022,1124088,4867,1088995,155,35093,2146,11,4196,91,0,54,216660.0,130000.0,-52.0,-46.0,-42.0,-49.0,-52.0,-47.0,-43.0,-47.0,-88.0,-89.0,-86.0,-88.0,36.0,43.0,44.0,39.0,1
580,CC:2F:71:3F:1F:24,4794339,1546627434,953822,1062258129,3840517,484369305,108,786475,859213204,785711,859121010,764,92194,759259,15,954010,99967,105,582,115556.0,28889.0,-67.0,-69.0,-66.0,-70.0,-66.0,-69.0,-65.0,-70.0,-88.0,-89.0,-86.0,-88.0,21.0,20.0,20.0,18.0,1
581,CC:2F:71:3E:C5:1F,3841440,484482066,923,112761,3840517,484369305,0,3856,323915,3180,243617,676,80298,979,11,1327,25,0,48,144444.0,39000.0,-66.0,-69.0,-64.0,-60.0,-70.0,-70.0,-66.0,-59.0,-88.0,-89.0,-86.0,-88.0,22.0,20.0,22.0,28.0,1
582,BA:8C:B9:54:50:24,3845390,490556192,4873,6186887,3840517,484369305,0,9262,1717793,9240,1714298,22,3495,2351,17,5342,41,0,62,229410.0,130000.0,-49.0,-35.0,-43.0,-46.0,-48.0,-35.0,-43.0,-45.0,-88.0,-89.0,-86.0,-88.0,39.0,54.0,43.0,42.0,1
583,62:47:05:9D:EB:15,3842618,486788992,2101,2419687,3840517,484369305,0,4222,3004997,4191,3000016,31,4981,2044,0,2145,53,0,105,229410.0,130000.0,-50.0,-44.0,-39.0,-47.0,-48.0,-45.0,-39.0,-47.0,-88.0,-89.0,-86.0,-88.0,38.0,45.0,47.0,41.0,1
584,3C:55:76:E8:8F:1F,3909675,657056056,69158,172686751,3840517,484369305,30,33656,6972558,33188,6891960,468,80598,14246,38,69229,7093,30,439,206470.0,97500.0,-44.0,-55.0,-52.0,-40.0,-44.0,-55.0,-52.0,-40.0,-88.0,-89.0,-86.0,-88.0,44.0,34.0,34.0,48.0,1
585,92:69:1D:31:68:E9,3844484,488000191,3967,3630886,3840517,484369305,0,5022,1124088,4867,1088995,155,35093,2146,11,4196,91,0,54,216660.0,130000.0,-52.0,-46.0,-42.0,-49.0,-52.0,-47.0,-43.0,-47.0,-88.0,-89.0,-86.0,-88.0,36.0,43.0,44.0,39.0,1
586,CC:2F:71:3F:1F:24,4794550,1546887566,954031,1062518059,3840519,484369507,108,786660,859457398,785896,859365204,764,92194,759443,15,954219,99983,105,583,130000.0,43333.0,-67.0,-69.0,-66.0,-70.0,-66.0,-69.0,-65.0,-70.0,-88.0,-89.0,-86.0,-88.0,21.0,20.0,20.0,18.0,1
587,CC:2F:71:3E:C5:1F,3841442,484482268,923,112761,3840519,484369507,0,3856,323915,3180,243617,676,80298,979,11,1327,25,0,48,144444.0,39000.0,-66.0,-69.0,-64.0,-60.0,-70.0,-70.0,-66.0,-59.0,-88.0,-89.0,-86.0,-88.0,22.0,20.0,22.0,28.0,1
588,BA:8C:B9:54:50:24,3845392,490556394,4873,6186887,3840519,484369507,0,9262,1717793,9240,1714298,22,3495,2351,17,5342,41,0,62,229410.0,130000.0,-49.0,-35.0,-43.0,-46.0,-48.0,-35.0,-43.0,-45.0,-88.0,-89.0,-86.0,-88.0,39.0,54.0,43.0,42.0,1
589,62:47:05:9D:EB:15,3842626,486789800,2101,2419687,3840525,484370113,0,4222,3004997,4191,3000016,31,4981,2044,0,2145,53,0,105,229410.0,130000.0,-50.0,-44.0,-39.0,-47.0,-48.0,-45.0,-39.0,-47.0,-88.0,-89.0,-86.0,-88.0,38.0,45.0,47.0,41.0,1
590,3C:55:76:E8:8F:1F,3909683,657056864,69158,172686751,3840525,484370113,30,33656,6972558,33188,6891960,468,80598,14246,38,69229,7093,30,439,206470.0,97500.0,-44.0,-55.0,-52.0,-40.0,-44.0,-55.0,-52.0,-40.0,-88.0,-89.0,-86.0,-88.0,44.0,34.0,34.0,48.0,1
591,92:69:1D:31:68:E9,3844492,488000999,3967,3630886,3840525,484370113,0,5022,1124088,4867,1088995,155,35093,2146,11,4196,91,0,54,216660.0,130000.0,-52.0,-46.0,-42.0,-49.0,-52.0,-47.0,-43.0,-47.0,-88.0,-89.0,-86.0,-88.0,36.0,43.0,44.0,39.0,1
592,CC:2F:71:3F:1F:24,4794765,1547149694,954240,1062779581,3840525,484370113,108,786848,859707608,786084,859615414,764,92194,759626,15,954428,100008,105,583,130000.0,43333.0,-67.0,-69.0,-66.0,-70.0,-67.0,-69.0,-66.0,-70.0,-88.0,-89.0,-86.0,-88.0,21.0,20.0,20.0,18.0,1
593,CC:2F:71:3E:C5:1F,3841448,484482874,923,112761,3840525,484370113,0,3856,323915,3180,243617,676,80298,979,11,1327,25,0,48,144444.0,39000.0,-66.0,-69.0,-64.0,-60.0,-70.0,-70.0,-66.0,-59.0,-88.0,-89.0,-86.0,-88.0,22.0,20.0,22.0,28.0,1
594,BA:8C:B9:54:50:24,3845398,490557000,4873,6186887,3840525,484370113,0,9262,1717793,9240,1714298,22,3495,2351,17,5342,41,0,62,229410.0,130000.0,-49.0,-35.0,-43.0,-46.0,-48.0,-35.0,-43.0,-45.0,-88.0,-89.0,-86.0,-88.0,39.0,54.0,43.0,42.0,1
595,62:47:05:9D:EB:15,3842627,486789860,2101,2419687,3840526,484370173,0,4222,3004997,4191,3000016,31,4981,2044,0,2145,53,0,105,229410.0,130000.0,-50.0,-44.0,-39.0,-47.0,-48.0,-45.0,-39.0,-47.0,-88.0,-89.0,-86.0,-88.0,38.0,45.0,47.0,41.0,1
596,3C:55:76:E8:8F:1F,3909686,657057126,69158,172686751,3840528,484370375,30,33656,6972558,33188,6891960,468,80598,14246,38,69229,7093,30,439,206470.0,97500.0,-44.0,-55.0,-52.0,-40.0,-44.0,-55.0,-52.0,-40.0,-88.0,-89.0,-86.0,-88.0,44.0,34.0,34.0,48.0,1
597,92:69:1D:31:68:E9,3844495,488001261,3967,3630886,3840528,484370375,0,5022,1124088,4867,1088995,155,35093,2146,11,4196,91,0,54,216660.0,130000.0,-52.0,-46.0,-42.0,-49.0,-52.0,-47.0,-43.0,-47.0,-88.0,-89.0,-86.0,-88.0,36.0,43.0,44.0,39.0,1
598,CC:2F:71:3F:1F:24,4794984,1547414711,954456,1063044336,3840528,484370375,108,787043,859956259,786279,859864065,764,92194,759820,15,954644,100054,105,583,130000.0,43333.0,-67.0,-70.0,-66.0,-70.0,-66.0,-69.0,-65.0,-70.0,-88.0,-89.0,-86.0,-88.0,21.0,19.0,20.0,18.0,1
599,CC:2F:71:3E:C5:1F,3841457,484483742,923,112761,3840534,484370981,0,3856,323915,3180,243617,676,80298,979,11,1327,25,0,48,144444.0,39000.0,-66.0,-69.0,-64.0,-60.0,-70.0,-70.0,-66.0,-59.0,-88.0,-89.0,-86.0,-88.0,22.0,20.0,22.0,28.0,1
600,BA:8C:B9:54:50:24,3845407,490557868,4873,6186887,3840534,484370981,0,9262,1717793,9240,1714298,22,3495,2351,17,5342,41,0,62,229410.0,130000.0,-49.0,-35.0,-43.0,-46.0,-48.0,-35.0,-43.0,-45.0,-88.0,-89.0,-86.0,-88.0,39.0,54.0,43.0,42.0,1
601,62:47:05:9D:EB:15,3842637,486790846,2102,2419803,3840535,484371043,0,4224,3005133,4193,3000152,31,4981,2044,0,2146,53,0,105,229410.0,130000.0,-50.0,-45.0,-39.0,-47.0,-49.0,-45.0,-39.0,-47.0,-88.0,-89.0,-86.0,-88.0,38.0,44.0,47.0,41.0,1
602,3C:55:76:E8:8F:1F,3909695,657057916,69159,172686811,3840536,484371105,30,33667,6973360,33198,6892644,469,80716,14247,38,69230,7093,30,439,206470.0,1000.0,-47.0,-55.0,-46.0,-44.0,-48.0,-58.0,-45.0,-44.0,-88.0,-89.0,-86.0,-88.0,41.0,34.0,40.0,44.0,1
603,92:69:1D:31:68:E9,3844504,488002107,3968,3631002,3840536,484371105,0,5024,1124224,4869,1089131,155,35093,2146,11,4197,91,0,55,216660.0,130000.0,-53.0,-47.0,-42.0,-49.0,-52.0,-47.0,-43.0,-47.0,-88.0,-89.0,-86.0,-88.0,35.0,42.0,44.0,39.0,1
604,CC:2F:71:3F:1F:24,4795204,1547679056,954668,1063307951,3840536,484371105,108,787234,860205422,786468,860112992,766,92430,760007,15,954855,100095,105,584,130000.0,43333.0,-67.0,-70.0,-66.0,-70.0,-66.0,-69.0,-65.0,-70.0,-88.0,-89.0,-86.0,-88.0,21.0,19.0,20.0,18.0,1
605,CC:2F:71:3E:C5:1F,3841460,484483982,924,112877,3840536,484371105,0,3858,324055,3182,243757,676,80298,979,11,1328,25,0,48,144444.0,43333.0,-71.0,-72.0,-69.0,-60.0,-70.0,-70.0,-67.0,-60.0,-88.0,-89.0,-86.0,-88.0,17.0,17.0,17.0,28.0,1
606,BA:8C:B9:54:50:24,3845410,490558108,4874,6187003,3840536,484371105,0,9264,1717929,9242,1714434,22,3495,2351,17,5343,41,0,63,229410.0,130000.0,-48.0,-35.0,-42.0,-45.0,-48.0,-35.0,-42.0,-45.0,-88.0,-89.0,-86.0,-88.0,40.0,54.0,44.0,43.0,1
607,62:47:05:9D:EB:15,3842644,486791432,2102,2419803,3840542,484371629,0,4224,3005133,4193,3000152,31,4981,2044,0,2146,53,0,105,229410.0,130000.0,-50.0,-45.0,-39.0,-47.0,-49.0,-45.0,-39.0,-47.0,-88.0,-89.0,-86.0,-88.0,38.0,44.0,47.0,41.0,1
608,3C:55:76:E8:8F:1F,3909703,657058642,69159,172686811,3840544,484371831,30,33678,6974152,33208,6893330,470,80822,14248,38,69230,7093,30,440,206470.0,1000.0,-46.0,-57.0,-44.0,-43.0,-44.0,-55.0,-47.0,-40.0,-88.0,-89.0,-86.0,-88.0,42.0,32.0,42.0,45.0,1
609,92:69:1D:31:68:E9,3844514,488003035,3968,3631002,3840546,484372033,0,5024,1124224,4869,1089131,155,35093,2146,11,4197,91,0,55,216660.0,130000.0,-53.0,-47.0,-42.0,-49.0,-52.0,-47.0,-43.0,-47.0,-88.0,-89.0,-86.0,-88.0,35.0,42.0,44.0,39.0,1
610,CC:2F:71:3F:1F:24,4795649,1548202863,955103,1063830830,3840546,484372033,108,787539,860479234,786773,860386804,766,92430,760298,15,955291,100236,105,585,130000.0,43333.0,-67.0,-70.0,-66.0,-71.0,-66.0,-70.0,-66.0,-70.0,-88.0,-89.0,-86.0,-88.0,21.0,19.0,20.0,17.0,1
611,CC:2F:71:3E:C5:1F,3841470,484484910,924,112877,3840546,484372033,0,3858,324055,3182,243757,676,80298,979,11,1328,25,0,48,144444.0,43333.0,-71.0,-72.0,-69.0,-60.0,-70.0,-70.0,-67.0,-60.0,-88.0,-89.0,-86.0,-88.0,17.0,17.0,17.0,28.0,1
612,BA:8C:B9:54:50:24,3845420,490559036,4874,6187003,3840546,484372033,0,9264,1717929,9242,1714434,22,3495,2351,17,5343,41,0,63,229410.0,130000.0,-48.0,-35.0,-42.0,-45.0,-48.0,-35.0,-42.0,-45.0,-88.0,-89.0,-86.0,-88.0,40.0,54.0,44.0,43.0,1
613,62:47:05:9D:EB:15,3842651,486792285,2103,2419919,3840548,484372366,0,4227,3005379,4196,3000398,31,4981,2045,0,2147,53,0,105,229410.0,137640.0,-44.0,-47.0,-39.0,-50.0,-47.0,-46.0,-39.0,-48.0,-88.0,-89.0,-86.0,-88.0,44.0,42.0,47.0,38.0,1
614,3C:55:76:E8:8F:1F,3909707,657059177,69159,172686811,3840548,484372366,30,33688,6974874,33217,6893946,471,80928,14249,38,69230,7093,30,441,206470.0,1000.0,-45.0,-52.0,-49.0,-42.0,-43.0,-50.0,-50.0,-40.0,-88.0,-89.0,-86.0,-88.0,43.0,37.0,37.0,46.0,1
615,92:69:1D:31:68:E9,3844516,488003368,3968,3631002,3840548,484372366,0,5024,1124224,4869,1089131,155,35093,2146,11,4197,91,0,55,216660.0,130000.0,-53.0,-47.0,-42.0,-49.0,-52.0,-47.0,-43.0,-47.0,-88.0,-89.0,-86.0,-88.0,35.0,42.0,44.0,39.0,1
616,CC:2F:71:3F:1F:24,4796055,1548714883,955507,1064342517,3840548,484372366,108,787831,860748744,787065,860656314,766,92430,760582,15,955695,100354,105,586,86667.0,14444.0,-69.0,-70.0,-65.0,-70.0,-68.0,-71.0,-65.0,-70.0,-88.0,-89.0,-86.0,-88.0,19.0,19.0,21.0,18.0,1
617,CC:2F:71:3E:C5:1F,3841472,484485243,924,112877,3840548,484372366,0,3858,324055,3182,243757,676,80298,979,11,1328,25,0,48,144444.0,43333.0,-71.0,-72.0,-69.0,-60.0,-70.0,-70.0,-67.0,-60.0,-88.0,-89.0,-86.0,-88.0,17.0,17.0,17.0,28.0,1
618,BA:8C:B9:54:50:24,3845422,490559369,4874,6187003,3840548,484372366,0,9264,1717929,9242,1714434,22,3495,2351,17,5343,41,0,63,229410.0,130000.0,-48.0,-35.0,-42.0,-45.0,-48.0,-35.0,-42.0,-45.0,-88.0,-89.0,-86.0,-88.0,40.0,54.0,44.0,43.0,1
619,62:47:05:9D:EB:15,3842661,486793215,2103,2419919,3840558,484373296,0,4227,3005379,4196,3000398,31,4981,2045,0,2147,53,0,105,229410.0,137640.0,-44.0,-47.0,-39.0,-50.0,-47.0,-46.0,-39.0,-48.0,-88.0,-89.0,-86.0,-88.0,44.0,42.0,47.0,38.0,1
620,3C:55:76:E8:8F:1F,3909717,657060107,69159,172686811,3840558,484373296,30,33694,6975324,33222,6894290,472,81034,14250,38,69230,7093,30,441,206470.0,1000.0,-41.0,-52.0,-45.0,-37.0,-43.0,-51.0,-46.0,-39.0,-88.0,-89.0,-86.0,-88.0,47.0,37.0,41.0,51.0,1
621,92:69:1D:31:68:E9,3844527,488004358,3968,3631002,3840559,484373356,0,5024,1124224,4869,1089131,155,35093,2146,11,4197,91,0,55,216660.0,130000.0,-53.0,-47.0,-42.0,-49.0,-52.0,-47.0,-43.0,-47.0,-88.0,-89.0,-86.0,-88.0,35.0,42.0,44.0,39.0,1
622,CC:2F:71:3F:1F:24,4796466,1549223743,955907,1064850387,3840559,484373356,108,788111,861012278,787345,860919848,766,92430,760858,15,956095,100354,105,586,86667.0,14444.0,-68.0,-70.0,-67.0,-69.0,-68.0,-69.0,-66.0,-68.0,-88.0,-89.0,-86.0,-88.0,20.0,19.0,19.0,19.0,1
623,CC:2F:71:3E:C5:1F,3841483,484486233,924,112877,3840559,484373356,0,3860,324243,3183,243827,677,80416,980,11,1328,25,0,48,144444.0,43333.0,-72.0,-71.0,-69.0,-60.0,-69.0,-70.0,-67.0,-60.0,-88.0,-89.0,-86.0,-88.0,16.0,18.0,17.0,28.0,1
624,BA:8C:B9:54:50:24,3845433,490560359,4874,6187003,3840559,484373356,0,9264,1717929,9242,1714434,22,3495,2351,17,5343,41,0,63,229410.0,130000.0,-48.0,-35.0,-42.0,-45.0,-48.0,-35.0,-42.0,-45.0,-88.0,-89.0,-86.0,-88.0,40.0,54.0,44.0,43.0,1
625,62:47:05:9D:EB:15,3842663,486793337,2103,2419919,3840560,484373418,0,4227,3005379,4196,3000398,31,4981,2045,0,2147,53,0,105,229410.0,137640.0,-44.0,-47.0,-39.0,-50.0,-47.0,-46.0,-39.0,-48.0,-88.0,-89.0,-86.0,-88.0,44.0,42.0,47.0,38.0,1
626,3C:55:76:E8:8F:1F,3909719,657060229,69159,172686811,3840560,484373418,30,33702,6975924,33229,6894772,473,81152,14251,38,69230,7093,30,441,206470.0,1000.0,-42.0,-52.0,-48.0,-38.0,-42.0,-53.0,-46.0,-38.0,-88.0,-89.0,-86.0,-88.0,46.0,37.0,38.0,50.0,1
627,92:69:1D:31:68:E9,3844528,488004420,3968,3631002,3840560,484373418,0,5024,1124224,4869,1089131,155,35093,2146,11,4197,91,0,55,216660.0,130000.0,-53.0,-47.0,-42.0,-49.0,-52.0,-47.0,-43.0,-47.0,-88.0,-89.0,-86.0,-88.0,35.0,42.0,44.0,39.0,1
628,CC:2F:71:3F:1F:24,4796676,1549486079,956116,1065112661,3840560,484373418,108,788314,861278522,787548,861186092,766,92430,761045,15,956304,100373,105,586,117000.0,39000.0,-69.0,-70.0,-66.0,-68.0,-68.0,-70.0,-66.0,-68.0,-88.0,-89.0,-86.0,-88.0,19.0,19.0,20.0,20.0,1
629,CC:2F:71:3E:C5:1F,3841484,484486295,924,112877,3840560,484373418,0,3860,324243,3183,243827,677,80416,980,11,1328,25,0,48,144444.0,43333.0,-72.0,-71.0,-69.0,-60.0,-69.0,-70.0,-67.0,-60.0,-88.0,-89.0,-86.0,-88.0,16.0,18.0,17.0,28.0,1
630,BA:8C:B9:54:50:24,3845434,490560421,4874,6187003,3840560,484373418,0,9264,1717929,9242,1714434,22,3495,2351,17,5343,41,0,63,229410.0,130000.0,-48.0,-35.0,-42.0,-45.0,-48.0,-35.0,-42.0,-45.0,-88.0,-89.0,-86.0,-88.0,40.0,54.0,44.0,43.0,1
631,62:47:05:9D:EB:15,3842671,486794145,2103,2419919,3840568,484374226,0,4227,3005379,4196,3000398,31,4981,2045,0,2147,53,0,105,229410.0,137640.0,-44.0,-47.0,-39.0,-50.0,-47.0,-46.0,-39.0,-48.0,-88.0,-89.0,-86.0,-88.0,44.0,42.0,47.0,38.0,1
632,3C:55:76:E8:8F:1F,3909727,657061037,69159,172686811,3840568,484374226,30,33702,6975924,33229,6894772,473,81152,14251,38,69230,7093,30,441,206470.0,1000.0,-42.0,-52.0,-48.0,-38.0,-42.0,-53.0,-46.0,-38.0,-88.0,-89.0,-86.0,-88.0,46.0,37.0,38.0,50.0,1
633,92:69:1D:31:68:E9,3844536,488005228,3968,3631002,3840568,484374226,0,5024,1124224,4869,1089131,155,35093,2146,11,4197,91,0,55,216660.0,130000.0,-53.0,-47.0,-42.0,-49.0,-52.0,-47.0,-43.0,-47.0,-88.0,-89.0,-86.0,-88.0,35.0,42.0,44.0,39.0,1
634,CC:2F:71:3F:1F:24,4796894,1549749851,956326,1065375625,3840568,484374226,108,788520,861550790,787754,861458360,766,92430,761233,15,956513,100419,105,586,115556.0,26000.0,-67.0,-70.0,-66.0,-68.0,-67.0,-70.0,-66.0,-67.0,-88.0,-89.0,-86.0,-88.0,21.0,19.0,20.0,20.0,1
635,CC:2F:71:3E:C5:1F,3841492,484487103,924,112877,3840568,484374226,0,3860,324243,3183,243827,677,80416,980,11,1328,25,0,48,144444.0,43333.0,-72.0,-71.0,-69.0,-60.0,-69.0,-70.0,-67.0,-60.0,-88.0,-89.0,-86.0,-88.0,16.0,18.0,17.0,28.0,1
636,BA:8C:B9:54:50:24,3845442,490561229,4874,6187003,3840568,484374226,0,9265,1717997,9243,1714502,22,3495,2351,17,5343,41,0,63,229410.0,130000.0,-51.0,-35.0,-44.0,-45.0,-49.0,-35.0,-43.0,-45.0,-88.0,-89.0,-86.0,-88.0,37.0,54.0,42.0,43.0,1
637,62:47:05:9D:EB:15,3842673,486794267,2103,2419919,3840570,484374348,0,4227,3005379,4196,3000398,31,4981,2045,0,2147,53,0,105,229410.0,137640.0,-44.0,-47.0,-39.0,-50.0,-47.0,-46.0,-39.0,-48.0,-88.0,-89.0,-86.0,-88.0,44.0,42.0,47.0,38.0,1
638,3C:55:76:E8:8F:1F,3909731,657061407,69161,172687059,3840570,484374348,30,33713,6976887,33239,6895617,474,81270,14255,38,69232,7093,30,441,195000.0,1000.0,-46.0,-52.0,-44.0,-41.0,-46.0,-52.0,-43.0,-42.0,-88.0,-89.0,-86.0,-88.0,42.0,37.0,42.0,47.0,1
639,92:69:1D:31:68:E9,3844538,488005350,3968,3631002,3840570,484374348,0,5024,1124224,4869,1089131,155,35093,2146,11,4197,91,0,55,216660.0,130000.0,-53.0,-47.0,-42.0,-49.0,-52.0,-47.0,-43.0,-47.0,-88.0,-89.0,-86.0,-88.0,35.0,42.0,44.0,39.0,1
640,CC:2F:71:3F:1F:24,4797114,1550016161,956542,1065641611,3840572,484374550,108,788721,861811571,787955,861719141,766,92430,761425,15,956730,100444,105,586,86667.0,14444.0,-68.0,-69.0,-66.0,-69.0,-68.0,-68.0,-65.0,-68.0,-88.0,-89.0,-86.0,-88.0,20.0,20.0,20.0,19.0,1
641,CC:2F:71:3E:C5:1F,3841498,484487629,924,112877,3840574,484374752,0,3860,324243,3183,243827,677,80416,980,11,1328,25,0,48,144444.0,43333.0,-72.0,-71.0,-69.0,-60.0,-69.0,-70.0,-67.0,-60.0,-88.0,-89.0,-86.0,-88.0,16.0,18.0,17.0,28.0,1
642,BA:8C:B9:54:50:24,3845450,490561957,4874,6187003,3840576,484374954,0,9270,1718337,9248,1714842,22,3495,2351,17,5343,41,0,63,229410.0,130000.0,-48.0,-35.0,-43.0,-46.0,-46.0,-35.0,-43.0,-47.0,-88.0,-89.0,-86.0,-88.0,40.0,54.0,43.0,42.0,1
643,62:47:05:9D:EB:15,3842681,486795075,2103,2419919,3840578,484375156,0,4227,3005379,4196,3000398,31,4981,2045,0,2147,53,0,105,229410.0,137640.0,-44.0,-47.0,-39.0,-50.0,-47.0,-46.0,-39.0,-48.0,-88.0,-89.0,-86.0,-88.0,44.0,42.0,47.0,38.0,1
644,3C:55:76:E8:8F:1F,3909739,657062215,69161,172687059,3840578,484375156,30,33718,6977229,33244,6895959,474,81270,14255,38,69232,7093,30,441,195000.0,1000.0,-49.0,-54.0,-45.0,-45.0,-47.0,-53.0,-44.0,-44.0,-88.0,-89.0,-86.0,-88.0,39.0,35.0,41.0,43.0,1
645,92:69:1D:31:68:E9,3844546,488006158,3968,3631002,3840578,484375156,0,5024,1124224,4869,1089131,155,35093,2146,11,4197,91,0,55,216660.0,130000.0,-53.0,-47.0,-42.0,-49.0,-52.0,-47.0,-43.0,-47.0,-88.0,-89.0,-86.0,-88.0,35.0,42.0,44.0,39.0,1
646,CC:2F:71:3F:1F:24,4797524,1550528117,956946,1066152961,3840578,484375156,108,789006,862081418,788240,861988988,766,92430,761701,15,957134,100444,105,586,86667.0,14444.0,-67.0,-69.0,-65.0,-68.0,-67.0,-69.0,-65.0,-68.0,-88.0,-89.0,-86.0,-88.0,21.0,20.0,21.0,20.0,1
647,CC:2F:71:3E:C5:1F,3841502,484488033,924,112877,3840578,484375156,0,3860,324243,3183,243827,677,80416,980,11,1328,25,0,48,144444.0,43333.0,-72.0,-71.0,-69.0,-60.0,-69.0,-70.0,-67.0,-60.0,-88.0,-89.0,-86.0,-88.0,16.0,18.0,17.0,28.0,1
648,BA:8C:B9:54:50:24,3845452,490562159,4874,6187003,3840578,484375156,0,9270,1718337,9248,1714842,22,3495,2351,17,5343,41,0,63,229410.0,130000.0,-48.0,-35.0,-43.0,-46.0,-46.0,-35.0,-43.0,-47.0,-88.0,-89.0,-86.0,-88.0,40.0,54.0,43.0,42.0,1
649,62:47:05:9D:EB:15,3842686,486795539,2103,2419919,3840583,484375620,0,4227,3005379,4196,3000398,31,4981,2045,0,2147,53,0,105,229410.0,137640.0,-44.0,-47.0,-39.0,-50.0,-47.0,-46.0,-39.0,-48.0,-88.0,-89.0,-86.0,-88.0,44.0,42.0,47.0,38.0,1
650,3C:55:76:E8:8F:1F,3909744,657062679,69161,172687059,3840583,484375620,30,33718,6977229,33244,6895959,474,81270,14255,38,69232,7093,30,441,195000.0,1000.0,-49.0,-54.0,-45.0,-45.0,-47.0,-53.0,-44.0,-44.0,-88.0,-89.0,-86.0,-88.0,39.0,35.0,41.0,43.0,1
651,92:69:1D:31:68:E9,3844555,488007026,3968,3631002,3840587,484376024,0,5025,1124292,4870,1089199,155,35093,2146,11,4197,91,0,55,216660.0,130000.0,-52.0,-47.0,-44.0,-47.0,-52.0,-47.0,-43.0,-47.0,-88.0,-89.0,-86.0,-88.0,36.0,42.0,42.0,41.0,1
652,CC:2F:71:3F:1F:24,4797742,1550791483,957155,1066415459,3840587,484376024,108,789200,862336582,788434,862244152,766,92430,761889,15,957343,100450,105,586,130000.0,43333.0,-67.0,-69.0,-65.0,-70.0,-67.0,-68.0,-64.0,-70.0,-88.0,-89.0,-86.0,-88.0,21.0,20.0,21.0,18.0,1
653,CC:2F:71:3E:C5:1F,3841511,484488901,924,112877,3840587,484376024,0,3860,324243,3183,243827,677,80416,980,11,1328,25,0,48,144444.0,43333.0,-72.0,-71.0,-69.0,-60.0,-69.0,-70.0,-67.0,-60.0,-88.0,-89.0,-86.0,-88.0,16.0,18.0,17.0,28.0,1
654,BA:8C:B9:54:50:24,3845461,490563027,4874,6187003,3840587,484376024,0,9270,1718337,9248,1714842,22,3495,2351,17,5343,41,0,63,229410.0,130000.0,-48.0,-35.0,-43.0,-46.0,-46.0,-35.0,-43.0,-47.0,-88.0,-89.0,-86.0,-88.0,40.0,54.0,43.0,42.0,1
655,62:47:05:9D:EB:15,3842690,486795943,2103,2419919,3840587,484376024,0,4227,3005379,4196,3000398,31,4981,2045,0,2147,53,0,105,229410.0,137640.0,-44.0,-47.0,-39.0,-50.0,-47.0,-46.0,-39.0,-48.0,-88.0,-89.0,-86.0,-88.0,44.0,42.0,47.0,38.0,1
656,3C:55:76:E8:8F:1F,3909748,657063083,69161,172687059,3840587,484376024,30,33718,6977229,33244,6895959,474,81270,14255,38,69232,7093,30,441,195000.0,1000.0,-49.0,-54.0,-45.0,-45.0,-47.0,-53.0,-44.0,-44.0,-88.0,-89.0,-86.0,-88.0,39.0,35.0,41.0,43.0,1
657,92:69:1D:31:68:E9,3844555,488007026,3968,3631002,3840587,484376024,0,5025,1124292,4870,1089199,155,35093,2146,11,4197,91,0,55,216660.0,130000.0,-52.0,-47.0,-44.0,-47.0,-52.0,-47.0,-43.0,-47.0,-88.0,-89.0,-86.0,-88.0,36.0,42.0,42.0,41.0,1
658,CC:2F:71:3F:1F:24,4798157,1551311775,957570,1066935751,3840587,484376024,108,789497,862621167,788731,862528737,766,92430,762175,15,957758,100515,105,586,117000.0,39000.0,-67.0,-69.0,-65.0,-69.0,-67.0,-69.0,-64.0,-69.0,-88.0,-89.0,-86.0,-88.0,21.0,20.0,21.0,19.0,1
659,CC:2F:71:3E:C5:1F,3841511,484488901,924,112877,3840587,484376024,0,3862,324383,3185,243967,677,80416,980,11,1329,25,0,48,144444.0,43333.0,-71.0,-71.0,-69.0,-60.0,-69.0,-70.0,-67.0,-60.0,-88.0,-89.0,-86.0,-88.0,17.0,18.0,17.0,28.0,1
660,BA:8C:B9:54:50:24,3845461,490563027,4874,6187003,3840587,484376024,0,9270,1718337,9248,1714842,22,3495,2351,17,5343,41,0,63,229410.0,130000.0,-48.0,-35.0,-43.0,-46.0,-46.0,-35.0,-43.0,-47.0,-88.0,-89.0,-86.0,-88.0,40.0,54.0,43.0,42.0,1
661,62:47:05:9D:EB:15,3842698,486796751,2103,2419919,3840595,484376832,0,4229,3005515,4198,3000534,31,4981,2045,0,2148,53,0,105,229410.0,137640.0,-48.0,-46.0,-39.0,-48.0,-47.0,-45.0,-39.0,-48.0,-88.0,-89.0,-86.0,-88.0,40.0,43.0,47.0,40.0,1
662,3C:55:76:E8:8F:1F,3909757,657063951,69161,172687059,3840596,484376892,30,33718,6977229,33244,6895959,474,81270,14255,38,69232,7093,30,441,195000.0,1000.0,-49.0,-54.0,-45.0,-45.0,-47.0,-53.0,-44.0,-44.0,-88.0,-89.0,-86.0,-88.0,39.0,35.0,41.0,43.0,1
663,92:69:1D:31:68:E9,3844564,488007894,3968,3631002,3840596,484376892,0,5025,1124292,4870,1089199,155,35093,2146,11,4197,91,0,55,216660.0,130000.0,-52.0,-47.0,-44.0,-47.0,-52.0,-47.0,-43.0,-47.0,-88.0,-89.0,-86.0,-88.0,36.0,42.0,42.0,41.0,1
664,CC:2F:71:3F:1F:24,4798717,1552030329,958121,1067653437,3840596,484376892,108,789834,862898474,789068,862806044,766,92430,762503,15,958309,100535,105,586,115556.0,28889.0,-67.0,-69.0,-64.0,-70.0,-67.0,-69.0,-64.0,-69.0,-88.0,-89.0,-86.0,-88.0,21.0,20.0,22.0,18.0,1
665,CC:2F:71:3E:C5:1F,3841520,484489769,924,112877,3840596,484376892,0,3862,324383,3185,243967,677,80416,980,11,1329,25,0,48,144444.0,43333.0,-71.0,-71.0,-69.0,-60.0,-69.0,-70.0,-67.0,-60.0,-88.0,-89.0,-86.0,-88.0,17.0,18.0,17.0,28.0,1
666,BA:8C:B9:54:50:24,3845470,490563895,4874,6187003,3840596,484376892,0,9270,1718337,9248,1714842,22,3495,2351,17,5343,41,0,63,229410.0,130000.0,-48.0,-35.0,-43.0,-46.0,-46.0,-35.0,-43.0,-47.0,-88.0,-89.0,-86.0,-88.0,40.0,54.0,43.0,42.0,1
667,62:47:05:9D:EB:15,3842711,486802410,2103,2419919,3840608,484382491,0,4229,3005515,4198,3000534,31,4981,2045,0,2148,53,0,105,229410.0,137640.0,-48.0,-46.0,-39.0,-48.0,-47.0,-45.0,-39.0,-48.0,-88.0,-89.0,-86.0,-88.0,40.0,43.0,47.0,40.0,1
668,3C:55:76:E8:8F:1F,3909769,657069550,69161,172687059,3840608,484382491,30,33718,6977229,33244,6895959,474,81270,14255,38,69232,7093,30,441,195000.0,1000.0,-49.0,-54.0,-45.0,-45.0,-47.0,-53.0,-44.0,-44.0,-88.0,-89.0,-86.0,-88.0,39.0,35.0,41.0,43.0,1
669,92:69:1D:31:68:E9,3844587,488018917,3968,3631002,3840619,484387915,0,5028,1124663,4872,1089335,156,35328,2147,11,4197,91,0,55,216660.0,130000.0,-52.0,-47.0,-45.0,-47.0,-52.0,-47.0,-44.0,-47.0,-88.0,-89.0,-86.0,-88.0,36.0,42.0,41.0,41.0,1
670,CC:2F:71:3F:1F:24,4799394,1552830780,958775,1068442865,3840619,484387915,108,790262,863205974,789496,863113544,766,92430,762921,15,958963,100656,105,586,115556.0,28889.0,-69.0,-69.0,-66.0,-69.0,-69.0,-69.0,-64.0,-67.0,-88.0,-89.0,-86.0,-88.0,19.0,20.0,20.0,19.0,1
671,CC:2F:71:3E:C5:1F,3841543,484500792,924,112877,3840619,484387915,0,3862,324383,3185,243967,677,80416,980,11,1329,25,0,48,144444.0,43333.0,-71.0,-71.0,-69.0,-60.0,-69.0,-70.0,-67.0,-60.0,-88.0,-89.0,-86.0,-88.0,17.0,18.0,17.0,28.0,1
672,BA:8C:B9:54:50:24,3845495,490575120,4874,6187003,3840621,484388117,0,9270,1718337,9248,1714842,22,3495,2351,17,5343,41,0,63,229410.0,130000.0,-48.0,-35.0,-43.0,-46.0,-46.0,-35.0,-43.0,-47.0,-88.0,-89.0,-86.0,-88.0,40.0,54.0,43.0,42.0,1
673,62:47:05:9D:EB:15,3842730,486808642,2103,2419919,3840627,484388723,0,4229,3005515,4198,3000534,31,4981,2045,0,2148,53,0,105,229410.0,137640.0,-48.0,-46.0,-39.0,-48.0,-47.0,-45.0,-39.0,-48.0,-88.0,-89.0,-86.0,-88.0,40.0,43.0,47.0,40.0,1
674,3C:55:76:E8:8F:1F,3909788,657075782,69161,172687059,3840627,484388723,30,33718,6977229,33244,6895959,474,81270,14255,38,69232,7093,30,441,195000.0,1000.0,-49.0,-54.0,-45.0,-45.0,-47.0,-53.0,-44.0,-44.0,-88.0,-89.0,-86.0,-88.0,39.0,35.0,41.0,43.0,1
675,92:69:1D:31:68:E9,3844595,488019725,3968,3631002,3840627,484388723,0,5028,1124663,4872,1089335,156,35328,2147,11,4197,91,0,55,216660.0,130000.0,-52.0,-47.0,-45.0,-47.0,-52.0,-47.0,-44.0,-47.0,-88.0,-89.0,-86.0,-88.0,36.0,42.0,41.0,41.0,1
676,CC:2F:71:3F:1F:24,4800226,1553863629,959599,1069474906,3840627,484388723,108,790760,863506315,789994,863413885,766,92430,763406,15,959787,100690,105,586,115556.0,28889.0,-69.0,-69.0,-66.0,-67.0,-68.0,-69.0,-65.0,-67.0,-88.0,-89.0,-86.0,-88.0,19.0,20.0,20.0,21.0,1
677,CC:2F:71:3E:C5:1F,3841552,484501660,924,112877,3840628,484388783,0,3862,324383,3185,243967,677,80416,980,11,1329,25,0,48,144444.0,43333.0,-71.0,-71.0,-69.0,-60.0,-69.0,-70.0,-67.0,-60.0,-88.0,-89.0,-86.0,-88.0,17.0,18.0,17.0,28.0,1
678,BA:8C:B9:54:50:24,3845502,490575786,4874,6187003,3840628,484388783,0,9270,1718337,9248,1714842,22,3495,2351,17,5343,41,0,63,229410.0,130000.0,-48.0,-35.0,-43.0,-46.0,-46.0,-35.0,-43.0,-47.0,-88.0,-89.0,-86.0,-88.0,40.0,54.0,43.0,42.0,1
679,62:47:05:9D:EB:15,3842732,486808975,2103,2419919,3840629,484389056,0,4229,3005515,4198,3000534,31,4981,2045,0,2148,53,0,105,229410.0,137640.0,-48.0,-46.0,-39.0,-48.0,-47.0,-45.0,-39.0,-48.0,-88.0,-89.0,-86.0,-88.0,40.0,43.0,47.0,40.0,1
680,3C:55:76:E8:8F:1F,3909790,657076115,69161,172687059,3840629,484389056,30,33718,6977229,33244,6895959,474,81270,14255,38,69232,7093,30,441,195000.0,1000.0,-49.0,-54.0,-45.0,-45.0,-47.0,-53.0,-44.0,-44.0,-88.0,-89.0,-86.0,-88.0,39.0,35.0,41.0,43.0,1
681,92:69:1D:31:68:E9,3844599,488020260,3968,3631002,3840631,484389258,0,5028,1124663,4872,1089335,156,35328,2147,11,4197,91,0,55,216660.0,130000.0,-52.0,-47.0,-45.0,-47.0,-52.0,-47.0,-44.0,-47.0,-88.0,-89.0,-86.0,-88.0,36.0,42.0,41.0,41.0,1
682,CC:2F:71:3F:1F:24,4800637,1554374861,960006,1069985603,3840631,484389258,108,791033,863766280,790267,863673850,766,92430,763674,15,960193,100711,105,586,130000.0,39000.0,-69.0,-70.0,-64.0,-68.0,-68.0,-69.0,-64.0,-68.0,-88.0,-89.0,-86.0,-88.0,19.0,19.0,22.0,20.0,1
683,CC:2F:71:3E:C5:1F,3841559,484502539,924,112877,3840635,484389662,0,3862,324383,3185,243967,677,80416,980,11,1329,25,0,48,144444.0,43333.0,-71.0,-71.0,-69.0,-60.0,-69.0,-70.0,-67.0,-60.0,-88.0,-89.0,-86.0,-88.0,17.0,18.0,17.0,28.0,1
684,BA:8C:B9:54:50:24,3845509,490576665,4874,6187003,3840635,484389662,0,9270,1718337,9248,1714842,22,3495,2351,17,5343,41,0,63,229410.0,130000.0,-48.0,-35.0,-43.0,-46.0,-46.0,-35.0,-43.0,-47.0,-88.0,-89.0,-86.0,-88.0,40.0,54.0,43.0,42.0,1
685,62:47:05:9D:EB:15,3842740,486809783,2103,2419919,3840637,484389864,0,4229,3005515,4198,3000534,31,4981,2045,0,2148,53,0,105,229410.0,137640.0,-48.0,-46.0,-39.0,-48.0,-47.0,-45.0,-39.0,-48.0,-88.0,-89.0,-86.0,-88.0,40.0,43.0,47.0,40.0,1
686,3C:55:76:E8:8F:1F,3909798,657076923,69161,172687059,3840637,484389864,30,33718,6977229,33244,6895959,474,81270,14255,38,69232,7093,30,441,195000.0,1000.0,-49.0,-54.0,-45.0,-45.0,-47.0,-53.0,-44.0,-44.0,-88.0,-89.0,-86.0,-88.0,39.0,35.0,41.0,43.0,1
687,92:69:1D:31:68:E9,3844605,488020866,3968,3631002,3840637,484389864,0,5028,1124663,4872,1089335,156,35328,2147,11,4197,91,0,55,216660.0,130000.0,-52.0,-47.0,-45.0,-47.0,-52.0,-47.0,-44.0,-47.0,-88.0,-89.0,-86.0,-88.0,36.0,42.0,41.0,41.0,1
688,CC:2F:71:3F:1F:24,4800854,1554638505,960217,1070248641,3840637,484389864,108,791233,864029452,790467,863937022,766,92430,763860,15,960404,100737,105,586,130000.0,43333.0,-69.0,-69.0,-65.0,-67.0,-69.0,-69.0,-65.0,-67.0,-88.0,-89.0,-86.0,-88.0,19.0,20.0,21.0,21.0,1
689,CC:2F:71:3E:C5:1F,3841561,484502741,924,112877,3840637,484389864,0,3862,324383,3185,243967,677,80416,980,11,1329,25,0,48,144444.0,43333.0,-71.0,-71.0,-69.0,-60.0,-69.0,-70.0,-67.0,-60.0,-88.0,-89.0,-86.0,-88.0,17.0,18.0,17.0,28.0,1
690,BA:8C:B9:54:50:24,3845511,490576867,4874,6187003,3840637,484389864,0,9270,1718337,9248,1714842,22,3495,2351,17,5343,41,0,63,229410.0,130000.0,-48.0,-35.0,-43.0,-46.0,-46.0,-35.0,-43.0,-47.0,-88.0,-89.0,-86.0,-88.0,40.0,54.0,43.0,42.0,1
691,62:47:05:9D:EB:15,3842745,486810247,2103,2419919,3840642,484390328,0,4229,3005515,4198,3000534,31,4981,2045,0,2148,53,0,105,229410.0,137640.0,-48.0,-46.0,-39.0,-48.0,-47.0,-45.0,-39.0,-48.0,-88.0,-89.0,-86.0,-88.0,40.0,43.0,47.0,40.0,1
692,3C:55:76:E8:8F:1F,3909803,657077387,69161,172687059,3840642,484390328,30,33718,6977229,33244,6895959,474,81270,14255,38,69232,7093,30,441,195000.0,1000.0,-49.0,-54.0,-45.0,-45.0,-47.0,-53.0,-44.0,-44.0,-88.0,-89.0,-86.0,-88.0,39.0,35.0,41.0,43.0,1
693,92:69:1D:31:68:E9,3844614,488021734,3968,3631002,3840646,484390732,0,5028,1124663,4872,1089335,156,35328,2147,11,4197,91,0,55,216660.0,130000.0,-52.0,-47.0,-45.0,-47.0,-52.0,-47.0,-44.0,-47.0,-88.0,-89.0,-86.0,-88.0,36.0,42.0,41.0,41.0,1
694,CC:2F:71:3F:1F:24,4801070,1554898011,960424,1070507279,3840646,484390732,108,791423,864284166,790657,864191736,766,92430,764043,15,960612,100744,105,586,130000.0,43333.0,-69.0,-69.0,-65.0,-68.0,-68.0,-69.0,-64.0,-68.0,-88.0,-89.0,-86.0,-88.0,19.0,20.0,21.0,20.0,1
695,CC:2F:71:3E:C5:1F,3841570,484503609,924,112877,3840646,484390732,0,3862,324383,3185,243967,677,80416,980,11,1329,25,0,48,144444.0,43333.0,-71.0,-71.0,-69.0,-60.0,-69.0,-70.0,-67.0,-60.0,-88.0,-89.0,-86.0,-88.0,17.0,18.0,17.0,28.0,1
696,BA:8C:B9:54:50:24,3845520,490577735,4874,6187003,3840646,484390732,0,9270,1718337,9248,1714842,22,3495,2351,17,5343,41,0,63,229410.0,130000.0,-48.0,-35.0,-43.0,-46.0,-46.0,-35.0,-43.0,-47.0,-88.0,-89.0,-86.0,-88.0,40.0,54.0,43.0,42.0,1
697,62:47:05:9D:EB:15,3842751,486811019,2103,2419919,3840648,484391100,0,4229,3005515,4198,3000534,31,4981,2045,0,2148,53,0,105,229410.0,137640.0,-48.0,-46.0,-39.0,-48.0,-47.0,-45.0,-39.0,-48.0,-88.0,-89.0,-86.0,-88.0,40.0,43.0,47.0,40.0,1
698,3C:55:76:E8:8F:1F,3909809,657078159,69161,172687059,3840648,484391100,30,33718,6977229,33244,6895959,474,81270,14255,38,69232,7093,30,441,195000.0,1000.0,-49.0,-54.0,-45.0,-45.0,-47.0,-53.0,-44.0,-44.0,-88.0,-89.0,-86.0,-88.0,39.0,35.0,41.0,43.0,1
699,92:69:1D:31:68:E9,3844616,488022102,3968,3631002,3840648,484391100,0,5028,1124663,4872,1089335,156,35328,2147,11,4197,91,0,55,216660.0,130000.0,-52.0,-47.0,-45.0,-47.0,-52.0,-47.0,-44.0,-47.0,-88.0,-89.0,-86.0,-88.0,36.0,42.0,41.0,41.0,1
700,CC:2F:71:3F:1F:24,4801291,1555165208,960643,1070774108,3840648,484391100,108,791628,864542661,790862,864450231,766,92430,764237,15,960831,100752,105,586,130000.0,43333.0,-68.0,-70.0,-65.0,-70.0,-68.0,-69.0,-65.0,-68.0,-88.0,-89.0,-86.0,-88.0,20.0,19.0,21.0,18.0,1
701,CC:2F:71:3E:C5:1F,3841572,484503977,924,112877,3840648,484391100,0,3862,324383,3185,243967,677,80416,980,11,1329,25,0,48,144444.0,43333.0,-71.0,-71.0,-69.0,-60.0,-69.0,-70.0,-67.0,-60.0,-88.0,-89.0,-86.0,-88.0,17.0,18.0,17.0,28.0,1
702,BA:8C:B9:54:50:24,3845522,490578103,4874,6187003,3840648,484391100,0,9270,1718337,9248,1714842,22,3495,2351,17,5343,41,0,63,229410.0,130000.0,-48.0,-35.0,-43.0,-46.0,-46.0,-35.0,-43.0,-47.0,-88.0,-89.0,-86.0,-88.0,40.0,54.0,43.0,42.0,1
703,62:47:05:9D:EB:15,3842760,486811887,2103,2419919,3840657,484391968,0,4229,3005515,4198,3000534,31,4981,2045,0,2148,53,0,105,229410.0,137640.0,-48.0,-46.0,-39.0,-48.0,-47.0,-45.0,-39.0,-48.0,-88.0,-89.0,-86.0,-88.0,40.0,43.0,47.0,40.0,1
704,3C:55:76:E8:8F:1F,3909819,657079095,69162,172687127,3840657,484391968,30,33731,6978183,33257,6896913,474,81270,14256,38,69233,7093,30,441,195000.0,1000.0,-44.0,-60.0,-52.0,-42.0,-45.0,-59.0,-54.0,-42.0,-88.0,-89.0,-86.0,-88.0,44.0,29.0,34.0,46.0,1
705,92:69:1D:31:68:E9,3844625,488022970,3968,3631002,3840657,484391968,0,5028,1124663,4872,1089335,156,35328,2147,11,4197,91,0,55,216660.0,130000.0,-52.0,-47.0,-45.0,-47.0,-52.0,-47.0,-44.0,-47.0,-88.0,-89.0,-86.0,-88.0,36.0,42.0,41.0,41.0,1
706,CC:2F:71:3F:1F:24,4801514,1555429712,960857,1071037744,3840657,484391968,108,791821,864796271,791055,864703841,766,92430,764425,15,961045,100752,105,586,130000.0,43333.0,-69.0,-68.0,-65.0,-67.0,-68.0,-69.0,-64.0,-67.0,-88.0,-89.0,-86.0,-88.0,19.0,21.0,21.0,21.0,1
707,CC:2F:71:3E:C5:1F,3841581,484504845,924,112877,3840657,484391968,0,3862,324383,3185,243967,677,80416,980,11,1329,25,0,48,144444.0,43333.0,-71.0,-71.0,-69.0,-60.0,-69.0,-70.0,-67.0,-60.0,-88.0,-89.0,-86.0,-88.0,17.0,18.0,17.0,28.0,1
708,BA:8C:B9:54:50:24,3845531,490578971,4874,6187003,3840657,484391968,0,9270,1718337,9248,1714842,22,3495,2351,17,5343,41,0,63,229410.0,130000.0,-48.0,-35.0,-43.0,-46.0,-46.0,-35.0,-43.0,-47.0,-88.0,-89.0,-86.0,-88.0,40.0,54.0,43.0,42.0,1
709,62:47:05:9D:EB:15,3842760,486811887,2103,2419919,3840657,484391968,0,4229,3005515,4198,3000534,31,4981,2045,0,2148,53,0,105,229410.0,137640.0,-48.0,-46.0,-39.0,-48.0,-47.0,-45.0,-39.0,-48.0,-88.0,-89.0,-86.0,-88.0,40.0,43.0,47.0,40.0,1
710,3C:55:76:E8:8F:1F,3909822,657079720,69165,172687752,3840657,484391968,30,33747,6979704,33273,6898434,474,81270,14260,38,69236,7093,30,441,195000.0,1000.0,-49.0,-57.0,-43.0,-44.0,-48.0,-56.0,-43.0,-43.0,-88.0,-89.0,-86.0,-88.0,39.0,32.0,43.0,44.0,1
711,92:69:1D:31:68:E9,3844625,488022970,3968,3631002,3840657,484391968,0,5028,1124663,4872,1089335,156,35328,2147,11,4197,91,0,55,216660.0,130000.0,-52.0,-47.0,-45.0,-47.0,-52.0,-47.0,-44.0,-47.0,-88.0,-89.0,-86.0,-88.0,36.0,42.0,41.0,41.0,1
712,CC:2F:71:3F:1F:24,4801728,1555696142,961071,1071304174,3840657,484391968,108,792015,865052835,791249,864960405,766,92430,764614,15,961259,100763,105,586,130000.0,43333.0,-68.0,-68.0,-64.0,-67.0,-68.0,-68.0,-64.0,-67.0,-88.0,-89.0,-86.0,-88.0,20.0,21.0,22.0,21.0,1
713,CC:2F:71:3E:C5:1F,3841581,484504845,924,112877,3840657,484391968,0,3862,324383,3185,243967,677,80416,980,11,1329,25,0,48,144444.0,43333.0,-71.0,-71.0,-69.0,-60.0,-69.0,-70.0,-67.0,-60.0,-88.0,-89.0,-86.0,-88.0,17.0,18.0,17.0,28.0,1
714,BA:8C:B9:54:50:24,3845533,490579173,4874,6187003,3840659,484392170,0,9270,1718337,9248,1714842,22,3495,2351,17,5343,41,0,63,229410.0,130000.0,-48.0,-35.0,-43.0,-46.0,-46.0,-35.0,-43.0,-47.0,-88.0,-89.0,-86.0,-88.0,40.0,54.0,43.0,42.0,1
715,62:47:05:9D:EB:15,3842768,486812695,2103,2419919,3840665,484392776,0,4229,3005515,4198,3000534,31,4981,2045,0,2148,53,0,105,229410.0,137640.0,-48.0,-46.0,-39.0,-48.0,-47.0,-45.0,-39.0,-48.0,-88.0,-89.0,-86.0,-88.0,40.0,43.0,47.0,40.0,1
716,3C:55:76:E8:8F:1F,3909830,657080528,69165,172687752,3840665,484392776,30,33747,6979704,33273,6898434,474,81270,14260,38,69236,7093,30,441,195000.0,1000.0,-49.0,-57.0,-43.0,-44.0,-48.0,-56.0,-43.0,-43.0,-88.0,-89.0,-86.0,-88.0,39.0,32.0,43.0,44.0,1
717,92:69:1D:31:68:E9,3844633,488023778,3968,3631002,3840665,484392776,0,5028,1124663,4872,1089335,156,35328,2147,11,4197,91,0,55,216660.0,130000.0,-52.0,-47.0,-45.0,-47.0,-52.0,-47.0,-44.0,-47.0,-88.0,-89.0,-86.0,-88.0,36.0,42.0,41.0,41.0,1
718,CC:2F:71:3F:1F:24,4801944,1555958566,961279,1071565790,3840665,484392776,108,792206,865305085,791440,865212655,766,92430,764796,15,961466,100763,105,586,130000.0,43333.0,-69.0,-69.0,-64.0,-67.0,-68.0,-69.0,-64.0,-67.0,-88.0,-89.0,-86.0,-88.0,19.0,20.0,22.0,21.0,1
719,CC:2F:71:3E:C5:1F,3841590,484505713,924,112877,3840666,484392836,0,3862,324383,3185,243967,677,80416,980,11,1329,25,0,48,144444.0,43333.0,-71.0,-71.0,-69.0,-60.0,-69.0,-70.0,-67.0,-60.0,-88.0,-89.0,-86.0,-88.0,17.0,18.0,17.0,28.0,1
720,BA:8C:B9:54:50:24,3845540,490579839,4874,6187003,3840666,484392836,0,9270,1718337,9248,1714842,22,3495,2351,17,5343,41,0,63,229410.0,130000.0,-48.0,-35.0,-43.0,-46.0,-46.0,-35.0,-43.0,-47.0,-88.0,-89.0,-86.0,-88.0,40.0,54.0,43.0,42.0,1
721,62:47:05:9D:EB:15,3842769,486812755,2103,2419919,3840666,484392836,0,4229,3005515,4198,3000534,31,4981,2045,0,2148,53,0,105,229410.0,137640.0,-48.0,-46.0,-39.0,-48.0,-47.0,-45.0,-39.0,-48.0,-88.0,-89.0,-86.0,-88.0,40.0,43.0,47.0,40.0,1
722,3C:55:76:E8:8F:1F,3909839,657083733,69171,172690695,3840668,484393038,30,33767,6984844,33293,6903574,474,81270,14265,38,69242,7093,30,441,206470.0,1000.0,-49.0,-56.0,-44.0,-45.0,-49.0,-55.0,-44.0,-44.0,-88.0,-89.0,-86.0,-88.0,39.0,33.0,42.0,43.0,1
723,92:69:1D:31:68:E9,3844636,488024040,3968,3631002,3840668,484393038,0,5028,1124663,4872,1089335,156,35328,2147,11,4197,91,0,55,216660.0,130000.0,-52.0,-47.0,-45.0,-47.0,-52.0,-47.0,-44.0,-47.0,-88.0,-89.0,-86.0,-88.0,36.0,42.0,41.0,41.0,1
724,CC:2F:71:3F:1F:24,4802164,1556225375,961496,1071832337,3840668,484393038,108,792412,865570731,791646,865478301,766,92430,764992,15,961684,100768,105,586,130000.0,43333.0,-69.0,-69.0,-65.0,-67.0,-68.0,-69.0,-65.0,-67.0,-88.0,-89.0,-86.0,-88.0,19.0,20.0,21.0,21.0,1
725,CC:2F:71:3E:C5:1F,3841594,484506117,924,112877,3840670,484393240,0,3862,324383,3185,243967,677,80416,980,11,1329,25,0,48,144444.0,43333.0,-71.0,-71.0,-69.0,-60.0,-69.0,-70.0,-67.0,-60.0,-88.0,-89.0,-86.0,-88.0,17.0,18.0,17.0,28.0,1
726,BA:8C:B9:54:50:24,3845544,490580243,4874,6187003,3840670,484393240,0,9270,1718337,9248,1714842,22,3495,2351,17,5343,41,0,63,229410.0,130000.0,-48.0,-35.0,-43.0,-46.0,-46.0,-35.0,-43.0,-47.0,-88.0,-89.0,-86.0,-88.0,40.0,54.0,43.0,42.0,1
727,62:47:05:9D:EB:15,3842777,486813563,2103,2419919,3840674,484393644,0,4230,3005583,4199,3000602,31,4981,2045,0,2148,53,0,105,229410.0,137640.0,-46.0,-46.0,-39.0,-47.0,-47.0,-46.0,-39.0,-48.0,-88.0,-89.0,-86.0,-88.0,42.0,43.0,47.0,41.0,1
728,3C:55:76:E8:8F:1F,3909846,657085552,69172,172691908,3840674,484393644,30,33774,6985358,33300,6904088,474,81270,14266,38,69243,7093,30,441,206470.0,1000.0,-49.0,-57.0,-44.0,-44.0,-48.0,-55.0,-43.0,-43.0,-88.0,-89.0,-86.0,-88.0,39.0,32.0,42.0,44.0,1
729,92:69:1D:31:68:E9,3844642,488024646,3968,3631002,3840674,484393644,0,5028,1124663,4872,1089335,156,35328,2147,11,4197,91,0,55,216660.0,130000.0,-52.0,-47.0,-45.0,-47.0,-52.0,-47.0,-44.0,-47.0,-88.0,-89.0,-86.0,-88.0,36.0,42.0,41.0,41.0,1
730,CC:2F:71:3F:1F:24,4802378,1556489021,961704,1072095377,3840674,484393644,108,792603,865824219,791837,865731789,766,92430,765177,15,961892,100768,105,586,130000.0,43333.0,-69.0,-69.0,-64.0,-67.0,-68.0,-69.0,-64.0,-67.0,-88.0,-89.0,-86.0,-88.0,19.0,20.0,22.0,21.0,1
731,CC:2F:71:3E:C5:1F,3841598,484506521,924,112877,3840674,484393644,0,3862,324383,3185,243967,677,80416,980,11,1329,25,0,48,144444.0,43333.0,-71.0,-71.0,-69.0,-60.0,-69.0,-70.0,-67.0,-60.0,-88.0,-89.0,-86.0,-88.0,17.0,18.0,17.0,28.0,1
732,BA:8C:B9:54:50:24,3845548,490580647,4874,6187003,3840674,484393644,0,9270,1718337,9248,1714842,22,3495,2351,17,5343,41,0,63,229410.0,130000.0,-48.0,-35.0,-43.0,-46.0,-46.0,-35.0,-43.0,-47.0,-88.0,-89.0,-86.0,-88.0,40.0,54.0,43.0,42.0,1
733,62:47:05:9D:EB:15,3842782,486814027,2103,2419919,3840679,484394108,0,4230,3005583,4199,3000602,31,4981,2045,0,2148,53,0,105,229410.0,137640.0,-46.0,-46.0,-39.0,-47.0,-47.0,-46.0,-39.0,-48.0,-88.0,-89.0,-86.0,-88.0,42.0,43.0,47.0,41.0,1
734,3C:55:76:E8:8F:1F,3909851,657086016,69172,172691908,3840679,484394108,30,33775,6985428,33301,6904158,474,81270,14266,38,69243,7093,30,441,206470.0,1000.0,-49.0,-57.0,-44.0,-44.0,-48.0,-56.0,-43.0,-43.0,-88.0,-89.0,-86.0,-88.0,39.0,32.0,42.0,44.0,1
735,92:69:1D:31:68:E9,3844647,488025110,3968,3631002,3840679,484394108,0,5028,1124663,4872,1089335,156,35328,2147,11,4197,91,0,55,216660.0,130000.0,-52.0,-47.0,-45.0,-47.0,-52.0,-47.0,-44.0,-47.0,-88.0,-89.0,-86.0,-88.0,36.0,42.0,41.0,41.0,1
736,CC:2F:71:3F:1F:24,4802813,1557010105,962134,1072615997,3840679,484394108,108,792907,866098914,792141,866006484,766,92430,765476,15,962322,100770,105,586,130000.0,43333.0,-69.0,-70.0,-64.0,-68.0,-68.0,-69.0,-64.0,-67.0,-88.0,-89.0,-86.0,-88.0,19.0,19.0,22.0,20.0,1
737,CC:2F:71:3E:C5:1F,3841603,484506985,924,112877,3840679,484394108,0,3862,324383,3185,243967,677,80416,980,11,1329,25,0,48,144444.0,43333.0,-71.0,-71.0,-69.0,-60.0,-69.0,-70.0,-67.0,-60.0,-88.0,-89.0,-86.0,-88.0,17.0,18.0,17.0,28.0,1
738,BA:8C:B9:54:50:24,3845555,490581313,4874,6187003,3840681,484394310,0,9270,1718337,9248,1714842,22,3495,2351,17,5343,41,0,63,229410.0,130000.0,-48.0,-35.0,-43.0,-46.0,-46.0,-35.0,-43.0,-47.0,-88.0,-89.0,-86.0,-88.0,40.0,54.0,43.0,42.0,1
739,62:47:05:9D:EB:15,3842788,486814553,2104,2419979,3840684,484394574,0,4231,3005651,4200,3000670,31,4981,2045,0,2149,53,0,105,216660.0,130000.0,-45.0,-45.0,-38.0,-45.0,-46.0,-46.0,-39.0,-47.0,-88.0,-89.0,-86.0,-88.0,43.0,44.0,48.0,43.0,1
740,3C:55:76:E8:8F:1F,3909857,657086598,69173,172692024,3840684,484394574,30,33787,6986298,33312,6904910,475,81388,14267,38,69244,7093,30,442,206470.0,1000.0,-49.0,-59.0,-43.0,-44.0,-48.0,-58.0,-43.0,-43.0,-88.0,-89.0,-86.0,-88.0,39.0,30.0,43.0,44.0,1
741,92:69:1D:31:68:E9,3844653,488025692,3969,3631118,3840684,484394574,0,5030,1124799,4874,1089471,156,35328,2147,11,4198,91,0,55,216660.0,130000.0,-54.0,-47.0,-42.0,-49.0,-52.0,-47.0,-43.0,-48.0,-88.0,-89.0,-86.0,-88.0,34.0,42.0,44.0,39.0,1
742,CC:2F:71:3F:1F:24,4803231,1557525764,962547,1073131190,3840684,484394574,108,793194,866367432,792428,866275002,766,92430,765757,15,962735,100781,105,586,130000.0,43333.0,-69.0,-70.0,-66.0,-68.0,-69.0,-69.0,-65.0,-67.0,-88.0,-89.0,-86.0,-88.0,19.0,19.0,20.0,20.0,1
743,CC:2F:71:3E:C5:1F,3841609,484507511,925,112937,3840684,484394574,0,3864,324523,3187,244107,677,80416,980,11,1330,25,0,48,130000.0,39000.0,-67.0,-66.0,-63.0,-60.0,-69.0,-70.0,-67.0,-60.0,-88.0,-89.0,-86.0,-88.0,21.0,23.0,23.0,28.0,1
744,BA:8C:B9:54:50:24,3845559,490581693,4875,6187119,3840684,484394574,0,9274,1718609,9252,1715114,22,3495,2351,17,5344,41,0,63,229410.0,130000.0,-49.0,-35.0,-43.0,-46.0,-44.0,-35.0,-43.0,-47.0,-88.0,-89.0,-86.0,-88.0,39.0,54.0,43.0,42.0,1
745,62:47:05:9D:EB:15,3842793,486815017,2104,2419979,3840689,484395038,0,4232,3005719,4201,3000738,31,4981,2045,0,2149,53,0,105,216660.0,130000.0,-46.0,-46.0,-39.0,-46.0,-45.0,-46.0,-39.0,-47.0,-88.0,-89.0,-86.0,-88.0,42.0,43.0,47.0,42.0,1
746,3C:55:76:E8:8F:1F,3909864,657087264,69173,172692024,3840691,484395240,30,33787,6986298,33312,6904910,475,81388,14267,38,69244,7093,30,442,206470.0,1000.0,-49.0,-59.0,-43.0,-44.0,-48.0,-58.0,-43.0,-43.0,-88.0,-89.0,-86.0,-88.0,39.0,30.0,43.0,44.0,1
747,92:69:1D:31:68:E9,3844661,488026420,3969,3631118,3840692,484395302,0,5030,1124799,4874,1089471,156,35328,2147,11,4198,91,0,55,216660.0,130000.0,-54.0,-47.0,-42.0,-49.0,-52.0,-47.0,-43.0,-48.0,-88.0,-89.0,-86.0,-88.0,34.0,42.0,44.0,39.0,1
748,CC:2F:71:3F:1F:24,4803644,1558035970,962950,1073640466,3840694,484395504,108,793476,866633138,792709,866540590,767,92548,766033,15,963138,100793,105,586,130000.0,43333.0,-69.0,-69.0,-64.0,-68.0,-68.0,-69.0,-64.0,-67.0,-88.0,-89.0,-86.0,-88.0,19.0,20.0,22.0,20.0,1
749,CC:2F:71:3E:C5:1F,3841619,484508441,925,112937,3840694,484395504,0,3864,324523,3187,244107,677,80416,980,11,1330,25,0,48,130000.0,39000.0,-67.0,-66.0,-63.0,-60.0,-69.0,-70.0,-67.0,-60.0,-88.0,-89.0,-86.0,-88.0,21.0,23.0,23.0,28.0,1
750,BA:8C:B9:54:50:24,3845569,490582623,4875,6187119,3840694,484395504,0,9275,1718677,9253,1715182,22,3495,2351,17,5344,41,0,63,229410.0,130000.0,-48.0,-35.0,-43.0,-45.0,-45.0,-34.0,-43.0,-46.0,-88.0,-89.0,-86.0,-88.0,40.0,54.0,43.0,43.0,1
751,62:47:05:9D:EB:15,3842799,486815756,2104,2419979,3840695,484395777,0,4232,3005719,4201,3000738,31,4981,2045,0,2149,53,0,105,216660.0,130000.0,-46.0,-46.0,-39.0,-46.0,-45.0,-46.0,-39.0,-47.0,-88.0,-89.0,-86.0,-88.0,42.0,43.0,47.0,42.0,1
752,3C:55:76:E8:8F:1F,3909868,657087801,69173,172692024,3840695,484395777,30,33787,6986298,33312,6904910,475,81388,14267,38,69244,7093,30,442,206470.0,1000.0,-49.0,-59.0,-43.0,-44.0,-48.0,-58.0,-43.0,-43.0,-88.0,-89.0,-86.0,-88.0,39.0,30.0,43.0,44.0,1
753,92:69:1D:31:68:E9,3844664,488026895,3969,3631118,3840695,484395777,0,5030,1124799,4874,1089471,156,35328,2147,11,4198,91,0,55,216660.0,130000.0,-54.0,-47.0,-42.0,-49.0,-52.0,-47.0,-43.0,-48.0,-88.0,-89.0,-86.0,-88.0,34.0,42.0,44.0,39.0,1
754,CC:2F:71:3F:1F:24,4804060,1558549018,963365,1074153241,3840695,484395777,108,793764,866897921,792997,866805373,767,92548,766318,15,963552,100805,105,586,130000.0,43333.0,-69.0,-69.0,-64.0,-67.0,-68.0,-69.0,-64.0,-67.0,-88.0,-89.0,-86.0,-88.0,19.0,20.0,22.0,21.0,1
755,CC:2F:71:3E:C5:1F,3841620,484508714,925,112937,3840695,484395777,0,3864,324523,3187,244107,677,80416,980,11,1330,25,0,48,130000.0,39000.0,-67.0,-66.0,-63.0,-60.0,-69.0,-70.0,-67.0,-60.0,-88.0,-89.0,-86.0,-88.0,21.0,23.0,23.0,28.0,1
756,BA:8C:B9:54:50:24,3845572,490583098,4875,6187119,3840697,484395979,0,9275,1718677,9253,1715182,22,3495,2351,17,5344,41,0,63,229410.0,130000.0,-48.0,-35.0,-43.0,-45.0,-45.0,-34.0,-43.0,-46.0,-88.0,-89.0,-86.0,-88.0,40.0,54.0,43.0,43.0,1
757,62:47:05:9D:EB:15,3842807,486816564,2104,2419979,3840703,484396585,0,4232,3005719,4201,3000738,31,4981,2045,0,2149,53,0,105,216660.0,130000.0,-46.0,-46.0,-39.0,-46.0,-45.0,-46.0,-39.0,-47.0,-88.0,-89.0,-86.0,-88.0,42.0,43.0,47.0,42.0,1
758,3C:55:76:E8:8F:1F,3909876,657088609,69173,172692024,3840703,484396585,30,33787,6986298,33312,6904910,475,81388,14267,38,69244,7093,30,442,206470.0,1000.0,-49.0,-59.0,-43.0,-44.0,-48.0,-58.0,-43.0,-43.0,-88.0,-89.0,-86.0,-88.0,39.0,30.0,43.0,44.0,1
759,92:69:1D:31:68:E9,3844672,488027703,3969,3631118,3840703,484396585,0,5030,1124799,4874,1089471,156,35328,2147,11,4198,91,0,55,216660.0,130000.0,-54.0,-47.0,-42.0,-49.0,-52.0,-47.0,-43.0,-48.0,-88.0,-89.0,-86.0,-88.0,34.0,42.0,44.0,39.0,1
760,CC:2F:71:3F:1F:24,4804278,1558810208,963574,1074413563,3840704,484396645,108,793952,867148227,793185,867055679,767,92548,766499,15,963761,100807,105,586,130000.0,43333.0,-68.0,-69.0,-64.0,-68.0,-68.0,-69.0,-64.0,-67.0,-88.0,-89.0,-86.0,-88.0,20.0,20.0,22.0,20.0,1
761,CC:2F:71:3E:C5:1F,3841629,484509582,925,112937,3840704,484396645,0,3864,324523,3187,244107,677,80416,980,11,1330,25,0,48,130000.0,39000.0,-67.0,-66.0,-63.0,-60.0,-69.0,-70.0,-67.0,-60.0,-88.0,-89.0,-86.0,-88.0,21.0,23.0,23.0,28.0,1
762,BA:8C:B9:54:50:24,3845579,490583764,4875,6187119,3840704,484396645,0,9275,1718677,9253,1715182,22,3495,2351,17,5344,41,0,63,229410.0,130000.0,-48.0,-35.0,-43.0,-45.0,-45.0,-34.0,-43.0,-46.0,-88.0,-89.0,-86.0,-88.0,40.0,54.0,43.0,43.0,1
763,62:47:05:9D:EB:15,3842808,486816624,2104,2419979,3840704,484396645,0,4232,3005719,4201,3000738,31,4981,2045,0,2149,53,0,105,216660.0,130000.0,-46.0,-46.0,-39.0,-46.0,-45.0,-46.0,-39.0,-47.0,-88.0,-89.0,-86.0,-88.0,42.0,43.0,47.0,42.0,1
764,3C:55:76:E8:8F:1F,3909879,657088871,69173,172692024,3840706,484396847,30,33787,6986298,33312,6904910,475,81388,14267,38,69244,7093,30,442,206470.0,1000.0,-49.0,-59.0,-43.0,-44.0,-48.0,-58.0,-43.0,-43.0,-88.0,-89.0,-86.0,-88.0,39.0,30.0,43.0,44.0,1
765,92:69:1D:31:68:E9,3844675,488027965,3969,3631118,3840706,484396847,0,5030,1124799,4874,1089471,156,35328,2147,11,4198,91,0,55,216660.0,130000.0,-54.0,-47.0,-42.0,-49.0,-52.0,-47.0,-43.0,-48.0,-88.0,-89.0,-86.0,-88.0,34.0,42.0,44.0,39.0,1
766,CC:2F:71:3F:1F:24,4804490,1559073486,963784,1074676639,3840706,484396847,108,794147,867407793,793380,867315245,767,92548,766687,15,963972,100812,105,586,130000.0,43333.0,-68.0,-70.0,-65.0,-69.0,-68.0,-69.0,-64.0,-67.0,-88.0,-89.0,-86.0,-88.0,20.0,19.0,21.0,19.0,1
767,CC:2F:71:3E:C5:1F,3841631,484509784,925,112937,3840706,484396847,0,3864,324523,3187,244107,677,80416,980,11,1330,25,0,48,130000.0,39000.0,-67.0,-66.0,-63.0,-60.0,-69.0,-70.0,-67.0,-60.0,-88.0,-89.0,-86.0,-88.0,21.0,23.0,23.0,28.0,1
768,BA:8C:B9:54:50:24,3845583,490584168,4875,6187119,3840708,484397049,0,9275,1718677,9253,1715182,22,3495,2351,17,5344,41,0,63,229410.0,130000.0,-48.0,-35.0,-43.0,-45.0,-45.0,-34.0,-43.0,-46.0,-88.0,-89.0,-86.0,-88.0,40.0,54.0,43.0,43.0,1
769,62:47:05:9D:EB:15,3842816,486817432,2104,2419979,3840712,484397453,0,4232,3005719,4201,3000738,31,4981,2045,0,2149,53,0,105,216660.0,130000.0,-46.0,-46.0,-39.0,-46.0,-45.0,-46.0,-39.0,-47.0,-88.0,-89.0,-86.0,-88.0,42.0,43.0,47.0,42.0,1
770,3C:55:76:E8:8F:1F,3909885,657089477,69173,172692024,3840712,484397453,30,33787,6986298,33312,6904910,475,81388,14267,38,69244,7093,30,442,206470.0,1000.0,-49.0,-59.0,-43.0,-44.0,-48.0,-58.0,-43.0,-43.0,-88.0,-89.0,-86.0,-88.0,39.0,30.0,43.0,44.0,1
771,92:69:1D:31:68:E9,3844681,488028571,3969,3631118,3840712,484397453,0,5030,1124799,4874,1089471,156,35328,2147,11,4198,91,0,55,216660.0,130000.0,-54.0,-47.0,-42.0,-49.0,-52.0,-47.0,-43.0,-48.0,-88.0,-89.0,-86.0,-88.0,34.0,42.0,44.0,39.0,1
772,CC:2F:71:3F:1F:24,4804711,1559340379,963999,1074942926,3840712,484397453,108,794341,867654821,793574,867562273,767,92548,766881,15,964187,100826,105,586,130000.0,43333.0,-70.0,-69.0,-65.0,-68.0,-69.0,-69.0,-64.0,-67.0,-88.0,-89.0,-86.0,-88.0,18.0,20.0,21.0,20.0,1
773,CC:2F:71:3E:C5:1F,3841637,484510390,925,112937,3840712,484397453,0,3864,324523,3187,244107,677,80416,980,11,1330,25,0,48,130000.0,39000.0,-67.0,-66.0,-63.0,-60.0,-69.0,-70.0,-67.0,-60.0,-88.0,-89.0,-86.0,-88.0,21.0,23.0,23.0,28.0,1
774,BA:8C:B9:54:50:24,3845588,490584634,4875,6187119,3840713,484397515,0,9275,1718677,9253,1715182,22,3495,2351,17,5344,41,0,63,229410.0,130000.0,-48.0,-35.0,-43.0,-45.0,-45.0,-34.0,-43.0,-46.0,-88.0,-89.0,-86.0,-88.0,40.0,54.0,43.0,43.0,1
775,62:47:05:9D:EB:15,3842820,486817756,2104,2419979,3840716,484397777,0,4232,3005719,4201,3000738,31,4981,2045,0,2149,53,0,105,216660.0,130000.0,-46.0,-46.0,-39.0,-46.0,-45.0,-46.0,-39.0,-47.0,-88.0,-89.0,-86.0,-88.0,42.0,43.0,47.0,42.0,1
776,3C:55:76:E8:8F:1F,3909892,657090177,69174,172692198,3840718,484397979,30,33804,6987638,33328,6906132,476,81506,14270,38,69245,7093,30,443,206470.0,1000.0,-49.0,-60.0,-44.0,-43.0,-47.0,-59.0,-44.0,-42.0,-88.0,-89.0,-86.0,-88.0,39.0,29.0,42.0,45.0,1
777,92:69:1D:31:68:E9,3844687,488029097,3969,3631118,3840718,484397979,0,5030,1124799,4874,1089471,156,35328,2147,11,4198,91,0,55,216660.0,130000.0,-54.0,-47.0,-42.0,-49.0,-52.0,-47.0,-43.0,-48.0,-88.0,-89.0,-86.0,-88.0,34.0,42.0,44.0,39.0,1
778,CC:2F:71:3F:1F:24,4804930,1559607429,964212,1075209450,3840718,484397979,108,794531,867903731,793764,867811183,767,92548,767071,15,964400,100828,105,586,130000.0,43333.0,-70.0,-68.0,-65.0,-66.0,-68.0,-69.0,-64.0,-67.0,-88.0,-89.0,-86.0,-88.0,18.0,21.0,21.0,22.0,1
779,CC:2F:71:3E:C5:1F,3841643,484510916,925,112937,3840718,484397979,0,3864,324523,3187,244107,677,80416,980,11,1330,25,0,48,130000.0,39000.0,-67.0,-66.0,-63.0,-60.0,-69.0,-70.0,-67.0,-60.0,-88.0,-89.0,-86.0,-88.0,21.0,23.0,23.0,28.0,1
780,BA:8C:B9:54:50:24,3845593,490585098,4875,6187119,3840718,484397979,0,9275,1718677,9253,1715182,22,3495,2351,17,5344,41,0,63,229410.0,130000.0,-48.0,-35.0,-43.0,-45.0,-45.0,-34.0,-43.0,-46.0,-88.0,-89.0,-86.0,-88.0,40.0,54.0,43.0,43.0,1
781,62:47:05:9D:EB:15,3842826,486818362,2104,2419979,3840722,484398383,0,4232,3005719,4201,3000738,31,4981,2045,0,2149,53,0,105,216660.0,130000.0,-46.0,-46.0,-39.0,-46.0,-45.0,-46.0,-39.0,-47.0,-88.0,-89.0,-86.0,-88.0,42.0,43.0,47.0,42.0,1
782,3C:55:76:E8:8F:1F,3909896,657090581,69174,172692198,3840722,484398383,30,33804,6987638,33328,6906132,476,81506,14270,38,69245,7093,30,443,206470.0,1000.0,-49.0,-60.0,-44.0,-43.0,-47.0,-59.0,-44.0,-42.0,-88.0,-89.0,-86.0,-88.0,39.0,29.0,42.0,45.0,1
783,92:69:1D:31:68:E9,3844691,488029501,3969,3631118,3840722,484398383,0,5030,1124799,4874,1089471,156,35328,2147,11,4198,91,0,55,216660.0,130000.0,-54.0,-47.0,-42.0,-49.0,-52.0,-47.0,-43.0,-48.0,-88.0,-89.0,-86.0,-88.0,34.0,42.0,44.0,39.0,1
784,CC:2F:71:3F:1F:24,4805145,1559871039,964423,1075472656,3840722,484398383,108,794717,868146491,793950,868053943,767,92548,767257,15,964611,100842,105,586,130000.0,43333.0,-68.0,-69.0,-64.0,-68.0,-68.0,-69.0,-64.0,-67.0,-88.0,-89.0,-86.0,-88.0,20.0,20.0,22.0,20.0,1
785,CC:2F:71:3E:C5:1F,3841647,484511320,925,112937,3840722,484398383,0,3864,324523,3187,244107,677,80416,980,11,1330,25,0,48,130000.0,39000.0,-67.0,-66.0,-63.0,-60.0,-69.0,-70.0,-67.0,-60.0,-88.0,-89.0,-86.0,-88.0,21.0,23.0,23.0,28.0,1
786,BA:8C:B9:54:50:24,3845597,490585502,4875,6187119,3840722,484398383,0,9275,1718677,9253,1715182,22,3495,2351,17,5344,41,0,63,229410.0,130000.0,-48.0,-35.0,-43.0,-45.0,-45.0,-34.0,-43.0,-46.0,-88.0,-89.0,-86.0,-88.0,40.0,54.0,43.0,43.0,1
787,62:47:05:9D:EB:15,3842831,486818826,2104,2419979,3840727,484398847,0,4232,3005719,4201,3000738,31,4981,2045,0,2149,53,0,105,216660.0,130000.0,-46.0,-46.0,-39.0,-46.0,-45.0,-46.0,-39.0,-47.0,-88.0,-89.0,-86.0,-88.0,42.0,43.0,47.0,42.0,1
788,3C:55:76:E8:8F:1F,3909901,657091045,69174,172692198,3840727,484398847,30,33804,6987638,33328,6906132,476,81506,14270,38,69245,7093,30,443,206470.0,1000.0,-49.0,-60.0,-44.0,-43.0,-47.0,-59.0,-44.0,-42.0,-88.0,-89.0,-86.0,-88.0,39.0,29.0,42.0,45.0,1
789,92:69:1D:31:68:E9,3844696,488029965,3969,3631118,3840727,484398847,0,5030,1124799,4874,1089471,156,35328,2147,11,4198,91,0,55,216660.0,130000.0,-54.0,-47.0,-42.0,-49.0,-52.0,-47.0,-43.0,-48.0,-88.0,-89.0,-86.0,-88.0,34.0,42.0,44.0,39.0,1
790,CC:2F:71:3F:1F:24,4805360,1560132873,964631,1075733824,3840729,484399049,108,794903,868393565,794136,868301017,767,92548,767442,15,964819,100860,105,586,130000.0,43333.0,-70.0,-72.0,-66.0,-71.0,-70.0,-72.0,-65.0,-70.0,-88.0,-89.0,-86.0,-88.0,18.0,17.0,20.0,17.0,1
791,CC:2F:71:3E:C5:1F,3841654,484511986,925,112937,3840729,484399049,0,3864,324523,3187,244107,677,80416,980,11,1330,25,0,48,130000.0,39000.0,-67.0,-66.0,-63.0,-60.0,-69.0,-70.0,-67.0,-60.0,-88.0,-89.0,-86.0,-88.0,21.0,23.0,23.0,28.0,1
792,BA:8C:B9:54:50:24,3845606,490586370,4875,6187119,3840731,484399251,0,9275,1718677,9253,1715182,22,3495,2351,17,5344,41,0,63,229410.0,130000.0,-48.0,-35.0,-43.0,-45.0,-45.0,-34.0,-43.0,-46.0,-88.0,-89.0,-86.0,-88.0,40.0,54.0,43.0,43.0,1
793,62:47:05:9D:EB:15,3842836,486819292,2104,2419979,3840732,484399313,0,4232,3005719,4201,3000738,31,4981,2045,0,2149,53,0,105,216660.0,130000.0,-46.0,-46.0,-39.0,-46.0,-45.0,-46.0,-39.0,-47.0,-88.0,-90.0,-86.0,-89.0,42.0,44.0,47.0,43.0,1
794,3C:55:76:E8:8F:1F,3909909,657092801,69175,172692364,3840734,484400437,30,33820,6988913,33343,6907289,477,81624,14273,38,69246,7093,30,443,206470.0,97500.0,-50.0,-50.0,-43.0,-44.0,-49.0,-50.0,-43.0,-42.0,-88.0,-90.0,-86.0,-89.0,38.0,40.0,43.0,45.0,1
795,92:69:1D:31:68:E9,3844703,488031555,3969,3631118,3840734,484400437,0,5032,1124935,4876,1089607,156,35328,2147,11,4199,91,0,55,216660.0,130000.0,-53.0,-47.0,-42.0,-48.0,-52.0,-47.0,-43.0,-48.0,-88.0,-90.0,-86.0,-89.0,35.0,43.0,44.0,41.0,1
796,CC:2F:71:3F:1F:24,4805595,1560420688,964859,1076020049,3840736,484400639,108,795115,868662796,794348,868570248,767,92548,767654,15,965047,100916,105,587,86667.0,14444.0,-70.0,-70.0,-66.0,-72.0,-70.0,-70.0,-66.0,-72.0,-88.0,-90.0,-86.0,-89.0,18.0,20.0,20.0,17.0,1
797,CC:2F:71:3E:C5:1F,3841661,484513576,925,112937,3840736,484400639,0,3866,324663,3189,244247,677,80416,980,11,1331,25,0,48,130000.0,39000.0,-72.0,-72.0,-68.0,-61.0,-70.0,-70.0,-67.0,-60.0,-88.0,-90.0,-86.0,-89.0,16.0,18.0,18.0,28.0,1
798,BA:8C:B9:54:50:24,3845611,490587758,4875,6187119,3840736,484400639,0,9277,1718813,9255,1715318,22,3495,2351,17,5345,41,0,63,229410.0,130000.0,-40.0,-37.0,-46.0,-52.0,-44.0,-35.0,-43.0,-47.0,-88.0,-90.0,-86.0,-89.0,48.0,53.0,40.0,37.0,1
799,62:47:05:9D:EB:15,3842847,486821286,2104,2419979,3840743,484401307,0,4234,3005855,4203,3000874,31,4981,2045,0,2150,53,0,105,216660.0,130000.0,-46.0,-45.0,-39.0,-47.0,-45.0,-46.0,-38.0,-47.0,-89.0,-90.0,-87.0,-90.0,43.0,45.0,48.0,43.0,1
800,3C:55:76:E8:8F:1F,3909919,657093731,69175,172692364,3840744,484401367,30,33825,6989255,33348,6907631,477,81624,14273,38,69246,7093,30,444,206470.0,97500.0,-50.0,-60.0,-43.0,-46.0,-49.0,-52.0,-43.0,-43.0,-89.0,-90.0,-87.0,-90.0,39.0,30.0,44.0,44.0,1
801,92:69:1D:31:68:E9,3844713,488032485,3969,3631118,3840744,484401367,0,5032,1124935,4876,1089607,156,35328,2147,11,4199,91,0,55,216660.0,130000.0,-53.0,-47.0,-42.0,-48.0,-52.0,-47.0,-43.0,-48.0,-89.0,-90.0,-87.0,-90.0,36.0,43.0,45.0,42.0,1
802,CC:2F:71:3F:1F:24,4805813,1560685356,965069,1076283989,3840744,484401367,108,795300,868908288,794533,868815740,767,92548,767839,15,965257,100917,105,587,86667.0,14444.0,-68.0,-70.0,-66.0,-71.0,-68.0,-70.0,-66.0,-71.0,-89.0,-90.0,-87.0,-90.0,21.0,20.0,21.0,19.0,1
803,CC:2F:71:3E:C5:1F,3841669,484514304,925,112937,3840744,484401367,0,3868,324851,3190,244317,678,80534,981,11,1331,25,0,48,130000.0,39000.0,-71.0,-71.0,-69.0,-60.0,-70.0,-70.0,-67.0,-60.0,-89.0,-90.0,-87.0,-90.0,18.0,19.0,18.0,30.0,1
804,BA:8C:B9:54:50:24,3845619,490588486,4875,6187119,3840744,484401367,0,9277,1718813,9255,1715318,22,3495,2351,17,5345,41,0,63,229410.0,130000.0,-40.0,-37.0,-46.0,-52.0,-44.0,-35.0,-43.0,-47.0,-89.0,-90.0,-87.0,-90.0,49.0,53.0,41.0,38.0,1
805,62:47:05:9D:EB:15,3842852,486822672,2104,2419979,3840748,484402693,0,4234,3005855,4203,3000874,31,4981,2045,0,2150,53,0,105,216660.0,130000.0,-46.0,-45.0,-39.0,-47.0,-45.0,-46.0,-38.0,-47.0,-89.0,-91.0,-87.0,-90.0,43.0,46.0,48.0,43.0,1
806,3C:55:76:E8:8F:1F,3909924,657095131,69176,172692438,3840748,484402693,30,33834,6989908,33357,6908284,477,81624,14274,39,69248,7096,30,445,195000.0,97500.0,-46.0,-53.0,-45.0,-41.0,-45.0,-52.0,-44.0,-40.0,-89.0,-91.0,-87.0,-90.0,43.0,38.0,42.0,49.0,1
807,92:69:1D:31:68:E9,3844730,488042010,3982,3639317,3840748,484402693,0,5053,1128619,4897,1093291,156,35328,2163,11,4212,92,0,55,229410.0,130000.0,-51.0,-47.0,-44.0,-46.0,-51.0,-49.0,-45.0,-49.0,-89.0,-91.0,-87.0,-90.0,38.0,44.0,43.0,44.0,1
808,CC:2F:71:3F:1F:24,4806029,1560950826,965281,1076548133,3840748,484402693,108,795487,869156860,794720,869064312,767,92548,768026,15,965469,100925,105,587,115556.0,28889.0,-67.0,-71.0,-67.0,-72.0,-67.0,-71.0,-67.0,-71.0,-89.0,-91.0,-87.0,-90.0,22.0,20.0,20.0,18.0,1
809,CC:2F:71:3E:C5:1F,3841675,484515832,925,112937,3840750,484402895,0,3868,324851,3190,244317,678,80534,981,11,1331,25,0,48,130000.0,39000.0,-71.0,-71.0,-69.0,-60.0,-70.0,-70.0,-67.0,-60.0,-89.0,-91.0,-87.0,-90.0,18.0,20.0,18.0,30.0,1
810,BA:8C:B9:54:50:24,3845625,490590014,4875,6187119,3840750,484402895,0,9277,1718813,9255,1715318,22,3495,2351,17,5345,41,0,63,229410.0,130000.0,-40.0,-37.0,-46.0,-52.0,-44.0,-35.0,-43.0,-47.0,-89.0,-91.0,-87.0,-90.0,49.0,54.0,41.0,38.0,1
811,62:47:05:9D:EB:15,3842858,486823278,2104,2419979,3840754,484403299,0,4234,3005855,4203,3000874,31,4981,2045,0,2150,53,0,105,216660.0,130000.0,-46.0,-45.0,-39.0,-47.0,-45.0,-46.0,-38.0,-47.0,-89.0,-91.0,-88.0,-91.0,43.0,46.0,49.0,44.0,1
812,3C:55:76:E8:8F:1F,3909930,657095737,69176,172692438,3840754,484403299,30,33834,6989908,33357,6908284,477,81624,14274,39,69248,7096,30,445,195000.0,97500.0,-46.0,-53.0,-45.0,-41.0,-45.0,-52.0,-44.0,-40.0,-89.0,-91.0,-88.0,-91.0,43.0,38.0,43.0,50.0,1
813,92:69:1D:31:68:E9,3844736,488042616,3982,3639317,3840754,484403299,0,5053,1128619,4897,1093291,156,35328,2163,11,4212,92,0,55,229410.0,130000.0,-51.0,-47.0,-44.0,-46.0,-51.0,-49.0,-45.0,-49.0,-89.0,-91.0,-88.0,-91.0,38.0,44.0,44.0,45.0,1
814,CC:2F:71:3F:1F:24,4806250,1561217422,965496,1076814123,3840754,484403299,108,795679,869403655,794912,869311107,767,92548,768218,15,965683,100925,105,587,115556.0,28889.0,-68.0,-70.0,-67.0,-71.0,-68.0,-70.0,-66.0,-71.0,-89.0,-91.0,-88.0,-91.0,21.0,21.0,21.0,20.0,1
815,CC:2F:71:3E:C5:1F,3841679,484516236,925,112937,3840754,484403299,0,3868,324851,3190,244317,678,80534,981,11,1331,25,0,48,130000.0,39000.0,-71.0,-71.0,-69.0,-60.0,-70.0,-70.0,-67.0,-60.0,-89.0,-91.0,-88.0,-91.0,18.0,20.0,19.0,31.0,1
816,BA:8C:B9:54:50:24,3845630,490590478,4875,6187119,3840755,484403359,0,9277,1718813,9255,1715318,22,3495,2351,17,5345,41,0,63,229410.0,130000.0,-40.0,-37.0,-46.0,-52.0,-44.0,-35.0,-43.0,-47.0,-89.0,-91.0,-88.0,-91.0,49.0,54.0,42.0,39.0,1
817,62:47:05:9D:EB:15,3842866,486825139,2104,2419979,3840762,484405160,0,4234,3005855,4203,3000874,31,4981,2045,0,2150,53,0,105,216660.0,130000.0,-46.0,-45.0,-39.0,-47.0,-45.0,-46.0,-38.0,-47.0,-89.0,-91.0,-88.0,-91.0,43.0,46.0,49.0,44.0,1
818,3C:55:76:E8:8F:1F,3909938,657097598,69176,172692438,3840762,484405160,30,33834,6989908,33357,6908284,477,81624,14274,39,69248,7096,30,445,195000.0,97500.0,-46.0,-53.0,-45.0,-41.0,-45.0,-52.0,-44.0,-40.0,-89.0,-91.0,-88.0,-91.0,43.0,38.0,43.0,50.0,1
819,92:69:1D:31:68:E9,3844744,488044477,3982,3639317,3840762,484405160,0,5053,1128619,4897,1093291,156,35328,2163,11,4212,92,0,55,229410.0,130000.0,-51.0,-47.0,-44.0,-46.0,-51.0,-49.0,-45.0,-49.0,-89.0,-90.0,-87.0,-90.0,38.0,43.0,43.0,44.0,1
820,CC:2F:71:3F:1F:24,4806478,1561492838,965716,1077087678,3840762,484405160,108,795876,869659097,795109,869566549,767,92548,768414,15,965904,100925,105,587,130000.0,39000.0,-69.0,-71.0,-67.0,-72.0,-69.0,-71.0,-67.0,-72.0,-89.0,-90.0,-87.0,-90.0,20.0,19.0,20.0,18.0,1
821,CC:2F:71:3E:C5:1F,3841687,484518097,925,112937,3840762,484405160,0,3868,324851,3190,244317,678,80534,981,11,1331,25,0,48,130000.0,39000.0,-71.0,-71.0,-69.0,-60.0,-70.0,-70.0,-67.0,-60.0,-89.0,-90.0,-87.0,-90.0,18.0,19.0,18.0,30.0,1
822,BA:8C:B9:54:50:24,3845637,490592279,4875,6187119,3840762,484405160,0,9277,1718813,9255,1715318,22,3495,2351,17,5345,41,0,63,229410.0,130000.0,-40.0,-37.0,-46.0,-52.0,-44.0,-35.0,-43.0,-47.0,-89.0,-90.0,-87.0,-90.0,49.0,53.0,41.0,38.0,1
823,62:47:05:9D:EB:15,3842870,486825543,2104,2419979,3840766,484405564,0,4234,3005855,4203,3000874,31,4981,2045,0,2150,53,0,105,216660.0,130000.0,-46.0,-45.0,-39.0,-47.0,-45.0,-46.0,-38.0,-47.0,-89.0,-90.0,-87.0,-90.0,43.0,45.0,48.0,43.0,1
824,3C:55:76:E8:8F:1F,3909943,657098076,69177,172692512,3840766,484405564,30,33841,6990425,33364,6908801,477,81624,14275,39,69249,7096,30,445,195000.0,97500.0,-44.0,-54.0,-44.0,-40.0,-43.0,-52.0,-43.0,-39.0,-89.0,-90.0,-87.0,-90.0,45.0,36.0,43.0,50.0,1
825,92:69:1D:31:68:E9,3844748,488044881,3982,3639317,3840766,484405564,0,5053,1128619,4897,1093291,156,35328,2163,11,4212,92,0,55,229410.0,130000.0,-51.0,-47.0,-44.0,-46.0,-51.0,-49.0,-45.0,-49.0,-89.0,-90.0,-87.0,-90.0,38.0,43.0,43.0,44.0,1
826,CC:2F:71:3F:1F:24,4806696,1561760774,965930,1077355210,3840766,484405564,108,796071,869909929,795304,869817381,767,92548,768607,15,966117,100947,105,587,115556.0,28889.0,-69.0,-72.0,-68.0,-73.0,-69.0,-72.0,-67.0,-72.0,-89.0,-90.0,-87.0,-90.0,20.0,18.0,19.0,17.0,1
827,CC:2F:71:3E:C5:1F,3841691,484518501,925,112937,3840766,484405564,0,3868,324851,3190,244317,678,80534,981,11,1331,25,0,48,130000.0,39000.0,-71.0,-71.0,-69.0,-60.0,-70.0,-70.0,-67.0,-60.0,-89.0,-90.0,-87.0,-90.0,18.0,19.0,18.0,30.0,1
828,BA:8C:B9:54:50:24,3845643,490592885,4875,6187119,3840768,484405766,0,9277,1718813,9255,1715318,22,3495,2351,17,5345,41,0,63,229410.0,130000.0,-40.0,-37.0,-46.0,-52.0,-44.0,-35.0,-43.0,-47.0,-89.0,-90.0,-87.0,-90.0,49.0,53.0,41.0,38.0,1
829,62:47:05:9D:EB:15,3842875,486826007,2104,2419979,3840771,484406028,0,4234,3005855,4203,3000874,31,4981,2045,0,2150,53,0,105,216660.0,130000.0,-46.0,-45.0,-39.0,-47.0,-45.0,-46.0,-38.0,-47.0,-89.0,-90.0,-87.0,-90.0,43.0,45.0,48.0,43.0,1
830,3C:55:76:E8:8F:1F,3909960,657105102,69189,172699074,3840771,484406028,30,33876,6998622,33399,6916998,477,81624,14290,39,69261,7096,30,445,206470.0,97500.0,-45.0,-55.0,-44.0,-40.0,-44.0,-54.0,-43.0,-40.0,-89.0,-90.0,-87.0,-90.0,44.0,35.0,43.0,50.0,1
831,92:69:1D:31:68:E9,3844753,488045345,3982,3639317,3840771,484406028,0,5053,1128619,4897,1093291,156,35328,2163,11,4212,92,0,55,229410.0,130000.0,-51.0,-47.0,-44.0,-46.0,-51.0,-49.0,-45.0,-49.0,-89.0,-90.0,-87.0,-90.0,38.0,43.0,43.0,44.0,1
832,CC:2F:71:3F:1F:24,4806922,1562035878,966149,1077629648,3840773,484406230,108,796265,870166531,795498,870073983,767,92548,768801,15,966337,100955,105,587,115556.0,28889.0,-69.0,-71.0,-67.0,-73.0,-68.0,-71.0,-67.0,-73.0,-89.0,-90.0,-87.0,-90.0,20.0,19.0,20.0,17.0,1
833,CC:2F:71:3E:C5:1F,3841700,484519369,925,112937,3840775,484406432,0,3868,324851,3190,244317,678,80534,981,11,1331,25,0,48,130000.0,39000.0,-71.0,-71.0,-69.0,-60.0,-70.0,-70.0,-67.0,-60.0,-89.0,-90.0,-87.0,-90.0,18.0,19.0,18.0,30.0,1
834,BA:8C:B9:54:50:24,3845650,490593551,4875,6187119,3840775,484406432,0,9277,1718813,9255,1715318,22,3495,2351,17,5345,41,0,63,229410.0,130000.0,-40.0,-37.0,-46.0,-52.0,-44.0,-35.0,-43.0,-47.0,-89.0,-90.0,-87.0,-90.0,49.0,53.0,41.0,38.0,1
835,62:47:05:9D:EB:15,3842879,486826411,2104,2419979,3840775,484406432,0,4234,3005855,4203,3000874,31,4981,2045,0,2150,53,0,105,216660.0,130000.0,-46.0,-45.0,-39.0,-47.0,-45.0,-46.0,-38.0,-47.0,-89.0,-90.0,-87.0,-90.0,43.0,45.0,48.0,43.0,1
836,3C:55:76:E8:8F:1F,3909967,657105860,69190,172699226,3840777,484406634,30,33879,6998917,33402,6917293,477,81624,14291,39,69262,7097,30,445,206470.0,97500.0,-45.0,-58.0,-47.0,-40.0,-44.0,-55.0,-44.0,-40.0,-89.0,-90.0,-87.0,-90.0,44.0,32.0,40.0,50.0,1
837,92:69:1D:31:68:E9,3844759,488045951,3982,3639317,3840777,484406634,0,5053,1128619,4897,1093291,156,35328,2163,11,4212,92,0,55,229410.0,130000.0,-51.0,-47.0,-44.0,-46.0,-51.0,-49.0,-45.0,-49.0,-89.0,-90.0,-87.0,-90.0,38.0,43.0,43.0,44.0,1
838,CC:2F:71:3F:1F:24,4807147,1562308879,966370,1077902245,3840777,484406634,108,796464,870422766,795697,870330218,767,92548,768999,15,966558,100979,105,588,130000.0,43333.0,-68.0,-71.0,-67.0,-72.0,-68.0,-70.0,-67.0,-72.0,-89.0,-90.0,-87.0,-90.0,21.0,19.0,20.0,18.0,1
839,CC:2F:71:3E:C5:1F,3841702,484519571,925,112937,3840777,484406634,0,3868,324851,3190,244317,678,80534,981,11,1331,25,0,48,130000.0,39000.0,-71.0,-71.0,-69.0,-60.0,-70.0,-70.0,-67.0,-60.0,-89.0,-90.0,-87.0,-90.0,18.0,19.0,18.0,30.0,1
840,BA:8C:B9:54:50:24,3845652,490593753,4875,6187119,3840777,484406634,0,9277,1718813,9255,1715318,22,3495,2351,17,5345,41,0,63,229410.0,130000.0,-40.0,-37.0,-46.0,-52.0,-44.0,-35.0,-43.0,-47.0,-89.0,-90.0,-87.0,-90.0,49.0,53.0,41.0,38.0,1
841,62:47:05:9D:EB:15,3842886,486827077,2104,2419979,3840782,484407098,0,4234,3005855,4203,3000874,31,4981,2045,0,2150,53,0,105,216660.0,130000.0,-46.0,-45.0,-39.0,-47.0,-45.0,-46.0,-38.0,-47.0,-89.0,-90.0,-87.0,-90.0,43.0,45.0,48.0,43.0,1
842,3C:55:76:E8:8F:1F,3909975,657106650,69191,172699350,3840784,484407300,30,33892,6999931,33415,6918307,477,81624,14293,39,69263,7097,30,445,206470.0,103230.0,-46.0,-54.0,-44.0,-40.0,-45.0,-55.0,-43.0,-40.0,-89.0,-90.0,-87.0,-90.0,43.0,36.0,43.0,50.0,1
843,92:69:1D:31:68:E9,3844767,488046733,3983,3639433,3840784,484407300,0,5056,1128865,4900,1093537,156,35328,2164,11,4213,92,0,55,229410.0,130000.0,-53.0,-47.0,-42.0,-48.0,-52.0,-48.0,-44.0,-48.0,-89.0,-90.0,-87.0,-90.0,36.0,43.0,45.0,42.0,1
844,CC:2F:71:3F:1F:24,4807362,1562572249,966578,1078164949,3840784,484407300,108,796650,870668416,795883,870575868,767,92548,769185,15,966766,101014,105,588,115556.0,28889.0,-69.0,-72.0,-67.0,-72.0,-69.0,-71.0,-66.0,-72.0,-89.0,-90.0,-87.0,-90.0,20.0,18.0,20.0,18.0,1
845,CC:2F:71:3E:C5:1F,3841709,484520237,925,112937,3840784,484407300,0,3868,324851,3190,244317,678,80534,981,11,1331,25,0,48,130000.0,39000.0,-71.0,-71.0,-69.0,-60.0,-70.0,-70.0,-67.0,-60.0,-89.0,-90.0,-87.0,-90.0,18.0,19.0,18.0,30.0,1
846,BA:8C:B9:54:50:24,3845659,490594419,4875,6187119,3840784,484407300,0,9277,1718813,9255,1715318,22,3495,2351,17,5345,41,0,63,229410.0,130000.0,-40.0,-37.0,-46.0,-52.0,-44.0,-35.0,-43.0,-47.0,-89.0,-90.0,-87.0,-90.0,49.0,53.0,41.0,38.0,1
847,62:47:05:9D:EB:15,3842890,486827481,2104,2419979,3840786,484407502,0,4234,3005855,4203,3000874,31,4981,2045,0,2150,53,0,105,216660.0,130000.0,-46.0,-45.0,-39.0,-47.0,-45.0,-46.0,-38.0,-47.0,-89.0,-90.0,-87.0,-90.0,43.0,45.0,48.0,43.0,1
848,3C:55:76:E8:8F:1F,3909979,657107145,69193,172699643,3840786,484407502,30,33903,7000918,33426,6919294,477,81624,14297,39,69265,7097,30,445,195000.0,97500.0,-47.0,-53.0,-40.0,-42.0,-48.0,-51.0,-43.0,-42.0,-89.0,-90.0,-87.0,-90.0,42.0,37.0,47.0,48.0,1
849,92:69:1D:31:68:E9,3844769,488046935,3983,3639433,3840786,484407502,0,5056,1128865,4900,1093537,156,35328,2164,11,4213,92,0,55,229410.0,130000.0,-53.0,-47.0,-42.0,-48.0,-52.0,-48.0,-44.0,-48.0,-89.0,-90.0,-87.0,-90.0,36.0,43.0,45.0,42.0,1
850,CC:2F:71:3F:1F:24,4807573,1562834965,966787,1078427463,3840786,484407502,108,796835,870913908,796068,870821360,767,92548,769370,15,966974,101070,105,588,104000.0,26000.0,-68.0,-71.0,-66.0,-72.0,-68.0,-71.0,-66.0,-72.0,-89.0,-90.0,-87.0,-90.0,21.0,19.0,21.0,18.0,1
851,CC:2F:71:3E:C5:1F,3841711,484520439,925,112937,3840786,484407502,0,3868,324851,3190,244317,678,80534,981,11,1331,25,0,48,130000.0,39000.0,-71.0,-71.0,-69.0,-60.0,-70.0,-70.0,-67.0,-60.0,-89.0,-90.0,-87.0,-90.0,18.0,19.0,18.0,30.0,1
852,BA:8C:B9:54:50:24,3845663,490594823,4875,6187119,3840788,484407704,0,9277,1718813,9255,1715318,22,3495,2351,17,5345,41,0,63,229410.0,130000.0,-40.0,-37.0,-46.0,-52.0,-44.0,-35.0,-43.0,-47.0,-89.0,-90.0,-87.0,-90.0,49.0,53.0,41.0,38.0,1
853,62:47:05:9D:EB:15,3842897,486828213,2104,2419979,3840793,484408234,0,4234,3005855,4203,3000874,31,4981,2045,0,2150,53,0,105,216660.0,130000.0,-46.0,-45.0,-39.0,-47.0,-45.0,-46.0,-38.0,-47.0,-89.0,-90.0,-87.0,-90.0,43.0,45.0,48.0,43.0,1
854,3C:55:76:E8:8F:1F,3909986,657107877,69193,172699643,3840793,484408234,30,33906,7001124,33429,6919500,477,81624,14297,39,69265,7097,30,445,195000.0,97500.0,-44.0,-53.0,-43.0,-40.0,-45.0,-52.0,-42.0,-41.0,-89.0,-90.0,-87.0,-90.0,45.0,37.0,44.0,50.0,1
855,92:69:1D:31:68:E9,3844776,488047667,3983,3639433,3840793,484408234,0,5056,1128865,4900,1093537,156,35328,2164,11,4213,92,0,55,229410.0,130000.0,-53.0,-47.0,-42.0,-48.0,-52.0,-48.0,-44.0,-48.0,-89.0,-90.0,-87.0,-90.0,36.0,43.0,45.0,42.0,1
856,CC:2F:71:3F:1F:24,4807796,1563098189,967002,1078689895,3840794,484408294,108,797023,871154613,796256,871062065,767,92548,769558,15,967189,101078,105,588,86667.0,14444.0,-68.0,-71.0,-66.0,-72.0,-68.0,-71.0,-66.0,-72.0,-89.0,-90.0,-87.0,-90.0,21.0,19.0,21.0,18.0,1
857,CC:2F:71:3E:C5:1F,3841719,484521231,925,112937,3840794,484408294,0,3868,324851,3190,244317,678,80534,981,11,1331,25,0,48,130000.0,39000.0,-71.0,-71.0,-69.0,-60.0,-70.0,-70.0,-67.0,-60.0,-89.0,-90.0,-87.0,-90.0,18.0,19.0,18.0,30.0,1
858,BA:8C:B9:54:50:24,3845669,490595413,4875,6187119,3840794,484408294,0,9277,1718813,9255,1715318,22,3495,2351,17,5345,41,0,63,229410.0,130000.0,-40.0,-37.0,-46.0,-52.0,-44.0,-35.0,-43.0,-47.0,-89.0,-90.0,-87.0,-90.0,49.0,53.0,41.0,38.0,1
859,62:47:05:9D:EB:15,3842900,486828475,2104,2419979,3840796,484408496,0,4234,3005855,4203,3000874,31,4981,2045,0,2150,53,0,105,216660.0,130000.0,-46.0,-45.0,-39.0,-47.0,-45.0,-46.0,-38.0,-47.0,-89.0,-90.0,-87.0,-90.0,43.0,45.0,48.0,43.0,1
860,3C:55:76:E8:8F:1F,3909997,657112017,69201,172703521,3840796,484408496,30,33922,7005738,33445,6924114,477,81624,14304,39,69273,7097,30,445,195000.0,97500.0,-49.0,-58.0,-42.0,-45.0,-47.0,-56.0,-41.0,-43.0,-89.0,-90.0,-87.0,-90.0,40.0,32.0,45.0,45.0,1
861,92:69:1D:31:68:E9,3844781,488048131,3983,3639433,3840798,484408698,0,5057,1128933,4901,1093605,156,35328,2164,11,4213,92,0,55,229410.0,130000.0,-52.0,-47.0,-42.0,-48.0,-52.0,-48.0,-44.0,-48.0,-89.0,-90.0,-87.0,-90.0,37.0,43.0,45.0,42.0,1
862,CC:2F:71:3F:1F:24,4808009,1563358005,967211,1078949307,3840798,484408698,108,797208,871400095,796441,871307547,767,92548,769743,15,967399,101081,105,589,104000.0,26000.0,-68.0,-71.0,-66.0,-72.0,-68.0,-71.0,-66.0,-72.0,-89.0,-90.0,-87.0,-90.0,21.0,19.0,21.0,18.0,1
863,CC:2F:71:3E:C5:1F,3841723,484521635,925,112937,3840798,484408698,0,3868,324851,3190,244317,678,80534,981,11,1331,25,0,48,130000.0,39000.0,-71.0,-71.0,-69.0,-60.0,-70.0,-70.0,-67.0,-60.0,-89.0,-90.0,-87.0,-90.0,18.0,19.0,18.0,30.0,1
864,BA:8C:B9:54:50:24,3845673,490595817,4875,6187119,3840798,484408698,0,9277,1718813,9255,1715318,22,3495,2351,17,5345,41,0,63,229410.0,130000.0,-40.0,-37.0,-46.0,-52.0,-44.0,-35.0,-43.0,-47.0,-89.0,-90.0,-87.0,-90.0,49.0,53.0,41.0,38.0,1
865,62:47:05:9D:EB:15,3842906,486829081,2104,2419979,3840802,484409102,0,4234,3005855,4203,3000874,31,4981,2045,0,2150,53,0,105,216660.0,130000.0,-46.0,-45.0,-39.0,-47.0,-45.0,-46.0,-38.0,-47.0,-89.0,-90.0,-87.0,-90.0,43.0,45.0,48.0,43.0,1
866,3C:55:76:E8:8F:1F,3910010,657113561,69208,172704459,3840802,484409102,30,33946,7009331,33469,6927707,477,81624,14311,39,69280,7097,30,445,195000.0,97500.0,-43.0,-54.0,-43.0,-40.0,-43.0,-54.0,-43.0,-39.0,-89.0,-90.0,-87.0,-90.0,46.0,36.0,44.0,50.0,1
867,92:69:1D:31:68:E9,3844785,488048535,3983,3639433,3840802,484409102,0,5057,1128933,4901,1093605,156,35328,2164,11,4213,92,0,55,229410.0,130000.0,-52.0,-47.0,-42.0,-48.0,-52.0,-48.0,-44.0,-48.0,-89.0,-90.0,-87.0,-90.0,37.0,43.0,45.0,42.0,1
868,CC:2F:71:3F:1F:24,4808222,1563623363,967420,1079214261,3840802,484409102,108,797393,871645797,796626,871553249,767,92548,769928,15,967607,101127,105,589,86667.0,14444.0,-68.0,-71.0,-66.0,-72.0,-68.0,-71.0,-66.0,-72.0,-89.0,-90.0,-87.0,-90.0,21.0,19.0,21.0,18.0,1
869,CC:2F:71:3E:C5:1F,3841727,484522039,925,112937,3840802,484409102,0,3868,324851,3190,244317,678,80534,981,11,1331,25,0,48,130000.0,39000.0,-71.0,-71.0,-69.0,-60.0,-70.0,-70.0,-67.0,-60.0,-89.0,-90.0,-87.0,-90.0,18.0,19.0,18.0,30.0,1
870,BA:8C:B9:54:50:24,3845679,490596423,4875,6187119,3840804,484409304,0,9277,1718813,9255,1715318,22,3495,2351,17,5345,41,0,63,229410.0,130000.0,-40.0,-37.0,-46.0,-52.0,-44.0,-35.0,-43.0,-47.0,-89.0,-90.0,-87.0,-90.0,49.0,53.0,41.0,38.0,1
871,62:47:05:9D:EB:15,3842911,486829545,2104,2419979,3840807,484409566,0,4234,3005855,4203,3000874,31,4981,2045,0,2150,53,0,105,216660.0,130000.0,-46.0,-45.0,-39.0,-47.0,-45.0,-46.0,-38.0,-47.0,-89.0,-90.0,-87.0,-90.0,43.0,45.0,48.0,43.0,1
872,3C:55:76:E8:8F:1F,3910015,657114025,69208,172704459,3840807,484409566,30,33947,7009401,33470,6927777,477,81624,14311,39,69280,7097,30,445,195000.0,97500.0,-44.0,-55.0,-44.0,-40.0,-43.0,-54.0,-43.0,-39.0,-89.0,-90.0,-87.0,-90.0,45.0,35.0,43.0,50.0,1
873,92:69:1D:31:68:E9,3844790,488048999,3983,3639433,3840807,484409566,0,5057,1128933,4901,1093605,156,35328,2164,11,4213,92,0,55,229410.0,130000.0,-52.0,-47.0,-42.0,-48.0,-52.0,-48.0,-44.0,-48.0,-89.0,-90.0,-87.0,-90.0,37.0,43.0,45.0,42.0,1
874,CC:2F:71:3F:1F:24,4808435,1563884659,967628,1079475093,3840807,484409566,108,797580,871892959,796813,871800411,767,92548,770114,15,967816,101129,105,589,86667.0,14444.0,-68.0,-71.0,-66.0,-72.0,-68.0,-71.0,-66.0,-72.0,-89.0,-90.0,-87.0,-90.0,21.0,19.0,21.0,18.0,1
875,CC:2F:71:3E:C5:1F,3841733,484522563,926,112997,3840807,484409566,0,3869,324921,3191,244387,678,80534,981,11,1332,25,0,48,130000.0,39000.0,-71.0,-71.0,-68.0,-60.0,-70.0,-70.0,-67.0,-60.0,-89.0,-90.0,-87.0,-90.0,18.0,19.0,19.0,30.0,1
876,BA:8C:B9:54:50:24,3845685,490597003,4876,6187235,3840809,484409768,0,9281,1719085,9259,1715590,22,3495,2351,17,5346,41,0,63,229410.0,130000.0,-48.0,-35.0,-43.0,-45.0,-44.0,-35.0,-43.0,-47.0,-88.0,-89.0,-87.0,-89.0,40.0,54.0,44.0,44.0,1
877,62:47:05:9D:EB:15,3842916,486830009,2105,2420039,3840811,484409970,0,4236,3005991,4205,3001010,31,4981,2045,0,2151,53,0,105,216660.0,130000.0,-47.0,-45.0,-39.0,-48.0,-46.0,-45.0,-38.0,-47.0,-88.0,-89.0,-87.0,-89.0,41.0,44.0,48.0,41.0,1
878,3C:55:76:E8:8F:1F,3910022,657114747,69209,172704575,3840813,484410172,30,33957,7010085,33480,6928461,477,81624,14311,39,69281,7097,30,445,195000.0,1000.0,-49.0,-58.0,-43.0,-46.0,-48.0,-57.0,-42.0,-43.0,-88.0,-89.0,-87.0,-89.0,39.0,31.0,44.0,43.0,1
879,92:69:1D:31:68:E9,3844797,488049721,3984,3639549,3840813,484410172,0,5059,1129069,4903,1093741,156,35328,2164,11,4214,92,0,55,229410.0,130000.0,-51.0,-47.0,-43.0,-46.0,-54.0,-50.0,-46.0,-49.0,-88.0,-89.0,-87.0,-89.0,37.0,42.0,44.0,43.0,1
880,CC:2F:71:3F:1F:24,4808663,1564158505,967850,1079748333,3840813,484410172,108,797780,872149226,797013,872056678,767,92548,770314,15,968038,101151,105,589,65000.0,14444.0,-68.0,-71.0,-66.0,-72.0,-68.0,-71.0,-66.0,-72.0,-88.0,-89.0,-87.0,-89.0,20.0,18.0,21.0,17.0,1
881,CC:2F:71:3E:C5:1F,3841739,484523169,926,112997,3840813,484410172,0,3870,324991,3192,244457,678,80534,981,11,1332,25,0,48,130000.0,39000.0,-71.0,-71.0,-69.0,-60.0,-70.0,-70.0,-67.0,-60.0,-88.0,-89.0,-87.0,-89.0,17.0,18.0,18.0,29.0,1
882,BA:8C:B9:54:50:24,3845689,490597407,4876,6187235,3840813,484410172,0,9281,1719085,9259,1715590,22,3495,2351,17,5346,41,0,63,229410.0,130000.0,-48.0,-35.0,-43.0,-45.0,-44.0,-35.0,-43.0,-47.0,-88.0,-89.0,-87.0,-89.0,40.0,54.0,44.0,44.0,1
883,62:47:05:9D:EB:15,3842921,486830473,2105,2420039,3840816,484410434,0,4236,3005991,4205,3001010,31,4981,2045,0,2151,53,0,105,216660.0,130000.0,-47.0,-45.0,-39.0,-48.0,-46.0,-45.0,-38.0,-47.0,-88.0,-90.0,-87.0,-89.0,41.0,45.0,48.0,41.0,1
884,3C:55:76:E8:8F:1F,3910027,657115211,69209,172704575,3840818,484410636,30,33957,7010085,33480,6928461,477,81624,14311,39,69281,7097,30,445,195000.0,1000.0,-49.0,-58.0,-43.0,-46.0,-48.0,-57.0,-42.0,-43.0,-88.0,-90.0,-87.0,-89.0,39.0,32.0,44.0,43.0,1
885,92:69:1D:31:68:E9,3844802,488050185,3984,3639549,3840818,484410636,0,5059,1129069,4903,1093741,156,35328,2164,11,4214,92,0,55,229410.0,130000.0,-51.0,-47.0,-43.0,-46.0,-54.0,-50.0,-46.0,-49.0,-88.0,-90.0,-87.0,-89.0,37.0,43.0,44.0,43.0,1
886,CC:2F:71:3F:1F:24,4808874,1564418061,968056,1080007425,3840818,484410636,108,797966,872393438,797199,872300890,767,92548,770498,15,968244,101153,105,589,86667.0,14444.0,-68.0,-71.0,-66.0,-72.0,-68.0,-71.0,-66.0,-72.0,-88.0,-90.0,-87.0,-89.0,20.0,19.0,21.0,17.0,1
887,CC:2F:71:3E:C5:1F,3841746,484523835,926,112997,3840820,484410838,0,3870,324991,3192,244457,678,80534,981,11,1332,25,0,48,130000.0,39000.0,-71.0,-71.0,-69.0,-60.0,-70.0,-70.0,-67.0,-60.0,-88.0,-90.0,-87.0,-89.0,17.0,19.0,18.0,29.0,1
888,BA:8C:B9:54:50:24,3845696,490598073,4876,6187235,3840820,484410838,0,9281,1719085,9259,1715590,22,3495,2351,17,5346,41,0,63,229410.0,130000.0,-48.0,-35.0,-43.0,-45.0,-44.0,-35.0,-43.0,-47.0,-88.0,-90.0,-87.0,-89.0,40.0,55.0,44.0,44.0,1
889,62:47:05:9D:EB:15,3842929,486831414,2105,2420039,3840824,484411375,0,4236,3005991,4205,3001010,31,4981,2045,0,2151,53,0,105,216660.0,130000.0,-47.0,-45.0,-39.0,-48.0,-46.0,-45.0,-38.0,-47.0,-88.0,-90.0,-87.0,-89.0,41.0,45.0,48.0,41.0,1
890,3C:55:76:E8:8F:1F,3911422,660778511,70598,176367136,3840824,484411375,30,34328,7068743,33850,6987001,478,81742,14509,39,70670,7108,30,445,270830.0,162500.0,-49.0,-58.0,-44.0,-45.0,-49.0,-57.0,-44.0,-45.0,-88.0,-90.0,-87.0,-89.0,39.0,32.0,43.0,44.0,1
891,92:69:1D:31:68:E9,3844808,488050924,3984,3639549,3840824,484411375,0,5059,1129069,4903,1093741,156,35328,2164,11,4214,92,0,55,229410.0,130000.0,-51.0,-47.0,-43.0,-46.0,-54.0,-50.0,-46.0,-49.0,-88.0,-90.0,-87.0,-89.0,37.0,43.0,44.0,43.0,1
892,CC:2F:71:3F:1F:24,4809095,1564690416,968271,1080279041,3840824,484411375,108,798160,872647096,797393,872554548,767,92548,770692,15,968459,101165,105,589,86667.0,14444.0,-68.0,-71.0,-66.0,-72.0,-68.0,-71.0,-66.0,-72.0,-88.0,-90.0,-87.0,-89.0,20.0,19.0,21.0,17.0,1
893,CC:2F:71:3E:C5:1F,3841751,484524434,926,112997,3840825,484411437,0,3871,325109,3192,244457,679,80652,982,11,1332,25,0,49,130000.0,39000.0,-81.0,-84.0,-75.0,-71.0,-72.0,-72.0,-68.0,-61.0,-88.0,-90.0,-87.0,-89.0,7.0,6.0,12.0,18.0,1
894,BA:8C:B9:54:50:24,3845703,490598874,4876,6187235,3840827,484411639,0,9281,1719085,9259,1715590,22,3495,2351,17,5346,41,0,63,229410.0,130000.0,-48.0,-35.0,-43.0,-45.0,-44.0,-35.0,-43.0,-47.0,-88.0,-90.0,-87.0,-89.0,40.0,55.0,44.0,44.0,1
895,62:47:05:9D:EB:15,3842936,486832082,2105,2420039,3840831,484412043,0,4236,3005991,4205,3001010,31,4981,2045,0,2151,53,0,105,216660.0,130000.0,-47.0,-45.0,-39.0,-48.0,-46.0,-45.0,-38.0,-47.0,-89.0,-90.0,-88.0,-90.0,42.0,45.0,49.0,42.0,1
896,3C:55:76:E8:8F:1F,3913486,666241930,72655,181829887,3840831,484412043,30,34802,7132383,34324,7050641,478,81742,14797,39,72727,7129,30,445,286760.0,172050.0,-44.0,-56.0,-44.0,-40.0,-43.0,-55.0,-43.0,-39.0,-89.0,-90.0,-88.0,-90.0,45.0,34.0,44.0,50.0,1
897,92:69:1D:31:68:E9,3844816,488051652,3984,3639549,3840832,484412103,0,5059,1129069,4903,1093741,156,35328,2164,11,4214,92,0,55,229410.0,130000.0,-51.0,-47.0,-43.0,-46.0,-54.0,-50.0,-46.0,-49.0,-89.0,-90.0,-88.0,-90.0,38.0,43.0,45.0,44.0,1
898,CC:2F:71:3F:1F:24,4809321,1564962846,968489,1080550743,3840832,484412103,108,798354,872898451,797587,872805903,767,92548,770886,15,968676,101165,105,589,86667.0,14444.0,-68.0,-71.0,-66.0,-72.0,-68.0,-71.0,-66.0,-72.0,-89.0,-90.0,-88.0,-90.0,21.0,19.0,22.0,18.0,1
899,CC:2F:71:3E:C5:1F,3841758,484525100,926,112997,3840832,484412103,0,3872,325179,3193,244527,679,80652,982,11,1332,25,0,49,130000.0,39000.0,-71.0,-72.0,-68.0,-60.0,-72.0,-73.0,-69.0,-61.0,-89.0,-90.0,-88.0,-90.0,18.0,18.0,20.0,30.0,1
900,BA:8C:B9:54:50:24,3845708,490599338,4876,6187235,3840832,484412103,0,9281,1719085,9259,1715590,22,3495,2351,17,5346,41,0,63,229410.0,130000.0,-48.0,-35.0,-43.0,-45.0,-44.0,-35.0,-43.0,-47.0,-89.0,-90.0,-88.0,-90.0,41.0,55.0,45.0,45.0,1
901,62:47:05:9D:EB:15,3842944,486832976,2105,2420039,3840839,484412937,0,4236,3005991,4205,3001010,31,4981,2045,0,2151,53,0,105,216660.0,130000.0,-47.0,-45.0,-39.0,-48.0,-46.0,-45.0,-38.0,-47.0,-89.0,-90.0,-88.0,-91.0,42.0,45.0,49.0,43.0,1
902,3C:55:76:E8:8F:1F,3913494,666242824,72655,181829887,3840839,484412937,30,34816,7133391,34337,7051531,479,81860,14798,39,72727,7129,30,446,286760.0,172050.0,-43.0,-57.0,-44.0,-39.0,-42.0,-56.0,-43.0,-38.0,-89.0,-90.0,-88.0,-91.0,46.0,33.0,44.0,52.0,1
903,92:69:1D:31:68:E9,3844823,488052486,3984,3639549,3840839,484412937,0,5059,1129069,4903,1093741,156,35328,2164,11,4214,92,0,55,229410.0,130000.0,-51.0,-47.0,-43.0,-46.0,-54.0,-50.0,-46.0,-49.0,-89.0,-90.0,-88.0,-91.0,38.0,43.0,45.0,45.0,1
904,CC:2F:71:3F:1F:24,4809552,1565248120,968713,1080835183,3840839,484412937,108,798554,873168551,797787,873076003,767,92548,771086,15,968901,101237,105,589,115556.0,28889.0,-68.0,-71.0,-66.0,-73.0,-68.0,-71.0,-66.0,-72.0,-89.0,-90.0,-88.0,-91.0,21.0,19.0,22.0,18.0,1
905,CC:2F:71:3E:C5:1F,3841765,484525934,926,112997,3840839,484412937,0,3872,325179,3193,244527,679,80652,982,11,1332,25,0,49,130000.0,39000.0,-71.0,-72.0,-68.0,-60.0,-72.0,-73.0,-69.0,-61.0,-89.0,-90.0,-88.0,-91.0,18.0,18.0,20.0,31.0,1
906,BA:8C:B9:54:50:24,3845715,490600172,4876,6187235,3840839,484412937,0,9281,1719085,9259,1715590,22,3495,2351,17,5346,41,0,63,229410.0,130000.0,-48.0,-35.0,-43.0,-45.0,-44.0,-35.0,-43.0,-47.0,-89.0,-90.0,-88.0,-91.0,41.0,55.0,45.0,46.0,1
907,62:47:05:9D:EB:15,3842949,486833585,2106,2420244,3840843,484413341,0,4239,3006247,4208,3001266,31,4981,2046,0,2152,53,0,105,216660.0,130000.0,-47.0,-46.0,-39.0,-48.0,-46.0,-46.0,-39.0,-48.0,-89.0,-91.0,-88.0,-91.0,42.0,45.0,49.0,43.0,1
908,3C:55:76:E8:8F:1F,3913498,666243228,72655,181829887,3840843,484413341,30,34816,7133391,34337,7051531,479,81860,14798,39,72727,7129,30,446,286760.0,172050.0,-43.0,-57.0,-44.0,-39.0,-42.0,-56.0,-43.0,-38.0,-89.0,-91.0,-88.0,-91.0,46.0,34.0,44.0,52.0,1
909,92:69:1D:31:68:E9,3844829,488053092,3984,3639549,3840845,484413543,0,5059,1129069,4903,1093741,156,35328,2164,11,4214,92,0,55,229410.0,130000.0,-51.0,-47.0,-43.0,-46.0,-54.0,-50.0,-46.0,-49.0,-89.0,-91.0,-88.0,-91.0,38.0,44.0,45.0,45.0,1
910,CC:2F:71:3F:1F:24,4809770,1565513486,968925,1081099943,3840845,484413543,108,798739,873414043,797972,873321495,767,92548,771271,15,969113,101277,105,589,115556.0,28889.0,-68.0,-71.0,-66.0,-73.0,-68.0,-71.0,-66.0,-72.0,-89.0,-91.0,-88.0,-91.0,21.0,20.0,22.0,18.0,1
911,CC:2F:71:3E:C5:1F,3841771,484526540,926,112997,3840845,484413543,0,3872,325179,3193,244527,679,80652,982,11,1332,25,0,49,130000.0,39000.0,-71.0,-72.0,-68.0,-60.0,-72.0,-73.0,-69.0,-61.0,-89.0,-91.0,-88.0,-91.0,18.0,19.0,20.0,31.0,1
912,BA:8C:B9:54:50:24,3845722,490600838,4876,6187235,3840846,484413603,0,9281,1719085,9259,1715590,22,3495,2351,17,5346,41,0,63,229410.0,130000.0,-48.0,-35.0,-43.0,-45.0,-44.0,-35.0,-43.0,-47.0,-89.0,-91.0,-88.0,-91.0,41.0,56.0,45.0,46.0,1
913,62:47:05:9D:EB:15,3842955,486834255,2107,2420450,3840848,484413805,0,4240,3006315,4209,3001334,31,4981,2046,0,2153,53,0,105,216660.0,130000.0,-45.0,-47.0,-40.0,-48.0,-46.0,-46.0,-39.0,-48.0,-89.0,-91.0,-88.0,-91.0,44.0,44.0,48.0,43.0,1
914,3C:55:76:E8:8F:1F,3913505,666244193,72657,181830388,3840848,484413805,30,34831,7134842,34352,7052982,479,81860,14802,39,72729,7129,30,446,286760.0,172050.0,-48.0,-55.0,-44.0,-45.0,-46.0,-55.0,-43.0,-43.0,-89.0,-91.0,-88.0,-91.0,41.0,36.0,44.0,46.0,1
915,92:69:1D:31:68:E9,3844832,488053354,3984,3639549,3840848,484413805,0,5059,1129069,4903,1093741,156,35328,2164,11,4214,92,0,55,229410.0,130000.0,-51.0,-47.0,-43.0,-46.0,-54.0,-50.0,-46.0,-49.0,-89.0,-91.0,-88.0,-91.0,38.0,44.0,45.0,45.0,1
916,CC:2F:71:3F:1F:24,4809984,1565774072,969134,1081360065,3840850,484414007,108,798923,873658033,798156,873565485,767,92548,771454,15,969321,101297,105,589,115556.0,28889.0,-68.0,-71.0,-66.0,-73.0,-68.0,-71.0,-66.0,-72.0,-89.0,-91.0,-88.0,-91.0,21.0,20.0,22.0,18.0,1
917,CC:2F:71:3E:C5:1F,3841776,484527004,926,112997,3840850,484414007,0,3872,325179,3193,244527,679,80652,982,11,1332,25,0,49,130000.0,39000.0,-71.0,-72.0,-68.0,-60.0,-72.0,-73.0,-69.0,-61.0,-89.0,-91.0,-88.0,-91.0,18.0,19.0,20.0,31.0,1
918,BA:8C:B9:54:50:24,3845726,490601242,4876,6187235,3840850,484414007,0,9281,1719085,9259,1715590,22,3495,2351,17,5346,41,0,63,229410.0,130000.0,-48.0,-35.0,-43.0,-45.0,-44.0,-35.0,-43.0,-47.0,-89.0,-91.0,-88.0,-91.0,41.0,56.0,45.0,46.0,1
919,62:47:05:9D:EB:15,3842962,486834923,2107,2420450,3840855,484414473,0,4242,3006503,4211,3001522,31,4981,2047,0,2153,53,0,105,216660.0,130000.0,-47.0,-46.0,-39.0,-48.0,-47.0,-46.0,-39.0,-48.0,-89.0,-91.0,-88.0,-91.0,42.0,45.0,49.0,43.0,1
920,3C:55:76:E8:8F:1F,3913512,666244861,72657,181830388,3840855,484414473,30,34834,7135048,34355,7053188,479,81860,14802,39,72729,7129,30,446,286760.0,172050.0,-48.0,-56.0,-44.0,-45.0,-47.0,-55.0,-43.0,-44.0,-89.0,-91.0,-88.0,-91.0,41.0,35.0,44.0,46.0,1
921,92:69:1D:31:68:E9,3844839,488054022,3984,3639549,3840855,484414473,0,5059,1129069,4903,1093741,156,35328,2164,11,4214,92,0,55,229410.0,130000.0,-51.0,-47.0,-43.0,-46.0,-54.0,-50.0,-46.0,-49.0,-89.0,-91.0,-88.0,-91.0,38.0,44.0,45.0,45.0,1
922,CC:2F:71:3F:1F:24,4810214,1566041789,969359,1081627316,3840855,484414473,108,799129,873907153,798361,873814487,768,92666,771660,15,969547,101351,105,589,115556.0,26000.0,-68.0,-71.0,-66.0,-73.0,-68.0,-71.0,-66.0,-72.0,-89.0,-91.0,-88.0,-91.0,21.0,20.0,22.0,18.0,1
923,CC:2F:71:3E:C5:1F,3841781,484527470,926,112997,3840855,484414473,0,3872,325179,3193,244527,679,80652,982,11,1332,25,0,49,130000.0,39000.0,-71.0,-72.0,-68.0,-60.0,-72.0,-73.0,-69.0,-61.0,-89.0,-91.0,-88.0,-91.0,18.0,19.0,20.0,31.0,1
924,BA:8C:B9:54:50:24,3845731,490601708,4876,6187235,3840855,484414473,0,9281,1719085,9259,1715590,22,3495,2351,17,5346,41,0,63,229410.0,130000.0,-48.0,-35.0,-43.0,-45.0,-44.0,-35.0,-43.0,-47.0,-89.0,-91.0,-89.0,-91.0,41.0,56.0,46.0,46.0,1
925,62:47:05:9D:EB:15,3842967,486835387,2107,2420450,3840860,484414937,0,4242,3006503,4211,3001522,31,4981,2047,0,2153,53,0,105,216660.0,130000.0,-47.0,-46.0,-39.0,-48.0,-47.0,-46.0,-39.0,-48.0,-89.0,-91.0,-89.0,-91.0,42.0,45.0,50.0,43.0,1
926,3C:55:76:E8:8F:1F,3913517,666245325,72657,181830388,3840860,484414937,30,34834,7135048,34355,7053188,479,81860,14802,39,72729,7129,30,446,286760.0,172050.0,-48.0,-56.0,-44.0,-45.0,-47.0,-55.0,-43.0,-44.0,-89.0,-91.0,-89.0,-91.0,41.0,35.0,45.0,46.0,1
927,92:69:1D:31:68:E9,3844844,488054486,3984,3639549,3840860,484414937,0,5059,1129069,4903,1093741,156,35328,2164,11,4214,92,0,55,229410.0,130000.0,-51.0,-47.0,-43.0,-46.0,-54.0,-50.0,-46.0,-49.0,-89.0,-91.0,-89.0,-91.0,38.0,44.0,46.0,45.0,1
928,CC:2F:71:3F:1F:24,4810428,1566302237,969566,1081887098,3840862,484415139,108,799311,874149449,798543,874056783,768,92666,771842,15,969754,101368,105,589,115556.0,28889.0,-68.0,-71.0,-67.0,-73.0,-68.0,-71.0,-66.0,-73.0,-89.0,-91.0,-89.0,-91.0,21.0,20.0,22.0,18.0,1
929,CC:2F:71:3E:C5:1F,3841788,484528136,926,112997,3840862,484415139,0,3872,325179,3193,244527,679,80652,982,11,1332,25,0,49,130000.0,39000.0,-71.0,-72.0,-68.0,-60.0,-72.0,-73.0,-69.0,-61.0,-89.0,-91.0,-89.0,-91.0,18.0,19.0,21.0,31.0,1
930,BA:8C:B9:54:50:24,3845738,490602374,4876,6187235,3840862,484415139,0,9281,1719085,9259,1715590,22,3495,2351,17,5346,41,0,63,229410.0,130000.0,-48.0,-35.0,-43.0,-45.0,-44.0,-35.0,-43.0,-47.0,-89.0,-91.0,-89.0,-91.0,41.0,56.0,46.0,46.0,1
931,62:47:05:9D:EB:15,3842971,486835791,2107,2420450,3840864,484415341,0,4242,3006503,4211,3001522,31,4981,2047,0,2153,53,0,105,216660.0,130000.0,-47.0,-46.0,-39.0,-48.0,-47.0,-46.0,-39.0,-48.0,-89.0,-91.0,-88.0,-91.0,42.0,45.0,49.0,43.0,1
932,3C:55:76:E8:8F:1F,3913521,666245729,72657,181830388,3840864,484415341,30,34834,7135048,34355,7053188,479,81860,14802,39,72729,7129,30,446,286760.0,172050.0,-48.0,-56.0,-44.0,-45.0,-47.0,-55.0,-43.0,-44.0,-89.0,-91.0,-88.0,-91.0,41.0,35.0,44.0,46.0,1
933,92:69:1D:31:68:E9,3844848,488054890,3984,3639549,3840864,484415341,0,5061,1129205,4905,1093877,156,35328,2164,11,4215,92,0,55,229410.0,130000.0,-51.0,-47.0,-43.0,-46.0,-54.0,-50.0,-46.0,-48.0,-89.0,-91.0,-88.0,-91.0,38.0,44.0,45.0,45.0,1
934,CC:2F:71:3F:1F:24,4810636,1566559075,969772,1082143734,3840864,484415341,108,799494,874393285,798726,874300619,768,92666,772025,15,969960,101395,105,589,115556.0,28889.0,-68.0,-71.0,-66.0,-73.0,-68.0,-71.0,-66.0,-72.0,-89.0,-91.0,-88.0,-91.0,21.0,20.0,22.0,18.0,1
935,CC:2F:71:3E:C5:1F,3841790,484528338,926,112997,3840864,484415341,0,3874,325319,3195,244667,679,80652,982,11,1333,25,0,49,130000.0,39000.0,-70.0,-72.0,-69.0,-60.0,-72.0,-73.0,-69.0,-61.0,-89.0,-91.0,-88.0,-91.0,19.0,19.0,19.0,31.0,1
936,BA:8C:B9:54:50:24,3845742,490602778,4876,6187235,3840866,484415543,0,9283,1719221,9261,1715726,22,3495,2351,17,5347,41,0,63,229410.0,130000.0,-40.0,-37.0,-46.0,-51.0,-43.0,-35.0,-43.0,-47.0,-89.0,-91.0,-88.0,-91.0,49.0,54.0,42.0,40.0,1
937,62:47:05:9D:EB:15,3842978,486836459,2107,2420450,3840871,484416009,0,4243,3006571,4212,3001590,31,4981,2047,0,2153,53,0,105,216660.0,130000.0,-45.0,-47.0,-40.0,-48.0,-47.0,-46.0,-40.0,-48.0,-89.0,-92.0,-89.0,-92.0,44.0,45.0,49.0,44.0,1
938,3C:55:76:E8:8F:1F,3913529,666246457,72657,181830388,3840872,484416069,30,34840,7135508,34360,7053530,480,81978,14803,39,72729,7129,30,446,286760.0,172050.0,-46.0,-54.0,-43.0,-41.0,-46.0,-54.0,-43.0,-41.0,-89.0,-92.0,-89.0,-92.0,43.0,38.0,46.0,51.0,1
939,92:69:1D:31:68:E9,3844856,488055618,3984,3639549,3840872,484416069,0,5061,1129205,4905,1093877,156,35328,2164,11,4215,92,0,55,229410.0,130000.0,-51.0,-47.0,-43.0,-46.0,-54.0,-50.0,-46.0,-48.0,-89.0,-92.0,-89.0,-92.0,38.0,45.0,46.0,46.0,1
940,CC:2F:71:3F:1F:24,4810865,1566829930,969993,1082413861,3840872,484416069,108,799685,874635724,798917,874543058,768,92666,772216,15,970181,101401,105,589,115556.0,28889.0,-68.0,-72.0,-67.0,-73.0,-68.0,-71.0,-66.0,-73.0,-89.0,-92.0,-89.0,-92.0,21.0,20.0,22.0,19.0,1
941,CC:2F:71:3E:C5:1F,3841798,484529066,926,112997,3840872,484416069,0,3874,325319,3195,244667,679,80652,982,11,1333,25,0,49,130000.0,39000.0,-70.0,-72.0,-69.0,-60.0,-72.0,-73.0,-69.0,-61.0,-89.0,-92.0,-89.0,-92.0,19.0,20.0,20.0,32.0,1
942,BA:8C:B9:54:50:24,3845748,490603304,4876,6187235,3840872,484416069,0,9283,1719221,9261,1715726,22,3495,2351,17,5347,41,0,63,229410.0,130000.0,-40.0,-37.0,-46.0,-51.0,-43.0,-35.0,-43.0,-47.0,-89.0,-92.0,-89.0,-92.0,49.0,55.0,43.0,41.0,1
943,62:47:05:9D:EB:15,3842981,486836721,2107,2420450,3840874,484416271,0,4243,3006571,4212,3001590,31,4981,2047,0,2153,53,0,105,216660.0,130000.0,-45.0,-47.0,-40.0,-48.0,-47.0,-46.0,-40.0,-48.0,-89.0,-92.0,-89.0,-92.0,44.0,45.0,49.0,44.0,1
944,3C:55:76:E8:8F:1F,3913532,666246789,72658,181830518,3840874,484416271,30,34847,7136025,34367,7054047,480,81978,14804,39,72730,7129,30,446,270830.0,162500.0,-47.0,-53.0,-44.0,-40.0,-47.0,-55.0,-43.0,-42.0,-89.0,-92.0,-89.0,-92.0,42.0,39.0,45.0,52.0,1
945,92:69:1D:31:68:E9,3844860,488056022,3984,3639549,3840876,484416473,0,5061,1129205,4905,1093877,156,35328,2164,11,4215,92,0,55,229410.0,130000.0,-51.0,-47.0,-43.0,-46.0,-54.0,-50.0,-46.0,-48.0,-89.0,-92.0,-89.0,-92.0,38.0,45.0,46.0,46.0,1
946,CC:2F:71:3F:1F:24,4811076,1567090172,970200,1082673699,3840876,484416473,108,799869,874881100,799101,874788434,768,92666,772400,15,970388,101422,105,589,115556.0,28889.0,-68.0,-71.0,-66.0,-72.0,-68.0,-70.0,-66.0,-72.0,-89.0,-92.0,-89.0,-92.0,21.0,21.0,23.0,20.0,1
947,CC:2F:71:3E:C5:1F,3841802,484529470,926,112997,3840876,484416473,0,3874,325319,3195,244667,679,80652,982,11,1333,25,0,49,130000.0,39000.0,-70.0,-72.0,-69.0,-60.0,-72.0,-73.0,-69.0,-61.0,-89.0,-92.0,-89.0,-92.0,19.0,20.0,20.0,32.0,1
948,BA:8C:B9:54:50:24,3845752,490603708,4876,6187235,3840876,484416473,0,9283,1719221,9261,1715726,22,3495,2351,17,5347,41,0,63,229410.0,130000.0,-40.0,-37.0,-46.0,-51.0,-43.0,-35.0,-43.0,-47.0,-89.0,-92.0,-89.0,-92.0,49.0,55.0,43.0,41.0,1
949,62:47:05:9D:EB:15,3842989,486837613,2109,2420736,3840880,484416877,0,4246,3006907,4215,3001926,31,4981,2049,0,2155,53,0,105,216660.0,130000.0,-49.0,-48.0,-41.0,-50.0,-47.0,-47.0,-40.0,-48.0,-89.0,-92.0,-89.0,-92.0,40.0,44.0,48.0,42.0,1
950,3C:55:76:E8:8F:1F,3913538,666247395,72658,181830518,3840880,484416877,30,34860,7136911,34380,7054933,480,81978,14804,39,72730,7129,30,446,270830.0,162500.0,-49.0,-56.0,-45.0,-45.0,-48.0,-55.0,-45.0,-44.0,-89.0,-92.0,-89.0,-92.0,40.0,36.0,44.0,47.0,1
951,92:69:1D:31:68:E9,3844864,488056426,3984,3639549,3840880,484416877,0,5061,1129205,4905,1093877,156,35328,2164,11,4215,92,0,55,229410.0,130000.0,-51.0,-47.0,-43.0,-46.0,-54.0,-50.0,-46.0,-48.0,-89.0,-92.0,-89.0,-92.0,38.0,45.0,46.0,46.0,1
952,CC:2F:71:3F:1F:24,4811291,1567353460,970409,1082936381,3840882,484417079,108,800057,875128476,799289,875035810,768,92666,772587,15,970597,101452,105,590,86667.0,14444.0,-68.0,-71.0,-67.0,-73.0,-68.0,-71.0,-67.0,-73.0,-89.0,-92.0,-89.0,-92.0,21.0,21.0,22.0,19.0,1
953,CC:2F:71:3E:C5:1F,3841808,484530076,926,112997,3840882,484417079,0,3874,325319,3195,244667,679,80652,982,11,1333,25,0,49,130000.0,39000.0,-70.0,-72.0,-69.0,-60.0,-72.0,-73.0,-69.0,-61.0,-89.0,-92.0,-89.0,-92.0,19.0,20.0,20.0,32.0,1
954,BA:8C:B9:54:50:24,3845758,490604314,4876,6187235,3840882,484417079,0,9283,1719221,9261,1715726,22,3495,2351,17,5347,41,0,63,229410.0,130000.0,-40.0,-37.0,-46.0,-51.0,-43.0,-35.0,-43.0,-47.0,-89.0,-92.0,-89.0,-92.0,49.0,55.0,43.0,41.0,1
955,62:47:05:9D:EB:15,3842995,486838350,2109,2420736,3840886,484417614,0,4247,3006975,4216,3001994,31,4981,2049,0,2155,53,0,105,216660.0,130000.0,-47.0,-46.0,-40.0,-48.0,-47.0,-47.0,-40.0,-48.0,-89.0,-92.0,-89.0,-92.0,42.0,46.0,49.0,44.0,1
956,3C:55:76:E8:8F:1F,3913544,666248132,72658,181830518,3840886,484417614,30,34860,7136911,34380,7054933,480,81978,14804,39,72730,7129,30,446,270830.0,162500.0,-49.0,-56.0,-45.0,-45.0,-48.0,-55.0,-45.0,-44.0,-89.0,-92.0,-89.0,-92.0,40.0,36.0,44.0,47.0,1
957,92:69:1D:31:68:E9,3844870,488057163,3984,3639549,3840886,484417614,0,5061,1129205,4905,1093877,156,35328,2164,11,4215,92,0,55,229410.0,130000.0,-51.0,-47.0,-43.0,-46.0,-54.0,-50.0,-46.0,-48.0,-89.0,-92.0,-89.0,-92.0,38.0,45.0,46.0,46.0,1
958,CC:2F:71:3F:1F:24,4811505,1567616455,970619,1083198841,3840886,484417614,108,800243,875372660,799475,875279994,768,92666,772773,15,970807,101452,105,590,104000.0,26000.0,-68.0,-73.0,-67.0,-73.0,-68.0,-73.0,-67.0,-73.0,-89.0,-92.0,-89.0,-92.0,21.0,19.0,22.0,19.0,1
959,CC:2F:71:3E:C5:1F,3841812,484530611,926,112997,3840886,484417614,0,3874,325319,3195,244667,679,80652,982,11,1333,25,0,49,130000.0,39000.0,-70.0,-72.0,-69.0,-60.0,-72.0,-73.0,-69.0,-61.0,-89.0,-92.0,-89.0,-92.0,19.0,20.0,20.0,32.0,1
960,BA:8C:B9:54:50:24,3845762,490604849,4876,6187235,3840886,484417614,0,9284,1719289,9262,1715794,22,3495,2351,17,5347,41,0,63,229410.0,130000.0,-48.0,-35.0,-43.0,-45.0,-44.0,-35.0,-43.0,-46.0,-89.0,-92.0,-89.0,-92.0,41.0,57.0,46.0,47.0,1
961,62:47:05:9D:EB:15,3843001,486838956,2109,2420736,3840892,484418220,0,4247,3006975,4216,3001994,31,4981,2049,0,2155,53,0,105,216660.0,130000.0,-47.0,-46.0,-40.0,-48.0,-47.0,-47.0,-40.0,-48.0,-89.0,-92.0,-89.0,-92.0,42.0,46.0,49.0,44.0,1
962,3C:55:76:E8:8F:1F,3913550,666248738,72658,181830518,3840892,484418220,30,34860,7136911,34380,7054933,480,81978,14804,39,72730,7129,30,446,270830.0,162500.0,-49.0,-56.0,-45.0,-45.0,-48.0,-55.0,-45.0,-44.0,-89.0,-92.0,-89.0,-92.0,40.0,36.0,44.0,47.0,1
963,92:69:1D:31:68:E9,3844876,488057769,3984,3639549,3840892,484418220,0,5061,1129205,4905,1093877,156,35328,2164,11,4215,92,0,55,229410.0,130000.0,-51.0,-47.0,-43.0,-46.0,-54.0,-50.0,-46.0,-48.0,-89.0,-92.0,-89.0,-92.0,38.0,45.0,46.0,46.0,1
964,CC:2F:71:3F:1F:24,4811727,1567880128,970835,1083461908,3840892,484418220,108,800435,875618031,799667,875525365,768,92666,772965,15,971023,101471,105,590,130000.0,43333.0,-68.0,-73.0,-67.0,-75.0,-68.0,-73.0,-67.0,-74.0,-89.0,-92.0,-89.0,-92.0,21.0,19.0,22.0,17.0,1
965,CC:2F:71:3E:C5:1F,3841818,484531217,926,112997,3840892,484418220,0,3874,325319,3195,244667,679,80652,982,11,1333,25,0,49,130000.0,39000.0,-70.0,-72.0,-69.0,-60.0,-72.0,-73.0,-69.0,-61.0,-89.0,-92.0,-89.0,-92.0,19.0,20.0,20.0,32.0,1
966,BA:8C:B9:54:50:24,3845768,490605455,4876,6187235,3840892,484418220,0,9284,1719289,9262,1715794,22,3495,2351,17,5347,41,0,63,229410.0,130000.0,-48.0,-35.0,-43.0,-45.0,-44.0,-35.0,-43.0,-46.0,-89.0,-92.0,-89.0,-92.0,41.0,57.0,46.0,47.0,1
967,62:47:05:9D:EB:15,3843005,486839278,2109,2420736,3840896,484418542,0,4247,3006975,4216,3001994,31,4981,2049,0,2155,53,0,105,216660.0,130000.0,-47.0,-46.0,-40.0,-48.0,-47.0,-47.0,-40.0,-48.0,-89.0,-92.0,-89.0,-92.0,42.0,46.0,49.0,44.0,1
968,3C:55:76:E8:8F:1F,3913555,666249146,72658,181830518,3840897,484418628,30,34860,7136911,34380,7054933,480,81978,14804,39,72730,7129,30,446,270830.0,162500.0,-49.0,-56.0,-45.0,-45.0,-48.0,-55.0,-45.0,-44.0,-89.0,-92.0,-89.0,-92.0,40.0,36.0,44.0,47.0,1
969,92:69:1D:31:68:E9,3844881,488058177,3984,3639549,3840897,484418628,0,5061,1129205,4905,1093877,156,35328,2164,11,4215,92,0,55,229410.0,130000.0,-51.0,-47.0,-43.0,-46.0,-54.0,-50.0,-46.0,-48.0,-89.0,-92.0,-89.0,-92.0,38.0,45.0,46.0,46.0,1
970,CC:2F:71:3F:1F:24,4811947,1568146828,971048,1083727998,3840899,484418830,108,800625,875868413,799855,875775491,770,92922,773154,15,971236,101525,105,590,130000.0,43333.0,-68.0,-73.0,-67.0,-74.0,-68.0,-73.0,-67.0,-74.0,-89.0,-92.0,-89.0,-92.0,21.0,19.0,22.0,18.0,1
971,CC:2F:71:3E:C5:1F,3841828,484532095,926,112997,3840902,484419098,0,3874,325319,3195,244667,679,80652,982,11,1333,25,0,49,130000.0,39000.0,-70.0,-72.0,-69.0,-60.0,-72.0,-73.0,-69.0,-61.0,-89.0,-92.0,-89.0,-92.0,19.0,20.0,20.0,32.0,1
972,BA:8C:B9:54:50:24,3845779,490606467,4876,6187235,3840903,484419232,0,9284,1719289,9262,1715794,22,3495,2351,17,5347,41,0,63,229410.0,130000.0,-48.0,-35.0,-43.0,-45.0,-44.0,-35.0,-43.0,-46.0,-89.0,-92.0,-89.0,-92.0,41.0,57.0,46.0,47.0,1
973,62:47:05:9D:EB:15,3843014,486840170,2109,2420736,3840905,484419434,0,4247,3006975,4216,3001994,31,4981,2049,0,2155,53,0,105,216660.0,130000.0,-47.0,-46.0,-40.0,-48.0,-47.0,-47.0,-40.0,-48.0,-89.0,-92.0,-89.0,-92.0,42.0,46.0,49.0,44.0,1
974,3C:55:76:E8:8F:1F,3913563,666249952,72658,181830518,3840905,484419434,30,34860,7136911,34380,7054933,480,81978,14804,39,72730,7129,30,446,270830.0,162500.0,-49.0,-56.0,-45.0,-45.0,-48.0,-55.0,-45.0,-44.0,-89.0,-92.0,-89.0,-92.0,40.0,36.0,44.0,47.0,1
975,92:69:1D:31:68:E9,3844889,488058983,3984,3639549,3840905,484419434,0,5061,1129205,4905,1093877,156,35328,2164,11,4215,92,0,55,229410.0,130000.0,-51.0,-47.0,-43.0,-46.0,-54.0,-50.0,-46.0,-48.0,-89.0,-92.0,-89.0,-92.0,38.0,45.0,46.0,46.0,1
976,CC:2F:71:3F:1F:24,4812175,1568426518,971270,1084007084,3840905,484419434,108,800823,876129961,800051,876036727,772,93234,773352,15,971458,101566,105,590,130000.0,43333.0,-67.0,-73.0,-66.0,-74.0,-67.0,-73.0,-66.0,-74.0,-89.0,-92.0,-89.0,-92.0,22.0,19.0,23.0,18.0,1
977,CC:2F:71:3E:C5:1F,3841831,484532431,926,112997,3840905,484419434,0,3874,325319,3195,244667,679,80652,982,11,1333,25,0,49,130000.0,39000.0,-70.0,-72.0,-69.0,-60.0,-72.0,-73.0,-69.0,-61.0,-89.0,-92.0,-89.0,-92.0,19.0,20.0,20.0,32.0,1
978,BA:8C:B9:54:50:24,3845781,490606669,4876,6187235,3840905,484419434,0,9284,1719289,9262,1715794,22,3495,2351,17,5347,41,0,63,229410.0,130000.0,-48.0,-35.0,-43.0,-45.0,-44.0,-35.0,-43.0,-46.0,-89.0,-92.0,-89.0,-92.0,41.0,57.0,46.0,47.0,1
979,62:47:05:9D:EB:15,3843021,486840836,2109,2420736,3840912,484420100,0,4247,3006975,4216,3001994,31,4981,2049,0,2155,53,0,105,216660.0,130000.0,-47.0,-46.0,-40.0,-48.0,-47.0,-47.0,-40.0,-48.0,-89.0,-92.0,-89.0,-92.0,42.0,46.0,49.0,44.0,1
980,3C:55:76:E8:8F:1F,3913578,666256090,72666,181835990,3840912,484420100,30,34883,7141627,34403,7059649,480,81978,14813,39,72738,7129,30,446,270830.0,162500.0,-45.0,-52.0,-43.0,-41.0,-45.0,-51.0,-43.0,-41.0,-89.0,-92.0,-89.0,-92.0,44.0,40.0,46.0,51.0,1
981,92:69:1D:31:68:E9,3844896,488059649,3984,3639549,3840912,484420100,0,5061,1129205,4905,1093877,156,35328,2164,11,4215,92,0,55,229410.0,130000.0,-51.0,-47.0,-43.0,-46.0,-54.0,-50.0,-46.0,-48.0,-89.0,-92.0,-89.0,-92.0,38.0,45.0,46.0,46.0,1
982,CC:2F:71:3F:1F:24,4812403,1568694329,971491,1084274229,3840912,484420100,108,801015,876375379,800243,876282145,772,93234,773544,15,971678,101593,105,590,130000.0,43333.0,-67.0,-73.0,-66.0,-74.0,-67.0,-73.0,-66.0,-73.0,-89.0,-92.0,-89.0,-92.0,22.0,19.0,23.0,18.0,1
983,CC:2F:71:3E:C5:1F,3841838,484533097,926,112997,3840912,484420100,0,3874,325319,3195,244667,679,80652,982,11,1333,25,0,49,130000.0,39000.0,-70.0,-72.0,-69.0,-60.0,-72.0,-73.0,-69.0,-61.0,-89.0,-92.0,-89.0,-92.0,19.0,20.0,20.0,32.0,1
984,BA:8C:B9:54:50:24,3845788,490607335,4876,6187235,3840912,484420100,0,9284,1719289,9262,1715794,22,3495,2351,17,5347,41,0,63,229410.0,130000.0,-48.0,-35.0,-43.0,-45.0,-44.0,-35.0,-43.0,-46.0,-89.0,-92.0,-89.0,-92.0,41.0,57.0,46.0,47.0,1
985,62:47:05:9D:EB:15,3843023,486841038,2109,2420736,3840914,484420302,0,4247,3006975,4216,3001994,31,4981,2049,0,2155,53,0,105,216660.0,130000.0,-47.0,-46.0,-40.0,-48.0,-47.0,-47.0,-40.0,-48.0,-90.0,-92.0,-90.0,-93.0,43.0,46.0,50.0,45.0,1
986,3C:55:76:E8:8F:1F,3913582,666256590,72668,181836288,3840914,484420302,30,34902,7143047,34422,7061069,480,81978,14815,39,72740,7129,30,446,270830.0,162500.0,-51.0,-58.0,-52.0,-44.0,-48.0,-52.0,-46.0,-44.0,-90.0,-92.0,-90.0,-93.0,39.0,34.0,38.0,49.0,1
987,92:69:1D:31:68:E9,3844898,488059851,3984,3639549,3840914,484420302,0,5061,1129205,4905,1093877,156,35328,2164,11,4215,92,0,55,229410.0,130000.0,-51.0,-47.0,-43.0,-46.0,-54.0,-50.0,-46.0,-48.0,-90.0,-92.0,-90.0,-93.0,39.0,45.0,47.0,47.0,1
988,CC:2F:71:3F:1F:24,4812617,1568959009,971701,1084538505,3840916,484420504,108,801204,876624281,800432,876531047,772,93234,773732,15,971889,101656,105,591,130000.0,43333.0,-67.0,-73.0,-66.0,-73.0,-67.0,-73.0,-66.0,-73.0,-90.0,-92.0,-90.0,-93.0,23.0,19.0,24.0,20.0,1
989,CC:2F:71:3E:C5:1F,3841842,484533501,926,112997,3840916,484420504,0,3874,325319,3195,244667,679,80652,982,11,1333,25,0,49,130000.0,39000.0,-70.0,-72.0,-69.0,-60.0,-72.0,-73.0,-69.0,-61.0,-90.0,-92.0,-90.0,-93.0,20.0,20.0,21.0,33.0,1
990,BA:8C:B9:54:50:24,3845794,490608023,4878,6187519,3840916,484420504,0,9290,1719833,9268,1716338,22,3495,2353,17,5349,41,0,63,229410.0,130000.0,-50.0,-34.0,-43.0,-44.0,-47.0,-36.0,-44.0,-46.0,-90.0,-92.0,-90.0,-93.0,40.0,58.0,47.0,49.0,1
991,62:47:05:9D:EB:15,3843030,486841760,2110,2420852,3840920,484420908,0,4249,3007153,4218,3002172,31,4981,2050,0,2156,53,0,105,216660.0,130000.0,-50.0,-49.0,-41.0,-49.0,-47.0,-47.0,-40.0,-48.0,-90.0,-92.0,-90.0,-93.0,40.0,43.0,49.0,44.0,1
992,3C:55:76:E8:8F:1F,3913618,666329530,72698,181908622,3840920,484420908,30,34929,7147083,34449,7065105,480,81978,14826,39,72770,7129,30,447,286760.0,162500.0,-44.0,-59.0,-45.0,-40.0,-44.0,-57.0,-44.0,-39.0,-90.0,-92.0,-90.0,-93.0,46.0,33.0,45.0,53.0,1
993,92:69:1D:31:68:E9,3844906,488060659,3984,3639549,3840922,484421110,0,5061,1129205,4905,1093877,156,35328,2164,11,4215,92,0,55,229410.0,130000.0,-51.0,-47.0,-43.0,-46.0,-54.0,-50.0,-46.0,-48.0,-90.0,-92.0,-90.0,-93.0,39.0,45.0,47.0,47.0,1
994,CC:2F:71:3F:1F:24,4812834,1569222837,971912,1084801727,3840922,484421110,108,801391,876870075,800619,876776841,772,93234,773919,15,972100,101690,105,591,130000.0,43333.0,-67.0,-73.0,-66.0,-73.0,-67.0,-73.0,-66.0,-73.0,-90.0,-92.0,-90.0,-93.0,23.0,19.0,24.0,20.0,1
995,CC:2F:71:3E:C5:1F,3841849,484534167,926,112997,3840923,484421170,0,3874,325319,3195,244667,679,80652,982,11,1333,25,0,49,130000.0,39000.0,-70.0,-72.0,-69.0,-60.0,-72.0,-73.0,-69.0,-61.0,-90.0,-92.0,-90.0,-93.0,20.0,20.0,21.0,33.0,1
996,BA:8C:B9:54:50:24,3845801,490608689,4878,6187519,3840923,484421170,0,9290,1719833,9268,1716338,22,3495,2353,17,5349,41,0,63,229410.0,130000.0,-50.0,-34.0,-43.0,-44.0,-47.0,-36.0,-44.0,-46.0,-90.0,-92.0,-90.0,-93.0,40.0,58.0,47.0,49.0,1
997,62:47:05:9D:EB:15,3843034,486842156,2110,2420852,3840924,484421304,0,4250,3007221,4219,3002240,31,4981,2050,0,2156,53,0,105,216660.0,130000.0,-47.0,-46.0,-39.0,-47.0,-47.0,-47.0,-40.0,-48.0,-90.0,-92.0,-90.0,-93.0,43.0,46.0,51.0,46.0,1
998,3C:55:76:E8:8F:1F,3913652,666398823,72728,181977519,3840924,484421304,30,34953,7153147,34473,7071169,480,81978,14834,39,72800,7129,30,447,286760.0,162500.0,-47.0,-52.0,-49.0,-44.0,-46.0,-53.0,-46.0,-43.0,-90.0,-92.0,-89.0,-92.0,43.0,40.0,40.0,48.0,1
999,92:69:1D:31:68:E9,3844909,488060921,3984,3639549,3840925,484421372,0,5061,1129205,4905,1093877,156,35328,2164,11,4215,92,0,55,229410.0,130000.0,-51.0,-47.0,-43.0,-46.0,-54.0,-50.0,-46.0,-48.0,-90.0,-92.0,-89.0,-92.0,39.0,45.0,46.0,46.0,1
1000,CC:2F:71:3F:1F:24,4813045,1569484155,972120,1085062783,3840925,484421372,108,801580,877116045,800808,877022811,772,93234,774107,15,972308,101738,105,591,115556.0,28889.0,-69.0,-72.0,-67.0,-75.0,-69.0,-71.0,-67.0,-74.0,-90.0,-92.0,-89.0,-92.0,21.0,20.0,22.0,17.0,1
1001,CC:2F:71:3E:C5:1F,3841851,484534369,926,112997,3840925,484421372,0,3874,325319,3195,244667,679,80652,982,11,1333,25,0,49,130000.0,39000.0,-70.0,-72.0,-69.0,-60.0,-72.0,-73.0,-69.0,-61.0,-90.0,-92.0,-89.0,-92.0,20.0,20.0,20.0,32.0,1
1002,BA:8C:B9:54:50:24,3845803,490608891,4878,6187519,3840925,484421372,0,9290,1719833,9268,1716338,22,3495,2353,17,5349,41,0,63,229410.0,130000.0,-50.0,-34.0,-43.0,-44.0,-47.0,-36.0,-44.0,-46.0,-90.0,-92.0,-89.0,-92.0,40.0,58.0,46.0,48.0,1
1003,62:47:05:9D:EB:15,3843041,486842830,2110,2420852,3840931,484421978,0,4250,3007221,4219,3002240,31,4981,2050,0,2156,53,0,105,216660.0,130000.0,-47.0,-46.0,-39.0,-47.0,-47.0,-47.0,-40.0,-48.0,-90.0,-92.0,-89.0,-92.0,43.0,46.0,50.0,45.0,1
1004,3C:55:76:E8:8F:1F,3913678,666418051,72747,181996073,3840931,484421978,30,34989,7163819,34509,7081841,480,81978,14852,39,72819,7129,30,448,286760.0,172050.0,-44.0,-59.0,-46.0,-40.0,-43.0,-58.0,-45.0,-39.0,-90.0,-92.0,-89.0,-92.0,46.0,33.0,43.0,52.0,1
1005,92:69:1D:31:68:E9,3844915,488061527,3984,3639549,3840931,484421978,0,5061,1129205,4905,1093877,156,35328,2164,11,4215,92,0,55,229410.0,130000.0,-51.0,-47.0,-43.0,-46.0,-54.0,-50.0,-46.0,-48.0,-89.0,-92.0,-89.0,-92.0,38.0,45.0,46.0,46.0,1
1006,CC:2F:71:3F:1F:24,4813306,1569810362,972375,1085388384,3840931,484421978,108,801810,877422074,801038,877328840,772,93234,774335,15,972562,101750,105,600,117000.0,39000.0,-68.0,-71.0,-67.0,-67.0,-68.0,-70.0,-66.0,-70.0,-89.0,-92.0,-89.0,-92.0,21.0,21.0,22.0,25.0,1
1007,CC:2F:71:3E:C5:1F,3841857,484534975,926,112997,3840931,484421978,0,3874,325319,3195,244667,679,80652,982,11,1333,25,0,49,130000.0,39000.0,-70.0,-72.0,-69.0,-60.0,-72.0,-73.0,-69.0,-61.0,-89.0,-92.0,-89.0,-92.0,19.0,20.0,20.0,32.0,1
1008,BA:8C:B9:54:50:24,3845810,490609557,4878,6187519,3840932,484422038,0,9290,1719833,9268,1716338,22,3495,2353,17,5349,41,0,63,229410.0,130000.0,-50.0,-34.0,-43.0,-44.0,-47.0,-36.0,-44.0,-46.0,-89.0,-92.0,-89.0,-92.0,39.0,58.0,46.0,48.0,1
1009,62:47:05:9D:EB:15,3843048,486843496,2110,2420852,3840938,484422644,0,4250,3007221,4219,3002240,31,4981,2050,0,2156,53,0,105,216660.0,130000.0,-47.0,-46.0,-39.0,-47.0,-47.0,-47.0,-40.0,-48.0,-89.0,-92.0,-89.0,-92.0,42.0,46.0,50.0,45.0,1
1010,3C:55:76:E8:8F:1F,3913686,666418915,72748,181996271,3840938,484422644,30,34993,7164159,34513,7082181,480,81978,14853,39,72820,7130,30,448,286760.0,1000.0,-47.0,-51.0,-49.0,-44.0,-44.0,-54.0,-46.0,-41.0,-89.0,-91.0,-88.0,-91.0,42.0,40.0,39.0,47.0,1
1011,92:69:1D:31:68:E9,3844923,488062309,3985,3639665,3840938,484422644,0,5063,1129341,4907,1094013,156,35328,2164,11,4216,92,0,55,229410.0,130000.0,-52.0,-48.0,-44.0,-47.0,-54.0,-50.0,-46.0,-48.0,-89.0,-91.0,-88.0,-91.0,37.0,43.0,44.0,44.0,1
1012,CC:2F:71:3F:1F:24,4813548,1570108326,972607,1085685410,3840941,484422916,108,802023,877709728,801251,877616494,772,93234,774541,15,972794,101768,105,600,115556.0,28889.0,-68.0,-69.0,-66.0,-69.0,-67.0,-69.0,-65.0,-69.0,-89.0,-91.0,-88.0,-91.0,21.0,22.0,22.0,22.0,1
1013,CC:2F:71:3E:C5:1F,3841868,484536029,927,113113,3840941,484422916,0,3876,325459,3197,244807,679,80652,982,11,1334,25,0,49,130000.0,39000.0,-76.0,-75.0,-72.0,-70.0,-72.0,-73.0,-69.0,-62.0,-89.0,-91.0,-88.0,-91.0,13.0,16.0,16.0,21.0,1
1014,BA:8C:B9:54:50:24,3845820,490610551,4879,6187635,3840941,484422916,0,9292,1719969,9270,1716474,22,3495,2353,17,5350,41,0,63,229410.0,130000.0,-48.0,-35.0,-42.0,-45.0,-47.0,-36.0,-44.0,-46.0,-89.0,-91.0,-88.0,-91.0,41.0,56.0,46.0,46.0,1
1015,62:47:05:9D:EB:15,3843052,486843884,2111,2420968,3840941,484422916,0,4252,3007357,4221,3002376,31,4981,2050,0,2157,53,0,105,216660.0,130000.0,-47.0,-45.0,-39.0,-47.0,-47.0,-46.0,-40.0,-48.0,-89.0,-91.0,-87.0,-90.0,42.0,46.0,48.0,43.0,1
1016,3C:55:76:E8:8F:1F,3913700,666428000,72757,182004882,3840943,484423118,30,35028,7177874,34547,7095770,481,82104,14867,39,72829,7137,30,455,286760.0,1000.0,-44.0,-58.0,-46.0,-40.0,-44.0,-55.0,-46.0,-40.0,-89.0,-91.0,-87.0,-90.0,45.0,33.0,41.0,50.0,1
1017,92:69:1D:31:68:E9,3844928,488062783,3985,3639665,3840943,484423118,0,5063,1129341,4907,1094013,156,35328,2164,11,4216,92,0,55,229410.0,130000.0,-52.0,-48.0,-44.0,-47.0,-54.0,-50.0,-46.0,-48.0,-89.0,-91.0,-87.0,-90.0,37.0,43.0,43.0,43.0,1
1018,CC:2F:71:3F:1F:24,4813801,1570428505,972858,1086005387,3840943,484423118,108,802275,878046571,801503,877953337,772,93234,774770,15,973046,101805,105,605,115556.0,28889.0,-68.0,-69.0,-65.0,-69.0,-67.0,-69.0,-65.0,-69.0,-89.0,-91.0,-87.0,-90.0,21.0,22.0,22.0,21.0,1
1019,CC:2F:71:3E:C5:1F,3841871,484536291,927,113113,3840944,484423178,0,3876,325459,3197,244807,679,80652,982,11,1334,25,0,49,130000.0,39000.0,-76.0,-75.0,-72.0,-70.0,-72.0,-73.0,-69.0,-62.0,-89.0,-91.0,-87.0,-90.0,13.0,16.0,15.0,20.0,1
1020,BA:8C:B9:54:50:24,3845826,490611131,4880,6187751,3840946,484423380,0,9297,1720351,9275,1716856,22,3495,2354,17,5351,41,0,64,229410.0,130000.0,-48.0,-35.0,-43.0,-45.0,-46.0,-36.0,-44.0,-47.0,-89.0,-91.0,-87.0,-90.0,41.0,56.0,44.0,45.0,1
1021,62:47:05:9D:EB:15,3843063,486845230,2112,2421173,3840951,484424057,0,4253,3007425,4222,3002444,31,4981,2050,0,2158,55,0,105,216660.0,130000.0,-47.0,-45.0,-39.0,-46.0,-47.0,-46.0,-39.0,-47.0,-89.0,-91.0,-87.0,-90.0,42.0,46.0,48.0,44.0,1
1022,3C:55:76:E8:8F:1F,3913708,666428939,72757,182004882,3840951,484424057,30,35045,7179222,34564,7097118,481,82104,14869,39,72829,7137,30,456,286760.0,1000.0,-44.0,-56.0,-49.0,-39.0,-43.0,-55.0,-47.0,-38.0,-88.0,-90.0,-86.0,-89.0,44.0,34.0,37.0,50.0,1
1023,92:69:1D:31:68:E9,3844936,488063722,3985,3639665,3840951,484424057,0,5063,1129341,4907,1094013,156,35328,2164,11,4216,92,0,55,229410.0,130000.0,-52.0,-48.0,-44.0,-47.0,-54.0,-50.0,-46.0,-48.0,-88.0,-90.0,-86.0,-89.0,36.0,42.0,42.0,42.0,1
1024,CC:2F:71:3F:1F:24,4814033,1570708071,973082,1086284014,3840951,484424057,108,802484,878315742,801712,878222508,772,93234,774970,15,973270,101876,105,605,115556.0,28889.0,-67.0,-70.0,-65.0,-70.0,-67.0,-70.0,-65.0,-68.0,-88.0,-90.0,-86.0,-89.0,21.0,20.0,21.0,19.0,1
1025,CC:2F:71:3E:C5:1F,3841878,484537170,927,113113,3840951,484424057,0,3876,325459,3197,244807,679,80652,982,11,1334,25,0,49,130000.0,39000.0,-76.0,-75.0,-72.0,-70.0,-72.0,-73.0,-69.0,-62.0,-88.0,-90.0,-86.0,-89.0,12.0,15.0,14.0,19.0,1
1026,BA:8C:B9:54:50:24,3845831,490611808,4880,6187751,3840951,484424057,0,9297,1720351,9275,1716856,22,3495,2354,17,5351,41,0,64,229410.0,130000.0,-48.0,-35.0,-43.0,-45.0,-46.0,-36.0,-44.0,-47.0,-88.0,-90.0,-86.0,-89.0,40.0,55.0,43.0,44.0,1
1027,62:47:05:9D:EB:15,3843065,486845432,2112,2421173,3840953,484424259,0,4255,3007613,4224,3002632,31,4981,2051,0,2158,55,0,105,216660.0,130000.0,-47.0,-45.0,-39.0,-46.0,-47.0,-46.0,-39.0,-47.0,-88.0,-90.0,-86.0,-89.0,41.0,45.0,47.0,43.0,1
1028,3C:55:76:E8:8F:1F,3913710,666429141,72757,182004882,3840953,484424259,30,35045,7179222,34564,7097118,481,82104,14869,39,72829,7137,30,456,286760.0,1000.0,-44.0,-56.0,-49.0,-39.0,-43.0,-55.0,-47.0,-38.0,-88.0,-90.0,-86.0,-89.0,44.0,34.0,37.0,50.0,1
1029,92:69:1D:31:68:E9,3844942,488064328,3985,3639665,3840957,484424663,0,5063,1129341,4907,1094013,156,35328,2164,11,4216,92,0,55,229410.0,130000.0,-52.0,-48.0,-44.0,-47.0,-54.0,-50.0,-46.0,-48.0,-88.0,-90.0,-86.0,-89.0,36.0,42.0,42.0,42.0,1
1030,CC:2F:71:3F:1F:24,4814250,1570972107,973293,1086547444,3840957,484424663,108,802676,878564844,801904,878471610,772,93234,775157,15,973480,101924,105,605,115556.0,28889.0,-68.0,-71.0,-65.0,-71.0,-68.0,-70.0,-65.0,-69.0,-88.0,-90.0,-86.0,-89.0,20.0,19.0,21.0,18.0,1
1031,CC:2F:71:3E:C5:1F,3841884,484537776,927,113113,3840957,484424663,0,3876,325459,3197,244807,679,80652,982,11,1334,25,0,49,130000.0,39000.0,-76.0,-75.0,-72.0,-70.0,-72.0,-73.0,-69.0,-62.0,-88.0,-89.0,-85.0,-88.0,12.0,14.0,13.0,18.0,1
1032,BA:8C:B9:54:50:24,3845837,490612414,4880,6187751,3840957,484424663,0,9297,1720351,9275,1716856,22,3495,2354,17,5351,41,0,64,229410.0,130000.0,-48.0,-35.0,-43.0,-45.0,-46.0,-36.0,-44.0,-47.0,-88.0,-89.0,-85.0,-88.0,40.0,54.0,42.0,43.0,1
1033,62:47:05:9D:EB:15,3843072,486846098,2112,2421173,3840960,484424925,0,4255,3007613,4224,3002632,31,4981,2051,0,2158,55,0,105,216660.0,130000.0,-47.0,-45.0,-39.0,-46.0,-47.0,-46.0,-39.0,-47.0,-88.0,-89.0,-85.0,-88.0,41.0,44.0,46.0,42.0,1
1034,3C:55:76:E8:8F:1F,3913718,666430304,72758,182005379,3840960,484424925,30,35059,7183031,34578,7100927,481,82104,14874,39,72830,7138,30,456,243750.0,1000.0,-46.0,-50.0,-46.0,-41.0,-43.0,-52.0,-46.0,-38.0,-88.0,-89.0,-85.0,-88.0,42.0,39.0,39.0,47.0,1
1035,92:69:1D:31:68:E9,3844945,488064590,3985,3639665,3840960,484424925,0,5063,1129341,4907,1094013,156,35328,2164,11,4216,92,0,55,229410.0,130000.0,-52.0,-48.0,-44.0,-47.0,-54.0,-50.0,-46.0,-48.0,-88.0,-89.0,-85.0,-88.0,36.0,41.0,41.0,41.0,1
1036,CC:2F:71:3F:1F:24,4814930,1571832354,973970,1087407429,3840960,484424925,108,803109,878891185,802337,878797951,772,93234,775582,15,974158,102088,105,605,86667.0,14444.0,-69.0,-71.0,-66.0,-69.0,-68.0,-71.0,-66.0,-69.0,-88.0,-89.0,-85.0,-88.0,19.0,18.0,19.0,19.0,1
1037,CC:2F:71:3E:C5:1F,3841887,484538038,927,113113,3840960,484424925,0,3876,325459,3197,244807,679,80652,982,11,1334,25,0,49,130000.0,39000.0,-76.0,-75.0,-72.0,-70.0,-72.0,-73.0,-69.0,-62.0,-87.0,-88.0,-84.0,-87.0,11.0,13.0,12.0,17.0,1
1038,BA:8C:B9:54:50:24,3845841,490612738,4880,6187751,3840961,484424987,0,9297,1720351,9275,1716856,22,3495,2354,17,5351,41,0,64,229410.0,130000.0,-48.0,-35.0,-43.0,-45.0,-46.0,-36.0,-44.0,-47.0,-87.0,-88.0,-84.0,-87.0,39.0,53.0,41.0,42.0,1
1039,62:47:05:9D:EB:15,3843081,486846968,2112,2421173,3840969,484425795,0,4255,3007613,4224,3002632,31,4981,2051,0,2158,55,0,105,216660.0,130000.0,-47.0,-45.0,-39.0,-46.0,-47.0,-46.0,-39.0,-47.0,-87.0,-88.0,-84.0,-87.0,40.0,43.0,45.0,41.0,1
1040,3C:55:76:E8:8F:1F,3913739,666441121,72770,182015326,3840969,484425795,30,35085,7191700,34604,7109596,481,82104,14883,39,72842,7147,30,457,1000.0,1000.0,-47.0,-47.0,-45.0,-41.0,-44.0,-53.0,-45.0,-40.0,-87.0,-88.0,-84.0,-87.0,40.0,41.0,39.0,46.0,1
1041,92:69:1D:31:68:E9,3844955,488065613,3986,3639818,3840969,484425795,0,5069,1129858,4913,1094530,156,35328,2164,11,4217,92,0,55,1000.0,130000.0,-54.0,-47.0,-42.0,-49.0,-53.0,-47.0,-42.0,-48.0,-87.0,-88.0,-84.0,-87.0,33.0,41.0,42.0,38.0,1
1042,CC:2F:71:3F:1F:24,4815388,1572401444,974419,1087975649,3840969,484425795,108,803413,879164333,802640,879070981,773,93352,775878,15,974607,102089,105,605,86667.0,14444.0,-67.0,-71.0,-65.0,-71.0,-67.0,-70.0,-65.0,-69.0,-87.0,-88.0,-84.0,-87.0,20.0,17.0,19.0,16.0,1
1043,CC:2F:71:3E:C5:1F,3841897,484539061,928,113266,3840969,484425795,0,3879,325776,3200,245124,679,80652,982,11,1335,25,0,49,1000.0,39000.0,-71.0,-70.0,-68.0,-61.0,-71.0,-71.0,-68.0,-61.0,-87.0,-88.0,-84.0,-87.0,16.0,18.0,16.0,26.0,1
1044,BA:8C:B9:54:50:24,3845850,490613699,4881,6187904,3840969,484425795,0,9304,1720936,9282,1717441,22,3495,2354,17,5352,41,0,64,1000.0,130000.0,-48.0,-35.0,-43.0,-46.0,-45.0,-35.0,-44.0,-47.0,-87.0,-88.0,-84.0,-87.0,39.0,53.0,41.0,41.0,1
1045,62:47:05:9D:EB:15,3843085,486847446,2114,2421529,3840971,484425917,0,4260,3008114,4229,3003133,31,4981,2052,0,2160,55,0,105,216660.0,130000.0,-47.0,-45.0,-39.0,-46.0,-47.0,-45.0,-39.0,-46.0,-86.0,-87.0,-84.0,-86.0,39.0,42.0,45.0,40.0,1
1046,3C:55:76:E8:8F:1F,3913742,666441361,72771,182015444,3840971,484425917,30,35093,7192439,34612,7110335,481,82104,14886,39,72843,7147,30,457,195000.0,1000.0,-50.0,-53.0,-49.0,-44.0,-47.0,-49.0,-46.0,-42.0,-86.0,-87.0,-84.0,-86.0,36.0,34.0,35.0,42.0,1
1047,92:69:1D:31:68:E9,3844957,488065735,3986,3639818,3840971,484425917,0,5069,1129858,4913,1094530,156,35328,2164,11,4217,92,0,55,1000.0,130000.0,-54.0,-47.0,-42.0,-49.0,-53.0,-47.0,-42.0,-48.0,-86.0,-87.0,-84.0,-86.0,32.0,40.0,42.0,37.0,1
1048,CC:2F:71:3F:1F:24,4815958,1573109728,974987,1088683811,3840971,484425917,108,803780,879458193,803007,879364841,773,93352,776232,15,975175,102147,105,605,115556.0,28889.0,-68.0,-69.0,-66.0,-67.0,-67.0,-70.0,-65.0,-68.0,-86.0,-87.0,-84.0,-86.0,18.0,18.0,18.0,19.0,1
1049,CC:2F:71:3E:C5:1F,3841899,484539183,928,113266,3840971,484425917,0,3881,325964,3201,245194,680,80770,983,11,1335,25,0,50,1000.0,39000.0,-70.0,-70.0,-68.0,-60.0,-71.0,-71.0,-68.0,-62.0,-86.0,-87.0,-84.0,-86.0,16.0,17.0,16.0,26.0,1
1050,BA:8C:B9:54:50:24,3845854,490614023,4881,6187904,3840973,484426119,0,9304,1720936,9282,1717441,22,3495,2354,17,5352,41,0,64,1000.0,130000.0,-48.0,-35.0,-43.0,-46.0,-45.0,-35.0,-44.0,-47.0,-86.0,-87.0,-84.0,-86.0,38.0,52.0,41.0,40.0,1
1051,62:47:05:9D:EB:15,3843094,486848316,2114,2421529,3840980,484426787,0,4260,3008114,4229,3003133,31,4981,2052,0,2160,55,0,105,216660.0,130000.0,-47.0,-45.0,-39.0,-46.0,-47.0,-45.0,-39.0,-46.0,-86.0,-86.0,-83.0,-85.0,39.0,41.0,44.0,39.0,1
1052,3C:55:76:E8:8F:1F,3913752,666442347,72772,182015560,3840980,484426787,30,35106,7193413,34624,7111191,482,82222,14888,39,72844,7147,30,457,195000.0,97500.0,-48.0,-50.0,-49.0,-45.0,-48.0,-50.0,-49.0,-44.0,-86.0,-86.0,-83.0,-85.0,38.0,36.0,34.0,40.0,1
1053,92:69:1D:31:68:E9,3844966,488066605,3986,3639818,3840980,484426787,0,5069,1129858,4913,1094530,156,35328,2164,11,4217,92,0,55,1000.0,130000.0,-54.0,-47.0,-42.0,-49.0,-53.0,-47.0,-42.0,-48.0,-86.0,-86.0,-83.0,-85.0,32.0,39.0,41.0,36.0,1
1054,CC:2F:71:3F:1F:24,4816379,1573628994,975399,1089202207,3840980,484426787,108,804073,879729716,803300,879636364,773,93352,776511,15,975587,102244,105,605,86667.0,14444.0,-68.0,-68.0,-66.0,-69.0,-67.0,-69.0,-65.0,-69.0,-86.0,-86.0,-83.0,-85.0,18.0,18.0,17.0,16.0,1
1055,CC:2F:71:3E:C5:1F,3841908,484540053,928,113266,3840980,484426787,0,3881,325964,3201,245194,680,80770,983,11,1335,25,0,50,1000.0,39000.0,-70.0,-70.0,-68.0,-60.0,-71.0,-71.0,-68.0,-62.0,-86.0,-86.0,-83.0,-85.0,16.0,16.0,15.0,25.0,1
1056,BA:8C:B9:54:50:24,3845861,490614691,4881,6187904,3840980,484426787,0,9304,1720936,9282,1717441,22,3495,2354,17,5352,41,0,64,1000.0,130000.0,-48.0,-35.0,-43.0,-46.0,-45.0,-35.0,-44.0,-47.0,-86.0,-86.0,-83.0,-85.0,38.0,51.0,40.0,39.0,1
1057,62:47:05:9D:EB:15,3843097,486848578,2114,2421529,3840983,484427049,0,4260,3008114,4229,3003133,31,4981,2052,0,2160,55,0,105,216660.0,130000.0,-47.0,-45.0,-39.0,-46.0,-47.0,-45.0,-39.0,-46.0,-85.0,-85.0,-82.0,-84.0,38.0,40.0,43.0,38.0,1
1058,3C:55:76:E8:8F:1F,3914865,669387397,73880,184960146,3840985,484427251,30,35343,7232399,34861,7150177,482,82222,14978,39,73952,7238,30,465,195000.0,1000.0,-49.0,-52.0,-47.0,-46.0,-48.0,-52.0,-47.0,-45.0,-85.0,-85.0,-82.0,-84.0,36.0,33.0,35.0,38.0,1
1059,92:69:1D:31:68:E9,3844971,488067069,3986,3639818,3840985,484427251,0,5070,1129926,4914,1094598,156,35328,2164,11,4217,92,0,55,1000.0,130000.0,-52.0,-47.0,-44.0,-46.0,-53.0,-47.0,-42.0,-48.0,-85.0,-85.0,-82.0,-84.0,33.0,38.0,38.0,38.0,1
1060,CC:2F:71:3F:1F:24,4817012,1574436069,976025,1090008616,3840987,484427453,108,804484,880068018,803711,879974666,773,93352,776907,15,976213,102308,105,605,115556.0,28889.0,-67.0,-71.0,-65.0,-71.0,-67.0,-70.0,-65.0,-68.0,-85.0,-85.0,-82.0,-84.0,18.0,14.0,17.0,13.0,1
1061,CC:2F:71:3E:C5:1F,3841917,484540921,928,113266,3840989,484427655,0,3881,325964,3201,245194,680,80770,983,11,1335,25,0,50,1000.0,39000.0,-70.0,-70.0,-68.0,-60.0,-71.0,-71.0,-68.0,-62.0,-85.0,-85.0,-82.0,-84.0,15.0,15.0,14.0,24.0,1
1062,BA:8C:B9:54:50:24,3845870,490615559,4881,6187904,3840989,484427655,0,9304,1720936,9282,1717441,22,3495,2354,17,5352,41,0,64,1000.0,130000.0,-48.0,-35.0,-43.0,-46.0,-45.0,-35.0,-44.0,-47.0,-85.0,-85.0,-82.0,-84.0,37.0,50.0,39.0,38.0,1
1063,62:47:05:9D:EB:15,3843103,486849184,2114,2421529,3840989,484427655,0,4260,3008114,4229,3003133,31,4981,2052,0,2160,55,0,105,216660.0,130000.0,-47.0,-45.0,-39.0,-46.0,-47.0,-45.0,-39.0,-46.0,-85.0,-85.0,-81.0,-82.0,38.0,40.0,42.0,36.0,1
1064,3C:55:76:E8:8F:1F,3914870,669387911,73881,184960256,3840989,484427655,30,35355,7233350,34873,7151128,482,82222,14980,39,73953,7238,30,465,162500.0,1000.0,-46.0,-51.0,-45.0,-42.0,-45.0,-50.0,-46.0,-40.0,-85.0,-85.0,-81.0,-82.0,39.0,34.0,36.0,40.0,1
1065,92:69:1D:31:68:E9,3844975,488067473,3986,3639818,3840989,484427655,0,5070,1129926,4914,1094598,156,35328,2164,11,4217,92,0,55,1000.0,130000.0,-52.0,-47.0,-44.0,-46.0,-53.0,-47.0,-42.0,-48.0,-85.0,-85.0,-81.0,-82.0,33.0,38.0,37.0,36.0,1
1066,CC:2F:71:3F:1F:24,4817620,1575200552,976631,1090772897,3840989,484427655,108,804857,880354800,804084,880261448,773,93352,777276,15,976819,102414,105,605,86667.0,14444.0,-67.0,-71.0,-65.0,-71.0,-67.0,-70.0,-65.0,-69.0,-85.0,-85.0,-81.0,-82.0,18.0,14.0,16.0,11.0,1
1067,CC:2F:71:3E:C5:1F,3841917,484540921,928,113266,3840989,484427655,0,3881,325964,3201,245194,680,80770,983,11,1335,25,0,50,1000.0,39000.0,-70.0,-70.0,-68.0,-60.0,-71.0,-71.0,-68.0,-62.0,-85.0,-85.0,-81.0,-82.0,15.0,15.0,13.0,22.0,1
1068,BA:8C:B9:54:50:24,3845870,490615559,4881,6187904,3840989,484427655,0,9304,1720936,9282,1717441,22,3495,2354,17,5352,41,0,64,1000.0,130000.0,-48.0,-35.0,-43.0,-46.0,-45.0,-35.0,-44.0,-47.0,-85.0,-85.0,-81.0,-82.0,37.0,50.0,38.0,36.0,1
1069,62:47:05:9D:EB:15,3843112,486850052,2114,2421529,3840998,484428523,0,4260,3008114,4229,3003133,31,4981,2052,0,2160,55,0,105,216660.0,130000.0,-47.0,-45.0,-39.0,-46.0,-47.0,-45.0,-39.0,-46.0,-85.0,-85.0,-81.0,-82.0,38.0,40.0,42.0,36.0,1
1070,3C:55:76:E8:8F:1F,3914879,669388779,73881,184960256,3840998,484428523,30,35359,7233624,34877,7151402,482,82222,14980,39,73953,7238,30,465,162500.0,1000.0,-48.0,-49.0,-47.0,-44.0,-47.0,-48.0,-46.0,-42.0,-85.0,-85.0,-81.0,-82.0,37.0,36.0,34.0,38.0,1
1071,92:69:1D:31:68:E9,3844984,488068341,3986,3639818,3840998,484428523,0,5070,1129926,4914,1094598,156,35328,2164,11,4217,92,0,55,1000.0,130000.0,-52.0,-47.0,-44.0,-46.0,-53.0,-47.0,-42.0,-48.0,-85.0,-85.0,-81.0,-82.0,33.0,38.0,37.0,36.0,1
1072,CC:2F:71:3F:1F:24,4818037,1575713163,977039,1091284640,3840998,484428523,108,805142,880624511,804369,880531159,773,93352,777555,15,977227,102434,105,605,86667.0,14444.0,-67.0,-70.0,-65.0,-71.0,-67.0,-69.0,-65.0,-69.0,-85.0,-85.0,-81.0,-82.0,18.0,15.0,16.0,11.0,1
1073,CC:2F:71:3E:C5:1F,3841926,484541789,928,113266,3840998,484428523,0,3881,325964,3201,245194,680,80770,983,11,1335,25,0,50,1000.0,39000.0,-70.0,-70.0,-68.0,-60.0,-71.0,-71.0,-68.0,-62.0,-85.0,-85.0,-81.0,-82.0,15.0,15.0,13.0,22.0,1
1074,BA:8C:B9:54:50:24,3845879,490616427,4881,6187904,3840998,484428523,0,9304,1720936,9282,1717441,22,3495,2354,17,5352,41,0,64,1000.0,130000.0,-48.0,-35.0,-43.0,-46.0,-45.0,-35.0,-44.0,-47.0,-85.0,-85.0,-81.0,-82.0,37.0,50.0,38.0,36.0,1
1075,62:47:05:9D:EB:15,3843124,486855651,2114,2421529,3841010,484434122,0,4260,3008114,4229,3003133,31,4981,2052,0,2160,55,0,105,216660.0,130000.0,-47.0,-45.0,-39.0,-46.0,-47.0,-45.0,-39.0,-46.0,-84.0,-84.0,-80.0,-81.0,37.0,39.0,41.0,35.0,1
1076,3C:55:76:E8:8F:1F,3914891,669394378,73881,184960256,3841010,484434122,30,35363,7233965,34881,7151743,482,82222,14981,39,73953,7238,30,465,162500.0,1000.0,-43.0,-51.0,-46.0,-38.0,-46.0,-50.0,-46.0,-41.0,-84.0,-84.0,-80.0,-81.0,41.0,33.0,34.0,43.0,1
1077,92:69:1D:31:68:E9,3845007,488079364,3986,3639818,3841021,484439546,0,5073,1130297,4916,1094734,157,35563,2165,11,4217,92,0,55,1000.0,130000.0,-53.0,-47.0,-42.0,-48.0,-53.0,-47.0,-43.0,-48.0,-84.0,-84.0,-80.0,-81.0,31.0,37.0,38.0,33.0,1
1078,CC:2F:71:3F:1F:24,4818289,1576014860,977268,1091575314,3841021,484439546,108,805367,880921953,804594,880828601,773,93352,777765,15,977456,102462,105,605,115556.0,28889.0,-68.0,-70.0,-66.0,-69.0,-67.0,-69.0,-65.0,-68.0,-84.0,-84.0,-80.0,-81.0,16.0,14.0,14.0,12.0,1
1079,CC:2F:71:3E:C5:1F,3841949,484552812,928,113266,3841021,484439546,0,3881,325964,3201,245194,680,80770,983,11,1335,25,0,50,1000.0,39000.0,-70.0,-70.0,-68.0,-60.0,-71.0,-71.0,-68.0,-62.0,-84.0,-84.0,-80.0,-81.0,14.0,14.0,12.0,21.0,1
1080,BA:8C:B9:54:50:24,3845904,490627652,4881,6187904,3841023,484439748,0,9304,1720936,9282,1717441,22,3495,2354,17,5352,41,0,64,1000.0,130000.0,-48.0,-35.0,-43.0,-46.0,-45.0,-35.0,-44.0,-47.0,-84.0,-84.0,-80.0,-81.0,36.0,49.0,37.0,35.0,1
1081,62:47:05:9D:EB:15,3843143,486861883,2114,2421529,3841029,484440354,0,4260,3008114,4229,3003133,31,4981,2052,0,2160,55,0,105,216660.0,130000.0,-47.0,-45.0,-39.0,-46.0,-47.0,-45.0,-39.0,-46.0,-83.0,-83.0,-79.0,-80.0,36.0,38.0,40.0,34.0,1
1082,3C:55:76:E8:8F:1F,3914910,669400610,73881,184960256,3841029,484440354,30,35372,7234579,34890,7152357,482,82222,14981,39,73953,7238,30,465,162500.0,1000.0,-46.0,-54.0,-48.0,-41.0,-45.0,-53.0,-47.0,-41.0,-83.0,-83.0,-79.0,-80.0,37.0,29.0,31.0,39.0,1
1083,92:69:1D:31:68:E9,3845015,488080172,3986,3639818,3841029,484440354,0,5073,1130297,4916,1094734,157,35563,2165,11,4217,92,0,55,1000.0,130000.0,-53.0,-47.0,-42.0,-48.0,-53.0,-47.0,-43.0,-48.0,-83.0,-83.0,-79.0,-80.0,30.0,36.0,37.0,32.0,1
1084,CC:2F:71:3F:1F:24,4818506,1576275680,977476,1091835266,3841030,484440414,108,805558,881178389,804785,881085037,773,93352,777947,15,977664,102506,105,605,115556.0,28889.0,-68.0,-69.0,-66.0,-69.0,-67.0,-69.0,-65.0,-69.0,-83.0,-83.0,-79.0,-80.0,15.0,14.0,13.0,11.0,1
1085,CC:2F:71:3E:C5:1F,3841958,484553680,928,113266,3841030,484440414,0,3881,325964,3201,245194,680,80770,983,11,1335,25,0,50,1000.0,39000.0,-70.0,-70.0,-68.0,-60.0,-71.0,-71.0,-68.0,-62.0,-83.0,-83.0,-79.0,-80.0,13.0,13.0,11.0,20.0,1
1086,BA:8C:B9:54:50:24,3845911,490628318,4881,6187904,3841030,484440414,0,9304,1720936,9282,1717441,22,3495,2354,17,5352,41,0,64,1000.0,130000.0,-48.0,-35.0,-43.0,-46.0,-45.0,-35.0,-44.0,-47.0,-83.0,-83.0,-79.0,-80.0,35.0,48.0,36.0,34.0,1
1087,62:47:05:9D:EB:15,3843191,486866864,2114,2421529,3841077,484445335,0,4269,3008726,4238,3003745,31,4981,2052,0,2160,55,0,105,216660.0,130000.0,-46.0,-45.0,-39.0,-46.0,-46.0,-45.0,-38.0,-46.0,-83.0,-82.0,-78.0,-79.0,37.0,37.0,39.0,33.0,1
1088,3C:55:76:E8:8F:1F,3915012,669424332,73935,184978997,3841077,484445335,38,35465,7263323,34983,7181101,482,82222,15021,39,73992,7238,38,471,162500.0,48750.0,-46.0,-53.0,-44.0,-42.0,-46.0,-54.0,-48.0,-41.0,-83.0,-82.0,-78.0,-79.0,37.0,29.0,34.0,37.0,1
1089,92:69:1D:31:68:E9,3845063,488085153,3986,3639818,3841077,484445335,0,5085,1131113,4928,1095550,157,35563,2165,11,4217,92,0,55,1000.0,130000.0,-53.0,-47.0,-43.0,-49.0,-52.0,-47.0,-42.0,-48.0,-83.0,-82.0,-78.0,-79.0,30.0,35.0,35.0,30.0,1
1090,CC:2F:71:3F:1F:24,4820429,1578910076,979352,1094464741,3841077,484445335,364,807380,883614519,806607,883521167,773,93352,779718,15,979287,103197,361,614,115556.0,28889.0,-68.0,-70.0,-66.0,-70.0,-68.0,-69.0,-65.0,-68.0,-83.0,-82.0,-78.0,-79.0,15.0,12.0,12.0,9.0,1
1091,CC:2F:71:3E:C5:1F,3842005,484558601,928,113266,3841077,484445335,0,3881,325964,3201,245194,680,80770,983,11,1335,25,0,50,1000.0,39000.0,-70.0,-70.0,-68.0,-60.0,-71.0,-71.0,-68.0,-62.0,-83.0,-82.0,-78.0,-79.0,13.0,12.0,10.0,19.0,1
1092,BA:8C:B9:54:50:24,3845958,490633239,4881,6187904,3841077,484445335,0,9325,1722364,9303,1718869,22,3495,2354,17,5352,41,0,64,1000.0,130000.0,-40.0,-37.0,-46.0,-51.0,-43.0,-36.0,-44.0,-49.0,-83.0,-82.0,-78.0,-79.0,43.0,45.0,32.0,28.0,1
1093,62:47:05:9D:EB:15,3843200,486867742,2114,2421529,3841086,484446213,0,4269,3008726,4238,3003745,31,4981,2052,0,2160,55,0,105,216660.0,130000.0,-46.0,-45.0,-39.0,-46.0,-46.0,-45.0,-38.0,-46.0,-82.0,-81.0,-77.0,-78.0,36.0,36.0,38.0,32.0,1
1094,3C:55:76:E8:8F:1F,3915035,669444759,73949,184998546,3841086,484446213,38,35483,7272360,35000,7190012,483,82348,15034,39,74006,7238,38,473,172050.0,48750.0,-49.0,-58.0,-51.0,-44.0,-47.0,-54.0,-46.0,-43.0,-82.0,-81.0,-77.0,-78.0,33.0,23.0,26.0,34.0,1
1095,92:69:1D:31:68:E9,3845073,488086147,3987,3639934,3841086,484446213,0,5087,1131249,4930,1095686,157,35563,2165,11,4218,92,0,55,229410.0,130000.0,-52.0,-48.0,-44.0,-47.0,-52.0,-47.0,-42.0,-48.0,-82.0,-81.0,-77.0,-78.0,30.0,33.0,33.0,31.0,1
1096,CC:2F:71:3F:1F:24,4820655,1579179461,979569,1094733248,3841086,484446213,364,807572,883866834,806799,883773482,773,93352,779907,15,979504,103209,361,614,115556.0,28889.0,-68.0,-71.0,-66.0,-69.0,-68.0,-70.0,-65.0,-68.0,-82.0,-81.0,-77.0,-78.0,14.0,10.0,11.0,9.0,1
1097,CC:2F:71:3E:C5:1F,3842019,484560312,933,114099,3841086,484446213,0,3887,326779,3207,246009,680,80770,988,11,1340,25,0,51,130000.0,39000.0,-71.0,-70.0,-68.0,-60.0,-71.0,-71.0,-68.0,-62.0,-82.0,-81.0,-77.0,-78.0,11.0,11.0,9.0,18.0,1
1098,BA:8C:B9:54:50:24,3845969,490634295,4882,6188020,3841087,484446275,0,9327,1722500,9305,1719005,22,3495,2354,17,5353,41,0,64,229410.0,130000.0,-48.0,-35.0,-43.0,-45.0,-44.0,-36.0,-44.0,-48.0,-82.0,-81.0,-77.0,-78.0,34.0,46.0,34.0,33.0,1
1099,62:47:05:9D:EB:15,3843202,486867920,2115,2421645,3841087,484446275,0,4271,3008862,4240,3003881,31,4981,2052,0,2161,56,0,105,216660.0,130000.0,-47.0,-46.0,-39.0,-46.0,-46.0,-45.0,-39.0,-46.0,-81.0,-80.0,-76.0,-77.0,34.0,34.0,37.0,31.0,1
1100,3C:55:76:E8:8F:1F,3915043,669447702,73956,185001427,3841087,484446275,38,35490,7273108,35007,7190760,483,82348,15038,39,74013,7239,38,473,172050.0,48750.0,-46.0,-53.0,-44.0,-42.0,-47.0,-55.0,-47.0,-43.0,-81.0,-80.0,-76.0,-77.0,35.0,27.0,32.0,35.0,1
1101,92:69:1D:31:68:E9,3845076,488086411,3987,3639934,3841089,484446477,0,5087,1131249,4930,1095686,157,35563,2165,11,4218,92,0,55,229410.0,130000.0,-52.0,-48.0,-44.0,-47.0,-52.0,-47.0,-42.0,-48.0,-81.0,-80.0,-76.0,-77.0,29.0,32.0,32.0,30.0,1
1102,CC:2F:71:3F:1F:24,4821037,1579659437,979947,1095212900,3841090,484446537,364,807840,884138846,807066,884045376,774,93470,780169,15,979882,103258,361,614,115556.0,28889.0,-68.0,-70.0,-65.0,-69.0,-68.0,-70.0,-65.0,-68.0,-81.0,-80.0,-76.0,-77.0,13.0,10.0,11.0,8.0,1
1103,CC:2F:71:3E:C5:1F,3842023,484560636,933,114099,3841090,484446537,0,3887,326779,3207,246009,680,80770,988,11,1340,25,0,51,130000.0,39000.0,-71.0,-70.0,-68.0,-60.0,-71.0,-71.0,-68.0,-62.0,-81.0,-80.0,-76.0,-77.0,10.0,10.0,8.0,17.0,1
1104,BA:8C:B9:54:50:24,3845974,490634759,4882,6188020,3841092,484446739,0,9327,1722500,9305,1719005,22,3495,2354,17,5353,41,0,64,229410.0,130000.0,-48.0,-35.0,-43.0,-45.0,-44.0,-36.0,-44.0,-48.0,-81.0,-80.0,-76.0,-77.0,33.0,45.0,33.0,32.0,1
1105,62:47:05:9D:EB:15,3843213,486869123,2115,2421645,3841098,484447478,0,4271,3008862,4240,3003881,31,4981,2052,0,2161,56,0,105,216660.0,130000.0,-47.0,-46.0,-39.0,-46.0,-46.0,-45.0,-39.0,-46.0,-81.0,-80.0,-76.0,-77.0,34.0,34.0,37.0,31.0,1
1106,3C:55:76:E8:8F:1F,3915055,669449032,73957,185001554,3841098,484447478,38,35495,7273450,35012,7191102,483,82348,15038,39,74014,7241,38,473,172050.0,48750.0,-49.0,-58.0,-51.0,-44.0,-47.0,-56.0,-50.0,-42.0,-81.0,-79.0,-75.0,-76.0,32.0,21.0,24.0,32.0,1
1107,92:69:1D:31:68:E9,3845085,488087412,3987,3639934,3841098,484447478,0,5087,1131249,4930,1095686,157,35563,2165,11,4218,92,0,55,229410.0,130000.0,-52.0,-48.0,-44.0,-47.0,-52.0,-47.0,-42.0,-48.0,-81.0,-79.0,-75.0,-76.0,29.0,31.0,31.0,29.0,1
1108,CC:2F:71:3F:1F:24,4821488,1580212016,980390,1095764538,3841098,484447478,364,808143,884407063,807369,884313593,774,93470,780467,15,980325,103304,361,614,115556.0,28889.0,-68.0,-70.0,-66.0,-69.0,-68.0,-69.0,-65.0,-68.0,-81.0,-79.0,-75.0,-76.0,13.0,9.0,9.0,7.0,1
1109,CC:2F:71:3E:C5:1F,3842031,484561577,933,114099,3841098,484447478,0,3889,326967,3208,246079,681,80888,989,11,1340,25,0,52,130000.0,39000.0,-76.0,-76.0,-70.0,-68.0,-71.0,-71.0,-68.0,-62.0,-81.0,-79.0,-75.0,-76.0,5.0,3.0,5.0,8.0,1
1110,BA:8C:B9:54:50:24,3845980,490635498,4882,6188020,3841098,484447478,0,9328,1722568,9306,1719073,22,3495,2354,17,5353,41,0,64,229410.0,130000.0,-48.0,-35.0,-43.0,-45.0,-44.0,-36.0,-44.0,-48.0,-81.0,-79.0,-75.0,-76.0,33.0,44.0,32.0,31.0,1
1111,62:47:05:9D:EB:15,3843216,486869387,2115,2421645,3841101,484447742,0,4271,3008862,4240,3003881,31,4981,2052,0,2161,56,0,105,216660.0,130000.0,-47.0,-46.0,-39.0,-46.0,-46.0,-45.0,-39.0,-46.0,-81.0,-79.0,-75.0,-76.0,34.0,33.0,36.0,30.0,1
1112,3C:55:76:E8:8F:1F,3915072,669454698,73969,185006754,3841103,484447944,38,35517,7277453,35033,7194987,484,82466,15047,39,74026,7241,38,473,172050.0,51610.0,-46.0,-53.0,-44.0,-42.0,-47.0,-56.0,-49.0,-42.0,-81.0,-79.0,-75.0,-76.0,35.0,26.0,31.0,34.0,1
1113,92:69:1D:31:68:E9,3845090,488087878,3987,3639934,3841103,484447944,0,5087,1131249,4930,1095686,157,35563,2165,11,4218,92,0,55,229410.0,130000.0,-52.0,-48.0,-44.0,-47.0,-52.0,-47.0,-42.0,-48.0,-81.0,-79.0,-75.0,-76.0,29.0,31.0,31.0,29.0,1
1114,CC:2F:71:3F:1F:24,4821901,1580722233,980796,1096274087,3841105,484448146,364,808418,884664651,807644,884571181,774,93470,780738,15,980731,103361,361,615,104000.0,26000.0,-68.0,-70.0,-66.0,-68.0,-68.0,-69.0,-65.0,-68.0,-80.0,-79.0,-75.0,-75.0,12.0,9.0,9.0,7.0,1
1115,CC:2F:71:3E:C5:1F,3842040,484562447,933,114099,3841107,484448348,0,3889,326967,3208,246079,681,80888,989,11,1340,25,0,52,130000.0,39000.0,-76.0,-76.0,-70.0,-68.0,-71.0,-71.0,-68.0,-62.0,-80.0,-79.0,-75.0,-75.0,4.0,3.0,5.0,7.0,1
1116,BA:8C:B9:54:50:24,3845989,490636368,4882,6188020,3841107,484448348,0,9328,1722568,9306,1719073,22,3495,2354,17,5353,41,0,64,229410.0,130000.0,-48.0,-35.0,-43.0,-45.0,-44.0,-36.0,-44.0,-48.0,-80.0,-79.0,-75.0,-75.0,32.0,44.0,32.0,30.0,1
1117,62:47:05:9D:EB:15,3843223,486870053,2115,2421645,3841108,484448408,0,4271,3008862,4240,3003881,31,4981,2052,0,2161,56,0,105,216660.0,130000.0,-47.0,-46.0,-39.0,-46.0,-46.0,-45.0,-39.0,-46.0,-80.0,-79.0,-75.0,-75.0,33.0,33.0,36.0,29.0,1
1118,3C:55:76:E8:8F:1F,3915080,669455795,73972,185007387,3841108,484448408,38,35527,7278518,35043,7196052,484,82466,15050,39,74029,7241,38,473,195000.0,97500.0,-48.0,-57.0,-51.0,-44.0,-46.0,-55.0,-48.0,-42.0,-80.0,-79.0,-75.0,-75.0,32.0,22.0,24.0,31.0,1
1119,92:69:1D:31:68:E9,3845095,488088342,3987,3639934,3841108,484448408,0,5087,1131249,4930,1095686,157,35563,2165,11,4218,92,0,55,229410.0,130000.0,-52.0,-48.0,-44.0,-47.0,-52.0,-47.0,-42.0,-48.0,-80.0,-79.0,-75.0,-75.0,28.0,31.0,31.0,28.0,1
1120,CC:2F:71:3F:1F:24,4822124,1581000327,981016,1096551919,3841108,484448408,364,808618,884930759,807844,884837289,774,93470,780937,15,980951,103386,361,618,65000.0,14444.0,-68.0,-70.0,-66.0,-69.0,-68.0,-69.0,-66.0,-68.0,-80.0,-79.0,-75.0,-75.0,12.0,9.0,9.0,6.0,1
1121,CC:2F:71:3E:C5:1F,3842041,484562507,933,114099,3841108,484448408,0,3889,326967,3208,246079,681,80888,989,11,1340,25,0,52,130000.0,39000.0,-76.0,-76.0,-70.0,-68.0,-71.0,-71.0,-68.0,-62.0,-80.0,-79.0,-75.0,-75.0,4.0,3.0,5.0,7.0,1
1122,BA:8C:B9:54:50:24,3845990,490636428,4882,6188020,3841108,484448408,0,9328,1722568,9306,1719073,22,3495,2354,17,5353,41,0,64,229410.0,130000.0,-48.0,-35.0,-43.0,-45.0,-44.0,-36.0,-44.0,-48.0,-80.0,-79.0,-75.0,-75.0,32.0,44.0,32.0,30.0,1
1123,62:47:05:9D:EB:15,3843229,486870659,2115,2421645,3841114,484449014,0,4271,3008862,4240,3003881,31,4981,2052,0,2161,56,0,105,216660.0,130000.0,-47.0,-46.0,-39.0,-46.0,-46.0,-45.0,-39.0,-46.0,-80.0,-79.0,-75.0,-75.0,33.0,33.0,36.0,29.0,1
1124,3C:55:76:E8:8F:1F,3915088,669456603,73972,185007387,3841116,484449216,38,35528,7278588,35044,7196122,484,82466,15050,39,74029,7241,38,473,195000.0,97500.0,-45.0,-55.0,-51.0,-41.0,-46.0,-55.0,-49.0,-41.0,-80.0,-79.0,-75.0,-75.0,35.0,24.0,24.0,34.0,1
1125,92:69:1D:31:68:E9,3845103,488089150,3987,3639934,3841116,484449216,0,5087,1131249,4930,1095686,157,35563,2165,11,4218,92,0,55,229410.0,130000.0,-52.0,-48.0,-44.0,-47.0,-52.0,-47.0,-42.0,-48.0,-80.0,-79.0,-75.0,-75.0,28.0,31.0,31.0,28.0,1
1126,CC:2F:71:3F:1F:24,4822342,1581263987,981226,1096814771,3841116,484449216,364,808808,885184147,808034,885090677,774,93470,781122,15,981161,103405,361,620,115556.0,28889.0,-68.0,-70.0,-65.0,-69.0,-68.0,-69.0,-65.0,-69.0,-80.0,-79.0,-75.0,-75.0,12.0,9.0,10.0,6.0,1
1127,CC:2F:71:3E:C5:1F,3842049,484563315,933,114099,3841116,484449216,0,3889,326967,3208,246079,681,80888,989,11,1340,25,0,52,130000.0,39000.0,-76.0,-76.0,-70.0,-68.0,-71.0,-71.0,-68.0,-62.0,-80.0,-79.0,-75.0,-75.0,4.0,3.0,5.0,7.0,1
1128,BA:8C:B9:54:50:24,3845998,490637236,4882,6188020,3841116,484449216,0,9328,1722568,9306,1719073,22,3495,2354,17,5353,41,0,64,229410.0,130000.0,-48.0,-35.0,-43.0,-45.0,-44.0,-36.0,-44.0,-48.0,-80.0,-79.0,-75.0,-75.0,32.0,44.0,32.0,30.0,1
1129,62:47:05:9D:EB:15,3843232,486870921,2115,2421645,3841117,484449276,0,4271,3008862,4240,3003881,31,4981,2052,0,2161,56,0,105,216660.0,130000.0,-47.0,-46.0,-39.0,-46.0,-46.0,-45.0,-39.0,-46.0,-80.0,-79.0,-75.0,-75.0,33.0,33.0,36.0,29.0,1
1130,3C:55:76:E8:8F:1F,3915089,669456663,73972,185007387,3841117,484449276,38,35528,7278588,35044,7196122,484,82466,15050,39,74029,7241,38,473,195000.0,97500.0,-45.0,-55.0,-51.0,-41.0,-46.0,-55.0,-49.0,-41.0,-80.0,-79.0,-75.0,-75.0,35.0,24.0,24.0,34.0,1
1131,92:69:1D:31:68:E9,3845104,488089210,3987,3639934,3841117,484449276,0,5087,1131249,4930,1095686,157,35563,2165,11,4218,92,0,55,229410.0,130000.0,-52.0,-48.0,-44.0,-47.0,-52.0,-47.0,-42.0,-48.0,-80.0,-79.0,-75.0,-75.0,28.0,31.0,31.0,28.0,1
1132,CC:2F:71:3F:1F:24,4822558,1581527712,981441,1097078436,3841117,484449276,364,809004,885434498,808230,885341028,774,93470,781312,15,981376,103425,361,620,115556.0,28889.0,-68.0,-70.0,-66.0,-69.0,-68.0,-70.0,-66.0,-68.0,-80.0,-79.0,-75.0,-75.0,12.0,9.0,9.0,6.0,1
1133,CC:2F:71:3E:C5:1F,3842054,484563809,935,114331,3841119,484449478,0,3894,327389,3213,246501,681,80888,991,11,1342,25,0,52,130000.0,39000.0,-71.0,-70.0,-69.0,-60.0,-70.0,-70.0,-68.0,-61.0,-80.0,-79.0,-75.0,-75.0,9.0,9.0,6.0,15.0,1
1134,BA:8C:B9:54:50:24,3846001,490637498,4882,6188020,3841119,484449478,0,9328,1722568,9306,1719073,22,3495,2354,17,5353,41,0,64,229410.0,130000.0,-48.0,-35.0,-43.0,-45.0,-44.0,-36.0,-44.0,-48.0,-80.0,-79.0,-75.0,-75.0,32.0,44.0,32.0,30.0,1
1135,62:47:05:9D:EB:15,3843240,486871729,2115,2421645,3841125,484450084,0,4271,3008862,4240,3003881,31,4981,2052,0,2161,56,0,105,216660.0,130000.0,-47.0,-46.0,-39.0,-46.0,-46.0,-45.0,-39.0,-46.0,-80.0,-79.0,-75.0,-75.0,33.0,33.0,36.0,29.0,1
1136,3C:55:76:E8:8F:1F,3915098,669457727,73973,185007643,3841125,484450084,38,35536,7279262,35052,7196796,484,82466,15052,39,74030,7242,38,473,195000.0,97500.0,-45.0,-54.0,-49.0,-40.0,-45.0,-53.0,-47.0,-40.0,-80.0,-79.0,-75.0,-75.0,35.0,25.0,26.0,35.0,1
1137,92:69:1D:31:68:E9,3845112,488090018,3987,3639934,3841125,484450084,0,5087,1131249,4930,1095686,157,35563,2165,11,4218,92,0,55,229410.0,130000.0,-52.0,-48.0,-44.0,-47.0,-52.0,-47.0,-42.0,-48.0,-80.0,-79.0,-75.0,-75.0,28.0,31.0,31.0,28.0,1
1138,CC:2F:71:3F:1F:24,4822992,1582060403,981867,1097610319,3841125,484450084,364,809292,885697037,808518,885603567,774,93470,781598,15,981797,103495,361,620,115556.0,28889.0,-68.0,-70.0,-66.0,-68.0,-68.0,-70.0,-66.0,-68.0,-80.0,-79.0,-75.0,-75.0,12.0,9.0,9.0,7.0,1
1139,CC:2F:71:3E:C5:1F,3842060,484564415,935,114331,3841125,484450084,0,3894,327389,3213,246501,681,80888,991,11,1342,25,0,52,130000.0,39000.0,-71.0,-70.0,-69.0,-60.0,-70.0,-70.0,-68.0,-61.0,-80.0,-79.0,-75.0,-75.0,9.0,9.0,6.0,15.0,1
1140,BA:8C:B9:54:50:24,3846007,490638104,4882,6188020,3841125,484450084,0,9328,1722568,9306,1719073,22,3495,2354,17,5353,41,0,64,229410.0,130000.0,-48.0,-35.0,-43.0,-45.0,-44.0,-36.0,-44.0,-48.0,-80.0,-79.0,-75.0,-75.0,32.0,44.0,32.0,30.0,1
1141,62:47:05:9D:EB:15,3843243,486871991,2115,2421645,3841128,484450346,0,4271,3008862,4240,3003881,31,4981,2052,0,2161,56,0,105,216660.0,130000.0,-47.0,-46.0,-39.0,-46.0,-46.0,-45.0,-39.0,-46.0,-80.0,-79.0,-75.0,-75.0,33.0,33.0,36.0,29.0,1
1142,3C:55:76:E8:8F:1F,3915101,669457989,73973,185007643,3841128,484450346,38,35536,7279262,35052,7196796,484,82466,15052,39,74030,7242,38,473,195000.0,97500.0,-45.0,-54.0,-49.0,-40.0,-45.0,-53.0,-47.0,-40.0,-80.0,-79.0,-75.0,-75.0,35.0,25.0,26.0,35.0,1
1143,92:69:1D:31:68:E9,3845115,488090280,3987,3639934,3841128,484450346,0,5087,1131249,4930,1095686,157,35563,2165,11,4218,92,0,55,229410.0,130000.0,-52.0,-48.0,-44.0,-47.0,-52.0,-47.0,-42.0,-48.0,-80.0,-79.0,-75.0,-75.0,28.0,31.0,31.0,28.0,1
1144,CC:2F:71:3F:1F:24,4823599,1582787320,982471,1098336974,3841128,484450346,364,809678,885990905,808904,885897435,774,93470,781978,15,982401,103581,361,620,115556.0,28889.0,-68.0,-70.0,-66.0,-69.0,-68.0,-70.0,-66.0,-68.0,-80.0,-79.0,-75.0,-75.0,12.0,9.0,9.0,6.0,1
1145,CC:2F:71:3E:C5:1F,3842065,484564879,935,114331,3841130,484450548,0,3894,327389,3213,246501,681,80888,991,11,1342,25,0,52,130000.0,39000.0,-71.0,-70.0,-69.0,-60.0,-70.0,-70.0,-68.0,-61.0,-80.0,-79.0,-75.0,-75.0,9.0,9.0,6.0,15.0,1
1146,BA:8C:B9:54:50:24,3846012,490638568,4882,6188020,3841130,484450548,0,9328,1722568,9306,1719073,22,3495,2354,17,5353,41,0,64,229410.0,130000.0,-48.0,-35.0,-43.0,-45.0,-44.0,-36.0,-44.0,-48.0,-80.0,-79.0,-75.0,-75.0,32.0,44.0,32.0,30.0,1
1147,62:47:05:9D:EB:15,3843249,486872597,2115,2421645,3841134,484450952,0,4271,3008862,4240,3003881,31,4981,2052,0,2161,56,0,105,216660.0,130000.0,-47.0,-46.0,-39.0,-46.0,-46.0,-45.0,-39.0,-46.0,-80.0,-79.0,-75.0,-75.0,33.0,33.0,36.0,29.0,1
1148,3C:55:76:E8:8F:1F,3915107,669458595,73973,185007643,3841134,484450952,38,35536,7279262,35052,7196796,484,82466,15052,39,74030,7242,38,473,195000.0,97500.0,-45.0,-54.0,-49.0,-40.0,-45.0,-53.0,-47.0,-40.0,-80.0,-79.0,-75.0,-75.0,35.0,25.0,26.0,35.0,1
1149,92:69:1D:31:68:E9,3845121,488090886,3987,3639934,3841134,484450952,0,5089,1131385,4932,1095822,157,35563,2165,11,4219,92,0,55,229410.0,130000.0,-51.0,-47.0,-44.0,-47.0,-52.0,-47.0,-43.0,-48.0,-80.0,-79.0,-75.0,-75.0,29.0,32.0,31.0,28.0,1
1150,CC:2F:71:3F:1F:24,4824039,1583338064,982905,1098887112,3841134,484450952,364,809978,886272562,809204,886179092,774,93470,782271,15,982840,103659,361,620,115556.0,28889.0,-69.0,-70.0,-67.0,-69.0,-68.0,-70.0,-66.0,-69.0,-80.0,-79.0,-75.0,-75.0,11.0,9.0,8.0,6.0,1
1151,CC:2F:71:3E:C5:1F,3842069,484565283,935,114331,3841134,484450952,0,3894,327389,3213,246501,681,80888,991,11,1342,25,0,52,130000.0,39000.0,-71.0,-70.0,-69.0,-60.0,-70.0,-70.0,-68.0,-61.0,-80.0,-79.0,-75.0,-75.0,9.0,9.0,6.0,15.0,1
1152,BA:8C:B9:54:50:24,3846016,490638972,4882,6188020,3841134,484450952,0,9331,1722772,9309,1719277,22,3495,2354,17,5354,41,0,64,229410.0,130000.0,-40.0,-37.0,-46.0,-51.0,-43.0,-36.0,-44.0,-48.0,-80.0,-79.0,-75.0,-75.0,40.0,42.0,29.0,24.0,1
1153,62:47:05:9D:EB:15,3843253,486873001,2115,2421645,3841138,484451356,0,4273,3008998,4242,3004017,31,4981,2052,0,2162,56,0,105,216660.0,130000.0,-46.0,-48.0,-40.0,-50.0,-46.0,-46.0,-39.0,-46.0,-80.0,-79.0,-75.0,-75.0,34.0,31.0,35.0,25.0,1
1154,3C:55:76:E8:8F:1F,3916171,672263567,75029,187811807,3841142,484451760,38,35639,7305459,35155,7222993,484,82466,15110,39,75045,7769,38,484,162500.0,48750.0,-48.0,-52.0,-44.0,-42.0,-47.0,-52.0,-44.0,-42.0,-80.0,-79.0,-75.0,-75.0,32.0,27.0,31.0,33.0,1
1155,92:69:1D:31:68:E9,3845130,488091754,3987,3639934,3841143,484451820,0,5089,1131385,4932,1095822,157,35563,2165,11,4219,92,0,55,229410.0,130000.0,-51.0,-47.0,-44.0,-47.0,-52.0,-47.0,-43.0,-48.0,-80.0,-79.0,-75.0,-75.0,29.0,32.0,31.0,28.0,1
1156,CC:2F:71:3F:1F:24,4824291,1583653642,983148,1099201822,3841143,484451820,364,810205,886578642,809431,886485172,774,93470,782491,15,983083,103677,361,620,115556.0,28889.0,-68.0,-71.0,-66.0,-66.0,-68.0,-69.0,-66.0,-67.0,-80.0,-79.0,-75.0,-75.0,12.0,8.0,9.0,9.0,1
1157,CC:2F:71:3E:C5:1F,3842078,484566151,935,114331,3841143,484451820,0,3894,327389,3213,246501,681,80888,991,11,1342,25,0,52,130000.0,39000.0,-71.0,-70.0,-69.0,-60.0,-70.0,-70.0,-68.0,-61.0,-80.0,-79.0,-75.0,-75.0,9.0,9.0,6.0,15.0,1
1158,BA:8C:B9:54:50:24,3846025,490639840,4882,6188020,3841143,484451820,0,9331,1722772,9309,1719277,22,3495,2354,17,5354,41,0,64,229410.0,130000.0,-40.0,-37.0,-46.0,-51.0,-43.0,-36.0,-44.0,-48.0,-80.0,-79.0,-75.0,-75.0,40.0,42.0,29.0,24.0,1
1159,62:47:05:9D:EB:15,3843258,486873465,2115,2421645,3841143,484451820,0,4273,3008998,4242,3004017,31,4981,2052,0,2162,56,0,105,216660.0,130000.0,-46.0,-48.0,-40.0,-50.0,-46.0,-46.0,-39.0,-46.0,-79.0,-79.0,-75.0,-75.0,33.0,31.0,35.0,25.0,1
1160,3C:55:76:E8:8F:1F,3916440,672966131,75297,188514311,3841143,484451820,38,35684,7318706,35200,7236240,484,82466,15142,39,75354,7770,38,503,172050.0,51610.0,-49.0,-53.0,-44.0,-43.0,-48.0,-53.0,-45.0,-43.0,-79.0,-79.0,-75.0,-75.0,30.0,26.0,31.0,32.0,1
1161,92:69:1D:31:68:E9,3845130,488091754,3987,3639934,3841143,484451820,0,5089,1131385,4932,1095822,157,35563,2165,11,4219,92,0,55,229410.0,130000.0,-51.0,-47.0,-44.0,-47.0,-52.0,-47.0,-43.0,-48.0,-79.0,-79.0,-75.0,-75.0,28.0,32.0,31.0,28.0,1
1162,CC:2F:71:3F:1F:24,4824506,1583921582,983361,1099469560,3841145,484452022,364,810405,886843198,809631,886749728,774,93470,782681,15,983296,103734,361,620,115556.0,28889.0,-68.0,-70.0,-66.0,-69.0,-68.0,-70.0,-66.0,-68.0,-79.0,-79.0,-75.0,-75.0,11.0,9.0,9.0,6.0,1
1163,CC:2F:71:3E:C5:1F,3842080,484566353,935,114331,3841145,484452022,0,3894,327389,3213,246501,681,80888,991,11,1342,25,0,52,130000.0,39000.0,-71.0,-70.0,-69.0,-60.0,-70.0,-70.0,-68.0,-61.0,-79.0,-79.0,-75.0,-75.0,8.0,9.0,6.0,15.0,1
1164,BA:8C:B9:54:50:24,3846027,490640042,4882,6188020,3841145,484452022,0,9331,1722772,9309,1719277,22,3495,2354,17,5354,41,0,64,229410.0,130000.0,-40.0,-37.0,-46.0,-51.0,-43.0,-36.0,-44.0,-48.0,-79.0,-79.0,-75.0,-75.0,39.0,42.0,29.0,24.0,1
1165,62:47:05:9D:EB:15,3843266,486874273,2115,2421645,3841151,484452628,0,4273,3008998,4242,3004017,31,4981,2052,0,2162,56,0,105,216660.0,130000.0,-46.0,-48.0,-40.0,-50.0,-46.0,-46.0,-39.0,-46.0,-79.0,-79.0,-75.0,-75.0,33.0,31.0,35.0,25.0,1
1166,3C:55:76:E8:8F:1F,3916448,672966939,75297,188514311,3841151,484452628,38,35684,7318706,35200,7236240,484,82466,15142,39,75354,7770,38,503,172050.0,51610.0,-49.0,-53.0,-44.0,-43.0,-48.0,-53.0,-45.0,-43.0,-79.0,-79.0,-75.0,-75.0,30.0,26.0,31.0,32.0,1
1167,92:69:1D:31:68:E9,3845138,488092562,3987,3639934,3841151,484452628,0,5089,1131385,4932,1095822,157,35563,2165,11,4219,92,0,55,229410.0,130000.0,-51.0,-47.0,-44.0,-47.0,-52.0,-47.0,-43.0,-48.0,-79.0,-79.0,-75.0,-75.0,28.0,32.0,31.0,28.0,1
1168,CC:2F:71:3F:1F:24,4824730,1584190291,983579,1099737663,3841151,484452628,364,810603,887097879,809829,887004409,774,93470,782874,15,983514,103781,361,620,115556.0,28889.0,-69.0,-71.0,-66.0,-71.0,-68.0,-70.0,-66.0,-70.0,-79.0,-79.0,-75.0,-75.0,10.0,8.0,9.0,4.0,1
1169,CC:2F:71:3E:C5:1F,3842086,484566959,935,114331,3841151,484452628,0,3894,327389,3213,246501,681,80888,991,11,1342,25,0,52,130000.0,39000.0,-71.0,-70.0,-69.0,-60.0,-70.0,-70.0,-68.0,-61.0,-79.0,-79.0,-75.0,-75.0,8.0,9.0,6.0,15.0,1
1170,BA:8C:B9:54:50:24,3846033,490640648,4882,6188020,3841151,484452628,0,9331,1722772,9309,1719277,22,3495,2354,17,5354,41,0,64,229410.0,130000.0,-40.0,-37.0,-46.0,-51.0,-43.0,-36.0,-44.0,-48.0,-79.0,-79.0,-75.0,-75.0,39.0,42.0,29.0,24.0,1
1171,62:47:05:9D:EB:15,3843270,486874808,2115,2421645,3841155,484453163,0,4273,3008998,4242,3004017,31,4981,2052,0,2162,56,0,105,216660.0,130000.0,-46.0,-48.0,-40.0,-50.0,-46.0,-46.0,-39.0,-46.0,-79.0,-79.0,-75.0,-75.0,33.0,31.0,35.0,25.0,1
1172,3C:55:76:E8:8F:1F,3916452,672967474,75297,188514311,3841155,484453163,38,35684,7318706,35200,7236240,484,82466,15142,39,75354,7770,38,503,172050.0,51610.0,-49.0,-53.0,-44.0,-43.0,-48.0,-53.0,-45.0,-43.0,-79.0,-79.0,-75.0,-75.0,30.0,26.0,31.0,32.0,1
1173,92:69:1D:31:68:E9,3845142,488093097,3987,3639934,3841155,484453163,0,5089,1131385,4932,1095822,157,35563,2165,11,4219,92,0,55,229410.0,130000.0,-51.0,-47.0,-44.0,-47.0,-52.0,-47.0,-43.0,-48.0,-79.0,-79.0,-75.0,-75.0,28.0,32.0,31.0,28.0,1
1174,CC:2F:71:3F:1F:24,4824942,1584452442,983787,1099999279,3841155,484453163,364,810790,887346507,810016,887253037,774,93470,783057,15,983722,103802,361,620,115556.0,28889.0,-68.0,-70.0,-66.0,-69.0,-68.0,-70.0,-66.0,-68.0,-79.0,-79.0,-75.0,-75.0,11.0,9.0,9.0,6.0,1
1175,CC:2F:71:3E:C5:1F,3842090,484567494,935,114331,3841155,484453163,0,3894,327389,3213,246501,681,80888,991,11,1342,25,0,52,130000.0,39000.0,-71.0,-70.0,-69.0,-60.0,-70.0,-70.0,-68.0,-61.0,-79.0,-79.0,-75.0,-75.0,8.0,9.0,6.0,15.0,1
1176,BA:8C:B9:54:50:24,3846039,490641385,4882,6188020,3841157,484453365,0,9331,1722772,9309,1719277,22,3495,2354,17,5354,41,0,64,229410.0,130000.0,-40.0,-37.0,-46.0,-51.0,-43.0,-36.0,-44.0,-48.0,-79.0,-79.0,-75.0,-75.0,39.0,42.0,29.0,24.0,1
1177,62:47:05:9D:EB:15,3843276,486875414,2115,2421645,3841161,484453769,0,4273,3008998,4242,3004017,31,4981,2052,0,2162,56,0,105,216660.0,130000.0,-46.0,-48.0,-40.0,-50.0,-46.0,-46.0,-39.0,-46.0,-79.0,-79.0,-75.0,-75.0,33.0,31.0,35.0,25.0,1
1178,3C:55:76:E8:8F:1F,3916458,672968080,75297,188514311,3841161,484453769,38,35684,7318706,35200,7236240,484,82466,15142,39,75354,7770,38,503,172050.0,51610.0,-49.0,-53.0,-44.0,-43.0,-48.0,-53.0,-45.0,-43.0,-79.0,-79.0,-75.0,-75.0,30.0,26.0,31.0,32.0,1
1179,92:69:1D:31:68:E9,3845148,488093703,3987,3639934,3841161,484453769,0,5089,1131385,4932,1095822,157,35563,2165,11,4219,92,0,55,229410.0,130000.0,-51.0,-47.0,-44.0,-47.0,-52.0,-47.0,-43.0,-48.0,-79.0,-79.0,-75.0,-75.0,28.0,32.0,31.0,28.0,1
1180,CC:2F:71:3F:1F:24,4825157,1584715770,983996,1100262001,3841161,484453769,364,810990,887610967,810216,887517497,774,93470,783247,15,983931,103834,361,620,115556.0,28889.0,-69.0,-72.0,-67.0,-72.0,-69.0,-71.0,-66.0,-72.0,-79.0,-79.0,-75.0,-75.0,10.0,7.0,8.0,3.0,1
1181,CC:2F:71:3E:C5:1F,3842096,484568100,935,114331,3841161,484453769,0,3894,327389,3213,246501,681,80888,991,11,1342,25,0,52,130000.0,39000.0,-71.0,-70.0,-69.0,-60.0,-70.0,-70.0,-68.0,-61.0,-79.0,-79.0,-75.0,-75.0,8.0,9.0,6.0,15.0,1
1182,BA:8C:B9:54:50:24,3846043,490641789,4882,6188020,3841161,484453769,0,9331,1722772,9309,1719277,22,3495,2354,17,5354,41,0,64,229410.0,130000.0,-40.0,-37.0,-46.0,-51.0,-43.0,-36.0,-44.0,-48.0,-79.0,-79.0,-75.0,-75.0,39.0,42.0,29.0,24.0,1
1183,62:47:05:9D:EB:15,3843281,486875878,2115,2421645,3841166,484454233,0,4276,3009202,4245,3004221,31,4981,2052,0,2162,56,0,105,216660.0,130000.0,-47.0,-46.0,-39.0,-46.0,-46.0,-46.0,-39.0,-46.0,-79.0,-79.0,-75.0,-75.0,32.0,33.0,36.0,29.0,1
1184,3C:55:76:E8:8F:1F,3916467,672969808,75301,188515575,3841166,484454233,38,35699,7322213,35215,7239747,484,82466,15146,39,75358,7770,38,504,195000.0,97500.0,-48.0,-51.0,-44.0,-43.0,-47.0,-51.0,-44.0,-43.0,-79.0,-79.0,-75.0,-75.0,31.0,28.0,31.0,32.0,1
1185,92:69:1D:31:68:E9,3845155,488094369,3987,3639934,3841168,484454435,0,5089,1131385,4932,1095822,157,35563,2165,11,4219,92,0,55,229410.0,130000.0,-51.0,-47.0,-44.0,-47.0,-52.0,-47.0,-43.0,-48.0,-79.0,-79.0,-75.0,-75.0,28.0,32.0,31.0,28.0,1
1186,CC:2F:71:3F:1F:24,4825565,1585223436,984397,1100769001,3841168,484454435,364,811279,887900381,810505,887806911,774,93470,783534,15,984331,103896,361,621,86667.0,14444.0,-69.0,-71.0,-67.0,-72.0,-69.0,-71.0,-67.0,-72.0,-79.0,-79.0,-75.0,-75.0,10.0,8.0,8.0,3.0,1
1187,CC:2F:71:3E:C5:1F,3842103,484568766,935,114331,3841168,484454435,0,3894,327389,3213,246501,681,80888,991,11,1342,25,0,52,130000.0,39000.0,-71.0,-70.0,-69.0,-60.0,-70.0,-70.0,-68.0,-61.0,-79.0,-79.0,-75.0,-75.0,8.0,9.0,6.0,15.0,1
1188,BA:8C:B9:54:50:24,3846052,490642657,4882,6188020,3841170,484454637,0,9331,1722772,9309,1719277,22,3495,2354,17,5354,41,0,64,229410.0,130000.0,-40.0,-37.0,-46.0,-51.0,-43.0,-36.0,-44.0,-48.0,-79.0,-79.0,-75.0,-75.0,39.0,42.0,29.0,24.0,1
1189,62:47:05:9D:EB:15,3843285,486876282,2115,2421645,3841170,484454637,0,4276,3009202,4245,3004221,31,4981,2052,0,2162,56,0,105,216660.0,130000.0,-47.0,-46.0,-39.0,-46.0,-46.0,-46.0,-39.0,-46.0,-80.0,-79.0,-76.0,-76.0,33.0,33.0,37.0,30.0,1
1190,3C:55:76:E8:8F:1F,3916471,672970212,75301,188515575,3841170,484454637,38,35714,7323235,35230,7240769,484,82466,15146,39,75358,7770,38,504,195000.0,97500.0,-49.0,-52.0,-44.0,-43.0,-48.0,-51.0,-44.0,-43.0,-80.0,-79.0,-76.0,-76.0,31.0,27.0,32.0,33.0,1
1191,92:69:1D:31:68:E9,3845157,488094571,3987,3639934,3841170,484454637,0,5089,1131385,4932,1095822,157,35563,2165,11,4219,92,0,55,229410.0,130000.0,-51.0,-47.0,-44.0,-47.0,-52.0,-47.0,-43.0,-48.0,-80.0,-79.0,-76.0,-76.0,29.0,32.0,32.0,29.0,1
1192,CC:2F:71:3F:1F:24,4826005,1585772350,984835,1101317713,3841170,484454637,364,811581,888170807,810807,888077337,774,93470,783834,15,984770,103896,361,621,86667.0,14444.0,-69.0,-71.0,-67.0,-71.0,-69.0,-71.0,-66.0,-71.0,-80.0,-79.0,-76.0,-76.0,11.0,8.0,9.0,5.0,1
1193,CC:2F:71:3E:C5:1F,3842107,484569170,935,114331,3841172,484454839,0,3894,327389,3213,246501,681,80888,991,11,1342,25,0,52,130000.0,39000.0,-71.0,-70.0,-69.0,-60.0,-70.0,-70.0,-68.0,-61.0,-80.0,-79.0,-76.0,-76.0,9.0,9.0,7.0,16.0,1
1194,BA:8C:B9:54:50:24,3846054,490642859,4882,6188020,3841172,484454839,0,9331,1722772,9309,1719277,22,3495,2354,17,5354,41,0,64,229410.0,130000.0,-40.0,-37.0,-46.0,-51.0,-43.0,-36.0,-44.0,-48.0,-80.0,-79.0,-76.0,-76.0,40.0,42.0,30.0,25.0,1
1195,62:47:05:9D:EB:15,3843292,486876948,2115,2421645,3841177,484455303,0,4276,3009202,4245,3004221,31,4981,2052,0,2162,56,0,105,216660.0,130000.0,-47.0,-46.0,-39.0,-46.0,-46.0,-46.0,-39.0,-46.0,-80.0,-80.0,-76.0,-76.0,33.0,34.0,37.0,30.0,1
1196,3C:55:76:E8:8F:1F,3916480,672971080,75301,188515575,3841179,484455505,38,35714,7323235,35230,7240769,484,82466,15146,39,75358,7770,38,504,195000.0,97500.0,-49.0,-52.0,-44.0,-43.0,-48.0,-51.0,-44.0,-43.0,-80.0,-80.0,-76.0,-76.0,31.0,28.0,32.0,33.0,1
1197,92:69:1D:31:68:E9,3845166,488095439,3987,3639934,3841179,484455505,0,5089,1131385,4932,1095822,157,35563,2165,11,4219,92,0,55,229410.0,130000.0,-51.0,-47.0,-44.0,-47.0,-52.0,-47.0,-43.0,-48.0,-80.0,-80.0,-76.0,-76.0,29.0,33.0,32.0,29.0,1
1198,CC:2F:71:3F:1F:24,4826548,1586472995,985369,1102017490,3841179,484455505,364,811904,888433045,811130,888339575,774,93470,784155,15,985304,103957,361,621,65000.0,13000.0,-69.0,-71.0,-67.0,-71.0,-69.0,-71.0,-67.0,-71.0,-80.0,-80.0,-76.0,-76.0,11.0,9.0,9.0,5.0,1
1199,CC:2F:71:3E:C5:1F,3842114,484569836,935,114331,3841179,484455505,0,3894,327389,3213,246501,681,80888,991,11,1342,25,0,52,130000.0,39000.0,-71.0,-70.0,-69.0,-60.0,-70.0,-70.0,-68.0,-61.0,-80.0,-80.0,-76.0,-76.0,9.0,10.0,7.0,16.0,1
1200,BA:8C:B9:54:50:24,3846061,490643525,4882,6188020,3841179,484455505,0,9331,1722772,9309,1719277,22,3495,2354,17,5354,41,0,64,229410.0,130000.0,-40.0,-37.0,-46.0,-51.0,-43.0,-36.0,-44.0,-48.0,-80.0,-80.0,-76.0,-76.0,40.0,43.0,30.0,25.0,1
1201,62:47:05:9D:EB:15,3843294,486877150,2115,2421645,3841179,484455505,0,4276,3009202,4245,3004221,31,4981,2052,0,2162,56,0,105,216660.0,130000.0,-47.0,-46.0,-39.0,-46.0,-46.0,-46.0,-39.0,-46.0,-81.0,-81.0,-77.0,-77.0,34.0,35.0,38.0,31.0,1
1202,3C:55:76:E8:8F:1F,3916483,672971456,75302,188515749,3841181,484455707,38,35724,7324045,35240,7241579,484,82466,15148,39,75359,7770,38,504,195000.0,97500.0,-45.0,-53.0,-50.0,-40.0,-44.0,-52.0,-48.0,-40.0,-81.0,-81.0,-77.0,-77.0,36.0,28.0,27.0,37.0,1
1203,92:69:1D:31:68:E9,3845168,488095641,3987,3639934,3841181,484455707,0,5089,1131385,4932,1095822,157,35563,2165,11,4219,92,0,55,229410.0,130000.0,-51.0,-47.0,-44.0,-47.0,-52.0,-47.0,-43.0,-48.0,-81.0,-81.0,-77.0,-77.0,30.0,34.0,33.0,30.0,1
1204,CC:2F:71:3F:1F:24,4827214,1587286135,986033,1102830428,3841181,484455707,364,812329,888723062,811555,888629592,774,93470,784573,15,985968,103958,361,621,86667.0,14444.0,-69.0,-71.0,-67.0,-71.0,-69.0,-71.0,-67.0,-71.0,-81.0,-81.0,-77.0,-77.0,12.0,10.0,10.0,6.0,1
1205,CC:2F:71:3E:C5:1F,3842116,484570038,935,114331,3841181,484455707,0,3894,327389,3213,246501,681,80888,991,11,1342,25,0,52,130000.0,39000.0,-71.0,-70.0,-69.0,-60.0,-70.0,-70.0,-68.0,-61.0,-81.0,-81.0,-77.0,-77.0,10.0,11.0,8.0,17.0,1
1206,BA:8C:B9:54:50:24,3846063,490643727,4882,6188020,3841181,484455707,0,9331,1722772,9309,1719277,22,3495,2354,17,5354,41,0,64,229410.0,130000.0,-40.0,-37.0,-46.0,-51.0,-43.0,-36.0,-44.0,-48.0,-81.0,-81.0,-77.0,-77.0,41.0,44.0,31.0,26.0,1
1207,62:47:05:9D:EB:15,3843303,486878084,2115,2421645,3841188,484456439,0,4276,3009202,4245,3004221,31,4981,2052,0,2162,56,0,105,216660.0,130000.0,-47.0,-46.0,-39.0,-46.0,-46.0,-46.0,-39.0,-46.0,-81.0,-82.0,-78.0,-78.0,34.0,36.0,39.0,32.0,1
1208,3C:55:76:E8:8F:1F,3916490,672972188,75302,188515749,3841188,484456439,38,35724,7324045,35240,7241579,484,82466,15148,39,75359,7770,38,504,195000.0,97500.0,-45.0,-53.0,-50.0,-40.0,-44.0,-52.0,-48.0,-40.0,-81.0,-82.0,-78.0,-78.0,36.0,29.0,28.0,38.0,1
1209,92:69:1D:31:68:E9,3845175,488096373,3987,3639934,3841188,484456439,0,5090,1131453,4933,1095890,157,35563,2165,11,4219,92,0,55,229410.0,130000.0,-51.0,-47.0,-44.0,-47.0,-52.0,-47.0,-43.0,-47.0,-81.0,-82.0,-78.0,-78.0,30.0,35.0,34.0,31.0,1
1210,CC:2F:71:3F:1F:24,4827818,1588039397,986629,1103582898,3841189,484456499,364,812689,888995515,811915,888902045,774,93470,784931,15,986564,103986,361,621,86667.0,14444.0,-69.0,-72.0,-66.0,-72.0,-68.0,-72.0,-66.0,-71.0,-81.0,-82.0,-78.0,-78.0,12.0,10.0,12.0,6.0,1
1211,CC:2F:71:3E:C5:1F,3842124,484570830,935,114331,3841189,484456499,0,3894,327389,3213,246501,681,80888,991,11,1342,25,0,52,130000.0,39000.0,-71.0,-70.0,-69.0,-60.0,-70.0,-70.0,-68.0,-61.0,-81.0,-82.0,-78.0,-78.0,10.0,12.0,9.0,18.0,1
1212,BA:8C:B9:54:50:24,3846071,490644519,4882,6188020,3841189,484456499,0,9331,1722772,9309,1719277,22,3495,2354,17,5354,41,0,64,229410.0,130000.0,-40.0,-37.0,-46.0,-51.0,-43.0,-36.0,-44.0,-48.0,-81.0,-82.0,-78.0,-78.0,41.0,45.0,32.0,27.0,1
1213,62:47:05:9D:EB:15,3843307,486879236,2116,2422535,3841191,484456701,0,4279,3009458,4248,3004477,31,4981,2053,0,2163,56,0,105,216660.0,130000.0,-45.0,-49.0,-41.0,-49.0,-46.0,-47.0,-39.0,-47.0,-81.0,-82.0,-78.0,-78.0,36.0,33.0,37.0,29.0,1
1214,3C:55:76:E8:8F:1F,3916494,672972658,75303,188515957,3841191,484456701,38,35731,7324953,35247,7242487,484,82466,15151,39,75360,7770,38,504,195000.0,97500.0,-44.0,-53.0,-48.0,-41.0,-45.0,-52.0,-47.0,-41.0,-82.0,-82.0,-78.0,-78.0,38.0,29.0,30.0,37.0,1
1215,92:69:1D:31:68:E9,3845178,488096635,3987,3639934,3841191,484456701,0,5090,1131453,4933,1095890,157,35563,2165,11,4219,92,0,55,229410.0,130000.0,-51.0,-47.0,-44.0,-47.0,-52.0,-47.0,-43.0,-47.0,-82.0,-82.0,-78.0,-78.0,31.0,35.0,34.0,31.0,1
1216,CC:2F:71:3F:1F:24,4828034,1588308331,986843,1103851630,3841191,484456701,364,812887,889261299,812113,889167829,774,93470,785119,15,986778,103987,361,622,86667.0,14444.0,-68.0,-72.0,-67.0,-71.0,-68.0,-71.0,-67.0,-71.0,-82.0,-82.0,-78.0,-78.0,14.0,10.0,11.0,7.0,1
1217,CC:2F:71:3E:C5:1F,3842126,484571032,935,114331,3841191,484456701,0,3894,327389,3213,246501,681,80888,991,11,1342,25,0,52,130000.0,39000.0,-71.0,-70.0,-69.0,-60.0,-70.0,-70.0,-68.0,-61.0,-82.0,-82.0,-78.0,-78.0,11.0,12.0,9.0,18.0,1
1218,BA:8C:B9:54:50:24,3846077,490645125,4882,6188020,3841195,484457105,0,9331,1722772,9309,1719277,22,3495,2354,17,5354,41,0,64,229410.0,130000.0,-40.0,-37.0,-46.0,-51.0,-43.0,-36.0,-44.0,-48.0,-82.0,-82.0,-78.0,-78.0,42.0,45.0,32.0,27.0,1
1219,62:47:05:9D:EB:15,3843313,486879842,2116,2422535,3841197,484457307,0,4279,3009458,4248,3004477,31,4981,2053,0,2163,56,0,105,216660.0,130000.0,-45.0,-49.0,-41.0,-49.0,-46.0,-47.0,-39.0,-47.0,-82.0,-82.0,-78.0,-78.0,37.0,33.0,37.0,29.0,1
1220,3C:55:76:E8:8F:1F,3916501,672973460,75304,188516153,3841197,484457307,38,35750,7326285,35266,7243819,484,82466,15152,39,75361,7770,38,505,195000.0,97500.0,-50.0,-59.0,-49.0,-45.0,-45.0,-53.0,-49.0,-41.0,-82.0,-82.0,-78.0,-78.0,32.0,23.0,29.0,33.0,1
1221,92:69:1D:31:68:E9,3845184,488097241,3987,3639934,3841197,484457307,0,5090,1131453,4933,1095890,157,35563,2165,11,4219,92,0,55,229410.0,130000.0,-51.0,-47.0,-44.0,-47.0,-52.0,-47.0,-43.0,-47.0,-82.0,-82.0,-78.0,-78.0,31.0,35.0,34.0,31.0,1
1222,CC:2F:71:3F:1F:24,4828250,1588570029,987053,1104112722,3841197,484457307,364,813078,889516309,812304,889422839,774,93470,785301,15,986987,103987,361,622,86667.0,14444.0,-69.0,-72.0,-68.0,-71.0,-68.0,-71.0,-67.0,-71.0,-82.0,-83.0,-79.0,-79.0,13.0,11.0,11.0,8.0,1
1223,CC:2F:71:3E:C5:1F,3842132,484571638,935,114331,3841197,484457307,0,3894,327389,3213,246501,681,80888,991,11,1342,25,0,52,130000.0,39000.0,-71.0,-70.0,-69.0,-60.0,-70.0,-70.0,-68.0,-61.0,-82.0,-83.0,-79.0,-79.0,11.0,13.0,10.0,19.0,1
1224,BA:8C:B9:54:50:24,3846079,490645327,4882,6188020,3841197,484457307,0,9331,1722772,9309,1719277,22,3495,2354,17,5354,41,0,64,229410.0,130000.0,-40.0,-37.0,-46.0,-51.0,-43.0,-36.0,-44.0,-48.0,-82.0,-83.0,-79.0,-79.0,42.0,46.0,33.0,28.0,1
1225,62:47:05:9D:EB:15,3843316,486880104,2116,2422535,3841200,484457569,0,4279,3009458,4248,3004477,31,4981,2053,0,2163,56,0,105,216660.0,130000.0,-45.0,-49.0,-41.0,-49.0,-46.0,-47.0,-39.0,-47.0,-82.0,-83.0,-79.0,-79.0,37.0,34.0,38.0,30.0,1
1226,3C:55:76:E8:8F:1F,3916537,673021162,75337,188563593,3841200,484457569,38,35817,7340054,35333,7257588,484,82466,15189,39,75394,7770,38,505,206470.0,97500.0,-49.0,-51.0,-43.0,-44.0,-48.0,-52.0,-44.0,-43.0,-82.0,-83.0,-79.0,-79.0,33.0,32.0,36.0,35.0,1
1227,92:69:1D:31:68:E9,3845189,488097705,3987,3639934,3841202,484457771,0,5090,1131453,4933,1095890,157,35563,2165,11,4219,92,0,55,229410.0,130000.0,-51.0,-47.0,-44.0,-47.0,-52.0,-47.0,-43.0,-47.0,-82.0,-83.0,-79.0,-79.0,31.0,36.0,35.0,32.0,1
1228,CC:2F:71:3F:1F:24,4828469,1588834545,987265,1104376572,3841204,484457973,364,813268,889770981,812494,889677511,774,93470,785487,15,987200,104012,361,622,86667.0,14444.0,-68.0,-72.0,-67.0,-71.0,-68.0,-72.0,-67.0,-71.0,-82.0,-83.0,-79.0,-79.0,14.0,11.0,12.0,8.0,1
1229,CC:2F:71:3E:C5:1F,3842142,484572622,936,114447,3841206,484458175,0,3895,327459,3214,246571,681,80888,991,11,1343,25,0,52,130000.0,39000.0,-67.0,-69.0,-66.0,-60.0,-70.0,-70.0,-67.0,-61.0,-82.0,-83.0,-79.0,-79.0,15.0,14.0,13.0,19.0,1
1230,BA:8C:B9:54:50:24,3846089,490646311,4883,6188136,3841206,484458175,0,9333,1722908,9311,1719413,22,3495,2354,17,5355,41,0,64,229410.0,137640.0,-39.0,-36.0,-46.0,-52.0,-43.0,-36.0,-44.0,-49.0,-82.0,-83.0,-79.0,-79.0,43.0,47.0,33.0,27.0,1
1231,62:47:05:9D:EB:15,3843322,486880710,2116,2422535,3841206,484458175,0,4279,3009458,4248,3004477,31,4981,2053,0,2163,56,0,105,216660.0,130000.0,-45.0,-49.0,-41.0,-49.0,-46.0,-47.0,-39.0,-47.0,-83.0,-84.0,-80.0,-80.0,38.0,35.0,39.0,31.0,1
1232,3C:55:76:E8:8F:1F,3916547,673022183,75340,188563946,3841207,484458237,38,35836,7342416,35351,7259832,485,82584,15192,39,75397,7770,38,505,206470.0,97500.0,-47.0,-51.0,-41.0,-41.0,-48.0,-51.0,-43.0,-43.0,-83.0,-84.0,-80.0,-80.0,36.0,33.0,39.0,39.0,1
1233,92:69:1D:31:68:E9,3845195,488098287,3988,3640050,3841207,484458237,0,5092,1131589,4935,1096026,157,35563,2165,11,4220,92,0,55,229410.0,130000.0,-52.0,-47.0,-44.0,-47.0,-51.0,-47.0,-43.0,-47.0,-83.0,-84.0,-80.0,-80.0,31.0,37.0,36.0,33.0,1
1234,CC:2F:71:3F:1F:24,4828690,1589102295,987483,1104644058,3841207,484458237,364,813466,890024225,812692,889930755,774,93470,785681,15,987418,104013,361,622,86667.0,14444.0,-68.0,-72.0,-67.0,-71.0,-68.0,-71.0,-67.0,-71.0,-83.0,-84.0,-80.0,-80.0,15.0,12.0,13.0,9.0,1
1235,CC:2F:71:3E:C5:1F,3842145,484572886,936,114447,3841209,484458439,0,3896,327529,3215,246641,681,80888,991,11,1343,25,0,52,130000.0,39000.0,-72.0,-71.0,-69.0,-60.0,-71.0,-70.0,-68.0,-61.0,-83.0,-84.0,-80.0,-80.0,11.0,13.0,11.0,20.0,1
1236,BA:8C:B9:54:50:24,3846092,490646575,4883,6188136,3841209,484458439,0,9333,1722908,9311,1719413,22,3495,2354,17,5355,41,0,64,229410.0,137640.0,-39.0,-36.0,-46.0,-52.0,-43.0,-36.0,-44.0,-49.0,-83.0,-84.0,-80.0,-80.0,44.0,48.0,34.0,28.0,1
1237,62:47:05:9D:EB:15,3843329,486881352,2117,2422651,3841212,484458701,0,4281,3009594,4250,3004613,31,4981,2053,0,2164,56,0,105,216660.0,130000.0,-47.0,-45.0,-39.0,-46.0,-46.0,-47.0,-39.0,-47.0,-83.0,-84.0,-80.0,-80.0,36.0,39.0,41.0,34.0,1
1238,3C:55:76:E8:8F:1F,3916555,673023419,75341,188564516,3841214,484458903,38,35844,7342998,35359,7260414,485,82584,15193,39,75398,7770,38,505,206470.0,97500.0,-49.0,-52.0,-45.0,-44.0,-47.0,-51.0,-42.0,-42.0,-83.0,-84.0,-80.0,-80.0,34.0,32.0,35.0,36.0,1
1239,92:69:1D:31:68:E9,3845202,488098953,3988,3640050,3841214,484458903,0,5092,1131589,4935,1096026,157,35563,2165,11,4220,92,0,55,229410.0,130000.0,-52.0,-47.0,-44.0,-47.0,-51.0,-47.0,-43.0,-47.0,-83.0,-84.0,-80.0,-80.0,31.0,37.0,36.0,33.0,1
1240,CC:2F:71:3F:1F:24,4828908,1589366581,987692,1104907476,3841216,484459105,364,813661,890284017,812887,890190547,774,93470,785868,15,987627,104024,361,622,86667.0,14444.0,-68.0,-72.0,-67.0,-71.0,-68.0,-71.0,-67.0,-71.0,-83.0,-84.0,-80.0,-80.0,15.0,12.0,13.0,9.0,1
1241,CC:2F:71:3E:C5:1F,3842152,484573552,936,114447,3841216,484459105,0,3896,327529,3215,246641,681,80888,991,11,1343,25,0,52,130000.0,39000.0,-72.0,-71.0,-69.0,-60.0,-71.0,-70.0,-68.0,-61.0,-83.0,-84.0,-80.0,-80.0,11.0,13.0,11.0,20.0,1
1242,BA:8C:B9:54:50:24,3846099,490647241,4883,6188136,3841216,484459105,0,9333,1722908,9311,1719413,22,3495,2354,17,5355,41,0,64,229410.0,137640.0,-39.0,-36.0,-46.0,-52.0,-43.0,-36.0,-44.0,-49.0,-83.0,-84.0,-80.0,-80.0,44.0,48.0,34.0,28.0,1
1243,62:47:05:9D:EB:15,3843336,486882231,2117,2422651,3841219,484459580,0,4281,3009594,4250,3004613,31,4981,2053,0,2164,56,0,105,216660.0,130000.0,-47.0,-45.0,-39.0,-46.0,-46.0,-47.0,-39.0,-47.0,-83.0,-84.0,-80.0,-80.0,36.0,39.0,41.0,34.0,1
1244,3C:55:76:E8:8F:1F,3916560,673024096,75341,188564516,3841219,484459580,38,35844,7342998,35359,7260414,485,82584,15193,39,75398,7770,38,505,206470.0,97500.0,-49.0,-52.0,-45.0,-44.0,-47.0,-51.0,-42.0,-42.0,-83.0,-84.0,-80.0,-80.0,34.0,32.0,35.0,36.0,1
1245,92:69:1D:31:68:E9,3845207,488099630,3988,3640050,3841219,484459580,0,5092,1131589,4935,1096026,157,35563,2165,11,4220,92,0,55,229410.0,130000.0,-52.0,-47.0,-44.0,-47.0,-51.0,-47.0,-43.0,-47.0,-83.0,-84.0,-80.0,-80.0,31.0,37.0,36.0,33.0,1
1246,CC:2F:71:3F:1F:24,4829121,1589632420,987902,1105172840,3841219,484459580,364,813856,890540763,813082,890447293,774,93470,786057,15,987837,104024,361,622,86667.0,14444.0,-68.0,-72.0,-67.0,-71.0,-68.0,-71.0,-67.0,-71.0,-83.0,-84.0,-80.0,-80.0,15.0,12.0,13.0,9.0,1
1247,CC:2F:71:3E:C5:1F,3842155,484574027,936,114447,3841219,484459580,0,3896,327529,3215,246641,681,80888,991,11,1343,25,0,52,130000.0,39000.0,-72.0,-71.0,-69.0,-60.0,-71.0,-70.0,-68.0,-61.0,-83.0,-84.0,-80.0,-80.0,11.0,13.0,11.0,20.0,1
1248,BA:8C:B9:54:50:24,3846102,490647716,4883,6188136,3841219,484459580,0,9333,1722908,9311,1719413,22,3495,2354,17,5355,41,0,64,229410.0,137640.0,-39.0,-36.0,-46.0,-52.0,-43.0,-36.0,-44.0,-49.0,-83.0,-84.0,-80.0,-80.0,44.0,48.0,34.0,28.0,1
1249,62:47:05:9D:EB:15,3843343,486882899,2117,2422651,3841226,484460248,0,4281,3009594,4250,3004613,31,4981,2053,0,2164,56,0,105,216660.0,130000.0,-47.0,-45.0,-39.0,-46.0,-46.0,-47.0,-39.0,-47.0,-84.0,-85.0,-81.0,-81.0,37.0,40.0,42.0,35.0,1
1250,3C:55:76:E8:8F:1F,3916575,673028021,75348,188567713,3841227,484460308,38,35864,7348236,35378,7265534,486,82702,15202,39,75405,7770,38,505,206470.0,97500.0,-49.0,-51.0,-44.0,-44.0,-47.0,-51.0,-44.0,-42.0,-84.0,-85.0,-81.0,-81.0,35.0,34.0,37.0,37.0,1
1251,92:69:1D:31:68:E9,3845215,488100358,3988,3640050,3841227,484460308,0,5092,1131589,4935,1096026,157,35563,2165,11,4220,92,0,55,229410.0,130000.0,-52.0,-47.0,-44.0,-47.0,-51.0,-47.0,-43.0,-47.0,-84.0,-85.0,-81.0,-81.0,32.0,38.0,37.0,34.0,1
1252,CC:2F:71:3F:1F:24,4829347,1589901778,988120,1105441470,3841227,484460308,364,814062,890802403,813288,890708933,774,93470,786253,15,988055,104034,361,622,86667.0,14444.0,-69.0,-72.0,-68.0,-71.0,-68.0,-72.0,-67.0,-71.0,-84.0,-85.0,-81.0,-81.0,15.0,13.0,13.0,10.0,1
1253,CC:2F:71:3E:C5:1F,3842163,484574755,936,114447,3841227,484460308,0,3896,327529,3215,246641,681,80888,991,11,1343,25,0,52,130000.0,39000.0,-72.0,-71.0,-69.0,-60.0,-71.0,-70.0,-68.0,-61.0,-84.0,-85.0,-81.0,-81.0,12.0,14.0,12.0,21.0,1
1254,BA:8C:B9:54:50:24,3846110,490648444,4883,6188136,3841227,484460308,0,9333,1722908,9311,1719413,22,3495,2354,17,5355,41,0,64,229410.0,137640.0,-39.0,-36.0,-46.0,-52.0,-43.0,-36.0,-44.0,-49.0,-84.0,-85.0,-81.0,-81.0,45.0,49.0,35.0,29.0,1
1255,62:47:05:9D:EB:15,3843349,486883591,2117,2422651,3841232,484460940,0,4281,3009594,4250,3004613,31,4981,2053,0,2164,56,0,105,216660.0,130000.0,-47.0,-45.0,-39.0,-46.0,-46.0,-47.0,-39.0,-47.0,-84.0,-85.0,-81.0,-81.0,37.0,40.0,42.0,35.0,1
1256,3C:55:76:E8:8F:1F,3916581,673028783,75349,188567843,3841232,484460940,38,35884,7349765,35398,7267063,486,82702,15205,39,75406,7770,38,507,206470.0,103230.0,-49.0,-52.0,-44.0,-44.0,-47.0,-51.0,-43.0,-42.0,-84.0,-85.0,-81.0,-81.0,35.0,33.0,37.0,37.0,1
1257,92:69:1D:31:68:E9,3845220,488100990,3988,3640050,3841232,484460940,0,5092,1131589,4935,1096026,157,35563,2165,11,4220,92,0,55,229410.0,130000.0,-52.0,-47.0,-44.0,-47.0,-51.0,-47.0,-43.0,-47.0,-84.0,-85.0,-82.0,-81.0,32.0,38.0,38.0,34.0,1
1258,CC:2F:71:3F:1F:24,4829562,1590167494,988330,1105706554,3841232,484460940,364,814252,891055793,813478,890962323,774,93470,786438,15,988265,104081,361,622,78000.0,13000.0,-69.0,-72.0,-67.0,-72.0,-68.0,-72.0,-67.0,-71.0,-84.0,-85.0,-82.0,-81.0,15.0,13.0,15.0,9.0,1
1259,CC:2F:71:3E:C5:1F,3842168,484575387,936,114447,3841232,484460940,0,3898,327717,3216,246711,682,81006,992,11,1343,25,0,52,130000.0,39000.0,-71.0,-71.0,-69.0,-60.0,-70.0,-70.0,-68.0,-60.0,-84.0,-85.0,-82.0,-81.0,13.0,14.0,13.0,21.0,1
1260,BA:8C:B9:54:50:24,3846117,490649278,4883,6188136,3841234,484461142,0,9333,1722908,9311,1719413,22,3495,2354,17,5355,41,0,64,229410.0,137640.0,-39.0,-36.0,-46.0,-52.0,-43.0,-36.0,-44.0,-49.0,-84.0,-85.0,-82.0,-81.0,45.0,49.0,36.0,29.0,1
1261,62:47:05:9D:EB:15,3843355,486884197,2117,2422651,3841238,484461546,0,4281,3009594,4250,3004613,31,4981,2053,0,2164,56,0,105,216660.0,130000.0,-47.0,-45.0,-39.0,-46.0,-46.0,-47.0,-39.0,-47.0,-84.0,-85.0,-82.0,-81.0,37.0,40.0,43.0,35.0,1
1262,3C:55:76:E8:8F:1F,3916588,673029457,75350,188567911,3841238,484461546,38,35896,7350653,35410,7267951,486,82702,15206,39,75407,7770,38,507,206470.0,103230.0,-45.0,-53.0,-49.0,-41.0,-44.0,-51.0,-46.0,-40.0,-85.0,-86.0,-82.0,-82.0,40.0,33.0,33.0,41.0,1
1263,92:69:1D:31:68:E9,3845226,488101596,3988,3640050,3841238,484461546,0,5092,1131589,4935,1096026,157,35563,2165,11,4220,92,0,55,229410.0,130000.0,-52.0,-47.0,-44.0,-47.0,-51.0,-47.0,-43.0,-47.0,-85.0,-86.0,-82.0,-82.0,33.0,39.0,38.0,35.0,1
1264,CC:2F:71:3F:1F:24,4829787,1590447338,988549,1105985792,3841238,484461546,364,814465,891340685,813691,891247215,774,93470,786635,15,988484,104081,361,622,86667.0,13000.0,-68.0,-72.0,-68.0,-71.0,-68.0,-72.0,-67.0,-71.0,-85.0,-86.0,-82.0,-82.0,17.0,14.0,14.0,11.0,1
1265,CC:2F:71:3E:C5:1F,3842175,484576053,936,114447,3841239,484461606,0,3898,327717,3216,246711,682,81006,992,11,1343,25,0,52,130000.0,39000.0,-71.0,-71.0,-69.0,-60.0,-70.0,-70.0,-68.0,-60.0,-85.0,-86.0,-82.0,-82.0,14.0,15.0,13.0,22.0,1
1266,BA:8C:B9:54:50:24,3846124,490649944,4883,6188136,3841241,484461808,0,9333,1722908,9311,1719413,22,3495,2354,17,5355,41,0,64,229410.0,137640.0,-39.0,-36.0,-46.0,-52.0,-43.0,-36.0,-44.0,-49.0,-85.0,-86.0,-82.0,-82.0,46.0,50.0,36.0,30.0,1
1267,62:47:05:9D:EB:15,3843359,486884521,2117,2422651,3841242,484461870,0,4281,3009594,4250,3004613,31,4981,2053,0,2164,56,0,105,216660.0,130000.0,-47.0,-45.0,-39.0,-46.0,-46.0,-47.0,-39.0,-47.0,-85.0,-86.0,-82.0,-82.0,38.0,41.0,43.0,36.0,1
1268,3C:55:76:E8:8F:1F,3916595,673030406,75353,188568536,3841242,484461870,38,35908,7351868,35422,7269166,486,82702,15209,39,75410,7770,38,507,206470.0,103230.0,-43.0,-52.0,-46.0,-38.0,-44.0,-52.0,-47.0,-41.0,-85.0,-86.0,-82.0,-82.0,42.0,34.0,36.0,44.0,1
1269,92:69:1D:31:68:E9,3845232,488102122,3988,3640050,3841244,484462072,0,5092,1131589,4935,1096026,157,35563,2165,11,4220,92,0,55,229410.0,130000.0,-52.0,-47.0,-44.0,-47.0,-51.0,-47.0,-43.0,-47.0,-85.0,-86.0,-82.0,-82.0,33.0,39.0,38.0,35.0,1
1270,CC:2F:71:3F:1F:24,4830018,1590724748,988774,1106262676,3841244,484462072,364,814670,891602000,813895,891508412,775,93588,786835,15,988709,104081,361,622,78000.0,13000.0,-69.0,-72.0,-67.0,-71.0,-68.0,-71.0,-67.0,-71.0,-85.0,-86.0,-83.0,-83.0,16.0,14.0,16.0,12.0,1
1271,CC:2F:71:3E:C5:1F,3842180,484576519,936,114447,3841244,484462072,0,3898,327717,3216,246711,682,81006,992,11,1343,25,0,52,130000.0,39000.0,-71.0,-71.0,-69.0,-60.0,-70.0,-70.0,-68.0,-60.0,-85.0,-86.0,-83.0,-83.0,14.0,15.0,14.0,23.0,1
1272,BA:8C:B9:54:50:24,3846129,490650410,4883,6188136,3841246,484462274,0,9333,1722908,9311,1719413,22,3495,2354,17,5355,41,0,64,229410.0,137640.0,-39.0,-36.0,-46.0,-52.0,-43.0,-36.0,-44.0,-49.0,-85.0,-86.0,-83.0,-83.0,46.0,50.0,37.0,31.0,1
1273,62:47:05:9D:EB:15,3843365,486885127,2117,2422651,3841248,484462476,0,4281,3009594,4250,3004613,31,4981,2053,0,2164,56,0,105,216660.0,130000.0,-47.0,-45.0,-39.0,-46.0,-46.0,-47.0,-39.0,-47.0,-85.0,-86.0,-83.0,-83.0,38.0,41.0,44.0,37.0,1
1274,3C:55:76:E8:8F:1F,3916603,673031214,75353,188568536,3841250,484462678,38,35925,7353062,35439,7270360,486,82702,15210,39,75410,7770,38,509,206470.0,103230.0,-45.0,-53.0,-49.0,-41.0,-45.0,-53.0,-48.0,-41.0,-85.0,-86.0,-83.0,-83.0,40.0,33.0,34.0,42.0,1
1275,92:69:1D:31:68:E9,3845238,488102728,3988,3640050,3841250,484462678,0,5092,1131589,4935,1096026,157,35563,2165,11,4220,92,0,55,229410.0,130000.0,-52.0,-47.0,-44.0,-47.0,-51.0,-47.0,-43.0,-47.0,-85.0,-86.0,-83.0,-83.0,33.0,39.0,39.0,36.0,1
1276,CC:2F:71:3F:1F:24,4830234,1590987534,988984,1106524856,3841250,484462678,364,814863,891860064,814088,891766476,775,93588,787019,15,988919,104105,361,622,78000.0,13000.0,-69.0,-72.0,-68.0,-71.0,-68.0,-72.0,-67.0,-71.0,-85.0,-86.0,-83.0,-83.0,16.0,14.0,15.0,12.0,1
1277,CC:2F:71:3E:C5:1F,3842186,484577125,936,114447,3841250,484462678,0,3898,327717,3216,246711,682,81006,992,11,1343,25,0,52,130000.0,39000.0,-71.0,-71.0,-69.0,-60.0,-70.0,-70.0,-68.0,-60.0,-85.0,-86.0,-83.0,-83.0,14.0,15.0,14.0,23.0,1
1278,BA:8C:B9:54:50:24,3846133,490650814,4883,6188136,3841250,484462678,0,9333,1722908,9311,1719413,22,3495,2354,17,5355,41,0,64,229410.0,137640.0,-39.0,-36.0,-46.0,-52.0,-43.0,-36.0,-44.0,-49.0,-86.0,-87.0,-83.0,-83.0,47.0,51.0,37.0,31.0,1
1279,62:47:05:9D:EB:15,3843373,486886102,2117,2422651,3841256,484463451,0,4281,3009594,4250,3004613,31,4981,2053,0,2164,56,0,105,216660.0,130000.0,-47.0,-45.0,-39.0,-46.0,-46.0,-47.0,-39.0,-47.0,-86.0,-87.0,-83.0,-83.0,39.0,42.0,44.0,37.0,1
1280,3C:55:76:E8:8F:1F,3916610,673032197,75354,188568746,3841256,484463451,38,35943,7354803,35454,7271422,489,83381,15214,39,75411,7770,38,511,206470.0,103230.0,-51.0,-55.0,-46.0,-45.0,-49.0,-53.0,-45.0,-44.0,-86.0,-87.0,-83.0,-83.0,35.0,32.0,37.0,38.0,1
1281,92:69:1D:31:68:E9,3845248,488103905,3988,3640050,3841260,484463855,0,5092,1131589,4935,1096026,157,35563,2165,11,4220,92,0,55,229410.0,130000.0,-52.0,-47.0,-44.0,-47.0,-51.0,-47.0,-43.0,-47.0,-86.0,-87.0,-83.0,-83.0,34.0,40.0,39.0,36.0,1
1282,CC:2F:71:3F:1F:24,4830455,1591254093,989195,1106790238,3841260,484463855,364,815057,892111056,814282,892017468,775,93588,787209,15,989130,104105,361,622,86667.0,14444.0,-68.0,-72.0,-68.0,-71.0,-68.0,-72.0,-67.0,-71.0,-86.0,-87.0,-83.0,-83.0,18.0,15.0,15.0,12.0,1
1283,CC:2F:71:3E:C5:1F,3842196,484578302,936,114447,3841260,484463855,0,3898,327717,3216,246711,682,81006,992,11,1343,25,0,52,130000.0,39000.0,-71.0,-71.0,-69.0,-60.0,-70.0,-70.0,-68.0,-60.0,-86.0,-87.0,-83.0,-83.0,15.0,16.0,14.0,23.0,1
1284,BA:8C:B9:54:50:24,3846143,490651991,4883,6188136,3841260,484463855,0,9333,1722908,9311,1719413,22,3495,2354,17,5355,41,0,64,229410.0,137640.0,-39.0,-36.0,-46.0,-52.0,-43.0,-36.0,-44.0,-49.0,-86.0,-87.0,-83.0,-83.0,47.0,51.0,37.0,31.0,1
1285,62:47:05:9D:EB:15,3843381,486887157,2117,2422651,3841264,484464506,0,4283,3009730,4252,3004749,31,4981,2053,0,2165,56,0,105,216660.0,130000.0,-47.0,-45.0,-39.0,-46.0,-46.0,-47.0,-40.0,-47.0,-86.0,-88.0,-84.0,-84.0,39.0,43.0,45.0,38.0,1
1286,3C:55:76:E8:8F:1F,3916619,673033418,75355,188568912,3841264,484464506,38,35954,7356111,35463,7272169,491,83942,15218,39,75412,7770,38,511,216660.0,130000.0,-49.0,-52.0,-44.0,-44.0,-47.0,-51.0,-44.0,-42.0,-86.0,-88.0,-84.0,-84.0,37.0,36.0,40.0,40.0,1
1287,92:69:1D:31:68:E9,3845252,488104556,3988,3640050,3841264,484464506,0,5094,1131725,4937,1096162,157,35563,2165,12,4221,93,0,55,229410.0,130000.0,-52.0,-47.0,-44.0,-47.0,-51.0,-47.0,-44.0,-47.0,-86.0,-88.0,-84.0,-84.0,34.0,41.0,40.0,37.0,1
1288,CC:2F:71:3F:1F:24,4830667,1591513928,989403,1107049422,3841264,484464506,364,815250,892366402,814475,892272814,775,93588,787393,15,989337,104118,361,622,86667.0,14444.0,-69.0,-72.0,-67.0,-72.0,-69.0,-72.0,-67.0,-71.0,-86.0,-88.0,-84.0,-84.0,17.0,16.0,17.0,12.0,1
1289,CC:2F:71:3E:C5:1F,3842200,484578953,936,114447,3841264,484464506,0,3900,327857,3218,246851,682,81006,992,11,1344,25,0,52,130000.0,39000.0,-72.0,-71.0,-69.0,-60.0,-70.0,-70.0,-68.0,-60.0,-86.0,-88.0,-84.0,-84.0,14.0,17.0,15.0,24.0,1
1290,BA:8C:B9:54:50:24,3846147,490652642,4883,6188136,3841264,484464506,0,9335,1723044,9313,1719549,22,3495,2354,17,5356,41,0,64,229410.0,137640.0,-40.0,-37.0,-46.0,-52.0,-41.0,-36.0,-45.0,-49.0,-86.0,-88.0,-84.0,-84.0,46.0,51.0,38.0,32.0,1
1291,62:47:05:9D:EB:15,3843390,486888272,2117,2422651,3841273,484465621,0,4284,3009798,4253,3004817,31,4981,2053,0,2165,56,0,105,216660.0,130000.0,-47.0,-45.0,-39.0,-46.0,-46.0,-47.0,-40.0,-47.0,-87.0,-88.0,-84.0,-85.0,40.0,43.0,45.0,39.0,1
1292,3C:55:76:E8:8F:1F,3916628,673034533,75355,188568912,3841273,484465621,38,35968,7357492,35475,7272989,493,84503,15220,39,75412,7770,38,512,216660.0,130000.0,-45.0,-52.0,-48.0,-41.0,-44.0,-51.0,-46.0,-40.0,-87.0,-88.0,-84.0,-85.0,42.0,36.0,36.0,44.0,1
1293,92:69:1D:31:68:E9,3845261,488105671,3988,3640050,3841273,484465621,0,5094,1131725,4937,1096162,157,35563,2165,12,4221,93,0,55,229410.0,130000.0,-52.0,-47.0,-44.0,-47.0,-51.0,-47.0,-44.0,-47.0,-87.0,-88.0,-84.0,-85.0,35.0,41.0,40.0,38.0,1
1294,CC:2F:71:3F:1F:24,4830908,1591787504,989635,1107321883,3841273,484465621,364,815462,892626424,814687,892532836,775,93588,787597,15,989570,104119,361,622,86667.0,14444.0,-68.0,-72.0,-67.0,-71.0,-68.0,-72.0,-67.0,-71.0,-87.0,-88.0,-84.0,-85.0,19.0,16.0,17.0,14.0,1
1295,CC:2F:71:3E:C5:1F,3842209,484580068,936,114447,3841273,484465621,0,3900,327857,3218,246851,682,81006,992,11,1344,25,0,52,130000.0,39000.0,-72.0,-71.0,-69.0,-60.0,-70.0,-70.0,-68.0,-60.0,-87.0,-88.0,-84.0,-85.0,15.0,17.0,15.0,25.0,1
1296,BA:8C:B9:54:50:24,3846156,490653757,4883,6188136,3841273,484465621,0,9335,1723044,9313,1719549,22,3495,2354,17,5356,41,0,64,229410.0,137640.0,-40.0,-37.0,-46.0,-52.0,-41.0,-36.0,-45.0,-49.0,-87.0,-88.0,-84.0,-85.0,47.0,51.0,38.0,33.0,1
1297,62:47:05:9D:EB:15,3843394,486888923,2117,2422651,3841277,484466272,0,4284,3009798,4253,3004817,31,4981,2053,0,2165,56,0,105,216660.0,130000.0,-47.0,-45.0,-39.0,-46.0,-46.0,-47.0,-40.0,-47.0,-87.0,-89.0,-85.0,-85.0,40.0,44.0,46.0,39.0,1
1298,3C:55:76:E8:8F:1F,3917840,676246708,76563,191780436,3841277,484466272,38,36192,7395371,35698,7310587,494,84784,15332,39,76620,7831,38,525,258080.0,146250.0,-49.0,-52.0,-44.0,-44.0,-48.0,-52.0,-45.0,-44.0,-87.0,-89.0,-85.0,-85.0,38.0,37.0,41.0,41.0,1
1299,92:69:1D:31:68:E9,3845265,488106322,3988,3640050,3841277,484466272,0,5094,1131725,4937,1096162,157,35563,2165,12,4221,93,0,55,229410.0,130000.0,-52.0,-47.0,-44.0,-47.0,-51.0,-47.0,-44.0,-47.0,-87.0,-89.0,-85.0,-85.0,35.0,42.0,41.0,38.0,1
1300,CC:2F:71:3F:1F:24,4831141,1592081397,989864,1107615125,3841277,484466272,364,815676,892915798,814901,892822210,775,93588,787804,15,989799,104132,361,622,86667.0,14444.0,-68.0,-72.0,-67.0,-72.0,-68.0,-71.0,-67.0,-71.0,-87.0,-89.0,-85.0,-85.0,19.0,17.0,18.0,13.0,1
1301,CC:2F:71:3E:C5:1F,3842215,484580921,936,114447,3841279,484466474,0,3900,327857,3218,246851,682,81006,992,11,1344,25,0,52,130000.0,39000.0,-72.0,-71.0,-69.0,-60.0,-70.0,-70.0,-68.0,-60.0,-87.0,-89.0,-85.0,-85.0,15.0,18.0,16.0,25.0,1
1302,BA:8C:B9:54:50:24,3846162,490654610,4883,6188136,3841279,484466474,0,9335,1723044,9313,1719549,22,3495,2354,17,5356,41,0,64,229410.0,137640.0,-40.0,-37.0,-46.0,-52.0,-41.0,-36.0,-45.0,-49.0,-87.0,-89.0,-85.0,-85.0,47.0,52.0,39.0,33.0,1
1303,62:47:05:9D:EB:15,3843401,486889589,2117,2422651,3841284,484466938,0,4284,3009798,4253,3004817,31,4981,2053,0,2165,56,0,105,216660.0,130000.0,-47.0,-45.0,-39.0,-46.0,-46.0,-47.0,-40.0,-47.0,-87.0,-89.0,-85.0,-85.0,40.0,44.0,46.0,39.0,1
1304,3C:55:76:E8:8F:1F,3917847,676247374,76563,191780436,3841284,484466938,38,36198,7395781,35704,7310997,494,84784,15332,39,76620,7831,38,525,258080.0,146250.0,-49.0,-53.0,-45.0,-45.0,-49.0,-52.0,-44.0,-44.0,-87.0,-89.0,-85.0,-85.0,38.0,36.0,40.0,40.0,1
1305,92:69:1D:31:68:E9,3845274,488107190,3988,3640050,3841286,484467140,0,5094,1131725,4937,1096162,157,35563,2165,12,4221,93,0,55,229410.0,130000.0,-52.0,-47.0,-44.0,-47.0,-51.0,-47.0,-44.0,-47.0,-87.0,-89.0,-85.0,-85.0,35.0,42.0,41.0,38.0,1
1306,CC:2F:71:3F:1F:24,4831371,1592360227,990085,1107893087,3841286,484467140,364,815875,893180402,815100,893086814,775,93588,787999,15,990020,104145,361,623,86667.0,14444.0,-69.0,-72.0,-68.0,-72.0,-68.0,-72.0,-67.0,-71.0,-87.0,-89.0,-85.0,-85.0,18.0,17.0,17.0,13.0,1
1307,CC:2F:71:3E:C5:1F,3842222,484581587,936,114447,3841286,484467140,0,3900,327857,3218,246851,682,81006,992,11,1344,25,0,52,130000.0,39000.0,-72.0,-71.0,-69.0,-60.0,-70.0,-70.0,-68.0,-60.0,-87.0,-89.0,-85.0,-85.0,15.0,18.0,16.0,25.0,1
1308,BA:8C:B9:54:50:24,3846169,490655276,4883,6188136,3841286,484467140,0,9336,1723112,9314,1719617,22,3495,2354,17,5356,41,0,65,229410.0,137640.0,-48.0,-35.0,-43.0,-45.0,-41.0,-36.0,-45.0,-49.0,-87.0,-89.0,-85.0,-85.0,39.0,54.0,42.0,40.0,1
1309,62:47:05:9D:EB:15,3843406,486890266,2117,2422651,3841289,484467615,0,4284,3009798,4253,3004817,31,4981,2053,0,2165,56,0,105,216660.0,130000.0,-47.0,-45.0,-39.0,-46.0,-46.0,-47.0,-40.0,-47.0,-87.0,-89.0,-85.0,-85.0,40.0,44.0,46.0,39.0,1
1310,3C:55:76:E8:8F:1F,3917852,676248051,76563,191780436,3841289,484467615,38,36198,7395781,35704,7310997,494,84784,15332,39,76620,7831,38,525,258080.0,146250.0,-49.0,-53.0,-45.0,-45.0,-49.0,-52.0,-44.0,-44.0,-87.0,-89.0,-85.0,-85.0,38.0,36.0,40.0,40.0,1
1311,92:69:1D:31:68:E9,3845277,488107665,3988,3640050,3841289,484467615,0,5094,1131725,4937,1096162,157,35563,2165,12,4221,93,0,55,229410.0,130000.0,-52.0,-47.0,-44.0,-47.0,-51.0,-47.0,-44.0,-47.0,-87.0,-89.0,-85.0,-85.0,35.0,42.0,41.0,38.0,1
1312,CC:2F:71:3F:1F:24,4831597,1592628764,990304,1108160745,3841293,484468019,364,816073,893432291,815298,893338703,775,93588,788193,15,990239,104146,361,623,86667.0,14444.0,-69.0,-72.0,-68.0,-72.0,-68.0,-72.0,-67.0,-71.0,-87.0,-89.0,-85.0,-85.0,18.0,17.0,17.0,13.0,1
1313,CC:2F:71:3E:C5:1F,3842229,484582466,936,114447,3841293,484468019,0,3900,327857,3218,246851,682,81006,992,11,1344,25,0,52,130000.0,39000.0,-72.0,-71.0,-69.0,-60.0,-70.0,-70.0,-68.0,-60.0,-87.0,-89.0,-85.0,-85.0,15.0,18.0,16.0,25.0,1
1314,BA:8C:B9:54:50:24,3846176,490656155,4883,6188136,3841293,484468019,0,9336,1723112,9314,1719617,22,3495,2354,17,5356,41,0,65,229410.0,137640.0,-48.0,-35.0,-43.0,-45.0,-41.0,-36.0,-45.0,-49.0,-87.0,-89.0,-85.0,-85.0,39.0,54.0,42.0,40.0,1
1315,62:47:05:9D:EB:15,3843412,486890872,2117,2422651,3841295,484468221,0,4284,3009798,4253,3004817,31,4981,2053,0,2165,56,0,105,216660.0,130000.0,-47.0,-45.0,-39.0,-46.0,-46.0,-47.0,-40.0,-47.0,-87.0,-89.0,-85.0,-85.0,40.0,44.0,46.0,39.0,1
1316,3C:55:76:E8:8F:1F,3917858,676248657,76563,191780436,3841295,484468221,38,36198,7395781,35704,7310997,494,84784,15332,39,76620,7831,38,525,258080.0,146250.0,-49.0,-53.0,-45.0,-45.0,-49.0,-52.0,-44.0,-44.0,-87.0,-89.0,-85.0,-85.0,38.0,36.0,40.0,40.0,1
1317,92:69:1D:31:68:E9,3845283,488108271,3988,3640050,3841295,484468221,0,5094,1131725,4937,1096162,157,35563,2165,12,4221,93,0,55,229410.0,130000.0,-52.0,-47.0,-44.0,-47.0,-51.0,-47.0,-44.0,-47.0,-87.0,-89.0,-85.0,-85.0,35.0,42.0,41.0,38.0,1
1318,CC:2F:71:3F:1F:24,4831812,1592896032,990517,1108427811,3841295,484468221,364,816265,893687309,815490,893593721,775,93588,788382,15,990452,104152,361,623,115556.0,28889.0,-68.0,-72.0,-68.0,-72.0,-68.0,-72.0,-67.0,-71.0,-87.0,-89.0,-85.0,-85.0,19.0,17.0,17.0,13.0,1
1319,CC:2F:71:3E:C5:1F,3842231,484582668,936,114447,3841295,484468221,0,3900,327857,3218,246851,682,81006,992,11,1344,25,0,52,130000.0,39000.0,-72.0,-71.0,-69.0,-60.0,-70.0,-70.0,-68.0,-60.0,-87.0,-89.0,-85.0,-85.0,15.0,18.0,16.0,25.0,1
1320,BA:8C:B9:54:50:24,3846179,490656417,4883,6188136,3841296,484468281,0,9336,1723112,9314,1719617,22,3495,2354,17,5356,41,0,65,229410.0,137640.0,-48.0,-35.0,-43.0,-45.0,-41.0,-36.0,-45.0,-49.0,-87.0,-89.0,-85.0,-85.0,39.0,54.0,42.0,40.0,1
1321,62:47:05:9D:EB:15,3843419,486891538,2117,2422651,3841302,484468887,0,4284,3009798,4253,3004817,31,4981,2053,0,2165,56,0,105,216660.0,130000.0,-47.0,-45.0,-39.0,-46.0,-46.0,-47.0,-40.0,-47.0,-87.0,-89.0,-85.0,-85.0,40.0,44.0,46.0,39.0,1
1322,3C:55:76:E8:8F:1F,3917866,676249535,76564,191780648,3841302,484468887,38,36213,7396841,35719,7312057,494,84784,15333,39,76621,7831,38,525,258080.0,146250.0,-50.0,-53.0,-45.0,-44.0,-49.0,-52.0,-45.0,-44.0,-87.0,-89.0,-85.0,-85.0,37.0,36.0,40.0,41.0,1
1323,92:69:1D:31:68:E9,3845290,488108937,3988,3640050,3841302,484468887,0,5094,1131725,4937,1096162,157,35563,2165,12,4221,93,0,55,229410.0,130000.0,-52.0,-47.0,-44.0,-47.0,-51.0,-47.0,-44.0,-47.0,-87.0,-89.0,-85.0,-85.0,35.0,42.0,41.0,38.0,1
1324,CC:2F:71:3F:1F:24,4832031,1593160674,990729,1108691787,3841302,484468887,364,816458,893942467,815683,893848879,775,93588,788568,15,990663,104222,361,623,86667.0,14444.0,-69.0,-72.0,-68.0,-72.0,-69.0,-72.0,-67.0,-72.0,-87.0,-89.0,-85.0,-85.0,18.0,17.0,17.0,13.0,1
1325,CC:2F:71:3E:C5:1F,3842238,484583334,936,114447,3841302,484468887,0,3900,327857,3218,246851,682,81006,992,11,1344,25,0,52,130000.0,39000.0,-72.0,-71.0,-69.0,-60.0,-70.0,-70.0,-68.0,-60.0,-87.0,-89.0,-85.0,-85.0,15.0,18.0,16.0,25.0,1
1326,BA:8C:B9:54:50:24,3846185,490657023,4883,6188136,3841302,484468887,0,9336,1723112,9314,1719617,22,3495,2354,17,5356,41,0,65,229410.0,137640.0,-48.0,-35.0,-43.0,-45.0,-41.0,-36.0,-45.0,-49.0,-87.0,-89.0,-85.0,-85.0,39.0,54.0,42.0,40.0,1
1327,62:47:05:9D:EB:15,3843421,486891740,2117,2422651,3841304,484469089,0,4284,3009798,4253,3004817,31,4981,2053,0,2165,56,0,105,216660.0,130000.0,-47.0,-45.0,-39.0,-46.0,-46.0,-47.0,-40.0,-47.0,-87.0,-89.0,-85.0,-85.0,40.0,44.0,46.0,39.0,1
1328,3C:55:76:E8:8F:1F,3917872,676250246,76568,191781157,3841304,484469089,38,36227,7398979,35733,7314195,494,84784,15337,39,76625,7831,38,525,258080.0,1000.0,-45.0,-52.0,-49.0,-40.0,-44.0,-52.0,-48.0,-40.0,-87.0,-89.0,-85.0,-85.0,42.0,37.0,36.0,45.0,1
1329,92:69:1D:31:68:E9,3845292,488109139,3988,3640050,3841304,484469089,0,5094,1131725,4937,1096162,157,35563,2165,12,4221,93,0,55,229410.0,130000.0,-52.0,-47.0,-44.0,-47.0,-51.0,-47.0,-44.0,-47.0,-87.0,-89.0,-85.0,-85.0,35.0,42.0,41.0,38.0,1
1330,CC:2F:71:3F:1F:24,4832245,1593425230,990941,1108956141,3841304,484469089,364,816651,894196067,815876,894102479,775,93588,788758,15,990876,104260,361,623,115556.0,28889.0,-70.0,-72.0,-68.0,-72.0,-70.0,-72.0,-68.0,-72.0,-87.0,-89.0,-85.0,-85.0,17.0,17.0,17.0,13.0,1
1331,CC:2F:71:3E:C5:1F,3842240,484583536,936,114447,3841304,484469089,0,3900,327857,3218,246851,682,81006,992,11,1344,25,0,52,130000.0,39000.0,-72.0,-71.0,-69.0,-60.0,-70.0,-70.0,-68.0,-60.0,-87.0,-89.0,-85.0,-85.0,15.0,18.0,16.0,25.0,1
1332,BA:8C:B9:54:50:24,3846187,490657225,4883,6188136,3841304,484469089,0,9336,1723112,9314,1719617,22,3495,2354,17,5356,41,0,65,229410.0,137640.0,-48.0,-35.0,-43.0,-45.0,-41.0,-36.0,-45.0,-49.0,-87.0,-89.0,-85.0,-85.0,39.0,54.0,42.0,40.0,1
1333,62:47:05:9D:EB:15,3843428,486892406,2117,2422651,3841311,484469755,0,4284,3009798,4253,3004817,31,4981,2053,0,2165,56,0,105,216660.0,130000.0,-47.0,-45.0,-39.0,-46.0,-46.0,-47.0,-40.0,-47.0,-87.0,-89.0,-85.0,-85.0,40.0,44.0,46.0,39.0,1
1334,3C:55:76:E8:8F:1F,3917885,676255435,76574,191785680,3841311,484469755,38,36252,7406274,35758,7321490,494,84784,15344,39,76631,7831,38,525,258080.0,146250.0,-45.0,-52.0,-49.0,-40.0,-45.0,-52.0,-48.0,-40.0,-87.0,-89.0,-85.0,-85.0,42.0,37.0,36.0,45.0,1
1335,92:69:1D:31:68:E9,3845299,488109805,3988,3640050,3841311,484469755,0,5094,1131725,4937,1096162,157,35563,2165,12,4221,93,0,55,229410.0,130000.0,-52.0,-47.0,-44.0,-47.0,-51.0,-47.0,-44.0,-47.0,-87.0,-89.0,-85.0,-85.0,35.0,42.0,41.0,38.0,1
1336,CC:2F:71:3F:1F:24,4832672,1593948081,991361,1109478326,3841311,484469755,364,816945,894470695,816170,894377107,775,93588,789046,15,991295,104361,361,623,115556.0,26000.0,-70.0,-72.0,-68.0,-72.0,-70.0,-72.0,-67.0,-72.0,-87.0,-89.0,-85.0,-85.0,17.0,17.0,17.0,13.0,1
1337,CC:2F:71:3E:C5:1F,3842249,484584404,936,114447,3841313,484469957,0,3900,327857,3218,246851,682,81006,992,11,1344,25,0,52,130000.0,39000.0,-72.0,-71.0,-69.0,-60.0,-70.0,-70.0,-68.0,-60.0,-87.0,-89.0,-85.0,-85.0,15.0,18.0,16.0,25.0,1
1338,BA:8C:B9:54:50:24,3846196,490658093,4883,6188136,3841313,484469957,0,9336,1723112,9314,1719617,22,3495,2354,17,5356,41,0,65,229410.0,137640.0,-48.0,-35.0,-43.0,-45.0,-41.0,-36.0,-45.0,-49.0,-87.0,-89.0,-85.0,-85.0,39.0,54.0,42.0,40.0,1
1339,62:47:05:9D:EB:15,3843430,486892608,2117,2422651,3841313,484469957,0,4284,3009798,4253,3004817,31,4981,2053,0,2165,56,0,105,216660.0,130000.0,-47.0,-45.0,-39.0,-46.0,-46.0,-47.0,-40.0,-47.0,-87.0,-89.0,-84.0,-85.0,40.0,44.0,45.0,39.0,1
1340,3C:55:76:E8:8F:1F,3917901,676264408,76588,191794451,3841313,484469957,38,36283,7414068,35789,7329284,494,84784,15360,39,76645,7831,38,527,258080.0,154850.0,-45.0,-53.0,-50.0,-41.0,-45.0,-52.0,-49.0,-40.0,-87.0,-89.0,-84.0,-85.0,42.0,36.0,34.0,44.0,1
1341,92:69:1D:31:68:E9,3845303,488110209,3988,3640050,3841315,484470159,0,5094,1131725,4937,1096162,157,35563,2165,12,4221,93,0,55,229410.0,130000.0,-52.0,-47.0,-44.0,-47.0,-51.0,-47.0,-44.0,-47.0,-87.0,-89.0,-84.0,-85.0,35.0,42.0,40.0,38.0,1
1342,CC:2F:71:3F:1F:24,4833081,1594461053,991766,1109990894,3841315,484470159,364,817227,894738845,816452,894645257,775,93588,789325,15,991701,104379,361,624,86667.0,14444.0,-70.0,-72.0,-68.0,-73.0,-69.0,-72.0,-67.0,-72.0,-87.0,-89.0,-84.0,-85.0,17.0,17.0,16.0,12.0,1
1343,CC:2F:71:3E:C5:1F,3842251,484584606,936,114447,3841315,484470159,0,3900,327857,3218,246851,682,81006,992,11,1344,25,0,52,130000.0,39000.0,-72.0,-71.0,-69.0,-60.0,-70.0,-70.0,-68.0,-60.0,-87.0,-89.0,-84.0,-85.0,15.0,18.0,15.0,25.0,1
1344,BA:8C:B9:54:50:24,3846200,490658497,4883,6188136,3841317,484470361,0,9336,1723112,9314,1719617,22,3495,2354,17,5356,41,0,65,229410.0,137640.0,-48.0,-35.0,-43.0,-45.0,-41.0,-36.0,-45.0,-49.0,-87.0,-89.0,-84.0,-85.0,39.0,54.0,41.0,40.0,1
1345,62:47:05:9D:EB:15,3843439,486893476,2117,2422651,3841322,484470825,0,4284,3009798,4253,3004817,31,4981,2053,0,2165,56,0,105,216660.0,130000.0,-47.0,-45.0,-39.0,-46.0,-46.0,-47.0,-40.0,-47.0,-87.0,-89.0,-84.0,-85.0,40.0,44.0,45.0,39.0,1
1346,3C:55:76:E8:8F:1F,3917910,676265276,76588,191794451,3841322,484470825,38,36283,7414068,35789,7329284,494,84784,15360,39,76645,7831,38,527,258080.0,154850.0,-45.0,-53.0,-50.0,-41.0,-45.0,-52.0,-49.0,-40.0,-87.0,-89.0,-84.0,-85.0,42.0,36.0,34.0,44.0,1
1347,92:69:1D:31:68:E9,3845310,488110875,3988,3640050,3841322,484470825,0,5094,1131725,4937,1096162,157,35563,2165,12,4221,93,0,55,229410.0,130000.0,-52.0,-47.0,-44.0,-47.0,-51.0,-47.0,-44.0,-47.0,-87.0,-89.0,-84.0,-85.0,35.0,42.0,40.0,38.0,1
1348,CC:2F:71:3F:1F:24,4833298,1594724011,991976,1110253186,3841322,484470825,364,817417,894989617,816642,894896029,775,93588,789509,15,991911,104407,361,624,86667.0,14444.0,-69.0,-72.0,-68.0,-72.0,-69.0,-72.0,-68.0,-72.0,-87.0,-89.0,-84.0,-85.0,18.0,17.0,16.0,13.0,1
1349,CC:2F:71:3E:C5:1F,3842258,484585272,936,114447,3841322,484470825,0,3900,327857,3218,246851,682,81006,992,11,1344,25,0,52,130000.0,39000.0,-72.0,-71.0,-69.0,-60.0,-70.0,-70.0,-68.0,-60.0,-87.0,-89.0,-84.0,-85.0,15.0,18.0,15.0,25.0,1
1350,BA:8C:B9:54:50:24,3846205,490658961,4883,6188136,3841322,484470825,0,9336,1723112,9314,1719617,22,3495,2354,17,5356,41,0,65,229410.0,137640.0,-48.0,-35.0,-43.0,-45.0,-41.0,-36.0,-45.0,-49.0,-87.0,-89.0,-84.0,-85.0,39.0,54.0,41.0,40.0,1
1351,62:47:05:9D:EB:15,3843441,486893678,2117,2422651,3841324,484471027,0,4284,3009798,4253,3004817,31,4981,2053,0,2165,56,0,105,216660.0,130000.0,-47.0,-45.0,-39.0,-46.0,-46.0,-47.0,-40.0,-47.0,-87.0,-89.0,-84.0,-85.0,40.0,44.0,45.0,39.0,1
1352,3C:55:76:E8:8F:1F,3917912,676265478,76588,191794451,3841324,484471027,38,36283,7414068,35789,7329284,494,84784,15360,39,76645,7831,38,527,258080.0,154850.0,-45.0,-53.0,-50.0,-41.0,-45.0,-52.0,-49.0,-40.0,-87.0,-89.0,-84.0,-85.0,42.0,36.0,34.0,44.0,1
1353,92:69:1D:31:68:E9,3845314,488111279,3988,3640050,3841326,484471229,0,5094,1131725,4937,1096162,157,35563,2165,12,4221,93,0,55,229410.0,130000.0,-52.0,-47.0,-44.0,-47.0,-51.0,-47.0,-44.0,-47.0,-87.0,-89.0,-84.0,-85.0,35.0,42.0,40.0,38.0,1
1354,CC:2F:71:3F:1F:24,4833511,1594983617,992185,1110512388,3841326,484471229,364,817604,895235397,816829,895141809,775,93588,789694,15,992120,104412,361,624,86667.0,14444.0,-69.0,-72.0,-68.0,-73.0,-69.0,-72.0,-68.0,-72.0,-87.0,-89.0,-84.0,-85.0,18.0,17.0,16.0,12.0,1
1355,CC:2F:71:3E:C5:1F,3842262,484585676,936,114447,3841326,484471229,0,3900,327857,3218,246851,682,81006,992,11,1344,25,0,52,130000.0,39000.0,-72.0,-71.0,-69.0,-60.0,-70.0,-70.0,-68.0,-60.0,-87.0,-89.0,-84.0,-85.0,15.0,18.0,15.0,25.0,1
1356,BA:8C:B9:54:50:24,3846211,490659567,4883,6188136,3841328,484471431,0,9336,1723112,9314,1719617,22,3495,2354,17,5356,41,0,65,229410.0,137640.0,-48.0,-35.0,-43.0,-45.0,-41.0,-36.0,-45.0,-49.0,-87.0,-89.0,-84.0,-85.0,39.0,54.0,41.0,40.0,1
1357,62:47:05:9D:EB:15,3843447,486894284,2117,2422651,3841330,484471633,0,4284,3009798,4253,3004817,31,4981,2053,0,2165,56,0,105,216660.0,130000.0,-47.0,-45.0,-39.0,-46.0,-46.0,-47.0,-40.0,-47.0,-87.0,-89.0,-85.0,-85.0,40.0,44.0,46.0,39.0,1
1358,3C:55:76:E8:8F:1F,3917922,676266595,76592,191794962,3841330,484471633,38,36302,7416621,35808,7331837,494,84784,15363,39,76649,7831,38,527,270830.0,162500.0,-44.0,-53.0,-50.0,-41.0,-44.0,-52.0,-49.0,-40.0,-87.0,-89.0,-85.0,-85.0,43.0,36.0,35.0,44.0,1
1359,92:69:1D:31:68:E9,3845318,488111683,3988,3640050,3841330,484471633,0,5094,1131725,4937,1096162,157,35563,2165,12,4221,93,0,55,229410.0,130000.0,-52.0,-47.0,-44.0,-47.0,-51.0,-47.0,-44.0,-47.0,-87.0,-89.0,-85.0,-85.0,35.0,42.0,41.0,38.0,1
1360,CC:2F:71:3F:1F:24,4833729,1595249499,992398,1110777806,3841331,484471693,364,817801,895498275,817026,895404687,775,93588,789880,15,992333,104429,361,624,86667.0,14444.0,-69.0,-72.0,-68.0,-72.0,-69.0,-71.0,-67.0,-72.0,-87.0,-89.0,-85.0,-85.0,18.0,17.0,17.0,13.0,1
1361,CC:2F:71:3E:C5:1F,3842267,484586140,936,114447,3841331,484471693,0,3900,327857,3218,246851,682,81006,992,11,1344,25,0,52,130000.0,39000.0,-72.0,-71.0,-69.0,-60.0,-70.0,-70.0,-68.0,-60.0,-87.0,-89.0,-85.0,-85.0,15.0,18.0,16.0,25.0,1
1362,BA:8C:B9:54:50:24,3846214,490659829,4883,6188136,3841331,484471693,0,9336,1723112,9314,1719617,22,3495,2354,17,5356,41,0,65,229410.0,137640.0,-48.0,-35.0,-43.0,-45.0,-41.0,-36.0,-45.0,-49.0,-87.0,-89.0,-85.0,-85.0,39.0,54.0,42.0,40.0,1
1363,62:47:05:9D:EB:15,3843453,486894875,2117,2422651,3841336,484472224,0,4284,3009798,4253,3004817,31,4981,2053,0,2165,56,0,105,216660.0,130000.0,-47.0,-45.0,-39.0,-46.0,-46.0,-47.0,-40.0,-47.0,-87.0,-89.0,-85.0,-85.0,40.0,44.0,46.0,39.0,1
1364,3C:55:76:E8:8F:1F,3917932,676267735,76594,191795309,3841338,484472426,38,36320,7418073,35825,7333106,495,84967,15366,39,76651,7833,38,527,270830.0,162500.0,-45.0,-53.0,-50.0,-41.0,-44.0,-52.0,-48.0,-40.0,-87.0,-89.0,-85.0,-85.0,42.0,36.0,35.0,44.0,1
1365,92:69:1D:31:68:E9,3845327,488112592,3989,3640166,3841338,484472426,0,5096,1131861,4939,1096298,157,35563,2165,12,4222,93,0,55,229410.0,130000.0,-52.0,-47.0,-44.0,-47.0,-51.0,-47.0,-44.0,-47.0,-87.0,-89.0,-85.0,-85.0,35.0,42.0,41.0,38.0,1
1366,CC:2F:71:3F:1F:24,4833971,1595541599,992633,1111069173,3841338,484472426,364,818015,895773560,817240,895679972,775,93588,790092,15,992568,104440,361,625,86667.0,14444.0,-69.0,-72.0,-68.0,-72.0,-69.0,-71.0,-67.0,-72.0,-87.0,-89.0,-85.0,-85.0,18.0,17.0,17.0,13.0,1
1367,CC:2F:71:3E:C5:1F,3842275,484586989,937,114563,3841338,484472426,0,3902,327997,3220,246991,682,81006,992,11,1345,25,0,52,130000.0,39000.0,-71.0,-71.0,-69.0,-60.0,-70.0,-70.0,-68.0,-60.0,-87.0,-89.0,-85.0,-85.0,16.0,18.0,16.0,25.0,1
1368,BA:8C:B9:54:50:24,3846222,490660622,4884,6188196,3841338,484472426,0,9338,1723248,9316,1719753,22,3495,2354,17,5357,41,0,65,216660.0,130000.0,-48.0,-35.0,-43.0,-45.0,-41.0,-36.0,-45.0,-49.0,-87.0,-89.0,-85.0,-85.0,39.0,54.0,42.0,40.0,1
1369,62:47:05:9D:EB:15,3843458,486895395,2118,2422767,3841340,484472628,0,4286,3009934,4255,3004953,31,4981,2053,0,2166,56,0,105,216660.0,130000.0,-46.0,-45.0,-39.0,-46.0,-46.0,-46.0,-39.0,-47.0,-87.0,-89.0,-85.0,-85.0,41.0,44.0,46.0,39.0,1
1370,3C:55:76:E8:8F:1F,3917935,676268055,76595,191795427,3841340,484472628,38,36332,7418893,35837,7333926,495,84967,15366,39,76652,7833,38,527,270830.0,1000.0,-49.0,-51.0,-44.0,-43.0,-45.0,-51.0,-44.0,-40.0,-87.0,-89.0,-85.0,-85.0,38.0,38.0,41.0,42.0,1
1371,92:69:1D:31:68:E9,3845329,488112794,3989,3640166,3841340,484472628,0,5096,1131861,4939,1096298,157,35563,2165,12,4222,93,0,55,229410.0,130000.0,-52.0,-47.0,-44.0,-47.0,-51.0,-47.0,-44.0,-47.0,-87.0,-89.0,-85.0,-85.0,35.0,42.0,41.0,38.0,1
1372,CC:2F:71:3F:1F:24,4834184,1595804391,992844,1111331763,3841340,484472628,364,818200,896019052,817425,895925464,775,93588,790277,15,992779,104441,361,625,104000.0,26000.0,-69.0,-72.0,-68.0,-72.0,-69.0,-72.0,-68.0,-72.0,-87.0,-89.0,-85.0,-85.0,18.0,17.0,17.0,13.0,1
1373,CC:2F:71:3E:C5:1F,3842277,484587191,937,114563,3841340,484472628,0,3902,327997,3220,246991,682,81006,992,11,1345,25,0,52,130000.0,39000.0,-71.0,-71.0,-69.0,-60.0,-70.0,-70.0,-68.0,-60.0,-87.0,-89.0,-85.0,-85.0,16.0,18.0,16.0,25.0,1
1374,BA:8C:B9:54:50:24,3846226,490661026,4884,6188196,3841342,484472830,0,9338,1723248,9316,1719753,22,3495,2354,17,5357,41,0,65,216660.0,130000.0,-48.0,-35.0,-43.0,-45.0,-41.0,-36.0,-45.0,-49.0,-87.0,-89.0,-85.0,-85.0,39.0,54.0,42.0,40.0,1
1375,62:47:05:9D:EB:15,3843465,486896061,2118,2422767,3841347,484473294,0,4286,3009934,4255,3004953,31,4981,2053,0,2166,56,0,105,216660.0,130000.0,-46.0,-45.0,-39.0,-46.0,-46.0,-46.0,-39.0,-47.0,-87.0,-89.0,-85.0,-85.0,41.0,44.0,46.0,39.0,1
1376,3C:55:76:E8:8F:1F,3917943,676268994,76595,191795427,3841348,484473567,38,36333,7418963,35838,7333996,495,84967,15366,39,76652,7833,38,527,270830.0,1000.0,-49.0,-52.0,-44.0,-44.0,-46.0,-51.0,-43.0,-41.0,-87.0,-89.0,-85.0,-85.0,38.0,37.0,41.0,41.0,1
1377,92:69:1D:31:68:E9,3845339,488113935,3989,3640166,3841350,484473769,0,5096,1131861,4939,1096298,157,35563,2165,12,4222,93,0,55,229410.0,130000.0,-52.0,-47.0,-44.0,-47.0,-51.0,-47.0,-44.0,-47.0,-87.0,-89.0,-85.0,-85.0,35.0,42.0,41.0,38.0,1
1378,CC:2F:71:3F:1F:24,4834405,1596069322,993055,1111595553,3841350,484473769,364,818387,896264886,817612,896171298,775,93588,790463,15,992990,104485,361,625,86667.0,14444.0,-69.0,-73.0,-68.0,-72.0,-68.0,-72.0,-68.0,-72.0,-87.0,-89.0,-85.0,-85.0,18.0,16.0,17.0,13.0,1
1379,CC:2F:71:3E:C5:1F,3842287,484588332,937,114563,3841350,484473769,0,3902,327997,3220,246991,682,81006,992,11,1345,25,0,52,130000.0,39000.0,-71.0,-71.0,-69.0,-60.0,-70.0,-70.0,-68.0,-60.0,-87.0,-89.0,-85.0,-85.0,16.0,18.0,16.0,25.0,1
1380,BA:8C:B9:54:50:24,3846234,490661965,4884,6188196,3841350,484473769,0,9338,1723248,9316,1719753,22,3495,2354,17,5357,41,0,65,216660.0,130000.0,-48.0,-35.0,-43.0,-45.0,-41.0,-36.0,-45.0,-49.0,-87.0,-89.0,-85.0,-85.0,39.0,54.0,42.0,40.0,1
1381,62:47:05:9D:EB:15,3843469,486896596,2118,2422767,3841351,484473829,0,4286,3009934,4255,3004953,31,4981,2053,0,2166,56,0,105,216660.0,130000.0,-46.0,-45.0,-39.0,-46.0,-46.0,-46.0,-39.0,-47.0,-88.0,-89.0,-85.0,-85.0,42.0,44.0,46.0,39.0,1
1382,3C:55:76:E8:8F:1F,3917946,676269256,76595,191795427,3841351,484473829,38,36341,7419549,35845,7334476,496,85073,15367,39,76652,7833,38,527,270830.0,1000.0,-45.0,-53.0,-51.0,-41.0,-42.0,-52.0,-47.0,-38.0,-88.0,-89.0,-85.0,-85.0,43.0,36.0,34.0,44.0,1
1383,92:69:1D:31:68:E9,3845340,488113995,3989,3640166,3841351,484473829,0,5096,1131861,4939,1096298,157,35563,2165,12,4222,93,0,55,229410.0,130000.0,-52.0,-47.0,-44.0,-47.0,-51.0,-47.0,-44.0,-47.0,-88.0,-89.0,-85.0,-85.0,36.0,42.0,41.0,38.0,1
1384,CC:2F:71:3F:1F:24,4834622,1596333422,993269,1111859391,3841353,484474031,364,818578,896511594,817803,896418006,775,93588,790654,15,993204,104496,361,625,86667.0,14444.0,-69.0,-72.0,-67.0,-72.0,-69.0,-72.0,-67.0,-72.0,-88.0,-89.0,-85.0,-85.0,19.0,17.0,18.0,13.0,1
1385,CC:2F:71:3E:C5:1F,3842290,484588594,937,114563,3841353,484474031,0,3902,327997,3220,246991,682,81006,992,11,1345,25,0,52,130000.0,39000.0,-71.0,-71.0,-69.0,-60.0,-70.0,-70.0,-68.0,-60.0,-88.0,-89.0,-85.0,-85.0,17.0,18.0,16.0,25.0,1
1386,BA:8C:B9:54:50:24,3846239,490662429,4884,6188196,3841355,484474233,0,9338,1723248,9316,1719753,22,3495,2354,17,5357,41,0,65,216660.0,130000.0,-48.0,-35.0,-43.0,-45.0,-41.0,-36.0,-45.0,-49.0,-88.0,-89.0,-85.0,-85.0,40.0,54.0,42.0,40.0,1
1387,62:47:05:9D:EB:15,3843479,486897524,2118,2422767,3841361,484474757,0,4286,3009934,4255,3004953,31,4981,2053,0,2166,56,0,105,216660.0,130000.0,-46.0,-45.0,-39.0,-46.0,-46.0,-46.0,-39.0,-47.0,-88.0,-89.0,-85.0,-86.0,42.0,44.0,46.0,40.0,1
1388,3C:55:76:E8:8F:1F,3917963,676273952,76602,191799195,3841361,484474757,38,36364,7424606,35867,7339427,497,85179,15373,39,76659,7833,38,527,270830.0,162500.0,-48.0,-50.0,-45.0,-43.0,-48.0,-50.0,-44.0,-43.0,-88.0,-89.0,-85.0,-86.0,40.0,39.0,40.0,43.0,1
1389,92:69:1D:31:68:E9,3845350,488114923,3989,3640166,3841361,484474757,0,5096,1131861,4939,1096298,157,35563,2165,12,4222,93,0,55,229410.0,130000.0,-52.0,-47.0,-44.0,-47.0,-51.0,-47.0,-44.0,-47.0,-88.0,-89.0,-85.0,-86.0,36.0,42.0,41.0,39.0,1
1390,CC:2F:71:3F:1F:24,4834840,1596599512,993479,1112124755,3841361,484474757,364,818763,896757128,817988,896663540,775,93588,790839,15,993414,104497,361,625,86667.0,14444.0,-68.0,-72.0,-67.0,-73.0,-68.0,-72.0,-67.0,-73.0,-88.0,-89.0,-85.0,-86.0,20.0,17.0,18.0,13.0,1
1391,CC:2F:71:3E:C5:1F,3842298,484589320,937,114563,3841361,484474757,0,3902,327997,3220,246991,682,81006,992,11,1345,25,0,52,130000.0,39000.0,-71.0,-71.0,-69.0,-60.0,-70.0,-70.0,-68.0,-60.0,-88.0,-89.0,-85.0,-86.0,17.0,18.0,16.0,26.0,1
1392,BA:8C:B9:54:50:24,3846245,490662953,4884,6188196,3841361,484474757,0,9338,1723248,9316,1719753,22,3495,2354,17,5357,41,0,65,216660.0,130000.0,-48.0,-35.0,-43.0,-45.0,-41.0,-36.0,-45.0,-49.0,-88.0,-89.0,-85.0,-86.0,40.0,54.0,42.0,41.0,1
1393,62:47:05:9D:EB:15,3843483,486897848,2118,2422767,3841365,484475081,0,4286,3009934,4255,3004953,31,4981,2053,0,2166,56,0,105,216660.0,130000.0,-46.0,-45.0,-39.0,-46.0,-46.0,-46.0,-39.0,-47.0,-88.0,-89.0,-84.0,-86.0,42.0,44.0,45.0,40.0,1
1394,3C:55:76:E8:8F:1F,3917970,676274666,76605,191799585,3841365,484475081,38,36379,7425845,35880,7340442,499,85403,15377,39,76662,7833,38,528,270830.0,1000.0,-49.0,-52.0,-46.0,-44.0,-48.0,-51.0,-45.0,-43.0,-88.0,-89.0,-84.0,-86.0,39.0,37.0,38.0,42.0,1
1395,92:69:1D:31:68:E9,3845356,488115449,3989,3640166,3841367,484475283,0,5096,1131861,4939,1096298,157,35563,2165,12,4222,93,0,55,229410.0,130000.0,-52.0,-47.0,-44.0,-47.0,-51.0,-47.0,-44.0,-47.0,-88.0,-89.0,-84.0,-86.0,36.0,42.0,40.0,39.0,1
1396,CC:2F:71:3F:1F:24,4835058,1596862240,993691,1112386957,3841367,484475283,364,818953,897007476,818178,896913888,775,93588,791028,15,993626,104514,361,625,86667.0,14444.0,-68.0,-72.0,-67.0,-74.0,-68.0,-71.0,-67.0,-73.0,-88.0,-89.0,-84.0,-86.0,20.0,17.0,17.0,12.0,1
1397,CC:2F:71:3E:C5:1F,3842306,484590048,937,114563,3841369,484475485,0,3902,327997,3220,246991,682,81006,992,11,1345,25,0,52,130000.0,39000.0,-71.0,-71.0,-69.0,-60.0,-70.0,-70.0,-68.0,-60.0,-88.0,-89.0,-84.0,-86.0,17.0,18.0,15.0,26.0,1
1398,BA:8C:B9:54:50:24,3846253,490663681,4884,6188196,3841369,484475485,0,9338,1723248,9316,1719753,22,3495,2354,17,5357,41,0,65,216660.0,130000.0,-48.0,-35.0,-43.0,-45.0,-41.0,-36.0,-45.0,-49.0,-88.0,-89.0,-84.0,-86.0,40.0,54.0,41.0,41.0,1
1399,62:47:05:9D:EB:15,3843489,486898454,2118,2422767,3841371,484475687,0,4286,3009934,4255,3004953,31,4981,2053,0,2166,56,0,105,216660.0,130000.0,-46.0,-45.0,-39.0,-46.0,-46.0,-46.0,-39.0,-47.0,-88.0,-89.0,-85.0,-86.0,42.0,44.0,46.0,40.0,1
1400,3C:55:76:E8:8F:1F,3917977,676275332,76605,191799585,3841372,484475747,38,36392,7426731,35893,7341328,499,85403,15377,39,76662,7833,38,528,270830.0,1000.0,-49.0,-53.0,-46.0,-44.0,-48.0,-51.0,-45.0,-43.0,-88.0,-89.0,-85.0,-86.0,39.0,36.0,39.0,42.0,1
1401,92:69:1D:31:68:E9,3845361,488115913,3989,3640166,3841372,484475747,0,5096,1131861,4939,1096298,157,35563,2165,12,4222,93,0,55,229410.0,130000.0,-52.0,-47.0,-44.0,-47.0,-51.0,-47.0,-44.0,-47.0,-88.0,-89.0,-85.0,-86.0,36.0,42.0,41.0,39.0,1
1402,CC:2F:71:3F:1F:24,4835284,1597140778,993912,1112665031,3841372,484475747,364,819150,897270038,818375,897176450,775,93588,791224,15,993847,104516,361,625,86667.0,14444.0,-67.0,-71.0,-67.0,-75.0,-68.0,-72.0,-68.0,-76.0,-88.0,-89.0,-85.0,-86.0,21.0,18.0,18.0,11.0,1
1403,CC:2F:71:3E:C5:1F,3842309,484590310,937,114563,3841372,484475747,0,3902,327997,3220,246991,682,81006,992,11,1345,25,0,52,130000.0,39000.0,-71.0,-71.0,-69.0,-60.0,-70.0,-70.0,-68.0,-60.0,-88.0,-89.0,-85.0,-86.0,17.0,18.0,16.0,26.0,1
1404,BA:8C:B9:54:50:24,3846256,490663943,4884,6188196,3841372,484475747,0,9338,1723248,9316,1719753,22,3495,2354,17,5357,41,0,65,216660.0,130000.0,-48.0,-35.0,-43.0,-45.0,-41.0,-36.0,-45.0,-49.0,-88.0,-89.0,-85.0,-86.0,40.0,54.0,42.0,41.0,1
1405,62:47:05:9D:EB:15,3843496,486899120,2118,2422767,3841378,484476353,0,4286,3009934,4255,3004953,31,4981,2053,0,2166,56,0,105,216660.0,130000.0,-46.0,-45.0,-39.0,-46.0,-46.0,-46.0,-39.0,-47.0,-88.0,-89.0,-85.0,-86.0,42.0,44.0,46.0,40.0,1
1406,3C:55:76:E8:8F:1F,3917988,676276600,76610,191800247,3841378,484476353,38,36417,7428720,35918,7343317,499,85403,15382,39,76667,7835,38,528,286760.0,162500.0,-48.0,-52.0,-45.0,-47.0,-48.0,-55.0,-47.0,-48.0,-88.0,-89.0,-85.0,-86.0,40.0,37.0,40.0,39.0,1
1407,92:69:1D:31:68:E9,3845367,488116519,3989,3640166,3841378,484476353,0,5096,1131861,4939,1096298,157,35563,2165,12,4222,93,0,55,229410.0,130000.0,-52.0,-47.0,-44.0,-47.0,-51.0,-47.0,-44.0,-47.0,-88.0,-89.0,-85.0,-86.0,36.0,42.0,41.0,39.0,1
1408,CC:2F:71:3F:1F:24,4835510,1597407712,994132,1112931359,3841378,484476353,364,819345,897517229,818570,897423641,775,93588,791419,15,994067,104520,361,625,130000.0,43333.0,-69.0,-70.0,-68.0,-74.0,-69.0,-70.0,-67.0,-73.0,-88.0,-89.0,-85.0,-86.0,19.0,19.0,17.0,12.0,1
1409,CC:2F:71:3E:C5:1F,3842315,484590916,937,114563,3841378,484476353,0,3902,327997,3220,246991,682,81006,992,11,1345,25,0,52,130000.0,39000.0,-71.0,-71.0,-69.0,-60.0,-70.0,-70.0,-68.0,-60.0,-88.0,-89.0,-85.0,-86.0,17.0,18.0,16.0,26.0,1
1410,BA:8C:B9:54:50:24,3846264,490664751,4884,6188196,3841380,484476555,0,9339,1723316,9317,1719821,22,3495,2354,17,5357,41,0,65,216660.0,130000.0,-59.0,-36.0,-44.0,-44.0,-44.0,-36.0,-45.0,-49.0,-88.0,-89.0,-85.0,-86.0,29.0,53.0,41.0,42.0,1
1411,62:47:05:9D:EB:15,3843500,486899446,2118,2422767,3841382,484476679,0,4286,3009934,4255,3004953,31,4981,2053,0,2166,56,0,105,216660.0,130000.0,-46.0,-45.0,-39.0,-46.0,-46.0,-46.0,-39.0,-47.0,-88.0,-89.0,-85.0,-86.0,42.0,44.0,46.0,40.0,1
1412,3C:55:76:E8:8F:1F,3917992,676276926,76610,191800247,3841382,484476679,38,36424,7429250,35924,7343729,500,85521,15383,39,76667,7835,38,528,286760.0,162500.0,-47.0,-52.0,-48.0,-41.0,-46.0,-50.0,-46.0,-39.0,-88.0,-89.0,-85.0,-86.0,41.0,37.0,37.0,45.0,1
1413,92:69:1D:31:68:E9,3845372,488116907,3989,3640166,3841383,484476741,0,5099,1132065,4942,1096502,157,35563,2165,12,4222,93,0,55,229410.0,130000.0,-53.0,-47.0,-42.0,-49.0,-52.0,-47.0,-43.0,-47.0,-88.0,-89.0,-85.0,-86.0,35.0,42.0,43.0,37.0,1
1414,CC:2F:71:3F:1F:24,4835726,1597672730,994343,1113195989,3841383,484476741,364,819531,897762839,818755,897669133,776,93706,791605,15,994278,104529,361,625,130000.0,43333.0,-70.0,-72.0,-66.0,-71.0,-70.0,-72.0,-66.0,-70.0,-88.0,-89.0,-85.0,-86.0,18.0,17.0,19.0,15.0,1
1415,CC:2F:71:3E:C5:1F,3842321,484591364,937,114563,3841384,484476801,0,3902,327997,3220,246991,682,81006,992,11,1345,25,0,52,130000.0,39000.0,-71.0,-71.0,-69.0,-60.0,-70.0,-70.0,-68.0,-60.0,-88.0,-89.0,-85.0,-86.0,17.0,18.0,16.0,26.0,1
1416,BA:8C:B9:54:50:24,3846268,490664997,4884,6188196,3841384,484476801,0,9342,1723520,9320,1720025,22,3495,2354,17,5357,41,0,65,216660.0,130000.0,-51.0,-34.0,-43.0,-45.0,-46.0,-35.0,-44.0,-47.0,-88.0,-89.0,-85.0,-86.0,37.0,55.0,42.0,41.0,1
1417,62:47:05:9D:EB:15,3843508,486900174,2118,2422767,3841390,484477407,0,4286,3009934,4255,3004953,31,4981,2053,0,2166,56,0,105,216660.0,130000.0,-46.0,-45.0,-39.0,-46.0,-46.0,-46.0,-39.0,-47.0,-88.0,-89.0,-85.0,-86.0,42.0,44.0,46.0,40.0,1
1418,3C:55:76:E8:8F:1F,3918002,676277856,76610,191800247,3841392,484477609,38,36431,7429780,35930,7344141,501,85639,15384,39,76667,7835,38,529,286760.0,162500.0,-46.0,-49.0,-49.0,-41.0,-45.0,-48.0,-47.0,-40.0,-88.0,-89.0,-85.0,-86.0,42.0,40.0,36.0,45.0,1
1419,92:69:1D:31:68:E9,3845381,488117775,3989,3640166,3841392,484477609,0,5100,1132133,4943,1096570,157,35563,2165,12,4222,93,0,55,229410.0,130000.0,-52.0,-47.0,-45.0,-47.0,-52.0,-47.0,-43.0,-47.0,-88.0,-89.0,-85.0,-86.0,36.0,42.0,40.0,39.0,1
1420,CC:2F:71:3F:1F:24,4835946,1597938004,994554,1113460395,3841392,484477609,364,819719,898011527,818943,897917821,776,93706,791793,15,994489,104572,361,625,78000.0,13000.0,-71.0,-71.0,-66.0,-72.0,-70.0,-71.0,-66.0,-72.0,-88.0,-89.0,-85.0,-86.0,17.0,18.0,19.0,14.0,1
1421,CC:2F:71:3E:C5:1F,3842329,484592172,937,114563,3841392,484477609,0,3902,327997,3220,246991,682,81006,992,11,1345,25,0,52,130000.0,39000.0,-71.0,-71.0,-69.0,-60.0,-70.0,-70.0,-68.0,-60.0,-88.0,-89.0,-85.0,-87.0,17.0,18.0,16.0,27.0,1
1422,BA:8C:B9:54:50:24,3846276,490665805,4884,6188196,3841392,484477609,0,9342,1723520,9320,1720025,22,3495,2354,17,5357,41,0,65,216660.0,130000.0,-51.0,-34.0,-43.0,-45.0,-46.0,-35.0,-44.0,-47.0,-88.0,-89.0,-85.0,-87.0,37.0,55.0,42.0,42.0,1
1423,62:47:05:9D:EB:15,3843510,486900376,2118,2422767,3841392,484477609,0,4286,3009934,4255,3004953,31,4981,2053,0,2166,56,0,105,216660.0,130000.0,-46.0,-45.0,-39.0,-46.0,-46.0,-46.0,-39.0,-47.0,-88.0,-89.0,-85.0,-87.0,42.0,44.0,46.0,41.0,1
1424,3C:55:76:E8:8F:1F,3918002,676277856,76610,191800247,3841392,484477609,38,36431,7429780,35930,7344141,501,85639,15384,39,76667,7835,38,529,286760.0,162500.0,-46.0,-49.0,-49.0,-41.0,-45.0,-48.0,-47.0,-40.0,-88.0,-89.0,-85.0,-87.0,42.0,40.0,36.0,46.0,1
1425,92:69:1D:31:68:E9,3845381,488117775,3989,3640166,3841392,484477609,0,5100,1132133,4943,1096570,157,35563,2165,12,4222,93,0,55,229410.0,130000.0,-52.0,-47.0,-45.0,-47.0,-52.0,-47.0,-43.0,-47.0,-88.0,-89.0,-85.0,-87.0,36.0,42.0,40.0,40.0,1
1426,CC:2F:71:3F:1F:24,4836165,1598203970,994771,1113726159,3841394,484477811,364,819912,898258508,819136,898164802,776,93706,791986,15,994706,104572,361,625,86667.0,14444.0,-68.0,-72.0,-67.0,-72.0,-68.0,-71.0,-66.0,-72.0,-88.0,-89.0,-85.0,-87.0,20.0,17.0,18.0,15.0,1
1427,CC:2F:71:3E:C5:1F,3842331,484592374,937,114563,3841394,484477811,0,3904,328137,3222,247131,682,81006,992,11,1346,25,0,52,130000.0,39000.0,-81.0,-84.0,-76.0,-71.0,-72.0,-72.0,-69.0,-61.0,-88.0,-89.0,-85.0,-87.0,7.0,5.0,9.0,16.0,1
1428,BA:8C:B9:54:50:24,3846278,490666007,4884,6188196,3841394,484477811,0,9342,1723520,9320,1720025,22,3495,2354,17,5357,41,0,65,216660.0,130000.0,-51.0,-34.0,-43.0,-45.0,-46.0,-35.0,-44.0,-47.0,-88.0,-89.0,-85.0,-87.0,37.0,55.0,42.0,42.0,1
1429,62:47:05:9D:EB:15,3843520,486901306,2118,2422767,3841402,484478539,0,4288,3010070,4257,3005089,31,4981,2053,0,2167,56,0,105,216660.0,130000.0,-47.0,-46.0,-39.0,-47.0,-46.0,-45.0,-39.0,-46.0,-88.0,-89.0,-86.0,-87.0,41.0,43.0,47.0,40.0,1
1430,3C:55:76:E8:8F:1F,3918012,676278786,76610,191800247,3841402,484478539,38,36431,7429780,35930,7344141,501,85639,15384,39,76667,7835,38,529,286760.0,162500.0,-46.0,-49.0,-49.0,-41.0,-45.0,-48.0,-47.0,-40.0,-88.0,-89.0,-86.0,-87.0,42.0,40.0,37.0,46.0,1
1431,92:69:1D:31:68:E9,3845391,488118705,3989,3640166,3841402,484478539,0,5100,1132133,4943,1096570,157,35563,2165,12,4222,93,0,55,229410.0,130000.0,-52.0,-47.0,-45.0,-47.0,-52.0,-47.0,-43.0,-47.0,-88.0,-89.0,-86.0,-87.0,36.0,42.0,41.0,40.0,1
1432,CC:2F:71:3F:1F:24,4836387,1598473654,994985,1113995115,3841402,484478539,364,820099,898507080,819323,898413374,776,93706,792173,15,994919,104602,361,625,78000.0,13000.0,-67.0,-72.0,-65.0,-72.0,-67.0,-72.0,-65.0,-72.0,-88.0,-89.0,-86.0,-87.0,21.0,17.0,21.0,15.0,1
1433,CC:2F:71:3E:C5:1F,3842339,484593102,937,114563,3841402,484478539,0,3906,328325,3223,247201,683,81124,993,11,1346,25,0,52,130000.0,39000.0,-71.0,-71.0,-69.0,-60.0,-72.0,-72.0,-69.0,-61.0,-88.0,-89.0,-86.0,-87.0,17.0,18.0,17.0,27.0,1
1434,BA:8C:B9:54:50:24,3846286,490666735,4884,6188196,3841402,484478539,0,9342,1723520,9320,1720025,22,3495,2354,17,5357,41,0,65,216660.0,130000.0,-51.0,-34.0,-43.0,-45.0,-46.0,-35.0,-44.0,-47.0,-88.0,-89.0,-86.0,-87.0,37.0,55.0,43.0,42.0,1
1435,62:47:05:9D:EB:15,3843545,486912531,2118,2422767,3841427,484489764,0,4288,3010070,4257,3005089,31,4981,2053,0,2167,56,0,105,216660.0,130000.0,-47.0,-46.0,-39.0,-47.0,-46.0,-45.0,-39.0,-46.0,-88.0,-90.0,-86.0,-88.0,41.0,44.0,47.0,41.0,1
1436,3C:55:76:E8:8F:1F,3918037,676290011,76610,191800247,3841427,484489764,38,36431,7429780,35930,7344141,501,85639,15384,39,76667,7835,38,529,286760.0,162500.0,-46.0,-49.0,-49.0,-41.0,-45.0,-48.0,-47.0,-40.0,-88.0,-90.0,-86.0,-88.0,42.0,41.0,37.0,47.0,1
1437,92:69:1D:31:68:E9,3845420,488130334,3989,3640166,3841431,484490168,0,5103,1132504,4945,1096706,158,35798,2166,12,4222,93,0,55,229410.0,130000.0,-53.0,-47.0,-42.0,-49.0,-52.0,-47.0,-43.0,-48.0,-88.0,-90.0,-86.0,-88.0,35.0,43.0,44.0,39.0,1
1438,CC:2F:71:3F:1F:24,4836629,1598752125,995198,1114261957,3841431,484490168,364,820289,898758890,819513,898665184,776,93706,792363,15,995132,104604,361,625,86667.0,14444.0,-69.0,-70.0,-66.0,-71.0,-68.0,-70.0,-66.0,-71.0,-88.0,-90.0,-86.0,-88.0,19.0,20.0,20.0,17.0,1
1439,CC:2F:71:3E:C5:1F,3842368,484604731,937,114563,3841431,484490168,0,3906,328325,3223,247201,683,81124,993,11,1346,25,0,52,130000.0,39000.0,-71.0,-71.0,-69.0,-60.0,-72.0,-72.0,-69.0,-61.0,-88.0,-90.0,-86.0,-88.0,17.0,19.0,17.0,28.0,1
1440,BA:8C:B9:54:50:24,3846315,490678364,4884,6188196,3841431,484490168,0,9342,1723520,9320,1720025,22,3495,2354,17,5357,41,0,65,216660.0,130000.0,-51.0,-34.0,-43.0,-45.0,-46.0,-35.0,-44.0,-47.0,-88.0,-90.0,-86.0,-88.0,37.0,56.0,43.0,43.0,1
1441,62:47:05:9D:EB:15,3843552,486913197,2118,2422767,3841434,484490430,0,4288,3010070,4257,3005089,31,4981,2053,0,2167,56,0,105,216660.0,130000.0,-47.0,-46.0,-39.0,-47.0,-46.0,-45.0,-39.0,-46.0,-89.0,-90.0,-86.0,-88.0,42.0,44.0,47.0,41.0,1
1442,3C:55:76:E8:8F:1F,3919183,679318141,77749,194827711,3841434,484490430,38,36688,7466785,36187,7381146,501,85639,15499,39,77806,7858,38,529,286760.0,172050.0,-50.0,-54.0,-49.0,-45.0,-49.0,-53.0,-47.0,-44.0,-89.0,-90.0,-86.0,-88.0,39.0,36.0,37.0,43.0,1
1443,92:69:1D:31:68:E9,3845423,488130596,3989,3640166,3841434,484490430,0,5103,1132504,4945,1096706,158,35798,2166,12,4222,93,0,55,229410.0,130000.0,-53.0,-47.0,-42.0,-49.0,-52.0,-47.0,-43.0,-48.0,-89.0,-90.0,-86.0,-88.0,36.0,43.0,44.0,39.0,1
1444,CC:2F:71:3F:1F:24,4836860,1599043995,995426,1114553565,3841434,484490430,364,820495,899035646,819719,898941940,776,93706,792568,15,995360,104634,361,625,65000.0,14444.0,-69.0,-72.0,-66.0,-72.0,-68.0,-71.0,-66.0,-72.0,-89.0,-90.0,-86.0,-88.0,20.0,18.0,20.0,16.0,1
1445,CC:2F:71:3E:C5:1F,3842371,484604993,937,114563,3841434,484490430,0,3906,328325,3223,247201,683,81124,993,11,1346,25,0,52,130000.0,39000.0,-71.0,-71.0,-69.0,-60.0,-72.0,-72.0,-69.0,-61.0,-89.0,-90.0,-86.0,-88.0,18.0,19.0,17.0,28.0,1
1446,BA:8C:B9:54:50:24,3846318,490678626,4884,6188196,3841434,484490430,0,9342,1723520,9320,1720025,22,3495,2354,17,5357,41,0,65,216660.0,130000.0,-51.0,-34.0,-43.0,-45.0,-46.0,-35.0,-44.0,-47.0,-89.0,-90.0,-86.0,-88.0,38.0,56.0,43.0,43.0,1
1447,62:47:05:9D:EB:15,3843560,486914154,2118,2422767,3841442,484491387,0,4288,3010070,4257,3005089,31,4981,2053,0,2167,56,0,105,216660.0,130000.0,-47.0,-46.0,-39.0,-47.0,-46.0,-45.0,-39.0,-46.0,-89.0,-90.0,-87.0,-89.0,42.0,44.0,48.0,42.0,1
1448,3C:55:76:E8:8F:1F,3919191,679319098,77749,194827711,3841442,484491387,38,36693,7467127,36192,7381488,501,85639,15499,39,77806,7858,38,529,286760.0,172050.0,-50.0,-52.0,-45.0,-43.0,-50.0,-52.0,-45.0,-44.0,-89.0,-90.0,-87.0,-89.0,39.0,38.0,42.0,46.0,1
1449,92:69:1D:31:68:E9,3845433,488131755,3989,3640166,3841444,484491589,0,5103,1132504,4945,1096706,158,35798,2166,12,4222,93,0,55,229410.0,130000.0,-53.0,-47.0,-42.0,-49.0,-52.0,-47.0,-43.0,-48.0,-89.0,-90.0,-87.0,-89.0,36.0,43.0,45.0,40.0,1
1450,CC:2F:71:3F:1F:24,4837084,1599307904,995640,1114816315,3841444,484491589,364,820685,899280785,819909,899187079,776,93706,792758,15,995575,104635,361,625,86667.0,14444.0,-68.0,-71.0,-67.0,-71.0,-68.0,-71.0,-66.0,-71.0,-89.0,-90.0,-87.0,-89.0,21.0,19.0,20.0,18.0,1
1451,CC:2F:71:3E:C5:1F,3842381,484606152,937,114563,3841444,484491589,0,3906,328325,3223,247201,683,81124,993,11,1346,25,0,52,130000.0,39000.0,-71.0,-71.0,-69.0,-60.0,-72.0,-72.0,-69.0,-61.0,-89.0,-90.0,-87.0,-89.0,18.0,19.0,18.0,29.0,1
1452,BA:8C:B9:54:50:24,3846328,490679785,4884,6188196,3841444,484491589,0,9342,1723520,9320,1720025,22,3495,2354,17,5357,41,0,65,216660.0,130000.0,-51.0,-34.0,-43.0,-45.0,-46.0,-35.0,-44.0,-47.0,-89.0,-90.0,-87.0,-89.0,38.0,56.0,44.0,44.0,1
1453,62:47:05:9D:EB:15,3843562,486914356,2118,2422767,3841444,484491589,0,4291,3010274,4260,3005293,31,4981,2053,0,2167,56,0,105,216660.0,130000.0,-46.0,-47.0,-39.0,-45.0,-46.0,-45.0,-39.0,-46.0,-89.0,-90.0,-87.0,-89.0,43.0,43.0,48.0,44.0,1
1454,3C:55:76:E8:8F:1F,3919193,679319300,77749,194827711,3841444,484491589,38,36693,7467127,36192,7381488,501,85639,15499,39,77806,7858,38,529,286760.0,172050.0,-50.0,-52.0,-45.0,-43.0,-50.0,-52.0,-45.0,-44.0,-89.0,-90.0,-87.0,-89.0,39.0,38.0,42.0,46.0,1
1455,92:69:1D:31:68:E9,3845434,488131815,3989,3640166,3841445,484491649,0,5103,1132504,4945,1096706,158,35798,2166,12,4222,93,0,55,229410.0,130000.0,-53.0,-47.0,-42.0,-49.0,-52.0,-47.0,-43.0,-48.0,-89.0,-90.0,-87.0,-89.0,36.0,43.0,45.0,40.0,1
1456,CC:2F:71:3F:1F:24,4837296,1599571810,995851,1115080161,3841445,484491649,364,820870,899526277,820094,899432571,776,93706,792943,15,995786,104663,361,625,86667.0,13000.0,-69.0,-69.0,-67.0,-73.0,-68.0,-69.0,-67.0,-72.0,-89.0,-90.0,-87.0,-89.0,20.0,21.0,20.0,16.0,1
1457,CC:2F:71:3E:C5:1F,3842382,484606212,937,114563,3841445,484491649,0,3906,328325,3223,247201,683,81124,993,11,1346,25,0,52,130000.0,39000.0,-71.0,-71.0,-69.0,-60.0,-72.0,-72.0,-69.0,-61.0,-89.0,-90.0,-87.0,-89.0,18.0,19.0,18.0,29.0,1
1458,BA:8C:B9:54:50:24,3846329,490679845,4884,6188196,3841445,484491649,0,9342,1723520,9320,1720025,22,3495,2354,17,5357,41,0,65,216660.0,130000.0,-51.0,-34.0,-43.0,-45.0,-46.0,-35.0,-44.0,-47.0,-89.0,-90.0,-87.0,-89.0,38.0,56.0,44.0,44.0,1
1459,62:47:05:9D:EB:15,3843571,486915224,2118,2422767,3841453,484492457,0,4291,3010274,4260,3005293,31,4981,2053,0,2167,56,0,105,216660.0,130000.0,-46.0,-47.0,-39.0,-45.0,-46.0,-45.0,-39.0,-46.0,-89.0,-90.0,-87.0,-89.0,43.0,43.0,48.0,44.0,1
1460,3C:55:76:E8:8F:1F,3919204,679320536,77749,194827711,3841455,484492825,38,36693,7467127,36192,7381488,501,85639,15499,39,77806,7858,38,529,286760.0,172050.0,-50.0,-52.0,-45.0,-43.0,-50.0,-52.0,-45.0,-44.0,-89.0,-91.0,-87.0,-90.0,39.0,39.0,42.0,47.0,1
1461,92:69:1D:31:68:E9,3845444,488132991,3989,3640166,3841455,484492825,0,5103,1132504,4945,1096706,158,35798,2166,12,4222,93,0,55,229410.0,130000.0,-53.0,-47.0,-42.0,-49.0,-52.0,-47.0,-43.0,-48.0,-89.0,-91.0,-87.0,-90.0,36.0,44.0,45.0,41.0,1
1462,CC:2F:71:3F:1F:24,4837521,1599843160,996066,1115350335,3841455,484492825,364,821063,899781241,820287,899687535,776,93706,793136,15,996001,104665,361,625,86667.0,14444.0,-69.0,-70.0,-67.0,-74.0,-68.0,-70.0,-66.0,-73.0,-89.0,-91.0,-87.0,-90.0,20.0,21.0,20.0,16.0,1
1463,CC:2F:71:3E:C5:1F,3842392,484607388,937,114563,3841455,484492825,0,3906,328325,3223,247201,683,81124,993,11,1346,25,0,52,130000.0,39000.0,-71.0,-71.0,-69.0,-60.0,-72.0,-72.0,-69.0,-61.0,-89.0,-91.0,-87.0,-90.0,18.0,20.0,18.0,30.0,1
1464,BA:8C:B9:54:50:24,3846339,490681021,4884,6188196,3841455,484492825,0,9342,1723520,9320,1720025,22,3495,2354,17,5357,41,0,65,216660.0,130000.0,-51.0,-34.0,-43.0,-45.0,-46.0,-35.0,-44.0,-47.0,-89.0,-91.0,-87.0,-90.0,38.0,57.0,44.0,45.0,1
1465,62:47:05:9D:EB:15,3843573,486915592,2118,2422767,3841455,484492825,0,4291,3010274,4260,3005293,31,4981,2053,0,2167,56,0,105,216660.0,130000.0,-46.0,-47.0,-39.0,-45.0,-46.0,-45.0,-39.0,-46.0,-89.0,-91.0,-87.0,-90.0,43.0,44.0,48.0,45.0,1
1466,3C:55:76:E8:8F:1F,3919204,679320536,77749,194827711,3841455,484492825,38,36693,7467127,36192,7381488,501,85639,15499,39,77806,7858,38,529,286760.0,172050.0,-50.0,-52.0,-45.0,-43.0,-50.0,-52.0,-45.0,-44.0,-89.0,-91.0,-87.0,-90.0,39.0,39.0,42.0,47.0,1
1467,92:69:1D:31:68:E9,3845446,488133193,3989,3640166,3841457,484493027,0,5103,1132504,4945,1096706,158,35798,2166,12,4222,93,0,55,229410.0,130000.0,-53.0,-47.0,-42.0,-49.0,-52.0,-47.0,-43.0,-48.0,-89.0,-91.0,-87.0,-90.0,36.0,44.0,45.0,41.0,1
1468,CC:2F:71:3F:1F:24,4837734,1600108816,996277,1115615789,3841457,484493027,364,821254,900030289,820478,899936583,776,93706,793327,15,996212,104665,361,625,104000.0,26000.0,-69.0,-68.0,-66.0,-72.0,-68.0,-68.0,-66.0,-72.0,-89.0,-91.0,-88.0,-90.0,20.0,23.0,22.0,18.0,1
1469,CC:2F:71:3E:C5:1F,3842395,484607724,937,114563,3841458,484493161,0,3906,328325,3223,247201,683,81124,993,11,1346,25,0,52,130000.0,39000.0,-71.0,-71.0,-69.0,-60.0,-72.0,-72.0,-69.0,-61.0,-89.0,-91.0,-88.0,-90.0,18.0,20.0,19.0,30.0,1
1470,BA:8C:B9:54:50:24,3846346,490681687,4884,6188196,3841462,484493491,0,9342,1723520,9320,1720025,22,3495,2354,17,5357,41,0,65,216660.0,130000.0,-51.0,-34.0,-43.0,-45.0,-46.0,-35.0,-44.0,-47.0,-89.0,-91.0,-88.0,-90.0,38.0,57.0,45.0,45.0,1
1471,62:47:05:9D:EB:15,3843582,486916460,2118,2422767,3841464,484493693,0,4291,3010274,4260,3005293,31,4981,2053,0,2167,56,0,105,216660.0,130000.0,-46.0,-47.0,-39.0,-45.0,-46.0,-45.0,-39.0,-46.0,-89.0,-91.0,-88.0,-90.0,43.0,44.0,49.0,45.0,1
1472,3C:55:76:E8:8F:1F,3919214,679321578,77750,194827885,3841464,484493693,38,36701,7467801,36200,7382162,501,85639,15501,39,77807,7858,38,529,286760.0,172050.0,-46.0,-50.0,-54.0,-40.0,-46.0,-50.0,-53.0,-40.0,-89.0,-91.0,-88.0,-90.0,43.0,41.0,34.0,50.0,1
1473,92:69:1D:31:68:E9,3845453,488133859,3989,3640166,3841464,484493693,0,5103,1132504,4945,1096706,158,35798,2166,12,4222,93,0,55,229410.0,130000.0,-53.0,-47.0,-42.0,-49.0,-52.0,-47.0,-43.0,-48.0,-89.0,-91.0,-88.0,-90.0,36.0,44.0,46.0,41.0,1
1474,CC:2F:71:3F:1F:24,4837955,1600372512,996491,1115878819,3841464,484493693,364,821445,900274120,820669,900180414,776,93706,793518,15,996426,104678,361,625,115556.0,26000.0,-69.0,-68.0,-66.0,-73.0,-68.0,-68.0,-66.0,-72.0,-89.0,-91.0,-88.0,-90.0,20.0,23.0,22.0,17.0,1
1475,CC:2F:71:3E:C5:1F,3842401,484608256,937,114563,3841464,484493693,0,3906,328325,3223,247201,683,81124,993,11,1346,25,0,52,130000.0,39000.0,-71.0,-71.0,-69.0,-60.0,-72.0,-72.0,-69.0,-61.0,-89.0,-91.0,-88.0,-90.0,18.0,20.0,19.0,30.0,1
1476,BA:8C:B9:54:50:24,3846348,490681889,4884,6188196,3841464,484493693,0,9342,1723520,9320,1720025,22,3495,2354,17,5357,41,0,65,216660.0,130000.0,-51.0,-34.0,-43.0,-45.0,-46.0,-35.0,-44.0,-47.0,-89.0,-91.0,-88.0,-90.0,38.0,57.0,45.0,45.0,1
1477,62:47:05:9D:EB:15,3843584,486916662,2118,2422767,3841466,484493895,0,4291,3010274,4260,3005293,31,4981,2053,0,2167,56,0,105,216660.0,130000.0,-46.0,-47.0,-39.0,-45.0,-46.0,-45.0,-39.0,-46.0,-89.0,-90.0,-88.0,-90.0,43.0,43.0,49.0,45.0,1
1478,3C:55:76:E8:8F:1F,3919221,679322511,77751,194828212,3841470,484494299,38,36711,7468788,36210,7383149,501,85639,15503,39,77808,7858,38,529,286760.0,172050.0,-46.0,-50.0,-54.0,-40.0,-45.0,-49.0,-52.0,-39.0,-89.0,-90.0,-88.0,-90.0,43.0,40.0,34.0,50.0,1
1479,92:69:1D:31:68:E9,3845459,488134465,3989,3640166,3841470,484494299,0,5103,1132504,4945,1096706,158,35798,2166,12,4222,93,0,55,229410.0,130000.0,-53.0,-47.0,-42.0,-49.0,-52.0,-47.0,-43.0,-48.0,-89.0,-90.0,-88.0,-90.0,36.0,43.0,46.0,41.0,1
1480,CC:2F:71:3F:1F:24,4838172,1600639532,996702,1116145233,3841470,484494299,364,821631,900522618,820855,900428912,776,93706,793704,15,996636,104752,361,625,115556.0,26000.0,-69.0,-68.0,-67.0,-73.0,-68.0,-68.0,-66.0,-72.0,-89.0,-90.0,-88.0,-90.0,20.0,22.0,21.0,17.0,1
1481,CC:2F:71:3E:C5:1F,3842407,484608862,937,114563,3841470,484494299,0,3906,328325,3223,247201,683,81124,993,11,1346,25,0,52,130000.0,39000.0,-71.0,-71.0,-69.0,-60.0,-72.0,-72.0,-69.0,-61.0,-89.0,-90.0,-88.0,-90.0,18.0,19.0,19.0,30.0,1
1482,BA:8C:B9:54:50:24,3846356,490682697,4884,6188196,3841472,484494501,0,9342,1723520,9320,1720025,22,3495,2354,17,5357,41,0,65,216660.0,130000.0,-51.0,-34.0,-43.0,-45.0,-46.0,-35.0,-44.0,-47.0,-89.0,-90.0,-88.0,-90.0,38.0,56.0,45.0,45.0,1
1483,62:47:05:9D:EB:15,3843591,486917328,2118,2422767,3841473,484494561,0,4291,3010274,4260,3005293,31,4981,2053,0,2167,56,0,105,216660.0,130000.0,-46.0,-47.0,-39.0,-45.0,-46.0,-45.0,-39.0,-46.0,-89.0,-90.0,-88.0,-91.0,43.0,43.0,49.0,46.0,1
1484,3C:55:76:E8:8F:1F,3919224,679322773,77751,194828212,3841473,484494561,38,36711,7468788,36210,7383149,501,85639,15503,39,77808,7858,38,529,286760.0,172050.0,-46.0,-50.0,-54.0,-40.0,-45.0,-49.0,-52.0,-39.0,-89.0,-90.0,-88.0,-91.0,43.0,40.0,34.0,51.0,1
1485,92:69:1D:31:68:E9,3845462,488134727,3989,3640166,3841473,484494561,0,5103,1132504,4945,1096706,158,35798,2166,12,4222,93,0,55,229410.0,130000.0,-53.0,-47.0,-42.0,-49.0,-52.0,-47.0,-43.0,-48.0,-89.0,-90.0,-88.0,-91.0,36.0,43.0,46.0,42.0,1
1486,CC:2F:71:3F:1F:24,4838382,1600900496,996909,1116405935,3841473,484494561,364,821815,900766598,821039,900672892,776,93706,793888,15,996843,104831,361,625,86667.0,14444.0,-69.0,-68.0,-66.0,-73.0,-69.0,-68.0,-66.0,-72.0,-89.0,-90.0,-88.0,-91.0,20.0,22.0,22.0,18.0,1
1487,CC:2F:71:3E:C5:1F,3842410,484609124,937,114563,3841473,484494561,0,3906,328325,3223,247201,683,81124,993,11,1346,25,0,52,130000.0,39000.0,-71.0,-71.0,-69.0,-60.0,-72.0,-72.0,-69.0,-61.0,-89.0,-90.0,-88.0,-91.0,18.0,19.0,19.0,31.0,1
1488,BA:8C:B9:54:50:24,3846357,490682757,4884,6188196,3841473,484494561,0,9342,1723520,9320,1720025,22,3495,2354,17,5357,41,0,65,216660.0,130000.0,-51.0,-34.0,-43.0,-45.0,-46.0,-35.0,-44.0,-47.0,-89.0,-90.0,-88.0,-91.0,38.0,56.0,45.0,46.0,1
1489,62:47:05:9D:EB:15,3843597,486917934,2118,2422767,3841479,484495167,0,4291,3010274,4260,3005293,31,4981,2053,0,2167,56,0,105,216660.0,130000.0,-46.0,-47.0,-39.0,-45.0,-46.0,-45.0,-39.0,-46.0,-89.0,-91.0,-88.0,-91.0,43.0,44.0,49.0,46.0,1
1490,3C:55:76:E8:8F:1F,3919243,679330632,77762,194835263,3841481,484495369,38,36746,7478457,36245,7392818,501,85639,15516,39,77819,7859,38,529,286760.0,172050.0,-50.0,-48.0,-45.0,-45.0,-50.0,-48.0,-44.0,-44.0,-89.0,-91.0,-88.0,-91.0,39.0,43.0,43.0,46.0,1
1491,92:69:1D:31:68:E9,3845470,488135535,3989,3640166,3841481,484495369,0,5103,1132504,4945,1096706,158,35798,2166,12,4222,93,0,55,229410.0,130000.0,-53.0,-47.0,-42.0,-49.0,-52.0,-47.0,-43.0,-48.0,-89.0,-91.0,-88.0,-91.0,36.0,44.0,46.0,42.0,1
1492,CC:2F:71:3F:1F:24,4838604,1601164093,997123,1116668724,3841481,484495369,364,822008,901010728,821232,900917022,776,93706,794081,15,997057,104832,361,625,86667.0,14444.0,-69.0,-68.0,-66.0,-73.0,-69.0,-68.0,-66.0,-72.0,-89.0,-91.0,-88.0,-91.0,20.0,23.0,22.0,18.0,1
1493,CC:2F:71:3E:C5:1F,3842418,484609932,937,114563,3841481,484495369,0,3906,328325,3223,247201,683,81124,993,11,1346,25,0,52,130000.0,39000.0,-71.0,-71.0,-69.0,-60.0,-72.0,-72.0,-69.0,-61.0,-89.0,-91.0,-88.0,-91.0,18.0,20.0,19.0,31.0,1
1494,BA:8C:B9:54:50:24,3846365,490683565,4884,6188196,3841481,484495369,0,9342,1723520,9320,1720025,22,3495,2354,17,5357,41,0,65,216660.0,130000.0,-51.0,-34.0,-43.0,-45.0,-46.0,-35.0,-44.0,-47.0,-89.0,-91.0,-88.0,-91.0,38.0,57.0,45.0,46.0,1
1495,62:47:05:9D:EB:15,3843599,486918136,2118,2422767,3841481,484495369,0,4292,3010342,4261,3005361,31,4981,2053,0,2167,56,0,105,216660.0,130000.0,-46.0,-50.0,-41.0,-50.0,-46.0,-46.0,-39.0,-46.0,-89.0,-91.0,-88.0,-91.0,43.0,41.0,47.0,41.0,1
1496,3C:55:76:E8:8F:1F,3919245,679331905,77763,194836476,3841482,484495429,38,36754,7479039,36253,7393400,501,85639,15517,39,77820,7859,38,529,286760.0,172050.0,-51.0,-49.0,-45.0,-45.0,-50.0,-49.0,-45.0,-45.0,-89.0,-91.0,-88.0,-91.0,38.0,42.0,43.0,46.0,1
1497,92:69:1D:31:68:E9,3845471,488135595,3989,3640166,3841482,484495429,0,5103,1132504,4945,1096706,158,35798,2166,12,4222,93,0,55,229410.0,130000.0,-53.0,-47.0,-42.0,-49.0,-52.0,-47.0,-43.0,-48.0,-89.0,-91.0,-88.0,-91.0,36.0,44.0,46.0,42.0,1
1498,CC:2F:71:3F:1F:24,4838811,1601423133,997329,1116927704,3841482,484495429,364,822193,901256234,821417,901162528,776,93706,794265,15,997264,104837,361,625,115556.0,28889.0,-69.0,-68.0,-66.0,-72.0,-69.0,-68.0,-66.0,-72.0,-89.0,-91.0,-88.0,-91.0,20.0,23.0,22.0,19.0,1
1499,CC:2F:71:3E:C5:1F,3842419,484609992,937,114563,3841482,484495429,0,3906,328325,3223,247201,683,81124,993,11,1346,25,0,52,130000.0,39000.0,-71.0,-71.0,-69.0,-60.0,-72.0,-72.0,-69.0,-61.0,-89.0,-91.0,-88.0,-91.0,18.0,20.0,19.0,31.0,1
1500,BA:8C:B9:54:50:24,3846366,490683625,4884,6188196,3841482,484495429,0,9342,1723520,9320,1720025,22,3495,2354,17,5357,41,0,65,216660.0,130000.0,-51.0,-34.0,-43.0,-45.0,-46.0,-35.0,-44.0,-47.0,-89.0,-91.0,-88.0,-91.0,38.0,57.0,45.0,46.0,1
1501,62:47:05:9D:EB:15,3843609,486919066,2118,2422767,3841491,484496299,0,4292,3010342,4261,3005361,31,4981,2053,0,2167,56,0,105,216660.0,130000.0,-46.0,-50.0,-41.0,-50.0,-46.0,-46.0,-39.0,-46.0,-89.0,-91.0,-88.0,-91.0,43.0,41.0,47.0,41.0,1
1502,3C:55:76:E8:8F:1F,3919255,679332891,77764,194836592,3841491,484496299,38,36760,7479499,36258,7393742,502,85757,15518,39,77821,7859,38,529,286760.0,172050.0,-47.0,-49.0,-47.0,-41.0,-48.0,-47.0,-44.0,-42.0,-90.0,-92.0,-89.0,-92.0,43.0,43.0,42.0,51.0,1
1503,92:69:1D:31:68:E9,3845481,488136581,3990,3640282,3841491,484496299,0,5105,1132640,4947,1096842,158,35798,2166,12,4223,93,0,55,229410.0,130000.0,-54.0,-47.0,-42.0,-48.0,-53.0,-47.0,-43.0,-48.0,-90.0,-92.0,-89.0,-92.0,36.0,45.0,47.0,44.0,1
1504,CC:2F:71:3F:1F:24,4839032,1601685301,997541,1117189002,3841491,484496299,364,822375,901498530,821599,901404824,776,93706,794447,15,997476,104856,361,625,86667.0,14444.0,-69.0,-68.0,-66.0,-72.0,-68.0,-68.0,-66.0,-72.0,-90.0,-92.0,-89.0,-92.0,21.0,24.0,23.0,20.0,1
1505,CC:2F:71:3E:C5:1F,3842429,484610978,938,114679,3841491,484496299,0,3908,328465,3225,247341,683,81124,993,11,1347,25,0,52,130000.0,39000.0,-66.0,-66.0,-65.0,-60.0,-71.0,-72.0,-69.0,-61.0,-90.0,-92.0,-89.0,-92.0,24.0,26.0,24.0,32.0,1
1506,BA:8C:B9:54:50:24,3846376,490684555,4885,6188256,3841491,484496299,0,9344,1723656,9322,1720161,22,3495,2354,17,5358,41,0,65,216660.0,130000.0,-48.0,-35.0,-42.0,-45.0,-46.0,-35.0,-44.0,-47.0,-90.0,-92.0,-89.0,-92.0,42.0,57.0,47.0,47.0,1
1507,62:47:05:9D:EB:15,3843612,486919306,2119,2422883,3841493,484496423,0,4294,3010478,4263,3005497,31,4981,2053,0,2168,56,0,105,216660.0,130000.0,-47.0,-48.0,-39.0,-45.0,-46.0,-47.0,-39.0,-46.0,-90.0,-92.0,-89.0,-92.0,43.0,44.0,50.0,47.0,1
1508,3C:55:76:E8:8F:1F,3919257,679333015,77764,194836592,3841493,484496423,38,36767,7479977,36265,7394220,502,85757,15518,39,77821,7859,38,529,286760.0,172050.0,-50.0,-49.0,-46.0,-45.0,-50.0,-49.0,-45.0,-44.0,-90.0,-92.0,-89.0,-92.0,40.0,43.0,43.0,47.0,1
1509,92:69:1D:31:68:E9,3845483,488136705,3990,3640282,3841493,484496423,0,5105,1132640,4947,1096842,158,35798,2166,12,4223,93,0,55,229410.0,130000.0,-54.0,-47.0,-42.0,-48.0,-53.0,-47.0,-43.0,-48.0,-90.0,-92.0,-89.0,-92.0,36.0,45.0,47.0,44.0,1
1510,CC:2F:71:3F:1F:24,4839244,1601946235,997749,1117449610,3841495,484496625,364,822562,901741408,821785,901647584,777,93824,794634,15,997683,104868,361,625,86667.0,14444.0,-69.0,-69.0,-67.0,-72.0,-68.0,-69.0,-66.0,-72.0,-90.0,-92.0,-89.0,-92.0,21.0,23.0,22.0,20.0,1
1511,CC:2F:71:3E:C5:1F,3842433,484611304,938,114679,3841495,484496625,0,3910,328653,3226,247411,684,81242,994,11,1347,25,0,52,130000.0,39000.0,-71.0,-71.0,-70.0,-60.0,-71.0,-72.0,-69.0,-61.0,-90.0,-92.0,-89.0,-92.0,19.0,21.0,19.0,32.0,1
1512,BA:8C:B9:54:50:24,3846380,490684881,4885,6188256,3841495,484496625,0,9344,1723656,9322,1720161,22,3495,2354,17,5358,41,0,65,216660.0,130000.0,-48.0,-35.0,-42.0,-45.0,-46.0,-35.0,-44.0,-47.0,-90.0,-92.0,-89.0,-92.0,42.0,57.0,47.0,47.0,1
1513,62:47:05:9D:EB:15,3843621,486920174,2119,2422883,3841502,484497291,0,4294,3010478,4263,3005497,31,4981,2053,0,2168,56,0,105,216660.0,130000.0,-47.0,-48.0,-39.0,-45.0,-46.0,-47.0,-39.0,-46.0,-90.0,-92.0,-89.0,-92.0,43.0,44.0,50.0,47.0,1
1514,3C:55:76:E8:8F:1F,3919267,679334156,77764,194836592,3841503,484497564,38,36767,7479977,36265,7394220,502,85757,15518,39,77821,7859,38,529,286760.0,172050.0,-50.0,-49.0,-46.0,-45.0,-50.0,-49.0,-45.0,-44.0,-90.0,-92.0,-89.0,-92.0,40.0,43.0,43.0,47.0,1
1515,92:69:1D:31:68:E9,3845493,488137846,3990,3640282,3841503,484497564,0,5105,1132640,4947,1096842,158,35798,2166,12,4223,93,0,55,229410.0,130000.0,-54.0,-47.0,-42.0,-48.0,-53.0,-47.0,-43.0,-48.0,-90.0,-92.0,-89.0,-92.0,36.0,45.0,47.0,44.0,1
1516,CC:2F:71:3F:1F:24,4839474,1602219452,997971,1117721888,3841503,484497564,364,822762,901997759,821985,901903935,777,93824,794834,15,997906,104875,361,626,104000.0,26000.0,-69.0,-69.0,-66.0,-72.0,-68.0,-69.0,-66.0,-72.0,-90.0,-92.0,-89.0,-92.0,21.0,23.0,23.0,20.0,1
1517,CC:2F:71:3E:C5:1F,3842441,484612243,938,114679,3841503,484497564,0,3910,328653,3226,247411,684,81242,994,11,1347,25,0,52,130000.0,39000.0,-71.0,-71.0,-70.0,-60.0,-71.0,-72.0,-69.0,-61.0,-90.0,-92.0,-89.0,-92.0,19.0,21.0,19.0,32.0,1
1518,BA:8C:B9:54:50:24,3846388,490685820,4885,6188256,3841503,484497564,0,9345,1723724,9323,1720229,22,3495,2354,17,5358,41,0,65,216660.0,130000.0,-59.0,-36.0,-44.0,-43.0,-49.0,-35.0,-43.0,-46.0,-90.0,-92.0,-89.0,-92.0,31.0,56.0,45.0,49.0,1
1519,62:47:05:9D:EB:15,3843625,486920711,2119,2422883,3841506,484497828,0,4294,3010478,4263,3005497,31,4981,2053,0,2168,56,0,105,216660.0,130000.0,-47.0,-48.0,-39.0,-45.0,-46.0,-47.0,-39.0,-46.0,-90.0,-92.0,-89.0,-92.0,43.0,44.0,50.0,47.0,1
1520,3C:55:76:E8:8F:1F,3919272,679334622,77764,194836592,3841508,484498030,38,36771,7480301,36268,7394426,503,85875,15519,39,77821,7859,38,529,286760.0,172050.0,-44.0,-52.0,-49.0,-37.0,-47.0,-50.0,-47.0,-41.0,-90.0,-92.0,-89.0,-92.0,46.0,40.0,40.0,55.0,1
1521,92:69:1D:31:68:E9,3845498,488138312,3990,3640282,3841508,484498030,0,5105,1132640,4947,1096842,158,35798,2166,12,4223,93,0,55,229410.0,130000.0,-54.0,-47.0,-42.0,-48.0,-53.0,-47.0,-43.0,-48.0,-90.0,-92.0,-89.0,-92.0,36.0,45.0,47.0,44.0,1
1522,CC:2F:71:3F:1F:24,4839689,1602482266,998181,1117984236,3841508,484498030,364,822946,902243135,822169,902149311,777,93824,795018,15,998116,104906,361,626,86667.0,14444.0,-69.0,-69.0,-66.0,-72.0,-68.0,-69.0,-66.0,-72.0,-90.0,-92.0,-89.0,-92.0,21.0,23.0,23.0,20.0,1
1523,CC:2F:71:3E:C5:1F,3842448,484612911,938,114679,3841510,484498232,0,3910,328653,3226,247411,684,81242,994,11,1347,25,0,52,130000.0,39000.0,-71.0,-71.0,-70.0,-60.0,-71.0,-72.0,-69.0,-61.0,-90.0,-92.0,-89.0,-92.0,19.0,21.0,19.0,32.0,1
1524,BA:8C:B9:54:50:24,3846397,490686690,4885,6188256,3841512,484498434,0,9345,1723724,9323,1720229,22,3495,2354,17,5358,41,0,65,216660.0,130000.0,-59.0,-36.0,-44.0,-43.0,-49.0,-35.0,-43.0,-46.0,-90.0,-92.0,-89.0,-92.0,31.0,56.0,45.0,49.0,1
1525,62:47:05:9D:EB:15,3843632,486921377,2119,2422883,3841513,484498494,0,4294,3010478,4263,3005497,31,4981,2053,0,2168,56,0,105,216660.0,130000.0,-47.0,-48.0,-39.0,-45.0,-46.0,-47.0,-39.0,-46.0,-90.0,-93.0,-89.0,-93.0,43.0,45.0,50.0,48.0,1
1526,3C:55:76:E8:8F:1F,3919295,679344316,77782,194845822,3841513,484498494,38,36810,7490783,36307,7404908,503,85875,15533,39,77840,7859,38,531,286760.0,172050.0,-46.0,-54.0,-52.0,-40.0,-46.0,-53.0,-52.0,-39.0,-90.0,-93.0,-89.0,-93.0,44.0,39.0,37.0,53.0,1
1527,92:69:1D:31:68:E9,3845503,488138776,3990,3640282,3841513,484498494,0,5105,1132640,4947,1096842,158,35798,2166,12,4223,93,0,55,229410.0,130000.0,-54.0,-47.0,-42.0,-48.0,-53.0,-47.0,-43.0,-48.0,-90.0,-93.0,-89.0,-93.0,36.0,46.0,47.0,45.0,1
1528,CC:2F:71:3F:1F:24,4839905,1602748168,998392,1118249674,3841513,484498494,364,823132,902490237,822355,902396413,777,93824,795204,15,998326,104908,361,626,65000.0,13000.0,-68.0,-69.0,-66.0,-72.0,-68.0,-69.0,-66.0,-72.0,-90.0,-93.0,-89.0,-93.0,22.0,24.0,23.0,21.0,1
1529,CC:2F:71:3E:C5:1F,3842451,484613173,938,114679,3841513,484498494,0,3910,328653,3226,247411,684,81242,994,11,1347,25,0,52,130000.0,39000.0,-71.0,-71.0,-70.0,-60.0,-71.0,-72.0,-69.0,-61.0,-90.0,-93.0,-89.0,-93.0,19.0,22.0,19.0,33.0,1
1530,BA:8C:B9:54:50:24,3846398,490686750,4885,6188256,3841513,484498494,0,9345,1723724,9323,1720229,22,3495,2354,17,5358,41,0,65,216660.0,130000.0,-59.0,-36.0,-44.0,-43.0,-49.0,-35.0,-43.0,-46.0,-90.0,-93.0,-89.0,-93.0,31.0,57.0,45.0,50.0,1
1531,62:47:05:9D:EB:15,3843636,486921781,2119,2422883,3841517,484498898,0,4294,3010478,4263,3005497,31,4981,2053,0,2168,56,0,105,216660.0,130000.0,-47.0,-48.0,-39.0,-45.0,-46.0,-47.0,-39.0,-46.0,-90.0,-93.0,-89.0,-93.0,43.0,45.0,50.0,48.0,1
1532,3C:55:76:E8:8F:1F,3919301,679344922,77782,194845822,3841519,484499100,38,36810,7490783,36307,7404908,503,85875,15533,39,77840,7859,38,531,286760.0,172050.0,-46.0,-54.0,-52.0,-40.0,-46.0,-53.0,-52.0,-39.0,-90.0,-93.0,-89.0,-93.0,44.0,39.0,37.0,53.0,1
1533,92:69:1D:31:68:E9,3845511,488139584,3990,3640282,3841521,484499302,0,5105,1132640,4947,1096842,158,35798,2166,12,4223,93,0,55,229410.0,130000.0,-54.0,-47.0,-42.0,-48.0,-53.0,-47.0,-43.0,-48.0,-90.0,-93.0,-89.0,-93.0,36.0,46.0,47.0,45.0,1
1534,CC:2F:71:3F:1F:24,4840131,1603012218,998610,1118512916,3841521,484499302,364,823324,902735588,822547,902641764,777,93824,795396,15,998545,104916,361,626,115556.0,28889.0,-69.0,-69.0,-66.0,-72.0,-68.0,-69.0,-66.0,-72.0,-90.0,-93.0,-89.0,-93.0,21.0,24.0,23.0,21.0,1
1535,CC:2F:71:3E:C5:1F,3842459,484613981,938,114679,3841521,484499302,0,3910,328653,3226,247411,684,81242,994,11,1347,25,0,52,130000.0,39000.0,-71.0,-71.0,-70.0,-60.0,-71.0,-72.0,-69.0,-61.0,-90.0,-93.0,-89.0,-93.0,19.0,22.0,19.0,33.0,1
1536,BA:8C:B9:54:50:24,3846406,490687558,4885,6188256,3841521,484499302,0,9345,1723724,9323,1720229,22,3495,2354,17,5358,41,0,65,216660.0,130000.0,-59.0,-36.0,-44.0,-43.0,-49.0,-35.0,-43.0,-46.0,-90.0,-93.0,-89.0,-93.0,31.0,57.0,45.0,50.0,1
1537,62:47:05:9D:EB:15,3843640,486922185,2119,2422883,3841521,484499302,0,4294,3010478,4263,3005497,31,4981,2053,0,2168,56,0,105,216660.0,130000.0,-47.0,-48.0,-39.0,-45.0,-46.0,-47.0,-39.0,-46.0,-90.0,-92.0,-89.0,-93.0,43.0,44.0,50.0,48.0,1
1538,3C:55:76:E8:8F:1F,3919304,679345184,77782,194845822,3841522,484499362,38,36810,7490783,36307,7404908,503,85875,15533,39,77840,7859,38,531,286760.0,172050.0,-46.0,-54.0,-52.0,-40.0,-46.0,-53.0,-52.0,-39.0,-90.0,-92.0,-89.0,-93.0,44.0,38.0,37.0,53.0,1
1539,92:69:1D:31:68:E9,3845512,488139644,3990,3640282,3841522,484499362,0,5105,1132640,4947,1096842,158,35798,2166,12,4223,93,0,55,229410.0,130000.0,-54.0,-47.0,-42.0,-48.0,-53.0,-47.0,-43.0,-48.0,-90.0,-92.0,-89.0,-93.0,36.0,45.0,47.0,45.0,1
1540,CC:2F:71:3F:1F:24,4840341,1603271733,998819,1118772371,3841522,484499362,364,823512,902977269,822735,902883445,777,93824,795584,15,998754,104938,361,627,86667.0,14444.0,-68.0,-69.0,-66.0,-72.0,-68.0,-69.0,-66.0,-72.0,-90.0,-92.0,-89.0,-93.0,22.0,23.0,23.0,21.0,1
1541,CC:2F:71:3E:C5:1F,3842460,484614041,938,114679,3841522,484499362,0,3910,328653,3226,247411,684,81242,994,11,1347,25,0,52,130000.0,39000.0,-71.0,-71.0,-70.0,-60.0,-71.0,-72.0,-69.0,-61.0,-90.0,-92.0,-89.0,-93.0,19.0,21.0,19.0,33.0,1
1542,BA:8C:B9:54:50:24,3846407,490687618,4885,6188256,3841522,484499362,0,9345,1723724,9323,1720229,22,3495,2354,17,5358,41,0,65,216660.0,130000.0,-59.0,-36.0,-44.0,-43.0,-49.0,-35.0,-43.0,-46.0,-90.0,-92.0,-89.0,-93.0,31.0,56.0,45.0,50.0,1
1543,62:47:05:9D:EB:15,3843649,486923053,2119,2422883,3841530,484500170,0,4294,3010478,4263,3005497,31,4981,2053,0,2168,56,0,105,216660.0,130000.0,-47.0,-48.0,-39.0,-45.0,-46.0,-47.0,-39.0,-46.0,-90.0,-92.0,-89.0,-93.0,43.0,44.0,50.0,48.0,1
1544,3C:55:76:E8:8F:1F,3919313,679346166,77783,194845996,3841530,484500170,38,36818,7491457,36315,7405582,503,85875,15535,39,77841,7859,38,531,286760.0,172050.0,-46.0,-53.0,-52.0,-40.0,-46.0,-52.0,-50.0,-39.0,-90.0,-92.0,-89.0,-93.0,44.0,39.0,37.0,53.0,1
1545,92:69:1D:31:68:E9,3845520,488140452,3990,3640282,3841530,484500170,0,5105,1132640,4947,1096842,158,35798,2166,12,4223,93,0,55,229410.0,130000.0,-54.0,-47.0,-42.0,-48.0,-53.0,-47.0,-43.0,-48.0,-90.0,-92.0,-89.0,-93.0,36.0,45.0,47.0,45.0,1
1546,CC:2F:71:3F:1F:24,4840560,1603535131,999030,1119034961,3841530,484500170,364,823695,903221161,822918,903127337,777,93824,795767,15,998964,104942,361,627,104000.0,26000.0,-68.0,-69.0,-67.0,-72.0,-68.0,-69.0,-66.0,-72.0,-90.0,-92.0,-89.0,-93.0,22.0,23.0,22.0,21.0,1
1547,CC:2F:71:3E:C5:1F,3842468,484614849,938,114679,3841530,484500170,0,3910,328653,3226,247411,684,81242,994,11,1347,25,0,52,130000.0,39000.0,-71.0,-71.0,-70.0,-60.0,-71.0,-72.0,-69.0,-61.0,-90.0,-92.0,-89.0,-93.0,19.0,21.0,19.0,33.0,1
1548,BA:8C:B9:54:50:24,3846415,490688426,4885,6188256,3841530,484500170,0,9345,1723724,9323,1720229,22,3495,2354,17,5358,41,0,65,216660.0,130000.0,-59.0,-36.0,-44.0,-43.0,-49.0,-35.0,-43.0,-46.0,-90.0,-92.0,-89.0,-93.0,31.0,56.0,45.0,50.0,1
1549,62:47:05:9D:EB:15,3843650,486923352,2120,2423182,3841530,484500170,0,4295,3010546,4264,3005565,31,4981,2053,0,2169,56,0,105,229410.0,130000.0,-47.0,-47.0,-39.0,-46.0,-46.0,-47.0,-39.0,-46.0,-90.0,-92.0,-89.0,-93.0,43.0,45.0,50.0,47.0,1
1550,3C:55:76:E8:8F:1F,3919313,679346166,77783,194845996,3841530,484500170,38,36818,7491457,36315,7405582,503,85875,15535,39,77841,7859,38,531,286760.0,172050.0,-46.0,-53.0,-52.0,-40.0,-46.0,-52.0,-50.0,-39.0,-90.0,-92.0,-89.0,-93.0,44.0,39.0,37.0,53.0,1
1551,92:69:1D:31:68:E9,3845520,488140452,3990,3640282,3841530,484500170,0,5105,1132640,4947,1096842,158,35798,2166,12,4223,93,0,55,229410.0,130000.0,-54.0,-47.0,-42.0,-48.0,-53.0,-47.0,-43.0,-48.0,-90.0,-92.0,-89.0,-93.0,36.0,45.0,47.0,45.0,1
1552,CC:2F:71:3F:1F:24,4840772,1603800251,999242,1119300081,3841530,484500170,364,823883,903472725,823106,903378901,777,93824,795955,15,999177,104987,361,627,78000.0,13000.0,-68.0,-69.0,-67.0,-72.0,-68.0,-69.0,-66.0,-72.0,-90.0,-92.0,-89.0,-93.0,22.0,23.0,22.0,21.0,1
1553,CC:2F:71:3E:C5:1F,3842468,484614849,938,114679,3841530,484500170,0,3910,328653,3226,247411,684,81242,994,11,1347,25,0,52,130000.0,39000.0,-71.0,-71.0,-70.0,-60.0,-71.0,-72.0,-69.0,-61.0,-90.0,-92.0,-89.0,-93.0,19.0,21.0,19.0,33.0,1
1554,BA:8C:B9:54:50:24,3846418,490688688,4885,6188256,3841533,484500432,0,9345,1723724,9323,1720229,22,3495,2354,17,5358,41,0,65,216660.0,130000.0,-59.0,-36.0,-44.0,-43.0,-49.0,-35.0,-43.0,-46.0,-90.0,-92.0,-89.0,-93.0,31.0,56.0,45.0,50.0,1
1555,62:47:05:9D:EB:15,3843660,486924294,2121,2423256,3841539,484501038,0,4298,3010895,4267,3005914,31,4981,2055,0,2170,56,0,105,229410.0,130000.0,-47.0,-47.0,-39.0,-46.0,-47.0,-48.0,-40.0,-47.0,-90.0,-92.0,-89.0,-93.0,43.0,45.0,50.0,47.0,1
1556,3C:55:76:E8:8F:1F,3919322,679347034,77783,194845996,3841539,484501038,38,36818,7491457,36315,7405582,503,85875,15535,39,77841,7859,38,531,286760.0,172050.0,-46.0,-53.0,-52.0,-40.0,-46.0,-52.0,-50.0,-39.0,-90.0,-92.0,-89.0,-93.0,44.0,39.0,37.0,53.0,1
1557,92:69:1D:31:68:E9,3845529,488141320,3990,3640282,3841539,484501038,0,5105,1132640,4947,1096842,158,35798,2166,12,4223,93,0,55,229410.0,130000.0,-54.0,-47.0,-42.0,-48.0,-53.0,-47.0,-43.0,-48.0,-90.0,-92.0,-89.0,-93.0,36.0,45.0,47.0,45.0,1
1558,CC:2F:71:3F:1F:24,4840997,1604069711,999458,1119568673,3841539,484501038,364,824077,903724262,823300,903630438,777,93824,796148,15,999393,105052,361,627,115556.0,28889.0,-69.0,-69.0,-67.0,-72.0,-68.0,-69.0,-66.0,-72.0,-90.0,-92.0,-89.0,-93.0,21.0,23.0,22.0,21.0,1
1559,CC:2F:71:3E:C5:1F,3842478,484615779,938,114679,3841540,484501100,0,3910,328653,3226,247411,684,81242,994,11,1347,25,0,52,130000.0,39000.0,-71.0,-71.0,-70.0,-60.0,-71.0,-72.0,-69.0,-61.0,-90.0,-92.0,-89.0,-93.0,19.0,21.0,19.0,33.0,1
1560,BA:8C:B9:54:50:24,3846425,490689356,4885,6188256,3841540,484501100,0,9345,1723724,9323,1720229,22,3495,2354,17,5358,41,0,65,216660.0,130000.0,-59.0,-36.0,-44.0,-43.0,-49.0,-35.0,-43.0,-46.0,-90.0,-92.0,-89.0,-93.0,31.0,56.0,45.0,50.0,1
1561,62:47:05:9D:EB:15,3843661,486924356,2121,2423256,3841540,484501100,0,4298,3010895,4267,3005914,31,4981,2055,0,2170,56,0,105,229410.0,130000.0,-47.0,-47.0,-39.0,-46.0,-47.0,-48.0,-40.0,-47.0,-90.0,-92.0,-89.0,-93.0,43.0,45.0,50.0,47.0,1
1562,3C:55:76:E8:8F:1F,3919329,679347908,77789,194846808,3841540,484501100,38,36847,7495247,36343,7409254,504,85993,15544,39,77847,7859,38,532,270830.0,162500.0,-51.0,-50.0,-47.0,-45.0,-50.0,-49.0,-46.0,-44.0,-90.0,-92.0,-89.0,-93.0,39.0,42.0,42.0,48.0,1
1563,92:69:1D:31:68:E9,3845532,488141584,3990,3640282,3841542,484501302,0,5107,1132776,4949,1096978,158,35798,2166,12,4224,93,0,55,229410.0,130000.0,-51.0,-47.0,-44.0,-47.0,-52.0,-47.0,-43.0,-48.0,-90.0,-92.0,-89.0,-93.0,39.0,45.0,45.0,46.0,1
1564,CC:2F:71:3F:1F:24,4841207,1604330037,999665,1119828735,3841542,484501302,364,824259,903966558,823482,903872734,777,93824,796330,15,999600,105068,361,627,115556.0,28889.0,-68.0,-69.0,-66.0,-72.0,-68.0,-69.0,-65.0,-72.0,-90.0,-92.0,-89.0,-93.0,22.0,23.0,23.0,21.0,1
1565,CC:2F:71:3E:C5:1F,3842480,484615981,938,114679,3841542,484501302,0,3912,328793,3228,247551,684,81242,994,11,1348,25,0,52,130000.0,39000.0,-71.0,-72.0,-69.0,-61.0,-70.0,-70.0,-68.0,-60.0,-90.0,-92.0,-89.0,-93.0,19.0,20.0,20.0,32.0,1
1566,BA:8C:B9:54:50:24,3846431,490689962,4885,6188256,3841546,484501706,0,9347,1723860,9325,1720365,22,3495,2354,17,5359,41,0,65,216660.0,130000.0,-40.0,-36.0,-46.0,-52.0,-46.0,-35.0,-43.0,-47.0,-90.0,-92.0,-89.0,-93.0,50.0,56.0,43.0,41.0,1
1567,62:47:05:9D:EB:15,3843670,486925224,2121,2423256,3841549,484501968,0,4298,3010895,4267,3005914,31,4981,2055,0,2170,56,0,105,229410.0,130000.0,-47.0,-47.0,-39.0,-46.0,-47.0,-48.0,-40.0,-47.0,-90.0,-92.0,-89.0,-93.0,43.0,45.0,50.0,47.0,1
1568,3C:55:76:E8:8F:1F,3919338,679348776,77789,194846808,3841549,484501968,38,36847,7495247,36343,7409254,504,85993,15544,39,77847,7859,38,532,270830.0,162500.0,-51.0,-50.0,-47.0,-45.0,-50.0,-49.0,-46.0,-44.0,-90.0,-92.0,-89.0,-93.0,39.0,42.0,42.0,48.0,1
1569,92:69:1D:31:68:E9,3845539,488142250,3990,3640282,3841549,484501968,0,5107,1132776,4949,1096978,158,35798,2166,12,4224,93,0,55,229410.0,130000.0,-51.0,-47.0,-44.0,-47.0,-52.0,-47.0,-43.0,-48.0,-90.0,-92.0,-89.0,-93.0,39.0,45.0,45.0,46.0,1
1570,CC:2F:71:3F:1F:24,4841425,1604592247,999876,1120090279,3841549,484501968,364,824443,904210514,823666,904116690,777,93824,796513,15,999811,105124,361,627,115556.0,28889.0,-69.0,-70.0,-67.0,-73.0,-69.0,-69.0,-66.0,-72.0,-90.0,-92.0,-89.0,-93.0,21.0,22.0,22.0,20.0,1
1571,CC:2F:71:3E:C5:1F,3842487,484616647,938,114679,3841549,484501968,0,3912,328793,3228,247551,684,81242,994,11,1348,25,0,52,130000.0,39000.0,-71.0,-72.0,-69.0,-61.0,-70.0,-70.0,-68.0,-60.0,-90.0,-92.0,-89.0,-93.0,19.0,20.0,20.0,32.0,1
1572,BA:8C:B9:54:50:24,3846434,490690224,4885,6188256,3841549,484501968,0,9347,1723860,9325,1720365,22,3495,2354,17,5359,41,0,65,216660.0,130000.0,-40.0,-36.0,-46.0,-52.0,-46.0,-35.0,-43.0,-47.0,-90.0,-92.0,-89.0,-93.0,50.0,56.0,43.0,41.0,1
1573,62:47:05:9D:EB:15,3843672,486925426,2121,2423256,3841551,484502170,0,4298,3010895,4267,3005914,31,4981,2055,0,2170,56,0,105,229410.0,130000.0,-47.0,-47.0,-39.0,-46.0,-47.0,-48.0,-40.0,-47.0,-90.0,-92.0,-89.0,-93.0,43.0,45.0,50.0,47.0,1
1574,3C:55:76:E8:8F:1F,3919343,679349304,77790,194846932,3841553,484502372,38,36856,7495929,36352,7409936,504,85993,15545,39,77848,7859,38,532,270830.0,162500.0,-51.0,-51.0,-47.0,-45.0,-50.0,-49.0,-45.0,-43.0,-90.0,-92.0,-89.0,-93.0,39.0,41.0,42.0,48.0,1
1575,92:69:1D:31:68:E9,3845545,488142856,3990,3640282,3841555,484502574,0,5107,1132776,4949,1096978,158,35798,2166,12,4224,93,0,55,229410.0,130000.0,-51.0,-47.0,-44.0,-47.0,-52.0,-47.0,-43.0,-48.0,-90.0,-92.0,-89.0,-93.0,39.0,45.0,45.0,46.0,1
1576,CC:2F:71:3F:1F:24,4841645,1604854682,1000088,1120351906,3841557,484502776,364,824634,904454346,823857,904360522,777,93824,796704,15,1000023,105165,361,627,115556.0,28889.0,-69.0,-69.0,-66.0,-72.0,-68.0,-69.0,-66.0,-72.0,-90.0,-92.0,-89.0,-93.0,21.0,23.0,23.0,21.0,1
1577,CC:2F:71:3E:C5:1F,3842495,484617455,938,114679,3841557,484502776,0,3912,328793,3228,247551,684,81242,994,11,1348,25,0,52,130000.0,39000.0,-71.0,-72.0,-69.0,-61.0,-70.0,-70.0,-68.0,-60.0,-90.0,-92.0,-89.0,-93.0,19.0,20.0,20.0,32.0,1
1578,BA:8C:B9:54:50:24,3846442,490691032,4885,6188256,3841557,484502776,0,9347,1723860,9325,1720365,22,3495,2354,17,5359,41,0,65,216660.0,130000.0,-40.0,-36.0,-46.0,-52.0,-46.0,-35.0,-43.0,-47.0,-90.0,-92.0,-89.0,-93.0,50.0,56.0,43.0,41.0,1
1579,62:47:05:9D:EB:15,3843679,486926092,2121,2423256,3841558,484502836,0,4298,3010895,4267,3005914,31,4981,2055,0,2170,56,0,105,229410.0,130000.0,-47.0,-47.0,-39.0,-46.0,-47.0,-48.0,-40.0,-47.0,-90.0,-93.0,-90.0,-93.0,43.0,46.0,51.0,47.0,1
1580,3C:55:76:E8:8F:1F,3919348,679349768,77790,194846932,3841558,484502836,38,36856,7495929,36352,7409936,504,85993,15545,39,77848,7859,38,532,270830.0,162500.0,-51.0,-51.0,-47.0,-45.0,-50.0,-49.0,-45.0,-43.0,-90.0,-93.0,-90.0,-93.0,39.0,42.0,43.0,48.0,1
1581,92:69:1D:31:68:E9,3845548,488143118,3990,3640282,3841558,484502836,0,5107,1132776,4949,1096978,158,35798,2166,12,4224,93,0,55,229410.0,130000.0,-51.0,-47.0,-44.0,-47.0,-52.0,-47.0,-43.0,-48.0,-90.0,-93.0,-90.0,-93.0,39.0,46.0,46.0,46.0,1
1582,CC:2F:71:3F:1F:24,4841853,1605114692,1000295,1120611856,3841558,484502836,364,824816,904696642,824039,904602818,777,93824,796886,15,1000230,105185,361,627,115556.0,28889.0,-68.0,-70.0,-66.0,-73.0,-68.0,-70.0,-65.0,-72.0,-90.0,-93.0,-90.0,-93.0,22.0,23.0,24.0,20.0,1
1583,CC:2F:71:3E:C5:1F,3842496,484617515,938,114679,3841558,484502836,0,3912,328793,3228,247551,684,81242,994,11,1348,25,0,52,130000.0,39000.0,-71.0,-72.0,-69.0,-61.0,-70.0,-70.0,-68.0,-60.0,-90.0,-93.0,-90.0,-93.0,19.0,21.0,21.0,32.0,1
1584,BA:8C:B9:54:50:24,3846443,490691092,4885,6188256,3841558,484502836,0,9347,1723860,9325,1720365,22,3495,2354,17,5359,41,0,65,216660.0,130000.0,-40.0,-36.0,-46.0,-52.0,-46.0,-35.0,-43.0,-47.0,-90.0,-93.0,-90.0,-93.0,50.0,57.0,44.0,41.0,1
1585,62:47:05:9D:EB:15,3843689,486927289,2122,2423372,3841567,484503917,0,4301,3011141,4270,3006160,31,4981,2056,0,2171,56,0,105,229410.0,130000.0,-45.0,-46.0,-40.0,-46.0,-47.0,-48.0,-40.0,-47.0,-90.0,-92.0,-89.0,-92.0,45.0,46.0,49.0,46.0,1
1586,3C:55:76:E8:8F:1F,3919357,679350849,77790,194846932,3841567,484503917,38,36856,7495929,36352,7409936,504,85993,15545,39,77848,7859,38,532,270830.0,162500.0,-51.0,-51.0,-47.0,-45.0,-50.0,-49.0,-45.0,-43.0,-90.0,-92.0,-89.0,-92.0,39.0,41.0,42.0,47.0,1
1587,92:69:1D:31:68:E9,3845557,488144199,3990,3640282,3841567,484503917,0,5107,1132776,4949,1096978,158,35798,2166,12,4224,93,0,55,229410.0,130000.0,-51.0,-47.0,-44.0,-47.0,-52.0,-47.0,-43.0,-48.0,-90.0,-92.0,-89.0,-92.0,39.0,45.0,45.0,45.0,1
1588,CC:2F:71:3F:1F:24,4842070,1605374901,1000503,1120870984,3841567,484503917,364,824998,904938938,824221,904845114,777,93824,797068,15,1000438,105211,361,627,86667.0,14444.0,-70.0,-72.0,-67.0,-73.0,-70.0,-71.0,-66.0,-72.0,-90.0,-92.0,-89.0,-92.0,20.0,20.0,22.0,19.0,1
1589,CC:2F:71:3E:C5:1F,3842505,484618596,938,114679,3841567,484503917,0,3912,328793,3228,247551,684,81242,994,11,1348,25,0,52,130000.0,39000.0,-71.0,-72.0,-69.0,-61.0,-70.0,-70.0,-68.0,-60.0,-90.0,-92.0,-89.0,-92.0,19.0,20.0,20.0,31.0,1
1590,BA:8C:B9:54:50:24,3846452,490692173,4885,6188256,3841567,484503917,0,9347,1723860,9325,1720365,22,3495,2354,17,5359,41,0,65,216660.0,130000.0,-40.0,-36.0,-46.0,-52.0,-46.0,-35.0,-43.0,-47.0,-90.0,-92.0,-89.0,-92.0,50.0,56.0,43.0,40.0,1
1591,62:47:05:9D:EB:15,3843689,486927289,2122,2423372,3841567,484503917,0,4301,3011141,4270,3006160,31,4981,2056,0,2171,56,0,105,229410.0,130000.0,-45.0,-46.0,-40.0,-46.0,-47.0,-48.0,-40.0,-47.0,-90.0,-92.0,-89.0,-92.0,45.0,46.0,49.0,46.0,1
1592,3C:55:76:E8:8F:1F,3919725,680329880,78158,195825963,3841567,484503917,38,36926,7507740,36422,7421747,504,85993,15581,39,78145,7859,38,532,286760.0,162500.0,-51.0,-54.0,-48.0,-45.0,-50.0,-53.0,-47.0,-44.0,-90.0,-92.0,-89.0,-92.0,39.0,38.0,41.0,47.0,1
1593,92:69:1D:31:68:E9,3845557,488144199,3990,3640282,3841567,484503917,0,5107,1132776,4949,1096978,158,35798,2166,12,4224,93,0,55,229410.0,130000.0,-51.0,-47.0,-44.0,-47.0,-52.0,-47.0,-43.0,-48.0,-90.0,-92.0,-89.0,-92.0,39.0,45.0,45.0,45.0,1
1594,CC:2F:71:3F:1F:24,4842295,1605659487,1000728,1121155570,3841567,484503917,364,825198,905207656,824421,905113832,777,93824,797267,15,1000663,105227,361,628,115556.0,28889.0,-69.0,-70.0,-66.0,-72.0,-69.0,-69.0,-65.0,-72.0,-90.0,-92.0,-89.0,-92.0,21.0,22.0,23.0,20.0,1
1595,CC:2F:71:3E:C5:1F,3842506,484618656,938,114679,3841568,484503977,0,3912,328793,3228,247551,684,81242,994,11,1348,25,0,52,130000.0,39000.0,-71.0,-72.0,-69.0,-61.0,-70.0,-70.0,-68.0,-60.0,-90.0,-92.0,-89.0,-92.0,19.0,20.0,20.0,31.0,1
1596,BA:8C:B9:54:50:24,3846453,490692233,4885,6188256,3841568,484503977,0,9347,1723860,9325,1720365,22,3495,2354,17,5359,41,0,65,216660.0,130000.0,-40.0,-36.0,-46.0,-52.0,-46.0,-35.0,-43.0,-47.0,-90.0,-92.0,-89.0,-92.0,50.0,56.0,43.0,40.0,1
1597,62:47:05:9D:EB:15,3843698,486928157,2122,2423372,3841576,484504785,0,4301,3011141,4270,3006160,31,4981,2056,0,2171,56,0,105,229410.0,130000.0,-45.0,-46.0,-40.0,-46.0,-47.0,-48.0,-40.0,-47.0,-90.0,-92.0,-89.0,-92.0,45.0,46.0,49.0,46.0,1
1598,3C:55:76:E8:8F:1F,3920415,682142149,78839,197637364,3841576,484504785,38,37107,7532631,36603,7446638,504,85993,15645,39,78897,7864,38,533,286760.0,172050.0,-51.0,-52.0,-46.0,-45.0,-51.0,-51.0,-45.0,-44.0,-90.0,-92.0,-89.0,-92.0,39.0,40.0,43.0,47.0,1
1599,92:69:1D:31:68:E9,3845566,488145067,3990,3640282,3841576,484504785,0,5107,1132776,4949,1096978,158,35798,2166,12,4224,93,0,55,229410.0,130000.0,-51.0,-47.0,-44.0,-47.0,-52.0,-47.0,-43.0,-48.0,-90.0,-92.0,-89.0,-92.0,39.0,45.0,45.0,45.0,1
1600,CC:2F:71:3F:1F:24,4842517,1605922336,1000941,1121417551,3841576,484504785,364,825385,905448174,824608,905354350,777,93824,797454,15,1000876,105227,361,628,115556.0,28889.0,-69.0,-71.0,-67.0,-71.0,-69.0,-71.0,-67.0,-71.0,-90.0,-92.0,-89.0,-92.0,21.0,21.0,22.0,21.0,1
1601,CC:2F:71:3E:C5:1F,3842514,484619464,938,114679,3841576,484504785,0,3912,328793,3228,247551,684,81242,994,11,1348,25,0,52,130000.0,39000.0,-71.0,-72.0,-69.0,-61.0,-70.0,-70.0,-68.0,-60.0,-90.0,-92.0,-89.0,-92.0,19.0,20.0,20.0,31.0,1
1602,BA:8C:B9:54:50:24,3846461,490693041,4885,6188256,3841576,484504785,0,9347,1723860,9325,1720365,22,3495,2354,17,5359,41,0,65,216660.0,130000.0,-40.0,-36.0,-46.0,-52.0,-46.0,-35.0,-43.0,-47.0,-90.0,-92.0,-89.0,-92.0,50.0,56.0,43.0,40.0,1
1603,62:47:05:9D:EB:15,3843698,486928157,2122,2423372,3841576,484504785,0,4301,3011141,4270,3006160,31,4981,2056,0,2171,56,0,105,229410.0,130000.0,-45.0,-46.0,-40.0,-46.0,-47.0,-48.0,-40.0,-47.0,-90.0,-92.0,-89.0,-92.0,45.0,46.0,49.0,46.0,1
1604,3C:55:76:E8:8F:1F,3920419,682142719,78843,197637934,3841576,484504785,38,37122,7534627,36618,7448634,504,85993,15649,39,78901,7864,38,533,286760.0,172050.0,-51.0,-52.0,-45.0,-43.0,-51.0,-52.0,-45.0,-43.0,-90.0,-92.0,-89.0,-92.0,39.0,40.0,44.0,49.0,1
1605,92:69:1D:31:68:E9,3845566,488145067,3990,3640282,3841576,484504785,0,5107,1132776,4949,1096978,158,35798,2166,12,4224,93,0,55,229410.0,130000.0,-51.0,-47.0,-44.0,-47.0,-52.0,-47.0,-43.0,-48.0,-90.0,-92.0,-89.0,-92.0,39.0,45.0,45.0,45.0,1
1606,CC:2F:71:3F:1F:24,4842728,1606184060,1001150,1121679073,3841578,484504987,364,825568,905690586,824791,905596762,777,93824,797637,15,1001084,105236,361,628,115556.0,28889.0,-69.0,-71.0,-67.0,-72.0,-69.0,-71.0,-67.0,-72.0,-90.0,-92.0,-89.0,-92.0,21.0,21.0,22.0,20.0,1
1607,CC:2F:71:3E:C5:1F,3842516,484619666,938,114679,3841578,484504987,0,3912,328793,3228,247551,684,81242,994,11,1348,25,0,52,130000.0,39000.0,-71.0,-72.0,-69.0,-61.0,-70.0,-70.0,-68.0,-60.0,-90.0,-92.0,-89.0,-92.0,19.0,20.0,20.0,31.0,1
1608,BA:8C:B9:54:50:24,3846465,490693445,4885,6188256,3841580,484505189,0,9347,1723860,9325,1720365,22,3495,2354,17,5359,41,0,65,216660.0,130000.0,-40.0,-36.0,-46.0,-52.0,-46.0,-35.0,-43.0,-47.0,-90.0,-92.0,-89.0,-92.0,50.0,56.0,43.0,40.0,1
1609,62:47:05:9D:EB:15,3843708,486929085,2122,2423372,3841586,484505713,0,4301,3011141,4270,3006160,31,4981,2056,0,2171,56,0,105,229410.0,130000.0,-45.0,-46.0,-40.0,-46.0,-47.0,-48.0,-40.0,-47.0,-90.0,-92.0,-89.0,-92.0,45.0,46.0,49.0,46.0,1
1610,3C:55:76:E8:8F:1F,3920430,682143821,78844,197638108,3841586,484505713,38,37133,7535505,36629,7449512,504,85993,15651,39,78902,7864,38,533,286760.0,172050.0,-45.0,-54.0,-49.0,-42.0,-45.0,-52.0,-48.0,-40.0,-90.0,-92.0,-89.0,-92.0,45.0,38.0,40.0,50.0,1
1611,92:69:1D:31:68:E9,3845576,488145995,3990,3640282,3841586,484505713,0,5107,1132776,4949,1096978,158,35798,2166,12,4224,93,0,55,229410.0,130000.0,-51.0,-47.0,-44.0,-47.0,-52.0,-47.0,-43.0,-48.0,-90.0,-92.0,-89.0,-92.0,39.0,45.0,45.0,45.0,1
1612,CC:2F:71:3F:1F:24,4842947,1606446792,1001361,1121941079,3841586,484505713,364,825753,905936146,824975,905842208,778,93938,797822,15,1001296,105238,361,628,115556.0,28889.0,-70.0,-70.0,-66.0,-72.0,-70.0,-70.0,-66.0,-72.0,-90.0,-92.0,-89.0,-92.0,20.0,22.0,23.0,20.0,1
1613,CC:2F:71:3E:C5:1F,3842524,484620392,938,114679,3841586,484505713,0,3912,328793,3228,247551,684,81242,994,11,1348,25,0,52,130000.0,39000.0,-71.0,-72.0,-69.0,-61.0,-70.0,-70.0,-68.0,-60.0,-90.0,-92.0,-89.0,-92.0,19.0,20.0,20.0,31.0,1
1614,BA:8C:B9:54:50:24,3846471,490693969,4885,6188256,3841586,484505713,0,9347,1723860,9325,1720365,22,3495,2354,17,5359,41,0,65,216660.0,130000.0,-40.0,-36.0,-46.0,-52.0,-46.0,-35.0,-43.0,-47.0,-90.0,-92.0,-89.0,-92.0,50.0,56.0,43.0,40.0,1
1615,62:47:05:9D:EB:15,3843713,486929573,2122,2423372,3841591,484506201,0,4301,3011141,4270,3006160,31,4981,2056,0,2171,56,0,105,229410.0,130000.0,-45.0,-46.0,-40.0,-46.0,-47.0,-48.0,-40.0,-47.0,-90.0,-92.0,-89.0,-92.0,45.0,46.0,49.0,46.0,1
1616,3C:55:76:E8:8F:1F,3920437,682144511,78844,197638108,3841593,484506403,38,37141,7536051,36637,7450058,504,85993,15651,39,78902,7864,38,533,286760.0,172050.0,-46.0,-55.0,-50.0,-42.0,-45.0,-54.0,-49.0,-41.0,-90.0,-92.0,-89.0,-92.0,44.0,37.0,39.0,50.0,1
1617,92:69:1D:31:68:E9,3845583,488146685,3990,3640282,3841593,484506403,0,5107,1132776,4949,1096978,158,35798,2166,12,4224,93,0,55,229410.0,130000.0,-51.0,-47.0,-44.0,-47.0,-52.0,-47.0,-43.0,-48.0,-90.0,-92.0,-89.0,-92.0,39.0,45.0,45.0,45.0,1
1618,CC:2F:71:3F:1F:24,4843175,1606715695,1001580,1122209090,3841595,484506605,364,825952,906185282,825171,906090890,781,94392,798021,15,1001515,105248,361,628,115556.0,28889.0,-69.0,-70.0,-67.0,-72.0,-69.0,-70.0,-66.0,-72.0,-90.0,-92.0,-89.0,-92.0,21.0,22.0,22.0,20.0,1
1619,CC:2F:71:3E:C5:1F,3842535,484621486,938,114679,3841597,484506807,0,3912,328793,3228,247551,684,81242,994,11,1348,25,0,52,130000.0,39000.0,-71.0,-72.0,-69.0,-61.0,-70.0,-70.0,-68.0,-60.0,-90.0,-92.0,-89.0,-92.0,19.0,20.0,20.0,31.0,1
1620,BA:8C:B9:54:50:24,3846482,490695063,4885,6188256,3841597,484506807,0,9347,1723860,9325,1720365,22,3495,2354,17,5359,41,0,65,216660.0,130000.0,-40.0,-36.0,-46.0,-52.0,-46.0,-35.0,-43.0,-47.0,-90.0,-92.0,-89.0,-92.0,50.0,56.0,43.0,40.0,1
1621,62:47:05:9D:EB:15,3843721,486930365,2122,2423372,3841599,484506993,0,4301,3011141,4270,3006160,31,4981,2056,0,2171,56,0,105,229410.0,130000.0,-45.0,-46.0,-40.0,-46.0,-47.0,-48.0,-40.0,-47.0,-90.0,-92.0,-89.0,-92.0,45.0,46.0,49.0,46.0,1
1622,3C:55:76:E8:8F:1F,3920443,682145101,78844,197638108,3841599,484506993,38,37141,7536051,36637,7450058,504,85993,15651,39,78902,7864,38,533,286760.0,172050.0,-46.0,-55.0,-50.0,-42.0,-45.0,-54.0,-49.0,-41.0,-90.0,-92.0,-89.0,-92.0,44.0,37.0,39.0,50.0,1
1623,92:69:1D:31:68:E9,3845589,488147275,3990,3640282,3841599,484506993,0,5108,1132844,4950,1097046,158,35798,2166,12,4224,93,0,55,229410.0,130000.0,-51.0,-47.0,-44.0,-46.0,-52.0,-47.0,-43.0,-48.0,-90.0,-92.0,-89.0,-92.0,39.0,45.0,45.0,46.0,1
1624,CC:2F:71:3F:1F:24,4843387,1606976261,1001788,1122469268,3841599,484506993,364,826137,906428006,825356,906333614,781,94392,798205,15,1001723,105250,361,628,115556.0,28889.0,-69.0,-70.0,-67.0,-72.0,-69.0,-70.0,-67.0,-72.0,-90.0,-92.0,-89.0,-92.0,21.0,22.0,22.0,20.0,1
1625,CC:2F:71:3E:C5:1F,3842537,484621672,938,114679,3841599,484506993,0,3912,328793,3228,247551,684,81242,994,11,1348,25,0,52,130000.0,39000.0,-71.0,-72.0,-69.0,-61.0,-70.0,-70.0,-68.0,-60.0,-90.0,-92.0,-89.0,-92.0,19.0,20.0,20.0,31.0,1
1626,BA:8C:B9:54:50:24,3846484,490695249,4885,6188256,3841599,484506993,0,9347,1723860,9325,1720365,22,3495,2354,17,5359,41,0,65,216660.0,130000.0,-40.0,-36.0,-46.0,-52.0,-46.0,-35.0,-43.0,-47.0,-90.0,-92.0,-89.0,-92.0,50.0,56.0,43.0,40.0,1
1627,62:47:05:9D:EB:15,3843727,486930971,2122,2423372,3841605,484507599,0,4301,3011141,4270,3006160,31,4981,2056,0,2171,56,0,105,229410.0,130000.0,-45.0,-46.0,-40.0,-46.0,-47.0,-48.0,-40.0,-47.0,-90.0,-92.0,-89.0,-92.0,45.0,46.0,49.0,46.0,1
1628,3C:55:76:E8:8F:1F,3920451,682145909,78844,197638108,3841607,484507801,38,37141,7536051,36637,7450058,504,85993,15651,39,78902,7864,38,533,286760.0,172050.0,-46.0,-55.0,-50.0,-42.0,-45.0,-54.0,-49.0,-41.0,-90.0,-92.0,-89.0,-92.0,44.0,37.0,39.0,50.0,1
1629,92:69:1D:31:68:E9,3845597,488148083,3990,3640282,3841607,484507801,0,5108,1132844,4950,1097046,158,35798,2166,12,4224,93,0,55,229410.0,130000.0,-51.0,-47.0,-44.0,-46.0,-52.0,-47.0,-43.0,-48.0,-90.0,-92.0,-89.0,-92.0,39.0,45.0,45.0,46.0,1
1630,CC:2F:71:3F:1F:24,4843607,1607240405,1002000,1122732604,3841607,484507801,364,826324,906675280,825543,906580888,781,94392,798392,15,1001935,105259,361,629,115556.0,28889.0,-69.0,-70.0,-67.0,-72.0,-69.0,-70.0,-66.0,-71.0,-90.0,-92.0,-89.0,-92.0,21.0,22.0,22.0,20.0,1
1631,CC:2F:71:3E:C5:1F,3842545,484622480,938,114679,3841607,484507801,0,3912,328793,3228,247551,684,81242,994,11,1348,25,0,52,130000.0,39000.0,-71.0,-72.0,-69.0,-61.0,-70.0,-70.0,-68.0,-60.0,-90.0,-92.0,-89.0,-92.0,19.0,20.0,20.0,31.0,1
1632,BA:8C:B9:54:50:24,3846492,490696057,4885,6188256,3841607,484507801,0,9347,1723860,9325,1720365,22,3495,2354,17,5359,41,0,65,216660.0,130000.0,-40.0,-36.0,-46.0,-52.0,-46.0,-35.0,-43.0,-47.0,-90.0,-92.0,-89.0,-92.0,50.0,56.0,43.0,40.0,1
1633,62:47:05:9D:EB:15,3843729,486931173,2122,2423372,3841607,484507801,0,4301,3011141,4270,3006160,31,4981,2056,0,2171,56,0,105,229410.0,130000.0,-45.0,-46.0,-40.0,-46.0,-47.0,-48.0,-40.0,-47.0,-90.0,-92.0,-89.0,-92.0,45.0,46.0,49.0,46.0,1
1634,3C:55:76:E8:8F:1F,3920451,682145909,78844,197638108,3841607,484507801,38,37141,7536051,36637,7450058,504,85993,15651,39,78902,7864,38,533,286760.0,172050.0,-46.0,-55.0,-50.0,-42.0,-45.0,-54.0,-49.0,-41.0,-90.0,-92.0,-89.0,-92.0,44.0,37.0,39.0,50.0,1
1635,92:69:1D:31:68:E9,3845597,488148083,3990,3640282,3841607,484507801,0,5108,1132844,4950,1097046,158,35798,2166,12,4224,93,0,55,229410.0,130000.0,-51.0,-47.0,-44.0,-46.0,-52.0,-47.0,-43.0,-48.0,-90.0,-92.0,-89.0,-92.0,39.0,45.0,45.0,46.0,1
1636,CC:2F:71:3F:1F:24,4843819,1607503895,1002211,1122996034,3841608,484507861,364,826513,906921488,825732,906827096,781,94392,798581,15,1002146,105261,361,631,115556.0,28889.0,-69.0,-71.0,-66.0,-72.0,-69.0,-70.0,-66.0,-71.0,-90.0,-92.0,-89.0,-92.0,21.0,21.0,23.0,20.0,1
1637,CC:2F:71:3E:C5:1F,3842546,484622540,938,114679,3841608,484507861,0,3912,328793,3228,247551,684,81242,994,11,1348,25,0,52,130000.0,39000.0,-71.0,-72.0,-69.0,-61.0,-70.0,-70.0,-68.0,-60.0,-90.0,-92.0,-89.0,-92.0,19.0,20.0,20.0,31.0,1
1638,BA:8C:B9:54:50:24,3846493,490696117,4885,6188256,3841608,484507861,0,9347,1723860,9325,1720365,22,3495,2354,17,5359,41,0,65,216660.0,130000.0,-40.0,-36.0,-46.0,-52.0,-46.0,-35.0,-43.0,-47.0,-90.0,-92.0,-89.0,-92.0,50.0,56.0,43.0,40.0,1
1639,62:47:05:9D:EB:15,3843738,486932041,2122,2423372,3841616,484508669,0,4301,3011141,4270,3006160,31,4981,2056,0,2171,56,0,105,229410.0,130000.0,-45.0,-46.0,-40.0,-46.0,-47.0,-48.0,-40.0,-47.0,-90.0,-92.0,-89.0,-92.0,45.0,46.0,49.0,46.0,1
1640,3C:55:76:E8:8F:1F,3920472,682154664,78856,197645995,3841616,484508669,38,37172,7544595,36668,7458602,504,85993,15665,39,78914,7864,38,533,286760.0,172050.0,-51.0,-52.0,-45.0,-44.0,-50.0,-52.0,-45.0,-43.0,-90.0,-92.0,-89.0,-92.0,39.0,40.0,44.0,48.0,1
1641,92:69:1D:31:68:E9,3845608,488149129,3991,3640398,3841617,484508731,0,5109,1132912,4951,1097114,158,35798,2166,12,4225,93,0,55,229410.0,137640.0,-51.0,-47.0,-44.0,-46.0,-52.0,-47.0,-43.0,-47.0,-90.0,-92.0,-89.0,-92.0,39.0,45.0,45.0,46.0,1
1642,CC:2F:71:3F:1F:24,4844046,1607768582,1002429,1123259851,3841617,484508731,364,826705,907167067,825924,907072675,781,94392,798771,15,1002364,105272,361,633,115556.0,28889.0,-70.0,-71.0,-67.0,-72.0,-69.0,-70.0,-66.0,-71.0,-90.0,-92.0,-89.0,-92.0,20.0,21.0,22.0,20.0,1
1643,CC:2F:71:3E:C5:1F,3842556,484623526,939,114795,3841617,484508731,0,3916,329121,3231,247761,685,81360,995,11,1349,25,0,52,130000.0,39000.0,-68.0,-68.0,-64.0,-60.0,-71.0,-72.0,-69.0,-61.0,-90.0,-91.0,-89.0,-91.0,22.0,23.0,25.0,31.0,1
1644,BA:8C:B9:54:50:24,3846503,490697103,4886,6188372,3841617,484508731,0,9349,1723996,9327,1720501,22,3495,2354,17,5360,41,0,65,216660.0,130000.0,-48.0,-35.0,-43.0,-45.0,-47.0,-35.0,-43.0,-46.0,-90.0,-91.0,-89.0,-91.0,42.0,56.0,46.0,46.0,1
1645,62:47:05:9D:EB:15,3843740,486932219,2123,2423488,3841617,484508731,0,4303,3011277,4272,3006296,31,4981,2056,0,2172,56,0,105,229410.0,130000.0,-45.0,-46.0,-40.0,-45.0,-47.0,-47.0,-40.0,-47.0,-90.0,-91.0,-89.0,-91.0,45.0,45.0,49.0,46.0,1
1646,3C:55:76:E8:8F:1F,3920473,682154726,78856,197645995,3841617,484508731,38,37175,7544801,36671,7458808,504,85993,15665,39,78914,7864,38,533,286760.0,172050.0,-51.0,-52.0,-45.0,-44.0,-50.0,-52.0,-45.0,-43.0,-90.0,-91.0,-89.0,-91.0,39.0,39.0,44.0,47.0,1
1647,92:69:1D:31:68:E9,3845608,488149129,3991,3640398,3841617,484508731,0,5110,1132980,4952,1097182,158,35798,2166,12,4225,93,0,55,229410.0,137640.0,-54.0,-48.0,-42.0,-48.0,-52.0,-47.0,-43.0,-47.0,-90.0,-91.0,-89.0,-91.0,36.0,43.0,47.0,43.0,1
1648,CC:2F:71:3F:1F:24,4844254,1608028774,1002637,1123520043,3841617,484508731,364,826897,907423465,826116,907329073,781,94392,798954,15,1002572,105276,361,633,115556.0,28889.0,-69.0,-70.0,-67.0,-72.0,-69.0,-70.0,-67.0,-72.0,-90.0,-91.0,-89.0,-91.0,21.0,21.0,22.0,19.0,1
1649,CC:2F:71:3E:C5:1F,3842558,484623728,939,114795,3841619,484508933,0,3916,329121,3231,247761,685,81360,995,11,1349,25,0,52,130000.0,39000.0,-68.0,-68.0,-64.0,-60.0,-71.0,-72.0,-69.0,-61.0,-90.0,-91.0,-89.0,-91.0,22.0,23.0,25.0,31.0,1
1650,BA:8C:B9:54:50:24,3846507,490697507,4886,6188372,3841621,484509135,0,9349,1723996,9327,1720501,22,3495,2354,17,5360,41,0,65,216660.0,130000.0,-48.0,-35.0,-43.0,-45.0,-47.0,-35.0,-43.0,-46.0,-90.0,-91.0,-89.0,-91.0,42.0,56.0,46.0,46.0,1
1651,62:47:05:9D:EB:15,3843749,486933087,2123,2423488,3841626,484509599,0,4303,3011277,4272,3006296,31,4981,2056,0,2172,56,0,105,229410.0,130000.0,-45.0,-46.0,-40.0,-45.0,-47.0,-47.0,-40.0,-47.0,-90.0,-91.0,-89.0,-92.0,45.0,45.0,49.0,47.0,1
1652,3C:55:76:E8:8F:1F,3920483,682155724,78857,197646125,3841626,484509599,38,37196,7546268,36692,7460275,504,85993,15666,39,78915,7864,38,533,286760.0,172050.0,-51.0,-52.0,-45.0,-44.0,-51.0,-52.0,-45.0,-44.0,-90.0,-91.0,-89.0,-92.0,39.0,39.0,44.0,48.0,1
1653,92:69:1D:31:68:E9,3845617,488149997,3991,3640398,3841626,484509599,0,5110,1132980,4952,1097182,158,35798,2166,12,4225,93,0,55,229410.0,137640.0,-54.0,-48.0,-42.0,-48.0,-52.0,-47.0,-43.0,-47.0,-90.0,-91.0,-89.0,-92.0,36.0,43.0,47.0,44.0,1
1654,CC:2F:71:3F:1F:24,4844472,1608292364,1002846,1123782765,3841626,484509599,364,827097,907680961,826316,907586569,781,94392,799142,15,1002780,105285,361,633,115556.0,28889.0,-69.0,-71.0,-67.0,-72.0,-69.0,-71.0,-67.0,-72.0,-90.0,-91.0,-89.0,-92.0,21.0,20.0,22.0,20.0,1
1655,CC:2F:71:3E:C5:1F,3842566,484624667,939,114795,3841627,484509872,0,3916,329121,3231,247761,685,81360,995,11,1349,25,0,52,130000.0,39000.0,-68.0,-68.0,-64.0,-60.0,-71.0,-72.0,-69.0,-61.0,-90.0,-91.0,-89.0,-92.0,22.0,23.0,25.0,32.0,1
1656,BA:8C:B9:54:50:24,3846513,490698244,4886,6188372,3841627,484509872,0,9349,1723996,9327,1720501,22,3495,2354,17,5360,41,0,65,216660.0,130000.0,-48.0,-35.0,-43.0,-45.0,-47.0,-35.0,-43.0,-46.0,-90.0,-91.0,-89.0,-92.0,42.0,56.0,46.0,47.0,1
1657,62:47:05:9D:EB:15,3843753,486933624,2123,2423488,3841630,484510136,0,4303,3011277,4272,3006296,31,4981,2056,0,2172,56,0,105,229410.0,130000.0,-45.0,-46.0,-40.0,-45.0,-47.0,-47.0,-40.0,-47.0,-89.0,-91.0,-89.0,-91.0,44.0,45.0,49.0,46.0,1
1658,3C:55:76:E8:8F:1F,3920489,682156463,78857,197646125,3841632,484510338,38,37204,7546868,36699,7460757,505,86111,15667,39,78915,7864,38,535,286760.0,172050.0,-52.0,-52.0,-45.0,-45.0,-50.0,-52.0,-46.0,-44.0,-89.0,-91.0,-89.0,-91.0,37.0,39.0,44.0,46.0,1
1659,92:69:1D:31:68:E9,3845623,488150736,3991,3640398,3841632,484510338,0,5110,1132980,4952,1097182,158,35798,2166,12,4225,93,0,55,229410.0,137640.0,-54.0,-48.0,-42.0,-48.0,-52.0,-47.0,-43.0,-47.0,-89.0,-91.0,-89.0,-91.0,35.0,43.0,47.0,43.0,1
1660,CC:2F:71:3F:1F:24,4844694,1608559746,1003062,1124049408,3841632,484510338,364,827298,907938966,826517,907844574,781,94392,799335,15,1002996,105290,361,634,115556.0,28889.0,-69.0,-71.0,-67.0,-72.0,-69.0,-70.0,-67.0,-72.0,-89.0,-91.0,-89.0,-91.0,20.0,20.0,22.0,19.0,1
1661,CC:2F:71:3E:C5:1F,3842571,484625133,939,114795,3841632,484510338,0,3916,329121,3231,247761,685,81360,995,11,1349,25,0,52,130000.0,39000.0,-68.0,-68.0,-64.0,-60.0,-71.0,-72.0,-69.0,-61.0,-89.0,-91.0,-89.0,-91.0,21.0,23.0,25.0,31.0,1
1662,BA:8C:B9:54:50:24,3846518,490698710,4886,6188372,3841632,484510338,0,9349,1723996,9327,1720501,22,3495,2354,17,5360,41,0,65,216660.0,130000.0,-48.0,-35.0,-43.0,-45.0,-47.0,-35.0,-43.0,-46.0,-89.0,-91.0,-89.0,-91.0,41.0,56.0,46.0,46.0,1
1663,62:47:05:9D:EB:15,3843761,486934352,2123,2423488,3841638,484510864,0,4303,3011277,4272,3006296,31,4981,2056,0,2172,56,0,105,229410.0,130000.0,-45.0,-46.0,-40.0,-45.0,-47.0,-47.0,-40.0,-47.0,-89.0,-91.0,-89.0,-91.0,44.0,45.0,49.0,46.0,1
1664,3C:55:76:E8:8F:1F,3920501,682160760,78863,197649896,3841638,484510864,38,37212,7550875,36707,7464764,505,86111,15672,39,78921,7864,38,535,286760.0,172050.0,-45.0,-54.0,-49.0,-41.0,-47.0,-51.0,-46.0,-42.0,-89.0,-91.0,-89.0,-91.0,44.0,37.0,40.0,50.0,1
1665,92:69:1D:31:68:E9,3845629,488151262,3991,3640398,3841638,484510864,0,5110,1132980,4952,1097182,158,35798,2166,12,4225,93,0,55,229410.0,137640.0,-54.0,-48.0,-42.0,-48.0,-52.0,-47.0,-43.0,-47.0,-89.0,-91.0,-89.0,-91.0,35.0,43.0,47.0,43.0,1
1666,CC:2F:71:3F:1F:24,4844904,1608816872,1003266,1124306008,3841638,484510864,364,827488,908186752,826706,908092242,782,94510,799517,15,1003201,105303,361,634,115556.0,28889.0,-69.0,-71.0,-67.0,-72.0,-69.0,-70.0,-67.0,-72.0,-89.0,-91.0,-89.0,-91.0,20.0,20.0,22.0,19.0,1
1667,CC:2F:71:3E:C5:1F,3842577,484625659,939,114795,3841638,484510864,0,3916,329121,3231,247761,685,81360,995,11,1349,25,0,52,130000.0,39000.0,-68.0,-68.0,-64.0,-60.0,-71.0,-72.0,-69.0,-61.0,-89.0,-91.0,-89.0,-91.0,21.0,23.0,25.0,31.0,1
1668,BA:8C:B9:54:50:24,3846524,490699236,4886,6188372,3841638,484510864,0,9349,1723996,9327,1720501,22,3495,2354,17,5360,41,0,65,216660.0,130000.0,-48.0,-35.0,-43.0,-45.0,-47.0,-35.0,-43.0,-46.0,-89.0,-91.0,-89.0,-91.0,41.0,56.0,46.0,46.0,1
1669,62:47:05:9D:EB:15,3843767,486935124,2123,2423488,3841644,484511636,0,4303,3011277,4272,3006296,31,4981,2056,0,2172,56,0,105,229410.0,130000.0,-45.0,-46.0,-40.0,-45.0,-47.0,-47.0,-40.0,-47.0,-88.0,-90.0,-88.0,-90.0,43.0,44.0,48.0,45.0,1
1670,3C:55:76:E8:8F:1F,3920507,682161532,78863,197649896,3841644,484511636,38,37221,7551489,36716,7465378,505,86111,15672,39,78921,7864,38,535,286760.0,172050.0,-46.0,-53.0,-48.0,-41.0,-45.0,-54.0,-49.0,-41.0,-88.0,-90.0,-88.0,-90.0,42.0,37.0,40.0,49.0,1
1671,92:69:1D:31:68:E9,3845635,488152034,3991,3640398,3841644,484511636,0,5110,1132980,4952,1097182,158,35798,2166,12,4225,93,0,55,229410.0,137640.0,-54.0,-48.0,-42.0,-48.0,-52.0,-47.0,-43.0,-47.0,-88.0,-90.0,-88.0,-90.0,34.0,42.0,46.0,42.0,1
1672,CC:2F:71:3F:1F:24,4845121,1609081016,1003475,1124569178,3841646,484511838,364,827678,908437446,826896,908342936,782,94510,799700,15,1003410,105308,361,634,115556.0,28889.0,-70.0,-71.0,-67.0,-72.0,-69.0,-70.0,-66.0,-71.0,-88.0,-90.0,-88.0,-90.0,18.0,19.0,21.0,18.0,1
1673,CC:2F:71:3E:C5:1F,3842587,484626835,939,114795,3841648,484512040,0,3916,329121,3231,247761,685,81360,995,11,1349,25,0,52,130000.0,39000.0,-68.0,-68.0,-64.0,-60.0,-71.0,-72.0,-69.0,-61.0,-88.0,-90.0,-88.0,-90.0,20.0,22.0,24.0,30.0,1
1674,BA:8C:B9:54:50:24,3846534,490700412,4886,6188372,3841648,484512040,0,9349,1723996,9327,1720501,22,3495,2354,17,5360,41,0,65,216660.0,130000.0,-48.0,-35.0,-43.0,-45.0,-47.0,-35.0,-43.0,-46.0,-88.0,-90.0,-88.0,-90.0,40.0,55.0,45.0,45.0,1
1675,62:47:05:9D:EB:15,3843771,486935528,2123,2423488,3841648,484512040,0,4303,3011277,4272,3006296,31,4981,2056,0,2172,56,0,105,229410.0,130000.0,-45.0,-46.0,-40.0,-45.0,-47.0,-47.0,-40.0,-47.0,-88.0,-90.0,-88.0,-90.0,43.0,44.0,48.0,45.0,1
1676,3C:55:76:E8:8F:1F,3920513,682162176,78865,197650136,3841648,484512040,38,37226,7551961,36721,7465850,505,86111,15674,39,78923,7864,38,535,286760.0,172050.0,-46.0,-50.0,-44.0,-41.0,-45.0,-52.0,-48.0,-40.0,-88.0,-90.0,-88.0,-90.0,42.0,40.0,44.0,49.0,1
1677,92:69:1D:31:68:E9,3845639,488152438,3991,3640398,3841648,484512040,0,5110,1132980,4952,1097182,158,35798,2166,12,4225,93,0,55,229410.0,137640.0,-54.0,-48.0,-42.0,-48.0,-52.0,-47.0,-43.0,-47.0,-88.0,-90.0,-88.0,-90.0,34.0,42.0,46.0,42.0,1
1678,CC:2F:71:3F:1F:24,4845332,1609342852,1003684,1124830812,3841648,484512040,364,827868,908690832,827086,908596322,782,94510,799883,15,1003618,105314,361,634,104000.0,26000.0,-69.0,-70.0,-66.0,-72.0,-69.0,-70.0,-67.0,-72.0,-88.0,-90.0,-88.0,-90.0,19.0,20.0,22.0,18.0,1
1679,CC:2F:71:3E:C5:1F,3842588,484626895,939,114795,3841649,484512100,0,3916,329121,3231,247761,685,81360,995,11,1349,25,0,52,130000.0,39000.0,-68.0,-68.0,-64.0,-60.0,-71.0,-72.0,-69.0,-61.0,-88.0,-90.0,-88.0,-90.0,20.0,22.0,24.0,30.0,1
1680,BA:8C:B9:54:50:24,3846535,490700472,4886,6188372,3841649,484512100,0,9349,1723996,9327,1720501,22,3495,2354,17,5360,41,0,65,216660.0,130000.0,-48.0,-35.0,-43.0,-45.0,-47.0,-35.0,-43.0,-46.0,-88.0,-90.0,-88.0,-90.0,40.0,55.0,45.0,45.0,1
1681,62:47:05:9D:EB:15,3843779,486936256,2123,2423488,3841656,484512768,0,4303,3011277,4272,3006296,31,4981,2056,0,2172,56,0,105,229410.0,130000.0,-45.0,-46.0,-40.0,-45.0,-47.0,-47.0,-40.0,-47.0,-88.0,-90.0,-88.0,-90.0,43.0,44.0,48.0,45.0,1
1682,3C:55:76:E8:8F:1F,3920525,682163404,78867,197650434,3841658,484512970,38,37252,7553909,36746,7467680,506,86229,15677,39,78925,7864,38,535,286760.0,172050.0,-45.0,-55.0,-50.0,-41.0,-45.0,-55.0,-50.0,-41.0,-88.0,-90.0,-88.0,-90.0,43.0,35.0,38.0,49.0,1
1683,92:69:1D:31:68:E9,3845649,488153368,3991,3640398,3841658,484512970,0,5110,1132980,4952,1097182,158,35798,2166,12,4225,93,0,55,229410.0,137640.0,-54.0,-48.0,-42.0,-48.0,-52.0,-47.0,-43.0,-47.0,-88.0,-90.0,-88.0,-90.0,34.0,42.0,46.0,42.0,1
1684,CC:2F:71:3F:1F:24,4845569,1609627311,1003911,1125114341,3841658,484512970,364,828091,908970341,827309,908875831,782,94510,800090,15,1003846,105317,361,635,115556.0,28889.0,-73.0,-74.0,-71.0,-76.0,-72.0,-73.0,-69.0,-74.0,-88.0,-90.0,-88.0,-90.0,15.0,16.0,17.0,14.0,1
1685,CC:2F:71:3E:C5:1F,3842597,484627765,939,114795,3841658,484512970,0,3916,329121,3231,247761,685,81360,995,11,1349,25,0,52,130000.0,39000.0,-68.0,-68.0,-64.0,-60.0,-71.0,-72.0,-69.0,-61.0,-88.0,-90.0,-88.0,-90.0,20.0,22.0,24.0,30.0,1
1686,BA:8C:B9:54:50:24,3846544,490701342,4886,6188372,3841658,484512970,0,9349,1723996,9327,1720501,22,3495,2354,17,5360,41,0,65,216660.0,130000.0,-48.0,-35.0,-43.0,-45.0,-47.0,-35.0,-43.0,-46.0,-88.0,-90.0,-88.0,-90.0,40.0,55.0,45.0,45.0,1
1687,62:47:05:9D:EB:15,3843781,486936458,2123,2423488,3841658,484512970,0,4303,3011277,4272,3006296,31,4981,2056,0,2172,56,0,105,229410.0,130000.0,-45.0,-46.0,-40.0,-45.0,-47.0,-47.0,-40.0,-47.0,-88.0,-90.0,-88.0,-90.0,43.0,44.0,48.0,45.0,1
1688,3C:55:76:E8:8F:1F,3920527,682163855,78869,197650885,3841658,484512970,38,37264,7555030,36758,7468801,506,86229,15679,39,78927,7864,38,535,286760.0,172050.0,-45.0,-56.0,-50.0,-41.0,-46.0,-55.0,-49.0,-41.0,-88.0,-90.0,-88.0,-90.0,43.0,34.0,38.0,49.0,1
1689,92:69:1D:31:68:E9,3845649,488153368,3991,3640398,3841658,484512970,0,5110,1132980,4952,1097182,158,35798,2166,12,4225,93,0,55,229410.0,137640.0,-54.0,-48.0,-42.0,-48.0,-52.0,-47.0,-43.0,-47.0,-88.0,-90.0,-88.0,-90.0,34.0,42.0,46.0,42.0,1
1690,CC:2F:71:3F:1F:24,4845780,1609893589,1004122,1125380619,3841658,484512970,364,828285,909227127,827503,909132617,782,94510,800278,15,1004057,105327,361,635,115556.0,28889.0,-73.0,-74.0,-70.0,-75.0,-72.0,-73.0,-69.0,-74.0,-88.0,-90.0,-88.0,-90.0,15.0,16.0,18.0,15.0,1
1691,CC:2F:71:3E:C5:1F,3842601,484628169,939,114795,3841662,484513374,0,3916,329121,3231,247761,685,81360,995,11,1349,25,0,52,130000.0,39000.0,-68.0,-68.0,-64.0,-60.0,-71.0,-72.0,-69.0,-61.0,-88.0,-90.0,-88.0,-90.0,20.0,22.0,24.0,30.0,1
1692,BA:8C:B9:54:50:24,3846548,490701746,4886,6188372,3841662,484513374,0,9349,1723996,9327,1720501,22,3495,2354,17,5360,41,0,65,216660.0,130000.0,-48.0,-35.0,-43.0,-45.0,-47.0,-35.0,-43.0,-46.0,-88.0,-90.0,-88.0,-90.0,40.0,55.0,45.0,45.0,1
1693,62:47:05:9D:EB:15,3843790,486937326,2123,2423488,3841667,484513838,0,4303,3011277,4272,3006296,31,4981,2056,0,2172,56,0,105,229410.0,130000.0,-45.0,-46.0,-40.0,-45.0,-47.0,-47.0,-40.0,-47.0,-88.0,-90.0,-88.0,-90.0,43.0,44.0,48.0,45.0,1
1694,3C:55:76:E8:8F:1F,3920537,682164875,78870,197651037,3841667,484513838,38,37271,7555631,36765,7469402,506,86229,15681,39,78928,7864,38,535,286760.0,172050.0,-51.0,-53.0,-45.0,-44.0,-49.0,-53.0,-47.0,-43.0,-88.0,-90.0,-88.0,-90.0,37.0,37.0,43.0,46.0,1
1695,92:69:1D:31:68:E9,3845658,488154236,3991,3640398,3841667,484513838,0,5110,1132980,4952,1097182,158,35798,2166,12,4225,93,0,55,229410.0,137640.0,-54.0,-48.0,-42.0,-48.0,-52.0,-47.0,-43.0,-47.0,-88.0,-90.0,-88.0,-90.0,34.0,42.0,46.0,42.0,1
1696,CC:2F:71:3F:1F:24,4846003,1610160901,1004336,1125647063,3841667,484513838,364,828478,909485051,827696,909390541,782,94510,800465,15,1004271,105354,361,635,115556.0,28889.0,-68.0,-70.0,-66.0,-71.0,-70.0,-71.0,-67.0,-71.0,-88.0,-90.0,-88.0,-90.0,20.0,20.0,22.0,19.0,1
1697,CC:2F:71:3E:C5:1F,3842606,484628633,939,114795,3841667,484513838,0,3916,329121,3231,247761,685,81360,995,11,1349,25,0,52,130000.0,39000.0,-68.0,-68.0,-64.0,-60.0,-71.0,-72.0,-69.0,-61.0,-88.0,-90.0,-88.0,-90.0,20.0,22.0,24.0,30.0,1
1698,BA:8C:B9:54:50:24,3846553,490702210,4886,6188372,3841667,484513838,0,9349,1723996,9327,1720501,22,3495,2354,17,5360,41,0,65,216660.0,130000.0,-48.0,-35.0,-43.0,-45.0,-47.0,-35.0,-43.0,-46.0,-88.0,-90.0,-88.0,-90.0,40.0,55.0,45.0,45.0,1
1699,62:47:05:9D:EB:15,3843794,486937730,2123,2423488,3841671,484514242,0,4303,3011277,4272,3006296,31,4981,2056,0,2172,56,0,105,229410.0,130000.0,-45.0,-46.0,-40.0,-45.0,-47.0,-47.0,-40.0,-47.0,-88.0,-89.0,-87.0,-89.0,43.0,43.0,47.0,44.0,1
1700,3C:55:76:E8:8F:1F,3920541,682165279,78870,197651037,3841671,484514242,38,37278,7556109,36772,7469880,506,86229,15681,39,78928,7864,38,535,286760.0,172050.0,-51.0,-53.0,-45.0,-44.0,-51.0,-52.0,-45.0,-44.0,-88.0,-89.0,-87.0,-89.0,37.0,36.0,42.0,45.0,1
1701,92:69:1D:31:68:E9,3845662,488154640,3991,3640398,3841671,484514242,0,5112,1133116,4954,1097318,158,35798,2166,12,4226,93,0,55,229410.0,137640.0,-54.0,-47.0,-42.0,-48.0,-52.0,-47.0,-43.0,-47.0,-88.0,-89.0,-87.0,-89.0,34.0,42.0,45.0,41.0,1
1702,CC:2F:71:3F:1F:24,4846221,1610424840,1004550,1125910598,3841671,484514242,364,828678,909740162,827896,909645652,782,94510,800655,15,1004485,105361,361,635,115556.0,28889.0,-69.0,-70.0,-66.0,-70.0,-68.0,-69.0,-65.0,-70.0,-88.0,-89.0,-87.0,-89.0,19.0,19.0,21.0,19.0,1
1703,CC:2F:71:3E:C5:1F,3842610,484629037,939,114795,3841671,484514242,0,3918,329261,3233,247901,685,81360,995,11,1350,25,0,52,130000.0,39000.0,-80.0,-81.0,-75.0,-71.0,-72.0,-73.0,-70.0,-62.0,-88.0,-89.0,-87.0,-89.0,8.0,8.0,12.0,18.0,1
1704,BA:8C:B9:54:50:24,3846557,490702614,4886,6188372,3841671,484514242,0,9351,1724132,9329,1720637,22,3495,2354,17,5361,41,0,65,216660.0,130000.0,-51.0,-34.0,-43.0,-44.0,-47.0,-35.0,-43.0,-46.0,-88.0,-89.0,-87.0,-89.0,37.0,55.0,44.0,45.0,1
1705,62:47:05:9D:EB:15,3843800,486938256,2123,2423488,3841677,484514768,0,4306,3011481,4275,3006500,31,4981,2056,0,2173,56,0,105,229410.0,130000.0,-46.0,-46.0,-40.0,-45.0,-46.0,-46.0,-40.0,-45.0,-88.0,-89.0,-87.0,-89.0,42.0,43.0,47.0,44.0,1
1706,3C:55:76:E8:8F:1F,3920549,682166009,78872,197651241,3841677,484514768,38,37291,7557149,36785,7470920,506,86229,15683,39,78930,7867,38,535,286760.0,1000.0,-45.0,-55.0,-50.0,-42.0,-45.0,-54.0,-50.0,-41.0,-88.0,-89.0,-87.0,-89.0,43.0,34.0,37.0,47.0,1
1707,92:69:1D:31:68:E9,3845668,488155166,3991,3640398,3841677,484514768,0,5112,1133116,4954,1097318,158,35798,2166,12,4226,93,0,55,229410.0,137640.0,-54.0,-47.0,-42.0,-48.0,-52.0,-47.0,-43.0,-47.0,-88.0,-89.0,-87.0,-89.0,34.0,42.0,45.0,41.0,1
1708,CC:2F:71:3F:1F:24,4846440,1610691680,1004763,1126176912,3841677,484514768,364,828868,909989346,828086,909894836,782,94510,800841,15,1004697,105378,361,636,115556.0,28889.0,-68.0,-69.0,-66.0,-70.0,-68.0,-69.0,-65.0,-70.0,-88.0,-89.0,-87.0,-89.0,20.0,20.0,21.0,19.0,1
1709,CC:2F:71:3E:C5:1F,3842616,484629563,939,114795,3841677,484514768,0,3918,329261,3233,247901,685,81360,995,11,1350,25,0,52,130000.0,39000.0,-80.0,-81.0,-75.0,-71.0,-72.0,-73.0,-70.0,-62.0,-88.0,-89.0,-87.0,-89.0,8.0,8.0,12.0,18.0,1
1710,BA:8C:B9:54:50:24,3846563,490703140,4886,6188372,3841677,484514768,0,9351,1724132,9329,1720637,22,3495,2354,17,5361,41,0,65,216660.0,130000.0,-51.0,-34.0,-43.0,-44.0,-47.0,-35.0,-43.0,-46.0,-88.0,-89.0,-87.0,-89.0,37.0,55.0,44.0,45.0,1
1711,62:47:05:9D:EB:15,3843804,486938660,2123,2423488,3841681,484515172,0,4306,3011481,4275,3006500,31,4981,2056,0,2173,56,0,105,229410.0,130000.0,-46.0,-46.0,-40.0,-45.0,-46.0,-46.0,-40.0,-45.0,-88.0,-89.0,-86.0,-88.0,42.0,43.0,46.0,43.0,1
1712,3C:55:76:E8:8F:1F,3920554,682166543,78873,197651371,3841681,484515172,38,37302,7557938,36796,7471709,506,86229,15684,39,78931,7867,38,535,270830.0,1000.0,-45.0,-55.0,-50.0,-41.0,-45.0,-53.0,-48.0,-40.0,-88.0,-89.0,-86.0,-88.0,43.0,34.0,36.0,47.0,1
1713,92:69:1D:31:68:E9,3845672,488155570,3991,3640398,3841681,484515172,0,5112,1133116,4954,1097318,158,35798,2166,12,4226,93,0,55,229410.0,137640.0,-54.0,-47.0,-42.0,-48.0,-52.0,-47.0,-43.0,-47.0,-88.0,-89.0,-86.0,-88.0,34.0,42.0,44.0,40.0,1
1714,CC:2F:71:3F:1F:24,4846656,1610961340,1004975,1126446168,3841681,484515172,364,829071,910257144,828289,910162634,782,94510,801035,15,1004910,105389,361,636,115556.0,28889.0,-69.0,-70.0,-65.0,-70.0,-69.0,-69.0,-65.0,-70.0,-88.0,-89.0,-86.0,-88.0,19.0,19.0,21.0,18.0,1
1715,CC:2F:71:3E:C5:1F,3842624,484630371,939,114795,3841685,484515576,0,3918,329261,3233,247901,685,81360,995,11,1350,25,0,52,130000.0,39000.0,-80.0,-81.0,-75.0,-71.0,-72.0,-73.0,-70.0,-62.0,-88.0,-89.0,-86.0,-88.0,8.0,8.0,11.0,17.0,1
1716,BA:8C:B9:54:50:24,3846571,490703948,4886,6188372,3841685,484515576,0,9351,1724132,9329,1720637,22,3495,2354,17,5361,41,0,65,216660.0,130000.0,-51.0,-34.0,-43.0,-44.0,-47.0,-35.0,-43.0,-46.0,-88.0,-89.0,-86.0,-88.0,37.0,55.0,43.0,44.0,1
1717,62:47:05:9D:EB:15,3843808,486939064,2123,2423488,3841685,484515576,0,4306,3011481,4275,3006500,31,4981,2056,0,2173,56,0,105,229410.0,130000.0,-46.0,-46.0,-40.0,-45.0,-46.0,-46.0,-40.0,-45.0,-87.0,-88.0,-85.0,-88.0,41.0,42.0,45.0,43.0,1
1718,3C:55:76:E8:8F:1F,3920559,682167007,78873,197651371,3841686,484515636,38,37303,7558008,36797,7471779,506,86229,15684,39,78931,7867,38,535,270830.0,1000.0,-46.0,-55.0,-50.0,-41.0,-44.0,-54.0,-49.0,-40.0,-87.0,-88.0,-85.0,-88.0,41.0,33.0,35.0,47.0,1
1719,92:69:1D:31:68:E9,3845677,488156034,3991,3640398,3841686,484515636,0,5112,1133116,4954,1097318,158,35798,2166,12,4226,93,0,55,229410.0,137640.0,-54.0,-47.0,-42.0,-48.0,-52.0,-47.0,-43.0,-47.0,-87.0,-88.0,-85.0,-88.0,33.0,41.0,43.0,40.0,1
1720,CC:2F:71:3F:1F:24,4846876,1611233850,1005190,1126718214,3841686,484515636,364,829263,910512230,828481,910417720,782,94510,801227,15,1005125,105422,361,636,104000.0,26000.0,-69.0,-70.0,-66.0,-71.0,-69.0,-69.0,-65.0,-70.0,-87.0,-88.0,-85.0,-88.0,18.0,18.0,19.0,17.0,1
1721,CC:2F:71:3E:C5:1F,3842625,484630431,939,114795,3841686,484515636,0,3918,329261,3233,247901,685,81360,995,11,1350,25,0,52,130000.0,39000.0,-80.0,-81.0,-75.0,-71.0,-72.0,-73.0,-70.0,-62.0,-87.0,-88.0,-85.0,-88.0,7.0,7.0,10.0,17.0,1
1722,BA:8C:B9:54:50:24,3846572,490704008,4886,6188372,3841686,484515636,0,9352,1724200,9330,1720705,22,3495,2354,17,5361,41,0,65,216660.0,130000.0,-39.0,-36.0,-45.0,-52.0,-46.0,-35.0,-43.0,-47.0,-87.0,-88.0,-85.0,-88.0,48.0,52.0,40.0,36.0,1
1723,62:47:05:9D:EB:15,3843816,486940003,2123,2423488,3841693,484516515,0,4306,3011481,4275,3006500,31,4981,2056,0,2173,56,0,105,229410.0,130000.0,-46.0,-46.0,-40.0,-45.0,-46.0,-46.0,-40.0,-45.0,-87.0,-88.0,-85.0,-88.0,41.0,42.0,45.0,43.0,1
1724,3C:55:76:E8:8F:1F,3920568,682168088,78873,197651371,3841695,484516717,38,37304,7558076,36798,7471847,506,86229,15684,39,78931,7867,38,535,270830.0,1000.0,-47.0,-50.0,-43.0,-41.0,-45.0,-53.0,-48.0,-40.0,-87.0,-88.0,-85.0,-88.0,40.0,38.0,42.0,47.0,1
1725,92:69:1D:31:68:E9,3845686,488157115,3991,3640398,3841695,484516717,0,5112,1133116,4954,1097318,158,35798,2166,12,4226,93,0,55,229410.0,137640.0,-54.0,-47.0,-42.0,-48.0,-52.0,-47.0,-43.0,-47.0,-87.0,-87.0,-85.0,-87.0,33.0,40.0,43.0,39.0,1
1726,CC:2F:71:3F:1F:24,4847559,1612065405,1005864,1127548688,3841695,484516717,364,829663,910796469,828881,910701959,782,94510,801623,15,1005799,105483,361,637,115556.0,28889.0,-69.0,-70.0,-65.0,-71.0,-68.0,-69.0,-65.0,-70.0,-87.0,-87.0,-85.0,-87.0,18.0,17.0,20.0,16.0,1
1727,CC:2F:71:3E:C5:1F,3842634,484631512,939,114795,3841695,484516717,0,3918,329261,3233,247901,685,81360,995,11,1350,25,0,52,130000.0,39000.0,-80.0,-81.0,-75.0,-71.0,-72.0,-73.0,-70.0,-62.0,-87.0,-87.0,-85.0,-87.0,7.0,6.0,10.0,16.0,1
1728,BA:8C:B9:54:50:24,3846581,490705089,4886,6188372,3841695,484516717,0,9352,1724200,9330,1720705,22,3495,2354,17,5361,41,0,65,216660.0,130000.0,-39.0,-36.0,-45.0,-52.0,-46.0,-35.0,-43.0,-47.0,-87.0,-87.0,-85.0,-87.0,48.0,51.0,40.0,35.0,1
1729,62:47:05:9D:EB:15,3843818,486940205,2123,2423488,3841695,484516717,0,4306,3011481,4275,3006500,31,4981,2056,0,2173,56,0,105,229410.0,130000.0,-46.0,-46.0,-40.0,-45.0,-46.0,-46.0,-40.0,-45.0,-87.0,-87.0,-85.0,-87.0,41.0,41.0,45.0,42.0,1
1730,3C:55:76:E8:8F:1F,3920568,682168088,78873,197651371,3841695,484516717,38,37304,7558076,36798,7471847,506,86229,15684,39,78931,7867,38,535,270830.0,1000.0,-47.0,-50.0,-43.0,-41.0,-45.0,-53.0,-48.0,-40.0,-87.0,-87.0,-85.0,-87.0,40.0,37.0,42.0,46.0,1
1731,92:69:1D:31:68:E9,3845686,488157115,3991,3640398,3841695,484516717,0,5112,1133116,4954,1097318,158,35798,2166,12,4226,93,0,55,229410.0,137640.0,-54.0,-47.0,-42.0,-48.0,-52.0,-47.0,-43.0,-47.0,-87.0,-87.0,-85.0,-87.0,33.0,40.0,43.0,39.0,1
1732,CC:2F:71:3F:1F:24,4847981,1612580187,1006282,1128063066,3841699,484517121,364,829952,911063989,829170,910969479,782,94510,801905,15,1006217,105562,361,637,115556.0,28889.0,-69.0,-70.0,-66.0,-70.0,-68.0,-70.0,-66.0,-70.0,-87.0,-87.0,-85.0,-87.0,18.0,17.0,19.0,17.0,1
1733,CC:2F:71:3E:C5:1F,3842638,484631916,939,114795,3841699,484517121,0,3918,329261,3233,247901,685,81360,995,11,1350,25,0,52,130000.0,39000.0,-80.0,-81.0,-75.0,-71.0,-72.0,-73.0,-70.0,-62.0,-86.0,-87.0,-84.0,-86.0,6.0,6.0,9.0,15.0,1
1734,BA:8C:B9:54:50:24,3846585,490705493,4886,6188372,3841699,484517121,0,9352,1724200,9330,1720705,22,3495,2354,17,5361,41,0,65,216660.0,130000.0,-39.0,-36.0,-45.0,-52.0,-46.0,-35.0,-43.0,-47.0,-86.0,-87.0,-84.0,-86.0,47.0,51.0,39.0,34.0,1
1735,62:47:05:9D:EB:15,3843827,486941073,2123,2423488,3841704,484517585,0,4306,3011481,4275,3006500,31,4981,2056,0,2173,56,0,105,229410.0,130000.0,-46.0,-46.0,-40.0,-45.0,-46.0,-46.0,-40.0,-45.0,-86.0,-87.0,-84.0,-86.0,40.0,41.0,44.0,41.0,1
1736,3C:55:76:E8:8F:1F,3920577,682168956,78873,197651371,3841704,484517585,38,37305,7558144,36799,7471915,506,86229,15684,39,78931,7867,38,535,270830.0,1000.0,-43.0,-52.0,-51.0,-37.0,-45.0,-53.0,-49.0,-40.0,-86.0,-87.0,-84.0,-86.0,43.0,35.0,33.0,49.0,1
1737,92:69:1D:31:68:E9,3845695,488157983,3991,3640398,3841704,484517585,0,5112,1133116,4954,1097318,158,35798,2166,12,4226,93,0,55,229410.0,137640.0,-54.0,-47.0,-42.0,-48.0,-52.0,-47.0,-43.0,-47.0,-86.0,-87.0,-84.0,-86.0,32.0,40.0,42.0,38.0,1
1738,CC:2F:71:3F:1F:24,4848198,1612845635,1006494,1128328050,3841704,484517585,364,830147,911322081,829365,911227571,782,94510,802090,15,1006429,105568,361,637,115556.0,28889.0,-68.0,-70.0,-65.0,-70.0,-68.0,-70.0,-65.0,-69.0,-86.0,-87.0,-84.0,-86.0,18.0,17.0,19.0,16.0,1
1739,CC:2F:71:3E:C5:1F,3842643,484632380,939,114795,3841704,484517585,0,3918,329261,3233,247901,685,81360,995,11,1350,25,0,52,130000.0,39000.0,-80.0,-81.0,-75.0,-71.0,-72.0,-73.0,-70.0,-62.0,-86.0,-87.0,-84.0,-86.0,6.0,6.0,9.0,15.0,1
1740,BA:8C:B9:54:50:24,3846590,490705957,4886,6188372,3841704,484517585,0,9352,1724200,9330,1720705,22,3495,2354,17,5361,41,0,65,216660.0,130000.0,-39.0,-36.0,-45.0,-52.0,-46.0,-35.0,-43.0,-47.0,-86.0,-87.0,-84.0,-86.0,47.0,51.0,39.0,34.0,1
1741,62:47:05:9D:EB:15,3843831,486941477,2123,2423488,3841708,484517989,0,4306,3011481,4275,3006500,31,4981,2056,0,2173,56,0,105,229410.0,130000.0,-46.0,-46.0,-40.0,-45.0,-46.0,-46.0,-40.0,-45.0,-86.0,-86.0,-84.0,-86.0,40.0,40.0,44.0,41.0,1
1742,3C:55:76:E8:8F:1F,3920624,682281672,78916,197763683,3841708,484517989,38,37311,7561457,36805,7475228,506,86229,15686,39,78931,7867,38,535,270830.0,1000.0,-42.0,-48.0,-51.0,-37.0,-44.0,-50.0,-49.0,-39.0,-86.0,-86.0,-84.0,-86.0,44.0,38.0,33.0,49.0,1
1743,92:69:1D:31:68:E9,3845699,488158387,3991,3640398,3841708,484517989,0,5112,1133116,4954,1097318,158,35798,2166,12,4226,93,0,55,229410.0,137640.0,-54.0,-47.0,-42.0,-48.0,-52.0,-47.0,-43.0,-47.0,-86.0,-86.0,-84.0,-86.0,32.0,39.0,42.0,38.0,1
1744,CC:2F:71:3F:1F:24,4848435,1613141697,1006727,1128623708,3841708,484517989,364,830365,911614217,829583,911519707,782,94510,802302,15,1006662,105580,361,637,130000.0,43333.0,-69.0,-71.0,-66.0,-70.0,-68.0,-70.0,-65.0,-70.0,-86.0,-86.0,-84.0,-86.0,17.0,15.0,18.0,16.0,1
1745,CC:2F:71:3E:C5:1F,3842649,484632986,939,114795,3841710,484518191,0,3918,329261,3233,247901,685,81360,995,11,1350,25,0,52,130000.0,39000.0,-80.0,-81.0,-75.0,-71.0,-72.0,-73.0,-70.0,-62.0,-86.0,-86.0,-84.0,-86.0,6.0,5.0,9.0,15.0,1
1746,BA:8C:B9:54:50:24,3846599,490706825,4886,6188372,3841713,484518453,0,9352,1724200,9330,1720705,22,3495,2354,17,5361,41,0,65,216660.0,130000.0,-39.0,-36.0,-45.0,-52.0,-46.0,-35.0,-43.0,-47.0,-86.0,-86.0,-83.0,-85.0,47.0,50.0,38.0,33.0,1
1747,62:47:05:9D:EB:15,3843836,486941941,2123,2423488,3841713,484518453,0,4306,3011481,4275,3006500,31,4981,2056,0,2173,56,0,105,229410.0,130000.0,-46.0,-46.0,-40.0,-45.0,-46.0,-46.0,-40.0,-45.0,-86.0,-86.0,-83.0,-85.0,40.0,40.0,43.0,40.0,1
1748,3C:55:76:E8:8F:1F,3922021,685907358,80308,201388905,3841713,484518453,38,37644,7618840,37138,7532611,506,86229,15838,42,80369,8264,38,547,146250.0,1000.0,-45.0,-51.0,-49.0,-39.0,-47.0,-51.0,-47.0,-41.0,-86.0,-86.0,-83.0,-85.0,41.0,35.0,34.0,46.0,1
1749,92:69:1D:31:68:E9,3845704,488158851,3991,3640398,3841713,484518453,0,5112,1133116,4954,1097318,158,35798,2166,12,4226,93,0,55,229410.0,137640.0,-54.0,-47.0,-42.0,-48.0,-52.0,-47.0,-43.0,-47.0,-86.0,-86.0,-83.0,-85.0,32.0,39.0,41.0,37.0,1
1750,CC:2F:71:3F:1F:24,4848709,1613486548,1006994,1128967893,3841715,484518655,364,830616,911949387,829834,911854877,782,94510,802543,15,1006929,105602,361,637,130000.0,43333.0,-69.0,-70.0,-66.0,-71.0,-69.0,-70.0,-66.0,-70.0,-86.0,-86.0,-83.0,-85.0,17.0,16.0,17.0,14.0,1
1751,CC:2F:71:3E:C5:1F,3842656,484633652,939,114795,3841717,484518857,0,3918,329261,3233,247901,685,81360,995,11,1350,25,0,52,130000.0,39000.0,-80.0,-81.0,-75.0,-71.0,-72.0,-73.0,-70.0,-62.0,-86.0,-86.0,-83.0,-85.0,6.0,5.0,8.0,14.0,1
1752,BA:8C:B9:54:50:24,3846603,490707229,4886,6188372,3841717,484518857,0,9352,1724200,9330,1720705,22,3495,2354,17,5361,41,0,65,216660.0,130000.0,-39.0,-36.0,-45.0,-52.0,-46.0,-35.0,-43.0,-47.0,-86.0,-86.0,-83.0,-85.0,47.0,50.0,38.0,33.0,1
1753,62:47:05:9D:EB:15,3843844,486942749,2123,2423488,3841721,484519261,0,4306,3011481,4275,3006500,31,4981,2056,0,2173,56,0,105,229410.0,130000.0,-46.0,-46.0,-40.0,-45.0,-46.0,-46.0,-40.0,-45.0,-85.0,-85.0,-82.0,-84.0,39.0,39.0,42.0,39.0,1
1754,3C:55:76:E8:8F:1F,3922029,685908166,80308,201388905,3841721,484519261,38,37651,7619318,37145,7533089,506,86229,15838,42,80369,8264,38,547,146250.0,1000.0,-46.0,-50.0,-51.0,-39.0,-45.0,-50.0,-49.0,-39.0,-85.0,-85.0,-82.0,-84.0,39.0,35.0,31.0,45.0,1
1755,92:69:1D:31:68:E9,3845712,488159659,3991,3640398,3841721,484519261,0,5112,1133116,4954,1097318,158,35798,2166,12,4226,93,0,55,229410.0,137640.0,-54.0,-47.0,-42.0,-48.0,-52.0,-47.0,-43.0,-47.0,-85.0,-85.0,-82.0,-84.0,31.0,38.0,40.0,36.0,1
1756,CC:2F:71:3F:1F:24,4848924,1613750324,1007203,1129231063,3841721,484519261,364,830810,912206111,830028,912111601,782,94510,802729,15,1007138,105603,361,637,130000.0,43333.0,-69.0,-70.0,-67.0,-70.0,-68.0,-70.0,-66.0,-70.0,-85.0,-85.0,-82.0,-84.0,16.0,15.0,15.0,14.0,1
1757,CC:2F:71:3E:C5:1F,3842660,484634056,939,114795,3841721,484519261,0,3918,329261,3233,247901,685,81360,995,11,1350,25,0,52,130000.0,39000.0,-80.0,-81.0,-75.0,-71.0,-72.0,-73.0,-70.0,-62.0,-85.0,-85.0,-82.0,-84.0,5.0,4.0,7.0,13.0,1
1758,BA:8C:B9:54:50:24,3846607,490707633,4886,6188372,3841721,484519261,0,9352,1724200,9330,1720705,22,3495,2354,17,5361,41,0,65,216660.0,130000.0,-39.0,-36.0,-45.0,-52.0,-46.0,-35.0,-43.0,-47.0,-85.0,-85.0,-82.0,-84.0,46.0,49.0,37.0,32.0,1
1759,62:47:05:9D:EB:15,3843849,486943213,2123,2423488,3841726,484519725,0,4306,3011481,4275,3006500,31,4981,2056,0,2173,56,0,105,229410.0,130000.0,-46.0,-46.0,-40.0,-45.0,-46.0,-46.0,-40.0,-45.0,-85.0,-84.0,-82.0,-84.0,39.0,38.0,42.0,39.0,1
1760,3C:55:76:E8:8F:1F,3922034,685908630,80308,201388905,3841726,484519725,38,37651,7619318,37145,7533089,506,86229,15838,42,80369,8264,38,547,146250.0,1000.0,-46.0,-50.0,-51.0,-39.0,-45.0,-50.0,-49.0,-39.0,-85.0,-84.0,-82.0,-84.0,39.0,34.0,31.0,45.0,1
1761,92:69:1D:31:68:E9,3845717,488160123,3991,3640398,3841726,484519725,0,5112,1133116,4954,1097318,158,35798,2166,12,4226,93,0,55,229410.0,137640.0,-54.0,-47.0,-42.0,-48.0,-52.0,-47.0,-43.0,-47.0,-85.0,-84.0,-82.0,-84.0,31.0,37.0,40.0,36.0,1
1762,CC:2F:71:3F:1F:24,4849138,1614012296,1007412,1129492571,3841726,484519725,364,830999,912456447,830217,912361937,782,94510,802913,15,1007347,105621,361,637,130000.0,43333.0,-68.0,-71.0,-66.0,-71.0,-68.0,-70.0,-66.0,-70.0,-85.0,-84.0,-82.0,-84.0,17.0,13.0,16.0,13.0,1
1763,CC:2F:71:3E:C5:1F,3842665,484634520,939,114795,3841726,484519725,0,3918,329261,3233,247901,685,81360,995,11,1350,25,0,52,130000.0,39000.0,-80.0,-81.0,-75.0,-71.0,-72.0,-73.0,-70.0,-62.0,-85.0,-84.0,-82.0,-84.0,5.0,3.0,7.0,13.0,1
1764,BA:8C:B9:54:50:24,3846612,490708097,4886,6188372,3841726,484519725,0,9352,1724200,9330,1720705,22,3495,2354,17,5361,41,0,65,216660.0,130000.0,-39.0,-36.0,-45.0,-52.0,-46.0,-35.0,-43.0,-47.0,-85.0,-84.0,-82.0,-84.0,46.0,48.0,37.0,32.0,1
1765,62:47:05:9D:EB:15,3843853,486943617,2123,2423488,3841730,484520129,0,4306,3011481,4275,3006500,31,4981,2056,0,2173,56,0,105,229410.0,130000.0,-46.0,-46.0,-40.0,-45.0,-46.0,-46.0,-40.0,-45.0,-85.0,-84.0,-81.0,-83.0,39.0,38.0,41.0,38.0,1
1766,3C:55:76:E8:8F:1F,3922038,685909034,80308,201388905,3841730,484520129,38,37651,7619318,37145,7533089,506,86229,15838,42,80369,8264,38,547,146250.0,1000.0,-46.0,-50.0,-51.0,-39.0,-45.0,-50.0,-49.0,-39.0,-85.0,-84.0,-81.0,-83.0,39.0,34.0,30.0,44.0,1
1767,92:69:1D:31:68:E9,3845721,488160527,3991,3640398,3841730,484520129,0,5112,1133116,4954,1097318,158,35798,2166,12,4226,93,0,55,229410.0,137640.0,-54.0,-47.0,-42.0,-48.0,-52.0,-47.0,-43.0,-47.0,-85.0,-84.0,-81.0,-83.0,31.0,37.0,39.0,35.0,1
1768,CC:2F:71:3F:1F:24,4849357,1614276139,1007627,1129756010,3841730,484520129,364,831197,912709732,830415,912615222,782,94510,803104,15,1007562,105637,361,637,130000.0,43333.0,-68.0,-71.0,-66.0,-71.0,-68.0,-70.0,-66.0,-70.0,-85.0,-84.0,-81.0,-83.0,17.0,13.0,15.0,12.0,1
1769,CC:2F:71:3E:C5:1F,3842669,484634924,939,114795,3841730,484520129,0,3918,329261,3233,247901,685,81360,995,11,1350,25,0,52,130000.0,39000.0,-80.0,-81.0,-75.0,-71.0,-72.0,-73.0,-70.0,-62.0,-85.0,-84.0,-81.0,-83.0,5.0,3.0,6.0,12.0,1
1770,BA:8C:B9:54:50:24,3846616,490708501,4886,6188372,3841730,484520129,0,9352,1724200,9330,1720705,22,3495,2354,17,5361,41,0,65,216660.0,130000.0,-39.0,-36.0,-45.0,-52.0,-46.0,-35.0,-43.0,-47.0,-85.0,-84.0,-81.0,-83.0,46.0,48.0,36.0,31.0,1
1771,62:47:05:9D:EB:15,3843858,486944081,2123,2423488,3841735,484520593,0,4306,3011481,4275,3006500,31,4981,2056,0,2173,56,0,105,229410.0,130000.0,-46.0,-46.0,-40.0,-45.0,-46.0,-46.0,-40.0,-45.0,-85.0,-84.0,-81.0,-83.0,39.0,38.0,41.0,38.0,1
1772,3C:55:76:E8:8F:1F,3922043,685909498,80308,201388905,3841735,484520593,38,37652,7619386,37146,7533157,506,86229,15838,42,80369,8264,38,547,146250.0,1000.0,-43.0,-49.0,-49.0,-36.0,-44.0,-50.0,-49.0,-38.0,-85.0,-84.0,-81.0,-83.0,42.0,35.0,32.0,47.0,1
1773,92:69:1D:31:68:E9,3845726,488160991,3991,3640398,3841735,484520593,0,5112,1133116,4954,1097318,158,35798,2166,12,4226,93,0,55,229410.0,137640.0,-54.0,-47.0,-42.0,-48.0,-52.0,-47.0,-43.0,-47.0,-85.0,-84.0,-81.0,-83.0,31.0,37.0,39.0,35.0,1
1774,CC:2F:71:3F:1F:24,4849573,1614538609,1007838,1130018016,3841735,484520593,364,831389,912966116,830607,912871606,782,94510,803288,15,1007773,105638,361,637,130000.0,43333.0,-68.0,-71.0,-66.0,-71.0,-68.0,-70.0,-66.0,-70.0,-85.0,-84.0,-81.0,-83.0,17.0,13.0,15.0,12.0,1
1775,CC:2F:71:3E:C5:1F,3842674,484635388,939,114795,3841735,484520593,0,3918,329261,3233,247901,685,81360,995,11,1350,25,0,52,130000.0,39000.0,-80.0,-81.0,-75.0,-71.0,-72.0,-73.0,-70.0,-62.0,-85.0,-84.0,-81.0,-83.0,5.0,3.0,6.0,12.0,1
1776,BA:8C:B9:54:50:24,3846623,490709167,4886,6188372,3841737,484520795,0,9352,1724200,9330,1720705,22,3495,2354,17,5361,41,0,65,216660.0,130000.0,-39.0,-36.0,-45.0,-52.0,-46.0,-35.0,-43.0,-47.0,-85.0,-84.0,-81.0,-83.0,46.0,48.0,36.0,31.0,1
1777,62:47:05:9D:EB:15,3843862,486944485,2123,2423488,3841739,484520997,0,4306,3011481,4275,3006500,31,4981,2056,0,2173,56,0,105,229410.0,130000.0,-46.0,-46.0,-40.0,-45.0,-46.0,-46.0,-40.0,-45.0,-84.0,-83.0,-80.0,-82.0,38.0,37.0,40.0,37.0,1
1778,3C:55:76:E8:8F:1F,3922047,685909902,80308,201388905,3841739,484520997,38,37652,7619386,37146,7533157,506,86229,15838,42,80369,8264,38,547,146250.0,1000.0,-43.0,-49.0,-49.0,-36.0,-44.0,-50.0,-49.0,-38.0,-84.0,-83.0,-80.0,-82.0,41.0,34.0,31.0,46.0,1
1779,92:69:1D:31:68:E9,3845731,488161455,3992,3640458,3841739,484520997,0,5114,1133252,4956,1097454,158,35798,2166,12,4227,93,0,55,216660.0,130000.0,-52.0,-48.0,-42.0,-47.0,-52.0,-47.0,-43.0,-47.0,-84.0,-83.0,-80.0,-82.0,32.0,35.0,38.0,35.0,1
1780,CC:2F:71:3F:1F:24,4849786,1614799097,1008047,1130278100,3841739,484520997,364,831579,913218052,830797,913123542,782,94510,803473,15,1007982,105669,361,639,130000.0,43333.0,-68.0,-71.0,-66.0,-71.0,-68.0,-71.0,-66.0,-70.0,-84.0,-83.0,-80.0,-82.0,16.0,12.0,14.0,11.0,1
1781,CC:2F:71:3E:C5:1F,3842679,484635908,940,114911,3841739,484520997,0,3920,329401,3235,248041,685,81360,995,11,1351,25,0,52,130000.0,39000.0,-71.0,-71.0,-69.0,-60.0,-72.0,-73.0,-69.0,-62.0,-84.0,-83.0,-80.0,-82.0,13.0,12.0,11.0,22.0,1
1782,BA:8C:B9:54:50:24,3846626,490709485,4887,6188488,3841739,484520997,0,9357,1724540,9335,1721045,22,3495,2354,17,5362,41,0,65,216660.0,130000.0,-40.0,-36.0,-45.0,-52.0,-42.0,-35.0,-43.0,-47.0,-84.0,-83.0,-80.0,-82.0,44.0,47.0,35.0,30.0,1
1783,62:47:05:9D:EB:15,3843867,486945005,2124,2423604,3841743,484521401,0,4308,3011617,4277,3006636,31,4981,2056,0,2174,56,0,105,229410.0,130000.0,-45.0,-47.0,-40.0,-45.0,-45.0,-46.0,-40.0,-45.0,-84.0,-83.0,-80.0,-82.0,39.0,36.0,40.0,37.0,1
1784,3C:55:76:E8:8F:1F,3922055,685910630,80309,201388965,3841746,484521665,38,37666,7620394,37159,7534047,507,86347,15839,42,80370,8264,38,550,130000.0,1000.0,-43.0,-50.0,-50.0,-37.0,-45.0,-53.0,-49.0,-40.0,-84.0,-83.0,-80.0,-82.0,41.0,33.0,30.0,45.0,1
1785,92:69:1D:31:68:E9,3845738,488162123,3992,3640458,3841746,484521665,0,5114,1133252,4956,1097454,158,35798,2166,12,4227,93,0,55,216660.0,130000.0,-52.0,-48.0,-42.0,-47.0,-52.0,-47.0,-43.0,-47.0,-85.0,-84.0,-80.0,-82.0,33.0,36.0,38.0,35.0,1
1786,CC:2F:71:3F:1F:24,4850006,1615065953,1008259,1130544228,3841747,484521725,364,831773,913477686,830991,913383176,782,94510,803659,15,1008194,105731,361,639,115556.0,28889.0,-69.0,-70.0,-66.0,-71.0,-69.0,-69.0,-66.0,-70.0,-85.0,-84.0,-80.0,-82.0,16.0,14.0,14.0,11.0,1
1787,CC:2F:71:3E:C5:1F,3842689,484636838,940,114911,3841749,484521927,0,3920,329401,3235,248041,685,81360,995,11,1351,25,0,52,130000.0,39000.0,-71.0,-71.0,-69.0,-60.0,-72.0,-73.0,-69.0,-62.0,-85.0,-84.0,-80.0,-82.0,14.0,13.0,11.0,22.0,1
1788,BA:8C:B9:54:50:24,3846636,490710415,4887,6188488,3841749,484521927,0,9357,1724540,9335,1721045,22,3495,2354,17,5362,41,0,65,216660.0,130000.0,-40.0,-36.0,-45.0,-52.0,-42.0,-35.0,-43.0,-47.0,-85.0,-84.0,-80.0,-82.0,45.0,48.0,35.0,30.0,1
1789,62:47:05:9D:EB:15,3843875,486945866,2124,2423604,3841751,484522262,0,4308,3011617,4277,3006636,31,4981,2056,0,2174,56,0,105,229410.0,130000.0,-45.0,-47.0,-40.0,-45.0,-45.0,-46.0,-40.0,-45.0,-85.0,-84.0,-80.0,-82.0,40.0,37.0,40.0,37.0,1
1790,3C:55:76:E8:8F:1F,3922060,685911227,80309,201388965,3841751,484522262,38,37677,7621198,37169,7534733,508,86465,15840,42,80370,8264,38,550,130000.0,1000.0,-51.0,-54.0,-44.0,-44.0,-48.0,-52.0,-42.0,-40.0,-85.0,-84.0,-80.0,-82.0,34.0,30.0,36.0,38.0,1
1791,92:69:1D:31:68:E9,3845743,488162720,3992,3640458,3841751,484522262,0,5114,1133252,4956,1097454,158,35798,2166,12,4227,93,0,55,216660.0,130000.0,-52.0,-48.0,-42.0,-47.0,-52.0,-47.0,-43.0,-47.0,-85.0,-84.0,-80.0,-82.0,33.0,36.0,38.0,35.0,1
1792,CC:2F:71:3F:1F:24,4850229,1615335246,1008476,1130812782,3841753,484522464,364,831974,913735619,831192,913641109,782,94510,803855,15,1008411,105783,361,639,65000.0,13000.0,-69.0,-70.0,-66.0,-70.0,-69.0,-69.0,-66.0,-70.0,-85.0,-84.0,-80.0,-82.0,16.0,14.0,14.0,12.0,1
1793,CC:2F:71:3E:C5:1F,3842693,484637375,940,114911,3841753,484522464,0,3920,329401,3235,248041,685,81360,995,11,1351,25,0,52,130000.0,39000.0,-71.0,-71.0,-69.0,-60.0,-72.0,-73.0,-69.0,-62.0,-84.0,-83.0,-80.0,-81.0,13.0,12.0,11.0,21.0,1
1794,BA:8C:B9:54:50:24,3846642,490711154,4887,6188488,3841755,484522666,0,9357,1724540,9335,1721045,22,3495,2354,17,5362,41,0,65,216660.0,130000.0,-40.0,-36.0,-45.0,-52.0,-42.0,-35.0,-43.0,-47.0,-84.0,-83.0,-80.0,-81.0,44.0,47.0,35.0,29.0,1
1795,62:47:05:9D:EB:15,3843881,486946472,2124,2423604,3841757,484522868,0,4308,3011617,4277,3006636,31,4981,2056,0,2174,56,0,105,229410.0,130000.0,-45.0,-47.0,-40.0,-45.0,-45.0,-46.0,-40.0,-45.0,-84.0,-83.0,-80.0,-81.0,39.0,36.0,40.0,36.0,1
1796,3C:55:76:E8:8F:1F,3922068,685912035,80309,201388965,3841759,484523070,38,37677,7621198,37169,7534733,508,86465,15840,42,80370,8264,38,550,130000.0,1000.0,-51.0,-54.0,-44.0,-44.0,-48.0,-52.0,-42.0,-40.0,-84.0,-83.0,-80.0,-81.0,33.0,29.0,36.0,37.0,1
1797,92:69:1D:31:68:E9,3845751,488163528,3992,3640458,3841759,484523070,0,5114,1133252,4956,1097454,158,35798,2166,12,4227,93,0,55,216660.0,130000.0,-52.0,-48.0,-42.0,-47.0,-52.0,-47.0,-43.0,-47.0,-84.0,-83.0,-80.0,-81.0,32.0,35.0,38.0,34.0,1
1798,CC:2F:71:3F:1F:24,4850642,1615845764,1008883,1131322694,3841759,484523070,364,832261,913997660,831479,913903150,782,94510,804137,15,1008818,105784,361,639,86667.0,14444.0,-69.0,-69.0,-66.0,-71.0,-69.0,-69.0,-66.0,-70.0,-84.0,-83.0,-80.0,-81.0,15.0,14.0,14.0,10.0,1
1799,CC:2F:71:3E:C5:1F,3842699,484637981,940,114911,3841759,484523070,0,3920,329401,3235,248041,685,81360,995,11,1351,25,0,52,130000.0,39000.0,-71.0,-71.0,-69.0,-60.0,-72.0,-73.0,-69.0,-62.0,-84.0,-83.0,-80.0,-81.0,13.0,12.0,11.0,21.0,1
1800,BA:8C:B9:54:50:24,3846646,490711558,4887,6188488,3841759,484523070,0,9357,1724540,9335,1721045,22,3495,2354,17,5362,41,0,65,216660.0,130000.0,-40.0,-36.0,-45.0,-52.0,-42.0,-35.0,-43.0,-47.0,-84.0,-83.0,-80.0,-81.0,44.0,47.0,35.0,29.0,1
1801,62:47:05:9D:EB:15,3843886,486946936,2124,2423604,3841762,484523332,0,4308,3011617,4277,3006636,31,4981,2056,0,2174,56,0,105,229410.0,130000.0,-45.0,-47.0,-40.0,-45.0,-45.0,-46.0,-40.0,-45.0,-84.0,-82.0,-79.0,-81.0,39.0,35.0,39.0,36.0,1
1802,3C:55:76:E8:8F:1F,3922078,685915152,80314,201391618,3841764,484523534,38,37690,7625767,37182,7539302,508,86465,15845,42,80375,8264,38,550,130000.0,1000.0,-50.0,-54.0,-44.0,-42.0,-49.0,-53.0,-44.0,-42.0,-84.0,-82.0,-79.0,-81.0,34.0,28.0,35.0,39.0,1
1803,92:69:1D:31:68:E9,3845756,488163992,3992,3640458,3841764,484523534,0,5114,1133252,4956,1097454,158,35798,2166,12,4227,93,0,55,216660.0,130000.0,-52.0,-48.0,-42.0,-47.0,-52.0,-47.0,-43.0,-47.0,-84.0,-82.0,-79.0,-81.0,32.0,34.0,37.0,34.0,1
1804,CC:2F:71:3F:1F:24,4851070,1616359887,1009306,1131836353,3841764,484523534,364,832553,914262581,831771,914168071,782,94510,804425,15,1009240,105808,361,639,86667.0,14444.0,-69.0,-69.0,-66.0,-70.0,-69.0,-69.0,-66.0,-70.0,-84.0,-82.0,-79.0,-81.0,15.0,13.0,13.0,11.0,1
1805,CC:2F:71:3E:C5:1F,3842704,484638445,940,114911,3841764,484523534,0,3920,329401,3235,248041,685,81360,995,11,1351,25,0,52,130000.0,39000.0,-71.0,-71.0,-69.0,-60.0,-72.0,-73.0,-69.0,-62.0,-84.0,-82.0,-79.0,-81.0,13.0,11.0,10.0,21.0,1
1806,BA:8C:B9:54:50:24,3846651,490712022,4887,6188488,3841764,484523534,0,9357,1724540,9335,1721045,22,3495,2354,17,5362,41,0,65,216660.0,130000.0,-40.0,-36.0,-45.0,-52.0,-42.0,-35.0,-43.0,-47.0,-84.0,-82.0,-79.0,-81.0,44.0,46.0,34.0,29.0,1
1807,62:47:05:9D:EB:15,3843892,486947542,2124,2423604,3841768,484523938,0,4308,3011617,4277,3006636,31,4981,2056,0,2174,56,0,105,229410.0,130000.0,-45.0,-47.0,-40.0,-45.0,-45.0,-46.0,-40.0,-45.0,-84.0,-82.0,-79.0,-81.0,39.0,35.0,39.0,36.0,1
1808,3C:55:76:E8:8F:1F,3922082,685915556,80314,201391618,3841768,484523938,38,37699,7626381,37191,7539916,508,86465,15845,42,80375,8264,38,550,130000.0,1000.0,-50.0,-55.0,-44.0,-43.0,-50.0,-54.0,-44.0,-42.0,-84.0,-82.0,-79.0,-81.0,34.0,27.0,35.0,38.0,1
1809,92:69:1D:31:68:E9,3845760,488164396,3992,3640458,3841768,484523938,0,5114,1133252,4956,1097454,158,35798,2166,12,4227,93,0,55,216660.0,130000.0,-52.0,-48.0,-42.0,-47.0,-52.0,-47.0,-43.0,-47.0,-84.0,-82.0,-79.0,-81.0,32.0,34.0,37.0,34.0,1
1810,CC:2F:71:3F:1F:24,4851282,1616622547,1009514,1132098609,3841768,484523938,364,832743,914515871,831961,914421361,782,94510,804610,15,1009449,105808,361,640,86667.0,14444.0,-69.0,-69.0,-66.0,-71.0,-69.0,-69.0,-66.0,-70.0,-84.0,-82.0,-79.0,-81.0,15.0,13.0,13.0,10.0,1
1811,CC:2F:71:3E:C5:1F,3842708,484638849,940,114911,3841768,484523938,0,3920,329401,3235,248041,685,81360,995,11,1351,25,0,52,130000.0,39000.0,-71.0,-71.0,-69.0,-60.0,-72.0,-73.0,-69.0,-62.0,-84.0,-82.0,-79.0,-81.0,13.0,11.0,10.0,21.0,1
1812,BA:8C:B9:54:50:24,3846655,490712426,4887,6188488,3841768,484523938,0,9357,1724540,9335,1721045,22,3495,2354,17,5362,41,0,65,216660.0,130000.0,-40.0,-36.0,-45.0,-52.0,-42.0,-35.0,-43.0,-47.0,-84.0,-82.0,-79.0,-81.0,44.0,46.0,34.0,29.0,1
1813,62:47:05:9D:EB:15,3843898,486948068,2124,2423604,3841774,484524464,0,4311,3011821,4280,3006840,31,4981,2056,0,2174,56,0,105,229410.0,130000.0,-45.0,-46.0,-40.0,-45.0,-45.0,-46.0,-40.0,-45.0,-84.0,-82.0,-80.0,-81.0,39.0,36.0,40.0,36.0,1
1814,3C:55:76:E8:8F:1F,3922089,685916226,80315,201391762,3841774,484524464,38,37710,7627203,37202,7540738,508,86465,15847,42,80376,8264,38,551,130000.0,1000.0,-50.0,-54.0,-44.0,-43.0,-49.0,-53.0,-43.0,-42.0,-84.0,-82.0,-80.0,-81.0,34.0,28.0,36.0,38.0,1
1815,92:69:1D:31:68:E9,3845766,488164922,3992,3640458,3841774,484524464,0,5114,1133252,4956,1097454,158,35798,2166,12,4227,93,0,55,216660.0,130000.0,-52.0,-48.0,-42.0,-47.0,-52.0,-47.0,-43.0,-47.0,-84.0,-82.0,-80.0,-81.0,32.0,34.0,38.0,34.0,1
1816,CC:2F:71:3F:1F:24,4851502,1616888683,1009728,1132364219,3841774,484524464,364,832937,914772577,832154,914677949,783,94628,804799,15,1009663,105859,361,640,115556.0,26000.0,-69.0,-69.0,-66.0,-71.0,-69.0,-69.0,-66.0,-70.0,-84.0,-82.0,-80.0,-81.0,15.0,13.0,14.0,10.0,1
1817,CC:2F:71:3E:C5:1F,3842718,484639701,940,114911,3841778,484524790,0,3921,329519,3235,248041,686,81478,996,11,1351,25,0,52,130000.0,39000.0,-70.0,-70.0,-69.0,-60.0,-72.0,-73.0,-69.0,-62.0,-84.0,-82.0,-80.0,-81.0,14.0,12.0,11.0,21.0,1
1818,BA:8C:B9:54:50:24,3846665,490713278,4887,6188488,3841778,484524790,0,9357,1724540,9335,1721045,22,3495,2354,17,5362,41,0,65,216660.0,130000.0,-40.0,-36.0,-45.0,-52.0,-42.0,-35.0,-43.0,-47.0,-84.0,-82.0,-80.0,-81.0,44.0,46.0,35.0,29.0,1
1819,62:47:05:9D:EB:15,3843904,486948596,2124,2423604,3841780,484524992,0,4311,3011821,4280,3006840,31,4981,2056,0,2174,56,0,105,229410.0,130000.0,-45.0,-46.0,-40.0,-45.0,-45.0,-46.0,-40.0,-45.0,-84.0,-83.0,-80.0,-81.0,39.0,37.0,40.0,36.0,1
1820,3C:55:76:E8:8F:1F,3922096,685916928,80316,201391936,3841780,484524992,38,37727,7628567,37219,7542102,508,86465,15849,42,80377,8264,38,551,130000.0,32500.0,-50.0,-55.0,-44.0,-44.0,-50.0,-54.0,-44.0,-43.0,-84.0,-83.0,-80.0,-81.0,34.0,28.0,36.0,37.0,1
1821,92:69:1D:31:68:E9,3845772,488165450,3992,3640458,3841780,484524992,0,5114,1133252,4956,1097454,158,35798,2166,12,4227,93,0,55,216660.0,130000.0,-52.0,-48.0,-42.0,-47.0,-52.0,-47.0,-43.0,-47.0,-84.0,-83.0,-80.0,-81.0,32.0,35.0,38.0,34.0,1
1822,CC:2F:71:3F:1F:24,4851731,1617162180,1009951,1132637188,3841780,484524992,364,833135,915030148,832352,914935520,783,94628,804994,15,1009886,105925,361,640,115556.0,28889.0,-70.0,-69.0,-66.0,-71.0,-69.0,-69.0,-66.0,-71.0,-84.0,-83.0,-80.0,-81.0,14.0,14.0,14.0,10.0,1
1823,CC:2F:71:3E:C5:1F,3842720,484639903,940,114911,3841780,484524992,0,3922,329589,3236,248111,686,81478,996,11,1351,25,0,52,130000.0,39000.0,-70.0,-70.0,-69.0,-60.0,-71.0,-71.0,-69.0,-61.0,-84.0,-83.0,-80.0,-81.0,14.0,13.0,11.0,21.0,1
1824,BA:8C:B9:54:50:24,3846667,490713480,4887,6188488,3841780,484524992,0,9357,1724540,9335,1721045,22,3495,2354,17,5362,41,0,65,216660.0,130000.0,-40.0,-36.0,-45.0,-52.0,-42.0,-35.0,-43.0,-47.0,-84.0,-83.0,-80.0,-81.0,44.0,47.0,35.0,29.0,1
1825,62:47:05:9D:EB:15,3843908,486949000,2124,2423604,3841784,484525396,0,4311,3011821,4280,3006840,31,4981,2056,0,2174,56,0,105,229410.0,130000.0,-45.0,-46.0,-40.0,-45.0,-45.0,-46.0,-40.0,-45.0,-84.0,-83.0,-80.0,-81.0,39.0,37.0,40.0,36.0,1
1826,3C:55:76:E8:8F:1F,3922102,685917534,80316,201391936,3841786,484525598,38,37727,7628567,37219,7542102,508,86465,15849,42,80377,8264,38,551,130000.0,32500.0,-50.0,-55.0,-44.0,-44.0,-50.0,-54.0,-44.0,-43.0,-84.0,-83.0,-80.0,-81.0,34.0,28.0,36.0,37.0,1
1827,92:69:1D:31:68:E9,3845779,488166116,3992,3640458,3841787,484525658,0,5115,1133320,4957,1097522,158,35798,2166,12,4227,93,0,55,216660.0,130000.0,-51.0,-47.0,-44.0,-46.0,-52.0,-47.0,-43.0,-46.0,-84.0,-83.0,-80.0,-81.0,33.0,36.0,36.0,35.0,1
1828,CC:2F:71:3F:1F:24,4851950,1617426070,1010163,1132900412,3841787,484525658,364,833323,915280444,832540,915185816,783,94628,805178,15,1010098,105946,361,640,104000.0,26000.0,-69.0,-70.0,-66.0,-71.0,-69.0,-69.0,-65.0,-70.0,-84.0,-83.0,-80.0,-81.0,15.0,13.0,14.0,10.0,1
1829,CC:2F:71:3E:C5:1F,3842727,484640569,940,114911,3841787,484525658,0,3922,329589,3236,248111,686,81478,996,11,1351,25,0,52,130000.0,39000.0,-70.0,-70.0,-69.0,-60.0,-71.0,-71.0,-69.0,-61.0,-84.0,-83.0,-80.0,-81.0,14.0,13.0,11.0,21.0,1
1830,BA:8C:B9:54:50:24,3846676,490714348,4887,6188488,3841789,484525860,0,9357,1724540,9335,1721045,22,3495,2354,17,5362,41,0,65,216660.0,130000.0,-40.0,-36.0,-45.0,-52.0,-42.0,-35.0,-43.0,-47.0,-84.0,-83.0,-80.0,-81.0,44.0,47.0,35.0,29.0,1
1831,62:47:05:9D:EB:15,3843913,486949464,2124,2423604,3841789,484525860,0,4311,3011821,4280,3006840,31,4981,2056,0,2174,56,0,105,229410.0,130000.0,-45.0,-46.0,-40.0,-45.0,-45.0,-46.0,-40.0,-45.0,-84.0,-83.0,-80.0,-81.0,39.0,37.0,40.0,36.0,1
1832,3C:55:76:E8:8F:1F,3922105,685917796,80316,201391936,3841789,484525860,38,37727,7628567,37219,7542102,508,86465,15849,42,80377,8264,38,551,130000.0,32500.0,-50.0,-55.0,-44.0,-44.0,-50.0,-54.0,-44.0,-43.0,-84.0,-83.0,-80.0,-81.0,34.0,28.0,36.0,37.0,1
1833,92:69:1D:31:68:E9,3845783,488166520,3992,3640458,3841791,484526062,0,5115,1133320,4957,1097522,158,35798,2166,12,4227,93,0,55,216660.0,130000.0,-51.0,-47.0,-44.0,-46.0,-52.0,-47.0,-43.0,-46.0,-84.0,-83.0,-80.0,-81.0,33.0,36.0,36.0,35.0,1
1834,CC:2F:71:3F:1F:24,4852167,1617695734,1010376,1133169672,3841791,484526062,364,833515,915535338,832732,915440710,783,94628,805366,15,1010310,105956,361,640,115556.0,28889.0,-69.0,-69.0,-66.0,-70.0,-69.0,-69.0,-65.0,-69.0,-84.0,-83.0,-80.0,-81.0,15.0,14.0,14.0,11.0,1
1835,CC:2F:71:3E:C5:1F,3842731,484640973,940,114911,3841791,484526062,0,3922,329589,3236,248111,686,81478,996,11,1351,25,0,52,130000.0,39000.0,-70.0,-70.0,-69.0,-60.0,-71.0,-71.0,-69.0,-61.0,-84.0,-83.0,-80.0,-81.0,14.0,13.0,11.0,21.0,1
1836,BA:8C:B9:54:50:24,3846678,490714550,4887,6188488,3841791,484526062,0,9360,1724744,9338,1721249,22,3495,2354,17,5363,41,0,65,216660.0,130000.0,-40.0,-36.0,-46.0,-52.0,-42.0,-35.0,-43.0,-48.0,-84.0,-83.0,-80.0,-81.0,44.0,47.0,34.0,29.0,1
1837,62:47:05:9D:EB:15,3843919,486950070,2124,2423604,3841795,484526466,0,4311,3011821,4280,3006840,31,4981,2056,0,2174,56,0,105,229410.0,130000.0,-45.0,-46.0,-40.0,-45.0,-45.0,-46.0,-40.0,-45.0,-84.0,-83.0,-80.0,-81.0,39.0,37.0,40.0,36.0,1
1838,3C:55:76:E8:8F:1F,3922118,685919290,80321,201392622,3841797,484526668,38,37748,7631733,37240,7545268,508,86465,15856,42,80382,8264,38,551,121870.0,32500.0,-51.0,-51.0,-45.0,-44.0,-50.0,-51.0,-44.0,-44.0,-84.0,-83.0,-80.0,-81.0,33.0,32.0,35.0,37.0,1
1839,92:69:1D:31:68:E9,3845789,488167126,3992,3640458,3841797,484526668,0,5115,1133320,4957,1097522,158,35798,2166,12,4227,93,0,55,216660.0,130000.0,-51.0,-47.0,-44.0,-46.0,-52.0,-47.0,-43.0,-46.0,-84.0,-83.0,-80.0,-81.0,33.0,36.0,36.0,35.0,1
1840,CC:2F:71:3F:1F:24,4852385,1617964172,1010588,1133437504,3841797,484526668,364,833704,915788428,832921,915693800,783,94628,805554,15,1010523,105958,361,640,115556.0,28889.0,-69.0,-69.0,-67.0,-70.0,-69.0,-69.0,-67.0,-70.0,-84.0,-83.0,-80.0,-81.0,15.0,14.0,13.0,11.0,1
1841,CC:2F:71:3E:C5:1F,3842737,484641579,940,114911,3841797,484526668,0,3922,329589,3236,248111,686,81478,996,11,1351,25,0,52,130000.0,39000.0,-70.0,-70.0,-69.0,-60.0,-71.0,-71.0,-69.0,-61.0,-84.0,-83.0,-80.0,-81.0,14.0,13.0,11.0,21.0,1
1842,BA:8C:B9:54:50:24,3846684,490715156,4887,6188488,3841797,484526668,0,9360,1724744,9338,1721249,22,3495,2354,17,5363,41,0,65,216660.0,130000.0,-40.0,-36.0,-46.0,-52.0,-42.0,-35.0,-43.0,-48.0,-84.0,-83.0,-80.0,-81.0,44.0,47.0,34.0,29.0,1
1843,62:47:05:9D:EB:15,3843924,486950534,2124,2423604,3841800,484526930,0,4311,3011821,4280,3006840,31,4981,2056,0,2174,56,0,105,229410.0,130000.0,-45.0,-46.0,-40.0,-45.0,-45.0,-46.0,-40.0,-45.0,-84.0,-83.0,-80.0,-81.0,39.0,37.0,40.0,36.0,1
1844,3C:55:76:E8:8F:1F,3922121,685919552,80321,201392622,3841800,484526930,38,37748,7631733,37240,7545268,508,86465,15856,42,80382,8264,38,551,121870.0,32500.0,-51.0,-51.0,-45.0,-44.0,-50.0,-51.0,-44.0,-44.0,-84.0,-83.0,-80.0,-81.0,33.0,32.0,35.0,37.0,1
1845,92:69:1D:31:68:E9,3845792,488167388,3992,3640458,3841800,484526930,0,5115,1133320,4957,1097522,158,35798,2166,12,4227,93,0,55,216660.0,130000.0,-51.0,-47.0,-44.0,-46.0,-52.0,-47.0,-43.0,-46.0,-84.0,-83.0,-80.0,-81.0,33.0,36.0,36.0,35.0,1
1846,CC:2F:71:3F:1F:24,4852606,1618229449,1010804,1133702317,3841802,484527132,364,833902,916041721,833119,915947093,783,94628,805747,15,1010739,105964,361,640,130000.0,43333.0,-69.0,-70.0,-66.0,-70.0,-69.0,-70.0,-66.0,-70.0,-84.0,-83.0,-80.0,-81.0,15.0,13.0,14.0,11.0,1
1847,CC:2F:71:3E:C5:1F,3842742,484642043,940,114911,3841802,484527132,0,3922,329589,3236,248111,686,81478,996,11,1351,25,0,52,130000.0,39000.0,-70.0,-70.0,-69.0,-60.0,-71.0,-71.0,-69.0,-61.0,-84.0,-83.0,-80.0,-81.0,14.0,13.0,11.0,21.0,1
1848,BA:8C:B9:54:50:24,3846701,490721219,4887,6188488,3841814,484532731,0,9360,1724744,9338,1721249,22,3495,2354,17,5363,41,0,65,216660.0,130000.0,-40.0,-36.0,-46.0,-52.0,-42.0,-35.0,-43.0,-48.0,-84.0,-83.0,-80.0,-81.0,44.0,47.0,34.0,29.0,1
1849,62:47:05:9D:EB:15,3843953,486962163,2124,2423604,3841829,484538559,0,4311,3011821,4280,3006840,31,4981,2056,0,2174,56,0,105,229410.0,130000.0,-45.0,-46.0,-40.0,-45.0,-45.0,-46.0,-40.0,-45.0,-84.0,-83.0,-80.0,-81.0,39.0,37.0,40.0,36.0,1
1850,3C:55:76:E8:8F:1F,3922150,685931181,80321,201392622,3841829,484538559,38,37748,7631733,37240,7545268,508,86465,15856,42,80382,8264,38,551,121870.0,32500.0,-51.0,-51.0,-45.0,-44.0,-50.0,-51.0,-44.0,-44.0,-84.0,-83.0,-80.0,-81.0,33.0,32.0,35.0,37.0,1
1851,92:69:1D:31:68:E9,3845821,488179017,3992,3640458,3841829,484538559,0,5118,1133691,4959,1097658,159,36033,2167,12,4227,93,0,55,216660.0,130000.0,-51.0,-47.0,-44.0,-46.0,-52.0,-47.0,-43.0,-47.0,-84.0,-83.0,-80.0,-81.0,33.0,36.0,36.0,35.0,1
1852,CC:2F:71:3F:1F:24,4852841,1618499644,1011012,1133961085,3841829,484538559,364,834091,916294923,833308,916200295,783,94628,805927,15,1010947,105964,361,640,130000.0,43333.0,-69.0,-70.0,-66.0,-71.0,-69.0,-70.0,-66.0,-71.0,-84.0,-83.0,-80.0,-81.0,15.0,13.0,14.0,10.0,1
1853,CC:2F:71:3E:C5:1F,3842769,484653470,940,114911,3841829,484538559,0,3922,329589,3236,248111,686,81478,996,11,1351,25,0,52,130000.0,39000.0,-70.0,-70.0,-69.0,-60.0,-71.0,-71.0,-69.0,-61.0,-84.0,-83.0,-80.0,-81.0,14.0,13.0,11.0,21.0,1
1854,BA:8C:B9:54:50:24,3846716,490727047,4887,6188488,3841829,484538559,0,9360,1724744,9338,1721249,22,3495,2354,17,5363,41,0,65,216660.0,130000.0,-40.0,-36.0,-46.0,-52.0,-42.0,-35.0,-43.0,-48.0,-84.0,-83.0,-80.0,-81.0,44.0,47.0,34.0,29.0,1
1855,62:47:05:9D:EB:15,3843956,486962425,2124,2423604,3841832,484538821,0,4311,3011821,4280,3006840,31,4981,2056,0,2174,56,0,105,229410.0,130000.0,-45.0,-46.0,-40.0,-45.0,-45.0,-46.0,-40.0,-45.0,-84.0,-83.0,-80.0,-81.0,39.0,37.0,40.0,36.0,1
1856,3C:55:76:E8:8F:1F,3922156,685931705,80322,201392682,3841834,484539023,38,37755,7632251,37247,7545786,508,86465,15857,42,80383,8264,38,551,121870.0,32500.0,-45.0,-51.0,-48.0,-39.0,-45.0,-49.0,-46.0,-38.0,-84.0,-83.0,-80.0,-81.0,39.0,32.0,32.0,42.0,1
1857,92:69:1D:31:68:E9,3845826,488179481,3992,3640458,3841834,484539023,0,5118,1133691,4959,1097658,159,36033,2167,12,4227,93,0,55,216660.0,130000.0,-51.0,-47.0,-44.0,-46.0,-52.0,-47.0,-43.0,-47.0,-84.0,-83.0,-80.0,-81.0,33.0,36.0,36.0,35.0,1
1858,CC:2F:71:3F:1F:24,4853055,1618760206,1011221,1134221183,3841834,484539023,364,834279,916546571,833496,916451943,783,94628,806111,15,1011156,105973,361,641,130000.0,43333.0,-69.0,-70.0,-66.0,-71.0,-69.0,-70.0,-66.0,-71.0,-84.0,-83.0,-80.0,-81.0,15.0,13.0,14.0,10.0,1
1859,CC:2F:71:3E:C5:1F,3842774,484653934,940,114911,3841834,484539023,0,3922,329589,3236,248111,686,81478,996,11,1351,25,0,52,130000.0,39000.0,-70.0,-70.0,-69.0,-60.0,-71.0,-71.0,-69.0,-61.0,-84.0,-83.0,-80.0,-81.0,14.0,13.0,11.0,21.0,1
1860,BA:8C:B9:54:50:24,3846723,490727713,4887,6188488,3841836,484539225,0,9360,1724744,9338,1721249,22,3495,2354,17,5363,41,0,65,216660.0,130000.0,-40.0,-36.0,-46.0,-52.0,-42.0,-35.0,-43.0,-48.0,-84.0,-83.0,-80.0,-81.0,44.0,47.0,34.0,29.0,1
1861,62:47:05:9D:EB:15,3843963,486963304,2124,2423604,3841839,484539700,0,4311,3011821,4280,3006840,31,4981,2056,0,2174,56,0,105,229410.0,130000.0,-45.0,-46.0,-40.0,-45.0,-45.0,-46.0,-40.0,-45.0,-84.0,-83.0,-80.0,-81.0,39.0,37.0,40.0,36.0,1
1862,3C:55:76:E8:8F:1F,3922161,685932382,80322,201392682,3841839,484539700,38,37755,7632251,37247,7545786,508,86465,15857,42,80383,8264,38,551,121870.0,32500.0,-45.0,-51.0,-48.0,-39.0,-45.0,-49.0,-46.0,-38.0,-84.0,-83.0,-80.0,-80.0,39.0,32.0,32.0,41.0,1
1863,92:69:1D:31:68:E9,3845831,488180158,3992,3640458,3841839,484539700,0,5118,1133691,4959,1097658,159,36033,2167,12,4227,93,0,55,216660.0,130000.0,-51.0,-47.0,-44.0,-46.0,-52.0,-47.0,-43.0,-47.0,-84.0,-83.0,-80.0,-80.0,33.0,36.0,36.0,34.0,1
1864,CC:2F:71:3F:1F:24,4853267,1619019129,1011428,1134479429,3841839,484539700,364,834464,916792133,833681,916697505,783,94628,806291,15,1011363,105991,361,641,130000.0,39000.0,-68.0,-70.0,-66.0,-71.0,-68.0,-70.0,-65.0,-70.0,-84.0,-83.0,-80.0,-80.0,16.0,13.0,14.0,9.0,1
1865,CC:2F:71:3E:C5:1F,3842779,484654611,940,114911,3841839,484539700,0,3922,329589,3236,248111,686,81478,996,11,1351,25,0,52,130000.0,39000.0,-70.0,-70.0,-69.0,-60.0,-71.0,-71.0,-69.0,-61.0,-84.0,-83.0,-80.0,-80.0,14.0,13.0,11.0,20.0,1
1866,BA:8C:B9:54:50:24,3846726,490728188,4887,6188488,3841839,484539700,0,9360,1724744,9338,1721249,22,3495,2354,17,5363,41,0,65,216660.0,130000.0,-40.0,-36.0,-46.0,-52.0,-42.0,-35.0,-43.0,-48.0,-84.0,-83.0,-80.0,-80.0,44.0,47.0,34.0,28.0,1
1867,62:47:05:9D:EB:15,3843967,486963708,2124,2423604,3841843,484540104,0,4311,3011821,4280,3006840,31,4981,2056,0,2174,56,0,105,229410.0,130000.0,-45.0,-46.0,-40.0,-45.0,-45.0,-46.0,-40.0,-45.0,-84.0,-83.0,-80.0,-80.0,39.0,37.0,40.0,35.0,1
1868,3C:55:76:E8:8F:1F,3922165,685932786,80322,201392682,3841843,484540104,38,37755,7632251,37247,7545786,508,86465,15857,42,80383,8264,38,551,121870.0,32500.0,-45.0,-51.0,-48.0,-39.0,-45.0,-49.0,-46.0,-38.0,-84.0,-83.0,-80.0,-81.0,39.0,32.0,32.0,42.0,1
1869,92:69:1D:31:68:E9,3845837,488180756,3992,3640458,3841845,484540298,0,5118,1133691,4959,1097658,159,36033,2167,12,4227,93,0,55,216660.0,130000.0,-51.0,-47.0,-44.0,-46.0,-52.0,-47.0,-43.0,-47.0,-84.0,-83.0,-80.0,-81.0,33.0,36.0,36.0,35.0,1
1870,CC:2F:71:3F:1F:24,4853492,1619287840,1011646,1134747474,3841846,484540366,364,834669,917056380,833886,916961752,783,94628,806484,15,1011581,106014,361,642,130000.0,43333.0,-69.0,-70.0,-67.0,-71.0,-69.0,-70.0,-66.0,-71.0,-84.0,-83.0,-80.0,-81.0,15.0,13.0,13.0,10.0,1
1871,CC:2F:71:3E:C5:1F,3842786,484655277,940,114911,3841846,484540366,0,3922,329589,3236,248111,686,81478,996,11,1351,25,0,52,130000.0,39000.0,-70.0,-70.0,-69.0,-60.0,-71.0,-71.0,-69.0,-61.0,-84.0,-83.0,-80.0,-81.0,14.0,13.0,11.0,21.0,1
1872,BA:8C:B9:54:50:24,3846733,490728854,4887,6188488,3841846,484540366,0,9360,1724744,9338,1721249,22,3495,2354,17,5363,41,0,65,216660.0,130000.0,-40.0,-36.0,-46.0,-52.0,-42.0,-35.0,-43.0,-48.0,-84.0,-83.0,-80.0,-81.0,44.0,47.0,34.0,29.0,1
1873,62:47:05:9D:EB:15,3843972,486964172,2124,2423604,3841848,484540568,0,4311,3011821,4280,3006840,31,4981,2056,0,2174,56,0,105,229410.0,130000.0,-45.0,-46.0,-40.0,-45.0,-45.0,-46.0,-40.0,-45.0,-84.0,-83.0,-80.0,-81.0,39.0,37.0,40.0,36.0,1
1874,3C:55:76:E8:8F:1F,3922172,685933508,80323,201392756,3841849,484540752,38,37766,7633040,37258,7546575,508,86465,15858,42,80384,8264,38,551,130000.0,1000.0,-46.0,-51.0,-49.0,-39.0,-44.0,-50.0,-47.0,-38.0,-84.0,-83.0,-80.0,-81.0,38.0,32.0,31.0,42.0,1
1875,92:69:1D:31:68:E9,3845842,488181394,3992,3640458,3841850,484540936,0,5118,1133691,4959,1097658,159,36033,2167,12,4227,93,0,55,216660.0,130000.0,-51.0,-47.0,-44.0,-46.0,-52.0,-47.0,-43.0,-47.0,-84.0,-83.0,-80.0,-81.0,33.0,36.0,36.0,35.0,1
1876,CC:2F:71:3F:1F:24,4853707,1619550302,1011855,1135009164,3841852,484541138,364,834869,917315788,834086,917221160,783,94628,806668,15,1011790,106023,361,642,130000.0,39000.0,-69.0,-70.0,-67.0,-71.0,-69.0,-70.0,-66.0,-71.0,-85.0,-84.0,-81.0,-81.0,16.0,14.0,14.0,10.0,1
1877,CC:2F:71:3E:C5:1F,3842792,484656049,940,114911,3841852,484541138,0,3922,329589,3236,248111,686,81478,996,11,1351,25,0,52,130000.0,39000.0,-70.0,-70.0,-69.0,-60.0,-71.0,-71.0,-69.0,-61.0,-85.0,-84.0,-81.0,-81.0,15.0,14.0,12.0,21.0,1
1878,BA:8C:B9:54:50:24,3846739,490729626,4887,6188488,3841852,484541138,0,9360,1724744,9338,1721249,22,3495,2354,17,5363,41,0,65,216660.0,130000.0,-40.0,-36.0,-46.0,-52.0,-42.0,-35.0,-43.0,-48.0,-85.0,-84.0,-81.0,-81.0,45.0,48.0,35.0,29.0,1
1879,62:47:05:9D:EB:15,3843980,486965146,2124,2423604,3841856,484541542,0,4311,3011821,4280,3006840,31,4981,2056,0,2174,56,0,105,229410.0,130000.0,-45.0,-46.0,-40.0,-45.0,-45.0,-46.0,-40.0,-45.0,-85.0,-84.0,-81.0,-81.0,40.0,38.0,41.0,36.0,1
1880,3C:55:76:E8:8F:1F,3922184,685934884,80328,201393342,3841856,484541542,38,37784,7635317,37276,7548852,508,86465,15863,42,80389,8264,38,551,130000.0,32500.0,-46.0,-52.0,-48.0,-40.0,-45.0,-50.0,-47.0,-38.0,-85.0,-84.0,-81.0,-81.0,39.0,32.0,33.0,41.0,1
1881,92:69:1D:31:68:E9,3845849,488182134,3992,3640458,3841857,484541676,0,5118,1133691,4959,1097658,159,36033,2167,12,4227,93,0,55,216660.0,130000.0,-51.0,-47.0,-44.0,-46.0,-52.0,-47.0,-43.0,-47.0,-85.0,-84.0,-81.0,-81.0,34.0,37.0,37.0,35.0,1
1882,CC:2F:71:3F:1F:24,4853925,1619819834,1012068,1135278158,3841857,484541676,364,835063,917576662,834280,917482034,783,94628,806855,15,1012003,106052,361,642,130000.0,43333.0,-69.0,-70.0,-66.0,-71.0,-69.0,-70.0,-66.0,-71.0,-85.0,-84.0,-81.0,-81.0,16.0,14.0,15.0,10.0,1
1883,CC:2F:71:3E:C5:1F,3842798,484656655,940,114911,3841858,484541744,0,3922,329589,3236,248111,686,81478,996,11,1351,25,0,52,130000.0,39000.0,-70.0,-70.0,-69.0,-60.0,-71.0,-71.0,-69.0,-61.0,-85.0,-84.0,-81.0,-81.0,15.0,14.0,12.0,21.0,1
1884,BA:8C:B9:54:50:24,3846745,490730232,4887,6188488,3841858,484541744,0,9360,1724744,9338,1721249,22,3495,2354,17,5363,41,0,65,216660.0,130000.0,-40.0,-36.0,-46.0,-52.0,-42.0,-35.0,-43.0,-48.0,-85.0,-84.0,-81.0,-81.0,45.0,48.0,35.0,29.0,1
1885,62:47:05:9D:EB:15,3843985,486965610,2124,2423604,3841861,484542006,0,4311,3011821,4280,3006840,31,4981,2056,0,2174,56,0,105,229410.0,130000.0,-45.0,-46.0,-40.0,-45.0,-45.0,-46.0,-40.0,-45.0,-85.0,-84.0,-81.0,-81.0,40.0,38.0,41.0,36.0,1
1886,3C:55:76:E8:8F:1F,3922190,685935522,80329,201393516,3841861,484542006,38,37799,7636469,37291,7550004,508,86465,15865,42,80390,8264,38,551,130000.0,32500.0,-46.0,-51.0,-48.0,-39.0,-45.0,-50.0,-46.0,-39.0,-85.0,-84.0,-81.0,-81.0,39.0,33.0,33.0,42.0,1
1887,92:69:1D:31:68:E9,3845853,488182464,3992,3640458,3841861,484542006,0,5118,1133691,4959,1097658,159,36033,2167,12,4227,93,0,55,216660.0,130000.0,-51.0,-47.0,-44.0,-46.0,-52.0,-47.0,-43.0,-47.0,-85.0,-84.0,-81.0,-81.0,34.0,37.0,37.0,35.0,1
1888,CC:2F:71:3F:1F:24,4854159,1620108465,1012298,1135566459,3841861,484542006,364,835281,917859537,834498,917764909,783,94628,807062,15,1012232,106059,361,642,130000.0,43333.0,-69.0,-71.0,-67.0,-72.0,-69.0,-70.0,-66.0,-71.0,-85.0,-84.0,-81.0,-81.0,16.0,13.0,14.0,9.0,1
1889,CC:2F:71:3E:C5:1F,3842803,484657119,940,114911,3841863,484542208,0,3922,329589,3236,248111,686,81478,996,11,1351,25,0,52,130000.0,39000.0,-70.0,-70.0,-69.0,-60.0,-71.0,-71.0,-69.0,-61.0,-85.0,-84.0,-81.0,-81.0,15.0,14.0,12.0,21.0,1
1890,BA:8C:B9:54:50:24,3846750,490730696,4887,6188488,3841863,484542208,0,9360,1724744,9338,1721249,22,3495,2354,17,5363,41,0,65,216660.0,130000.0,-40.0,-36.0,-46.0,-52.0,-42.0,-35.0,-43.0,-48.0,-85.0,-84.0,-81.0,-80.0,45.0,48.0,35.0,28.0,1
1891,62:47:05:9D:EB:15,3843991,486966216,2124,2423604,3841867,484542612,0,4311,3011821,4280,3006840,31,4981,2056,0,2174,56,0,105,229410.0,130000.0,-45.0,-46.0,-40.0,-45.0,-45.0,-46.0,-40.0,-45.0,-85.0,-84.0,-81.0,-80.0,40.0,38.0,41.0,35.0,1
1892,3C:55:76:E8:8F:1F,3923185,688554111,81318,204011499,3841867,484542612,38,38011,7670312,37503,7583847,508,86465,15959,42,81379,8265,38,562,154850.0,48750.0,-50.0,-52.0,-46.0,-44.0,-50.0,-51.0,-45.0,-44.0,-85.0,-84.0,-81.0,-80.0,35.0,32.0,35.0,36.0,1
1893,92:69:1D:31:68:E9,3845859,488183070,3992,3640458,3841867,484542612,0,5118,1133691,4959,1097658,159,36033,2167,12,4227,93,0,55,216660.0,130000.0,-51.0,-47.0,-44.0,-46.0,-52.0,-47.0,-43.0,-47.0,-85.0,-84.0,-81.0,-80.0,34.0,37.0,37.0,34.0,1
1894,CC:2F:71:3F:1F:24,4854396,1620405981,1012529,1135863369,3841867,484542612,364,835496,918148479,834713,918053851,783,94628,807272,15,1012464,106073,361,642,130000.0,43333.0,-69.0,-71.0,-68.0,-72.0,-69.0,-70.0,-67.0,-71.0,-85.0,-84.0,-81.0,-80.0,16.0,13.0,13.0,8.0,1
1895,CC:2F:71:3E:C5:1F,3842807,484657523,940,114911,3841867,484542612,0,3922,329589,3236,248111,686,81478,996,11,1351,25,0,52,130000.0,39000.0,-70.0,-70.0,-69.0,-60.0,-71.0,-71.0,-69.0,-61.0,-85.0,-84.0,-81.0,-80.0,15.0,14.0,12.0,20.0,1
1896,BA:8C:B9:54:50:24,3846754,490731100,4887,6188488,3841867,484542612,0,9360,1724744,9338,1721249,22,3495,2354,17,5363,41,0,65,216660.0,130000.0,-40.0,-36.0,-46.0,-52.0,-42.0,-35.0,-43.0,-48.0,-85.0,-84.0,-81.0,-80.0,45.0,48.0,35.0,28.0,1
1897,62:47:05:9D:EB:15,3843996,486966680,2124,2423604,3841872,484543076,0,4311,3011821,4280,3006840,31,4981,2056,0,2174,56,0,105,229410.0,130000.0,-45.0,-46.0,-40.0,-45.0,-45.0,-46.0,-40.0,-45.0,-85.0,-84.0,-81.0,-80.0,40.0,38.0,41.0,35.0,1
1898,3C:55:76:E8:8F:1F,3923190,688554575,81318,204011499,3841872,484543076,38,38011,7670312,37503,7583847,508,86465,15959,42,81379,8265,38,562,154850.0,48750.0,-50.0,-52.0,-46.0,-44.0,-50.0,-51.0,-45.0,-44.0,-85.0,-84.0,-81.0,-80.0,35.0,32.0,35.0,36.0,1
1899,92:69:1D:31:68:E9,3845864,488183534,3992,3640458,3841872,484543076,0,5118,1133691,4959,1097658,159,36033,2167,12,4227,93,0,55,216660.0,130000.0,-51.0,-47.0,-44.0,-46.0,-52.0,-47.0,-43.0,-47.0,-85.0,-84.0,-81.0,-80.0,34.0,37.0,37.0,34.0,1
1900,CC:2F:71:3F:1F:24,4854614,1620672535,1012742,1136129459,3841872,484543076,364,835690,918405067,834907,918310439,783,94628,807460,15,1012677,106101,361,642,130000.0,43333.0,-69.0,-70.0,-66.0,-71.0,-69.0,-69.0,-66.0,-71.0,-85.0,-84.0,-81.0,-80.0,16.0,14.0,15.0,9.0,1
1901,CC:2F:71:3E:C5:1F,3842812,484657987,940,114911,3841872,484543076,0,3922,329589,3236,248111,686,81478,996,11,1351,25,0,52,130000.0,39000.0,-70.0,-70.0,-69.0,-60.0,-71.0,-71.0,-69.0,-61.0,-85.0,-84.0,-81.0,-80.0,15.0,14.0,12.0,20.0,1
1902,BA:8C:B9:54:50:24,3846759,490731564,4887,6188488,3841872,484543076,0,9360,1724744,9338,1721249,22,3495,2354,17,5363,41,0,65,216660.0,130000.0,-40.0,-36.0,-46.0,-52.0,-42.0,-35.0,-43.0,-48.0,-85.0,-84.0,-81.0,-80.0,45.0,48.0,35.0,28.0,1
1903,62:47:05:9D:EB:15,3844000,486967084,2124,2423604,3841876,484543480,0,4311,3011821,4280,3006840,31,4981,2056,0,2174,56,0,105,229410.0,130000.0,-45.0,-46.0,-40.0,-45.0,-45.0,-46.0,-40.0,-45.0,-85.0,-84.0,-81.0,-80.0,40.0,38.0,41.0,35.0,1
1904,3C:55:76:E8:8F:1F,3923194,688554979,81318,204011499,3841876,484543480,38,38011,7670312,37503,7583847,508,86465,15959,42,81379,8265,38,562,154850.0,48750.0,-50.0,-52.0,-46.0,-44.0,-50.0,-51.0,-45.0,-44.0,-85.0,-84.0,-81.0,-80.0,35.0,32.0,35.0,36.0,1
1905,92:69:1D:31:68:E9,3845870,488184140,3992,3640458,3841878,484543682,0,5118,1133691,4959,1097658,159,36033,2167,12,4227,93,0,55,216660.0,130000.0,-51.0,-47.0,-44.0,-46.0,-52.0,-47.0,-43.0,-47.0,-85.0,-84.0,-81.0,-80.0,34.0,37.0,37.0,34.0,1
1906,CC:2F:71:3F:1F:24,4854838,1620942890,1012960,1136399208,3841878,484543682,364,835892,918668868,835109,918574240,783,94628,807653,15,1012895,106104,361,643,130000.0,43333.0,-69.0,-70.0,-67.0,-71.0,-68.0,-69.0,-66.0,-71.0,-85.0,-84.0,-81.0,-80.0,16.0,14.0,14.0,9.0,1
1907,CC:2F:71:3E:C5:1F,3842818,484658593,940,114911,3841878,484543682,0,3922,329589,3236,248111,686,81478,996,11,1351,25,0,52,130000.0,39000.0,-70.0,-70.0,-69.0,-60.0,-71.0,-71.0,-69.0,-61.0,-85.0,-84.0,-81.0,-80.0,15.0,14.0,12.0,20.0,1
1908,BA:8C:B9:54:50:24,3846765,490732170,4887,6188488,3841878,484543682,0,9360,1724744,9338,1721249,22,3495,2354,17,5363,41,0,65,216660.0,130000.0,-40.0,-36.0,-46.0,-52.0,-42.0,-35.0,-43.0,-48.0,-85.0,-84.0,-81.0,-80.0,45.0,48.0,35.0,28.0,1
1909,62:47:05:9D:EB:15,3844005,486967548,2124,2423604,3841881,484543944,0,4312,3011889,4281,3006908,31,4981,2056,0,2174,56,0,105,229410.0,130000.0,-45.0,-46.0,-40.0,-45.0,-45.0,-46.0,-40.0,-45.0,-84.0,-84.0,-81.0,-80.0,39.0,38.0,41.0,35.0,1
1910,3C:55:76:E8:8F:1F,3923199,688555443,81318,204011499,3841881,484543944,38,38011,7670312,37503,7583847,508,86465,15959,42,81379,8265,38,562,154850.0,48750.0,-50.0,-52.0,-46.0,-44.0,-50.0,-51.0,-45.0,-44.0,-84.0,-84.0,-81.0,-80.0,34.0,32.0,35.0,36.0,1
1911,92:69:1D:31:68:E9,3845873,488184402,3992,3640458,3841881,484543944,0,5118,1133691,4959,1097658,159,36033,2167,12,4227,93,0,55,216660.0,130000.0,-51.0,-47.0,-44.0,-46.0,-52.0,-47.0,-43.0,-47.0,-84.0,-84.0,-81.0,-80.0,33.0,37.0,37.0,34.0,1
1912,CC:2F:71:3F:1F:24,4855055,1621209538,1013172,1136665392,3841883,484544146,364,836087,918927106,835304,918832478,783,94628,807841,15,1013107,106137,361,643,130000.0,43333.0,-69.0,-70.0,-67.0,-71.0,-69.0,-70.0,-66.0,-71.0,-84.0,-84.0,-81.0,-80.0,15.0,14.0,14.0,9.0,1
1913,CC:2F:71:3E:C5:1F,3842825,484659259,940,114911,3841885,484544348,0,3922,329589,3236,248111,686,81478,996,11,1351,25,0,52,130000.0,39000.0,-70.0,-70.0,-69.0,-60.0,-71.0,-71.0,-69.0,-61.0,-84.0,-84.0,-81.0,-80.0,14.0,14.0,12.0,20.0,1
1914,BA:8C:B9:54:50:24,3846772,490732836,4887,6188488,3841885,484544348,0,9360,1724744,9338,1721249,22,3495,2354,17,5363,41,0,65,216660.0,130000.0,-40.0,-36.0,-46.0,-52.0,-42.0,-35.0,-43.0,-48.0,-84.0,-84.0,-81.0,-80.0,44.0,48.0,35.0,28.0,1
1915,62:47:05:9D:EB:15,3844012,486968216,2124,2423604,3841888,484544612,0,4312,3011889,4281,3006908,31,4981,2056,0,2174,56,0,105,229410.0,130000.0,-45.0,-46.0,-40.0,-45.0,-45.0,-46.0,-40.0,-45.0,-84.0,-84.0,-81.0,-80.0,39.0,38.0,41.0,35.0,1
1916,3C:55:76:E8:8F:1F,3923208,688556376,81320,204011764,3841888,484544612,38,38033,7671973,37524,7585390,509,86583,15962,42,81381,8265,38,562,154850.0,48750.0,-50.0,-53.0,-46.0,-44.0,-47.0,-51.0,-44.0,-41.0,-84.0,-84.0,-81.0,-80.0,34.0,31.0,35.0,36.0,1
1917,92:69:1D:31:68:E9,3845881,488185130,3993,3640518,3841888,484544612,0,5120,1133827,4961,1097794,159,36033,2167,12,4228,93,0,55,216660.0,130000.0,-51.0,-47.0,-44.0,-46.0,-55.0,-51.0,-48.0,-50.0,-84.0,-84.0,-81.0,-80.0,33.0,37.0,37.0,34.0,1
1918,CC:2F:71:3F:1F:24,4855276,1621482390,1013388,1136937778,3841888,484544612,364,836284,919186924,835501,919092296,783,94628,808033,15,1013322,106164,361,643,130000.0,43333.0,-69.0,-70.0,-67.0,-72.0,-69.0,-70.0,-66.0,-71.0,-84.0,-84.0,-81.0,-80.0,15.0,14.0,14.0,8.0,1
1919,CC:2F:71:3E:C5:1F,3842829,484659639,941,115027,3841888,484544612,0,3924,329729,3238,248251,686,81478,996,11,1352,25,0,52,130000.0,39000.0,-83.0,-82.0,-80.0,-78.0,-73.0,-73.0,-70.0,-63.0,-84.0,-84.0,-81.0,-80.0,1.0,2.0,1.0,2.0,1
1920,BA:8C:B9:54:50:24,3846777,490733278,4888,6188604,3841889,484544674,0,9362,1724880,9340,1721385,22,3495,2354,17,5364,41,0,65,216660.0,130000.0,-48.0,-35.0,-43.0,-45.0,-43.0,-35.0,-43.0,-47.0,-84.0,-84.0,-81.0,-80.0,36.0,49.0,38.0,35.0,1
1921,62:47:05:9D:EB:15,3844020,486969000,2125,2423720,3841895,484545280,0,4314,3012025,4283,3007044,31,4981,2056,0,2175,56,0,105,229410.0,130000.0,-45.0,-46.0,-39.0,-46.0,-45.0,-46.0,-40.0,-45.0,-85.0,-84.0,-81.0,-80.0,40.0,38.0,42.0,34.0,1
1922,3C:55:76:E8:8F:1F,3923215,688557044,81320,204011764,3841895,484545280,38,38033,7671973,37524,7585390,509,86583,15962,42,81381,8265,38,562,154850.0,48750.0,-50.0,-53.0,-46.0,-44.0,-47.0,-51.0,-44.0,-41.0,-85.0,-84.0,-81.0,-80.0,35.0,31.0,35.0,36.0,1
1923,92:69:1D:31:68:E9,3845889,488185858,3993,3640518,3841896,484545340,0,5120,1133827,4961,1097794,159,36033,2167,12,4228,93,0,55,216660.0,130000.0,-51.0,-47.0,-44.0,-46.0,-55.0,-51.0,-48.0,-50.0,-85.0,-84.0,-81.0,-80.0,34.0,37.0,37.0,34.0,1
1924,CC:2F:71:3F:1F:24,4855493,1621745952,1013597,1137200612,3841896,484545340,364,836472,919434624,835689,919339996,783,94628,808218,15,1013532,106199,361,643,117000.0,39000.0,-69.0,-70.0,-67.0,-72.0,-68.0,-70.0,-66.0,-71.0,-85.0,-84.0,-81.0,-80.0,16.0,14.0,14.0,8.0,1
1925,CC:2F:71:3E:C5:1F,3842837,484660367,941,115027,3841896,484545340,0,3926,329917,3239,248321,687,81596,997,11,1352,25,0,52,130000.0,39000.0,-71.0,-71.0,-69.0,-60.0,-72.0,-72.0,-70.0,-62.0,-85.0,-84.0,-81.0,-80.0,14.0,13.0,12.0,20.0,1
1926,BA:8C:B9:54:50:24,3846784,490733944,4888,6188604,3841896,484545340,0,9363,1724948,9341,1721453,22,3495,2354,17,5364,41,0,65,216660.0,130000.0,-48.0,-35.0,-43.0,-45.0,-44.0,-35.0,-44.0,-47.0,-85.0,-84.0,-81.0,-80.0,37.0,49.0,38.0,35.0,1
1927,62:47:05:9D:EB:15,3844024,486969535,2125,2423720,3841899,484545815,0,4314,3012025,4283,3007044,31,4981,2056,0,2175,56,0,105,229410.0,130000.0,-45.0,-46.0,-39.0,-46.0,-45.0,-46.0,-40.0,-45.0,-85.0,-84.0,-81.0,-80.0,40.0,38.0,42.0,34.0,1
1928,3C:55:76:E8:8F:1F,3923220,688557641,81320,204011764,3841900,484545877,38,38035,7672161,37525,7585460,510,86701,15963,42,81381,8265,38,562,154850.0,48750.0,-44.0,-49.0,-46.0,-37.0,-47.0,-50.0,-44.0,-40.0,-85.0,-84.0,-81.0,-80.0,41.0,35.0,35.0,43.0,1
1929,92:69:1D:31:68:E9,3845893,488186395,3993,3640518,3841900,484545877,0,5120,1133827,4961,1097794,159,36033,2167,12,4228,93,0,55,216660.0,130000.0,-51.0,-47.0,-44.0,-46.0,-55.0,-51.0,-48.0,-50.0,-85.0,-84.0,-81.0,-80.0,34.0,37.0,37.0,34.0,1
1930,CC:2F:71:3F:1F:24,4855718,1622016404,1013816,1137470325,3841902,484546079,364,836672,919689565,835889,919594937,783,94628,808415,15,1013751,106206,361,643,115556.0,28889.0,-69.0,-70.0,-67.0,-71.0,-69.0,-70.0,-66.0,-71.0,-85.0,-84.0,-81.0,-80.0,16.0,14.0,14.0,9.0,1
1931,CC:2F:71:3E:C5:1F,3842843,484661106,941,115027,3841902,484546079,0,3926,329917,3239,248321,687,81596,997,11,1352,25,0,52,130000.0,39000.0,-71.0,-71.0,-69.0,-60.0,-72.0,-72.0,-70.0,-62.0,-85.0,-84.0,-81.0,-80.0,14.0,13.0,12.0,20.0,1
1932,BA:8C:B9:54:50:24,3846790,490734683,4888,6188604,3841902,484546079,0,9363,1724948,9341,1721453,22,3495,2354,17,5364,41,0,65,216660.0,130000.0,-48.0,-35.0,-43.0,-45.0,-44.0,-35.0,-44.0,-47.0,-85.0,-84.0,-81.0,-80.0,37.0,49.0,38.0,35.0,1
1933,62:47:05:9D:EB:15,3844031,486970203,2125,2423720,3841906,484546483,0,4314,3012025,4283,3007044,31,4981,2056,0,2175,56,0,105,229410.0,130000.0,-45.0,-46.0,-39.0,-46.0,-45.0,-46.0,-40.0,-45.0,-85.0,-84.0,-81.0,-80.0,40.0,38.0,42.0,34.0,1
1934,3C:55:76:E8:8F:1F,3923226,688558247,81320,204011764,3841906,484546483,38,38042,7672639,37532,7585938,510,86701,15963,42,81381,8265,38,563,154850.0,48750.0,-46.0,-52.0,-49.0,-40.0,-44.0,-50.0,-47.0,-38.0,-85.0,-84.0,-81.0,-80.0,39.0,32.0,32.0,40.0,1
1935,92:69:1D:31:68:E9,3845899,488187001,3993,3640518,3841906,484546483,0,5120,1133827,4961,1097794,159,36033,2167,12,4228,93,0,55,216660.0,130000.0,-51.0,-47.0,-44.0,-46.0,-55.0,-51.0,-48.0,-50.0,-85.0,-84.0,-81.0,-80.0,34.0,37.0,37.0,34.0,1
1936,CC:2F:71:3F:1F:24,4855930,1622277000,1014024,1137730517,3841906,484546483,364,836861,919938487,836078,919843859,783,94628,808599,15,1013959,106207,361,643,115556.0,28889.0,-69.0,-70.0,-67.0,-71.0,-69.0,-70.0,-66.0,-70.0,-85.0,-84.0,-81.0,-80.0,16.0,14.0,14.0,9.0,1
1937,CC:2F:71:3E:C5:1F,3842847,484661510,941,115027,3841906,484546483,0,3926,329917,3239,248321,687,81596,997,11,1352,25,0,52,130000.0,39000.0,-71.0,-71.0,-69.0,-60.0,-72.0,-72.0,-70.0,-62.0,-85.0,-84.0,-81.0,-80.0,14.0,13.0,12.0,20.0,1
1938,BA:8C:B9:54:50:24,3846796,490735289,4888,6188604,3841908,484546685,0,9363,1724948,9341,1721453,22,3495,2354,17,5364,41,0,65,216660.0,130000.0,-48.0,-35.0,-43.0,-45.0,-44.0,-35.0,-44.0,-47.0,-85.0,-84.0,-81.0,-80.0,37.0,49.0,38.0,35.0,1
1939,62:47:05:9D:EB:15,3844037,486970729,2125,2423720,3841912,484547009,0,4314,3012025,4283,3007044,31,4981,2056,0,2175,56,0,105,229410.0,130000.0,-45.0,-46.0,-39.0,-46.0,-45.0,-46.0,-40.0,-45.0,-84.0,-84.0,-81.0,-80.0,39.0,38.0,42.0,34.0,1
1940,3C:55:76:E8:8F:1F,3923238,688562305,81326,204015296,3841912,484547009,38,38058,7677184,37547,7590365,511,86819,15968,42,81387,8265,38,563,154850.0,48750.0,-46.0,-52.0,-48.0,-39.0,-45.0,-51.0,-47.0,-39.0,-84.0,-84.0,-81.0,-80.0,38.0,32.0,33.0,41.0,1
1941,92:69:1D:31:68:E9,3845905,488187527,3993,3640518,3841912,484547009,0,5120,1133827,4961,1097794,159,36033,2167,12,4228,93,0,55,216660.0,130000.0,-51.0,-47.0,-44.0,-46.0,-55.0,-51.0,-48.0,-50.0,-84.0,-84.0,-81.0,-80.0,33.0,37.0,37.0,34.0,1
1942,CC:2F:71:3F:1F:24,4856147,1622540537,1014235,1137993528,3841912,484547009,364,837059,920195638,836276,920101010,783,94628,808790,15,1014170,106221,361,643,117000.0,39000.0,-69.0,-70.0,-67.0,-72.0,-68.0,-69.0,-66.0,-71.0,-84.0,-84.0,-81.0,-80.0,15.0,14.0,14.0,8.0,1
1943,CC:2F:71:3E:C5:1F,3842853,484662036,941,115027,3841912,484547009,0,3926,329917,3239,248321,687,81596,997,11,1352,25,0,52,130000.0,39000.0,-71.0,-71.0,-69.0,-60.0,-72.0,-72.0,-70.0,-62.0,-84.0,-84.0,-81.0,-80.0,13.0,13.0,12.0,20.0,1
1944,BA:8C:B9:54:50:24,3846800,490735613,4888,6188604,3841912,484547009,0,9363,1724948,9341,1721453,22,3495,2354,17,5364,41,0,65,216660.0,130000.0,-48.0,-35.0,-43.0,-45.0,-44.0,-35.0,-44.0,-47.0,-84.0,-84.0,-81.0,-80.0,36.0,49.0,38.0,35.0,1
1945,62:47:05:9D:EB:15,3844041,486971133,2125,2423720,3841916,484547413,0,4314,3012025,4283,3007044,31,4981,2056,0,2175,56,0,105,229410.0,130000.0,-45.0,-46.0,-39.0,-46.0,-45.0,-46.0,-40.0,-45.0,-84.0,-84.0,-81.0,-80.0,39.0,38.0,42.0,34.0,1
1946,3C:55:76:E8:8F:1F,3923244,688562911,81326,204015296,3841918,484547615,38,38061,7677390,37550,7590571,511,86819,15968,42,81387,8265,38,563,154850.0,48750.0,-44.0,-50.0,-47.0,-36.0,-45.0,-51.0,-48.0,-38.0,-84.0,-84.0,-81.0,-80.0,40.0,34.0,34.0,44.0,1
1947,92:69:1D:31:68:E9,3845911,488188133,3993,3640518,3841918,484547615,0,5120,1133827,4961,1097794,159,36033,2167,12,4228,93,0,55,216660.0,130000.0,-51.0,-47.0,-44.0,-46.0,-55.0,-51.0,-48.0,-50.0,-84.0,-84.0,-81.0,-80.0,33.0,37.0,37.0,34.0,1
1948,CC:2F:71:3F:1F:24,4856375,1622814148,1014457,1138266533,3841918,484547615,364,837264,920458900,836481,920364272,783,94628,808984,15,1014392,106222,361,643,130000.0,43333.0,-70.0,-70.0,-67.0,-71.0,-69.0,-70.0,-66.0,-71.0,-84.0,-84.0,-81.0,-80.0,14.0,14.0,14.0,9.0,1
1949,CC:2F:71:3E:C5:1F,3842859,484662642,941,115027,3841918,484547615,0,3926,329917,3239,248321,687,81596,997,11,1352,25,0,52,130000.0,39000.0,-71.0,-71.0,-69.0,-60.0,-72.0,-72.0,-70.0,-62.0,-84.0,-84.0,-81.0,-80.0,13.0,13.0,12.0,20.0,1
1950,BA:8C:B9:54:50:24,3846806,490736219,4888,6188604,3841918,484547615,0,9363,1724948,9341,1721453,22,3495,2354,17,5364,41,0,65,216660.0,130000.0,-48.0,-35.0,-43.0,-45.0,-44.0,-35.0,-44.0,-47.0,-84.0,-84.0,-81.0,-80.0,36.0,49.0,38.0,35.0,1
1951,62:47:05:9D:EB:15,3844046,486971597,2125,2423720,3841921,484547877,0,4314,3012025,4283,3007044,31,4981,2056,0,2175,56,0,105,229410.0,130000.0,-45.0,-46.0,-39.0,-46.0,-45.0,-46.0,-40.0,-45.0,-84.0,-84.0,-81.0,-80.0,39.0,38.0,42.0,34.0,1
1952,3C:55:76:E8:8F:1F,3923248,688563347,81327,204015470,3841921,484547877,38,38064,7677722,37553,7590903,511,86819,15970,42,81388,8265,38,563,154850.0,48750.0,-47.0,-51.0,-44.0,-40.0,-46.0,-51.0,-46.0,-39.0,-84.0,-84.0,-81.0,-80.0,37.0,33.0,37.0,40.0,1
1953,92:69:1D:31:68:E9,3845914,488188395,3993,3640518,3841921,484547877,0,5120,1133827,4961,1097794,159,36033,2167,12,4228,93,0,55,216660.0,130000.0,-51.0,-47.0,-44.0,-46.0,-55.0,-51.0,-48.0,-50.0,-84.0,-84.0,-81.0,-80.0,33.0,37.0,37.0,34.0,1
1954,CC:2F:71:3F:1F:24,4856587,1623072046,1014666,1138524169,3841921,484547877,364,837457,920708648,836674,920614020,783,94628,809168,15,1014601,106235,361,643,130000.0,43333.0,-70.0,-70.0,-66.0,-71.0,-69.0,-70.0,-66.0,-71.0,-84.0,-84.0,-81.0,-80.0,14.0,14.0,15.0,9.0,1
1955,CC:2F:71:3E:C5:1F,3842866,484663308,941,115027,3841925,484548281,0,3926,329917,3239,248321,687,81596,997,11,1352,25,0,52,130000.0,39000.0,-71.0,-71.0,-69.0,-60.0,-72.0,-72.0,-70.0,-62.0,-84.0,-84.0,-81.0,-80.0,13.0,13.0,12.0,20.0,1
1956,BA:8C:B9:54:50:24,3846813,490736885,4888,6188604,3841925,484548281,0,9363,1724948,9341,1721453,22,3495,2354,17,5364,41,0,65,216660.0,130000.0,-48.0,-35.0,-43.0,-45.0,-44.0,-35.0,-44.0,-47.0,-84.0,-84.0,-81.0,-80.0,36.0,49.0,38.0,35.0,1
1957,62:47:05:9D:EB:15,3844052,486972203,2125,2423720,3841927,484548483,0,4314,3012025,4283,3007044,31,4981,2056,0,2175,56,0,105,229410.0,130000.0,-45.0,-46.0,-39.0,-46.0,-45.0,-46.0,-40.0,-45.0,-84.0,-84.0,-81.0,-80.0,39.0,38.0,42.0,34.0,1
1958,3C:55:76:E8:8F:1F,3923255,688564083,81328,204015600,3841927,484548483,38,38077,7678649,37566,7591830,511,86819,15971,42,81389,8265,38,563,154850.0,48750.0,-50.0,-52.0,-45.0,-43.0,-49.0,-51.0,-45.0,-42.0,-84.0,-84.0,-81.0,-80.0,34.0,32.0,36.0,37.0,1
1959,92:69:1D:31:68:E9,3845920,488189001,3993,3640518,3841927,484548483,0,5120,1133827,4961,1097794,159,36033,2167,12,4228,93,0,55,216660.0,130000.0,-51.0,-47.0,-44.0,-46.0,-55.0,-51.0,-48.0,-50.0,-84.0,-84.0,-81.0,-80.0,33.0,37.0,37.0,34.0,1
1960,CC:2F:71:3F:1F:24,4856806,1623339206,1014879,1138790723,3841927,484548483,364,837656,920965814,836873,920871186,783,94628,809362,15,1014814,106256,361,643,117000.0,39000.0,-69.0,-70.0,-66.0,-71.0,-69.0,-70.0,-66.0,-70.0,-84.0,-84.0,-81.0,-80.0,15.0,14.0,15.0,9.0,1
1961,CC:2F:71:3E:C5:1F,3842868,484663510,941,115027,3841927,484548483,0,3926,329917,3239,248321,687,81596,997,11,1352,25,0,52,130000.0,39000.0,-71.0,-71.0,-69.0,-60.0,-72.0,-72.0,-70.0,-62.0,-84.0,-84.0,-81.0,-80.0,13.0,13.0,12.0,20.0,1
1962,BA:8C:B9:54:50:24,3846815,490737087,4888,6188604,3841927,484548483,0,9363,1724948,9341,1721453,22,3495,2354,17,5364,41,0,65,216660.0,130000.0,-48.0,-35.0,-43.0,-45.0,-44.0,-35.0,-44.0,-47.0,-84.0,-84.0,-81.0,-80.0,36.0,49.0,38.0,35.0,1
1963,62:47:05:9D:EB:15,3844059,486972869,2125,2423720,3841934,484549149,0,4314,3012025,4283,3007044,31,4981,2056,0,2175,56,0,105,229410.0,130000.0,-45.0,-46.0,-39.0,-46.0,-45.0,-46.0,-40.0,-45.0,-84.0,-84.0,-81.0,-80.0,39.0,38.0,42.0,34.0,1
1964,3C:55:76:E8:8F:1F,3923262,688564749,81328,204015600,3841934,484549149,38,38077,7678649,37566,7591830,511,86819,15971,42,81389,8265,38,563,154850.0,48750.0,-50.0,-52.0,-45.0,-43.0,-49.0,-51.0,-45.0,-42.0,-84.0,-84.0,-81.0,-80.0,34.0,32.0,36.0,37.0,1
1965,92:69:1D:31:68:E9,3845927,488189667,3993,3640518,3841934,484549149,0,5120,1133827,4961,1097794,159,36033,2167,12,4228,93,0,55,216660.0,130000.0,-51.0,-47.0,-44.0,-46.0,-55.0,-51.0,-48.0,-50.0,-84.0,-84.0,-81.0,-80.0,33.0,37.0,37.0,34.0,1
1966,CC:2F:71:3F:1F:24,4857024,1623606038,1015090,1139056889,3841934,484549149,364,837851,921225380,837068,921130752,783,94628,809550,15,1015025,106257,361,643,130000.0,43333.0,-69.0,-70.0,-67.0,-71.0,-69.0,-70.0,-66.0,-70.0,-84.0,-84.0,-81.0,-80.0,15.0,14.0,14.0,9.0,1
1967,CC:2F:71:3E:C5:1F,3842875,484664176,941,115027,3841934,484549149,0,3926,329917,3239,248321,687,81596,997,11,1352,25,0,52,130000.0,39000.0,-71.0,-71.0,-69.0,-60.0,-72.0,-72.0,-70.0,-62.0,-84.0,-84.0,-81.0,-80.0,13.0,13.0,12.0,20.0,1
1968,BA:8C:B9:54:50:24,3846822,490737753,4888,6188604,3841934,484549149,0,9363,1724948,9341,1721453,22,3495,2354,17,5364,41,0,65,216660.0,130000.0,-48.0,-35.0,-43.0,-45.0,-44.0,-35.0,-44.0,-47.0,-84.0,-84.0,-81.0,-80.0,36.0,49.0,38.0,35.0,1
1969,62:47:05:9D:EB:15,3844061,486973071,2125,2423720,3841936,484549351,0,4314,3012025,4283,3007044,31,4981,2056,0,2175,56,0,105,229410.0,130000.0,-45.0,-46.0,-39.0,-46.0,-45.0,-46.0,-40.0,-45.0,-84.0,-84.0,-81.0,-80.0,39.0,38.0,42.0,34.0,1
1970,3C:55:76:E8:8F:1F,3923264,688564951,81328,204015600,3841936,484549351,38,38077,7678649,37566,7591830,511,86819,15971,42,81389,8265,38,563,154850.0,48750.0,-50.0,-52.0,-45.0,-43.0,-49.0,-51.0,-45.0,-42.0,-84.0,-84.0,-81.0,-80.0,34.0,32.0,36.0,37.0,1
1971,92:69:1D:31:68:E9,3845929,488189869,3993,3640518,3841936,484549351,0,5120,1133827,4961,1097794,159,36033,2167,12,4228,93,0,55,216660.0,130000.0,-51.0,-47.0,-44.0,-46.0,-55.0,-51.0,-48.0,-50.0,-84.0,-84.0,-81.0,-80.0,33.0,37.0,37.0,34.0,1
1972,CC:2F:71:3F:1F:24,4857252,1623888325,1015316,1139338974,3841936,484549351,364,838071,921501743,837288,921407115,783,94628,809756,15,1015251,106264,361,643,130000.0,43333.0,-69.0,-71.0,-66.0,-72.0,-69.0,-70.0,-66.0,-70.0,-84.0,-84.0,-81.0,-80.0,15.0,13.0,15.0,8.0,1
1973,CC:2F:71:3E:C5:1F,3842879,484664580,941,115027,3841938,484549553,0,3927,329987,3240,248391,687,81596,997,11,1353,25,0,52,130000.0,39000.0,-71.0,-71.0,-69.0,-60.0,-72.0,-72.0,-70.0,-62.0,-84.0,-84.0,-81.0,-80.0,13.0,13.0,12.0,20.0,1
1974,BA:8C:B9:54:50:24,3846827,490738219,4888,6188604,3841939,484549615,0,9365,1725084,9343,1721589,22,3495,2354,17,5365,41,0,65,216660.0,130000.0,-39.0,-36.0,-45.0,-52.0,-44.0,-35.0,-44.0,-47.0,-84.0,-84.0,-81.0,-80.0,45.0,48.0,36.0,28.0,1
1975,62:47:05:9D:EB:15,3844068,486973739,2125,2423720,3841943,484550019,0,4316,3012161,4285,3007180,31,4981,2056,0,2176,56,0,105,229410.0,130000.0,-45.0,-46.0,-40.0,-45.0,-45.0,-46.0,-39.0,-45.0,-84.0,-84.0,-81.0,-80.0,39.0,38.0,41.0,35.0,1
1976,3C:55:76:E8:8F:1F,3923272,688565771,81329,204015752,3841943,484550019,38,38087,7679456,37576,7592637,511,86819,15973,42,81390,8265,38,563,154850.0,48750.0,-50.0,-53.0,-47.0,-44.0,-49.0,-52.0,-45.0,-42.0,-84.0,-84.0,-81.0,-80.0,34.0,31.0,34.0,36.0,1
1977,92:69:1D:31:68:E9,3845936,488190537,3993,3640518,3841943,484550019,0,5122,1133963,4963,1097930,159,36033,2167,12,4229,93,0,55,216660.0,130000.0,-51.0,-47.0,-44.0,-46.0,-55.0,-51.0,-48.0,-50.0,-84.0,-84.0,-81.0,-80.0,33.0,37.0,37.0,34.0,1
1978,CC:2F:71:3F:1F:24,4857473,1624153955,1015528,1139603734,3841945,484550221,364,838268,921764419,837484,921669673,784,94746,809944,15,1015463,106274,361,643,130000.0,43333.0,-68.0,-70.0,-67.0,-71.0,-68.0,-70.0,-66.0,-71.0,-84.0,-84.0,-81.0,-80.0,16.0,14.0,14.0,9.0,1
1979,CC:2F:71:3E:C5:1F,3842887,484665308,941,115027,3841946,484550281,0,3928,330057,3241,248461,687,81596,997,11,1353,25,0,52,130000.0,39000.0,-71.0,-72.0,-69.0,-60.0,-72.0,-72.0,-70.0,-62.0,-84.0,-84.0,-81.0,-80.0,13.0,12.0,12.0,20.0,1
1980,BA:8C:B9:54:50:24,3846834,490738885,4888,6188604,3841946,484550281,0,9365,1725084,9343,1721589,22,3495,2354,17,5365,41,0,65,216660.0,130000.0,-39.0,-36.0,-45.0,-52.0,-44.0,-35.0,-44.0,-47.0,-84.0,-84.0,-81.0,-80.0,45.0,48.0,36.0,28.0,1
1981,62:47:05:9D:EB:15,3844072,486974135,2125,2423720,3841947,484550415,0,4316,3012161,4285,3007180,31,4981,2056,0,2176,56,0,105,229410.0,130000.0,-45.0,-46.0,-40.0,-45.0,-45.0,-46.0,-39.0,-45.0,-84.0,-84.0,-81.0,-80.0,39.0,38.0,41.0,35.0,1
1982,3C:55:76:E8:8F:1F,3923277,688566235,81329,204015752,3841948,484550483,38,38087,7679456,37576,7592637,511,86819,15973,42,81390,8265,38,563,154850.0,48750.0,-50.0,-53.0,-47.0,-44.0,-49.0,-52.0,-45.0,-42.0,-84.0,-84.0,-81.0,-80.0,34.0,31.0,34.0,36.0,1
1983,92:69:1D:31:68:E9,3845941,488191001,3993,3640518,3841948,484550483,0,5122,1133963,4963,1097930,159,36033,2167,12,4229,93,0,55,216660.0,130000.0,-51.0,-47.0,-44.0,-46.0,-55.0,-51.0,-48.0,-50.0,-84.0,-84.0,-81.0,-80.0,33.0,37.0,37.0,34.0,1
1984,CC:2F:71:3F:1F:24,4857692,1624425403,1015744,1139874920,3841948,484550483,364,838471,922026875,837687,921932129,784,94746,810136,15,1015679,106274,361,643,130000.0,43333.0,-69.0,-70.0,-66.0,-71.0,-69.0,-70.0,-66.0,-71.0,-84.0,-84.0,-81.0,-80.0,15.0,14.0,15.0,9.0,1
1985,CC:2F:71:3E:C5:1F,3842889,484665510,941,115027,3841948,484550483,0,3928,330057,3241,248461,687,81596,997,11,1353,25,0,52,130000.0,39000.0,-71.0,-72.0,-69.0,-60.0,-72.0,-72.0,-70.0,-62.0,-84.0,-84.0,-81.0,-80.0,13.0,12.0,12.0,20.0,1
1986,BA:8C:B9:54:50:24,3846836,490739087,4888,6188604,3841948,484550483,0,9365,1725084,9343,1721589,22,3495,2354,17,5365,41,0,65,216660.0,130000.0,-39.0,-36.0,-45.0,-52.0,-44.0,-35.0,-44.0,-47.0,-84.0,-84.0,-81.0,-79.0,45.0,48.0,36.0,27.0,1
1987,62:47:05:9D:EB:15,3844079,486974809,2125,2423720,3841954,484551089,0,4316,3012161,4285,3007180,31,4981,2056,0,2176,56,0,105,229410.0,130000.0,-45.0,-46.0,-40.0,-45.0,-45.0,-46.0,-39.0,-45.0,-84.0,-84.0,-81.0,-79.0,39.0,38.0,41.0,34.0,1
1988,3C:55:76:E8:8F:1F,3923283,688566841,81329,204015752,3841954,484551089,38,38087,7679456,37576,7592637,511,86819,15973,42,81390,8265,38,563,154850.0,48750.0,-50.0,-53.0,-47.0,-44.0,-49.0,-52.0,-45.0,-42.0,-84.0,-84.0,-81.0,-79.0,34.0,31.0,34.0,35.0,1
1989,92:69:1D:31:68:E9,3845947,488191607,3993,3640518,3841954,484551089,0,5122,1133963,4963,1097930,159,36033,2167,12,4229,93,0,55,216660.0,130000.0,-51.0,-47.0,-44.0,-46.0,-55.0,-51.0,-48.0,-50.0,-84.0,-84.0,-81.0,-79.0,33.0,37.0,37.0,33.0,1
1990,CC:2F:71:3F:1F:24,4857913,1624690872,1015959,1140139783,3841954,484551089,364,838675,922288159,837891,922193413,784,94746,810327,15,1015894,106281,361,643,130000.0,43333.0,-69.0,-70.0,-67.0,-71.0,-69.0,-69.0,-67.0,-71.0,-84.0,-84.0,-81.0,-79.0,15.0,14.0,14.0,8.0,1
1991,CC:2F:71:3E:C5:1F,3842895,484666116,941,115027,3841954,484551089,0,3928,330057,3241,248461,687,81596,997,11,1353,25,0,52,130000.0,39000.0,-71.0,-72.0,-69.0,-60.0,-72.0,-72.0,-70.0,-62.0,-84.0,-84.0,-81.0,-79.0,13.0,12.0,12.0,19.0,1
1992,BA:8C:B9:54:50:24,3846842,490739693,4888,6188604,3841954,484551089,0,9365,1725084,9343,1721589,22,3495,2354,17,5365,41,0,65,216660.0,130000.0,-39.0,-36.0,-45.0,-52.0,-44.0,-35.0,-44.0,-47.0,-84.0,-84.0,-81.0,-79.0,45.0,48.0,36.0,27.0,1
1993,62:47:05:9D:EB:15,3844082,486975071,2125,2423720,3841957,484551351,0,4316,3012161,4285,3007180,31,4981,2056,0,2176,56,0,105,229410.0,130000.0,-45.0,-46.0,-40.0,-45.0,-45.0,-46.0,-39.0,-45.0,-84.0,-84.0,-81.0,-80.0,39.0,38.0,41.0,35.0,1
1994,3C:55:76:E8:8F:1F,3923286,688567103,81329,204015752,3841957,484551351,38,38087,7679456,37576,7592637,511,86819,15973,42,81390,8265,38,563,154850.0,48750.0,-50.0,-53.0,-47.0,-44.0,-49.0,-52.0,-45.0,-42.0,-84.0,-84.0,-81.0,-80.0,34.0,31.0,34.0,36.0,1
1995,92:69:1D:31:68:E9,3845950,488191869,3993,3640518,3841957,484551351,0,5122,1133963,4963,1097930,159,36033,2167,12,4229,93,0,55,216660.0,130000.0,-51.0,-47.0,-44.0,-46.0,-55.0,-51.0,-48.0,-50.0,-84.0,-84.0,-81.0,-80.0,33.0,37.0,37.0,34.0,1
1996,CC:2F:71:3F:1F:24,4858130,1624955254,1016169,1140403499,3841961,484551755,364,838871,922546545,838087,922451799,784,94746,810516,15,1016104,106338,361,643,86667.0,14444.0,-70.0,-70.0,-67.0,-72.0,-70.0,-70.0,-66.0,-72.0,-84.0,-84.0,-81.0,-80.0,14.0,14.0,14.0,8.0,1
1997,CC:2F:71:3E:C5:1F,3842903,484667055,941,115027,3841962,484552028,0,3928,330057,3241,248461,687,81596,997,11,1353,25,0,52,130000.0,39000.0,-71.0,-72.0,-69.0,-60.0,-72.0,-72.0,-70.0,-62.0,-84.0,-84.0,-81.0,-80.0,13.0,12.0,12.0,20.0,1
1998,BA:8C:B9:54:50:24,3846850,490740632,4888,6188604,3841962,484552028,0,9365,1725084,9343,1721589,22,3495,2354,17,5365,41,0,65,216660.0,130000.0,-39.0,-36.0,-45.0,-52.0,-44.0,-35.0,-44.0,-47.0,-84.0,-84.0,-81.0,-80.0,45.0,48.0,36.0,28.0,1
1999,62:47:05:9D:EB:15,3844089,486975950,2125,2423720,3841964,484552230,0,4316,3012161,4285,3007180,31,4981,2056,0,2176,56,0,105,229410.0,130000.0,-45.0,-46.0,-40.0,-45.0,-45.0,-46.0,-39.0,-45.0,-84.0,-84.0,-81.0,-80.0,39.0,38.0,41.0,35.0,1
2000,3C:55:76:E8:8F:1F,3923293,688567982,81329,204015752,3841964,484552230,38,38087,7679456,37576,7592637,511,86819,15973,42,81390,8265,38,563,154850.0,48750.0,-50.0,-53.0,-47.0,-44.0,-49.0,-52.0,-45.0,-42.0,-84.0,-84.0,-81.0,-80.0,34.0,31.0,34.0,36.0,1
2001,92:69:1D:31:68:E9,3845957,488192748,3993,3640518,3841964,484552230,0,5122,1133963,4963,1097930,159,36033,2167,12,4229,93,0,55,216660.0,130000.0,-51.0,-47.0,-44.0,-46.0,-55.0,-51.0,-48.0,-50.0,-84.0,-84.0,-81.0,-80.0,33.0,37.0,37.0,34.0,1
2002,CC:2F:71:3F:1F:24,4858347,1625221221,1016383,1140668991,3841964,484552230,364,839068,922804059,838284,922709313,784,94746,810703,15,1016318,106341,361,643,86667.0,14444.0,-70.0,-70.0,-67.0,-71.0,-69.0,-69.0,-66.0,-71.0,-84.0,-84.0,-81.0,-80.0,14.0,14.0,14.0,9.0,1
2003,CC:2F:71:3E:C5:1F,3842905,484667257,941,115027,3841964,484552230,0,3928,330057,3241,248461,687,81596,997,11,1353,25,0,52,130000.0,39000.0,-71.0,-72.0,-69.0,-60.0,-72.0,-72.0,-70.0,-62.0,-84.0,-84.0,-81.0,-80.0,13.0,12.0,12.0,20.0,1
2004,BA:8C:B9:54:50:24,3846852,490740834,4888,6188604,3841964,484552230,0,9365,1725084,9343,1721589,22,3495,2354,17,5365,41,0,65,216660.0,130000.0,-39.0,-36.0,-45.0,-52.0,-44.0,-35.0,-44.0,-47.0,-84.0,-84.0,-81.0,-80.0,45.0,48.0,36.0,28.0,1
2005,62:47:05:9D:EB:15,3844094,486976414,2125,2423720,3841969,484552694,0,4316,3012161,4285,3007180,31,4981,2056,0,2176,56,0,105,229410.0,130000.0,-45.0,-46.0,-40.0,-45.0,-45.0,-46.0,-39.0,-45.0,-84.0,-84.0,-81.0,-80.0,39.0,38.0,41.0,35.0,1
2006,3C:55:76:E8:8F:1F,3923298,688568446,81329,204015752,3841969,484552694,38,38087,7679456,37576,7592637,511,86819,15973,42,81390,8265,38,563,154850.0,48750.0,-50.0,-53.0,-47.0,-44.0,-49.0,-52.0,-45.0,-42.0,-84.0,-84.0,-81.0,-80.0,34.0,31.0,34.0,36.0,1
2007,92:69:1D:31:68:E9,3845964,488193414,3993,3640518,3841971,484552896,0,5122,1133963,4963,1097930,159,36033,2167,12,4229,93,0,55,216660.0,130000.0,-51.0,-47.0,-44.0,-46.0,-55.0,-51.0,-48.0,-50.0,-84.0,-84.0,-81.0,-80.0,33.0,37.0,37.0,34.0,1
2008,CC:2F:71:3F:1F:24,4858571,1625493633,1016600,1140940737,3841971,484552896,364,839258,923057377,838474,922962631,784,94746,810893,15,1016535,106354,361,643,86667.0,14444.0,-69.0,-70.0,-66.0,-71.0,-69.0,-69.0,-66.0,-70.0,-84.0,-84.0,-81.0,-80.0,15.0,14.0,15.0,9.0,1
2009,CC:2F:71:3E:C5:1F,3842912,484667923,941,115027,3841971,484552896,0,3928,330057,3241,248461,687,81596,997,11,1353,25,0,52,130000.0,39000.0,-71.0,-72.0,-69.0,-60.0,-72.0,-72.0,-70.0,-62.0,-84.0,-84.0,-81.0,-80.0,13.0,12.0,12.0,20.0,1
2010,BA:8C:B9:54:50:24,3846859,490741500,4888,6188604,3841971,484552896,0,9365,1725084,9343,1721589,22,3495,2354,17,5365,41,0,65,216660.0,130000.0,-39.0,-36.0,-45.0,-52.0,-44.0,-35.0,-44.0,-47.0,-84.0,-84.0,-81.0,-80.0,45.0,48.0,36.0,28.0,1
2011,62:47:05:9D:EB:15,3844098,486976818,2125,2423720,3841973,484553098,0,4316,3012161,4285,3007180,31,4981,2056,0,2176,56,0,105,229410.0,130000.0,-45.0,-46.0,-40.0,-45.0,-45.0,-46.0,-39.0,-45.0,-84.0,-84.0,-81.0,-80.0,39.0,38.0,41.0,35.0,1
2012,3C:55:76:E8:8F:1F,3923303,688569070,81330,204015972,3841973,484553098,38,38097,7680214,37586,7593395,511,86819,15975,42,81391,8265,38,563,154850.0,48750.0,-50.0,-51.0,-44.0,-45.0,-47.0,-50.0,-42.0,-43.0,-84.0,-84.0,-81.0,-80.0,34.0,33.0,37.0,35.0,1
2013,92:69:1D:31:68:E9,3845966,488193616,3993,3640518,3841973,484553098,0,5122,1133963,4963,1097930,159,36033,2167,12,4229,93,0,55,216660.0,130000.0,-51.0,-47.0,-44.0,-46.0,-55.0,-51.0,-48.0,-50.0,-84.0,-84.0,-81.0,-80.0,33.0,37.0,37.0,34.0,1
2014,CC:2F:71:3F:1F:24,4859015,1626019701,1017042,1141466603,3841973,484553098,364,839562,923329885,838778,923235139,784,94746,811193,15,1016977,106354,361,643,86667.0,14444.0,-70.0,-70.0,-67.0,-71.0,-69.0,-70.0,-66.0,-71.0,-84.0,-84.0,-81.0,-80.0,14.0,14.0,14.0,9.0,1
2015,CC:2F:71:3E:C5:1F,3842914,484668125,941,115027,3841973,484553098,0,3928,330057,3241,248461,687,81596,997,11,1353,25,0,52,130000.0,39000.0,-71.0,-72.0,-69.0,-60.0,-72.0,-72.0,-70.0,-62.0,-84.0,-84.0,-81.0,-80.0,13.0,12.0,12.0,20.0,1
2016,BA:8C:B9:54:50:24,3846863,490741904,4888,6188604,3841975,484553300,0,9365,1725084,9343,1721589,22,3495,2354,17,5365,41,0,65,216660.0,130000.0,-39.0,-36.0,-45.0,-52.0,-44.0,-35.0,-44.0,-47.0,-84.0,-84.0,-81.0,-80.0,45.0,48.0,36.0,28.0,1
2017,62:47:05:9D:EB:15,3844104,486977424,2125,2423720,3841979,484553704,0,4316,3012161,4285,3007180,31,4981,2056,0,2176,56,0,105,229410.0,130000.0,-45.0,-46.0,-40.0,-45.0,-45.0,-46.0,-39.0,-45.0,-84.0,-84.0,-81.0,-80.0,39.0,38.0,41.0,35.0,1
2018,3C:55:76:E8:8F:1F,3923309,688569676,81330,204015972,3841979,484553704,38,38097,7680214,37586,7593395,511,86819,15975,42,81391,8265,38,563,154850.0,48750.0,-50.0,-51.0,-44.0,-45.0,-47.0,-50.0,-42.0,-43.0,-84.0,-84.0,-81.0,-80.0,34.0,33.0,37.0,35.0,1
2019,92:69:1D:31:68:E9,3845975,488194484,3993,3640518,3841982,484553966,0,5122,1133963,4963,1097930,159,36033,2167,12,4229,93,0,55,216660.0,130000.0,-51.0,-47.0,-44.0,-46.0,-55.0,-51.0,-48.0,-50.0,-84.0,-84.0,-81.0,-80.0,33.0,37.0,37.0,34.0,1
2020,CC:2F:71:3F:1F:24,4859428,1626528959,1017446,1141974993,3841982,484553966,364,839853,923596117,839069,923501371,784,94746,811479,15,1017381,106356,361,643,115556.0,28889.0,-70.0,-70.0,-67.0,-71.0,-69.0,-69.0,-66.0,-71.0,-84.0,-84.0,-81.0,-80.0,14.0,14.0,14.0,9.0,1
2021,CC:2F:71:3E:C5:1F,3842923,484668993,941,115027,3841982,484553966,0,3928,330057,3241,248461,687,81596,997,11,1353,25,0,52,130000.0,39000.0,-71.0,-72.0,-69.0,-60.0,-72.0,-72.0,-70.0,-62.0,-84.0,-84.0,-81.0,-80.0,13.0,12.0,12.0,20.0,1
2022,BA:8C:B9:54:50:24,3846870,490742570,4888,6188604,3841982,484553966,0,9365,1725084,9343,1721589,22,3495,2354,17,5365,41,0,65,216660.0,130000.0,-39.0,-36.0,-45.0,-52.0,-44.0,-35.0,-44.0,-47.0,-84.0,-84.0,-81.0,-80.0,45.0,48.0,36.0,28.0,1
2023,62:47:05:9D:EB:15,3844107,486977686,2125,2423720,3841982,484553966,0,4316,3012161,4285,3007180,31,4981,2056,0,2176,56,0,105,229410.0,130000.0,-45.0,-46.0,-40.0,-45.0,-45.0,-46.0,-39.0,-45.0,-84.0,-84.0,-81.0,-80.0,39.0,38.0,41.0,35.0,1
2024,3C:55:76:E8:8F:1F,3923315,688570314,81331,204016146,3841984,484554168,38,38105,7680888,37594,7594069,511,86819,15977,42,81392,8265,38,563,154850.0,48750.0,-45.0,-55.0,-50.0,-41.0,-44.0,-53.0,-47.0,-40.0,-84.0,-84.0,-81.0,-80.0,39.0,29.0,31.0,39.0,1
2025,92:69:1D:31:68:E9,3845977,488194686,3993,3640518,3841984,484554168,0,5122,1133963,4963,1097930,159,36033,2167,12,4229,93,0,55,216660.0,130000.0,-51.0,-47.0,-44.0,-46.0,-55.0,-51.0,-48.0,-50.0,-84.0,-84.0,-81.0,-80.0,33.0,37.0,37.0,34.0,1
2026,CC:2F:71:3F:1F:24,4859644,1626797557,1017660,1142243389,3841984,484554168,364,840047,923852883,839263,923758137,784,94746,811668,15,1017595,106398,361,643,86667.0,14444.0,-70.0,-69.0,-67.0,-71.0,-69.0,-69.0,-66.0,-71.0,-84.0,-84.0,-81.0,-80.0,14.0,15.0,14.0,9.0,1
2027,CC:2F:71:3E:C5:1F,3842925,484669195,941,115027,3841984,484554168,0,3928,330057,3241,248461,687,81596,997,11,1353,25,0,52,130000.0,39000.0,-71.0,-72.0,-69.0,-60.0,-72.0,-72.0,-70.0,-62.0,-84.0,-84.0,-81.0,-80.0,13.0,12.0,12.0,20.0,1
2028,BA:8C:B9:54:50:24,3846872,490742772,4888,6188604,3841984,484554168,0,9365,1725084,9343,1721589,22,3495,2354,17,5365,41,0,65,216660.0,130000.0,-39.0,-36.0,-45.0,-52.0,-44.0,-35.0,-44.0,-47.0,-84.0,-84.0,-81.0,-80.0,45.0,48.0,36.0,28.0,1
2029,62:47:05:9D:EB:15,3844115,486978494,2125,2423720,3841990,484554774,0,4316,3012161,4285,3007180,31,4981,2056,0,2176,56,0,105,229410.0,130000.0,-45.0,-46.0,-40.0,-45.0,-45.0,-46.0,-39.0,-45.0,-84.0,-84.0,-81.0,-80.0,39.0,38.0,41.0,35.0,1
2030,3C:55:76:E8:8F:1F,3923321,688570920,81331,204016146,3841990,484554774,38,38108,7683995,37597,7597176,511,86819,15979,42,81392,8265,38,563,154850.0,48750.0,-47.0,-51.0,-44.0,-42.0,-44.0,-53.0,-47.0,-40.0,-84.0,-84.0,-81.0,-80.0,37.0,33.0,37.0,38.0,1
2031,92:69:1D:31:68:E9,3845983,488195292,3993,3640518,3841990,484554774,0,5122,1133963,4963,1097930,159,36033,2167,12,4229,93,0,55,216660.0,130000.0,-51.0,-47.0,-44.0,-46.0,-55.0,-51.0,-48.0,-50.0,-84.0,-84.0,-81.0,-80.0,33.0,37.0,37.0,34.0,1
2032,CC:2F:71:3F:1F:24,4859878,1627090111,1017887,1142535211,3841991,484554900,364,840265,924142199,839481,924047453,784,94746,811878,15,1017822,106401,361,643,65000.0,14444.0,-70.0,-69.0,-66.0,-71.0,-69.0,-69.0,-65.0,-71.0,-84.0,-84.0,-81.0,-80.0,14.0,15.0,15.0,9.0,1
2033,CC:2F:71:3E:C5:1F,3842933,484669987,941,115027,3841992,484554960,0,3928,330057,3241,248461,687,81596,997,11,1353,25,0,52,130000.0,39000.0,-71.0,-72.0,-69.0,-60.0,-72.0,-72.0,-70.0,-62.0,-84.0,-84.0,-81.0,-80.0,13.0,12.0,12.0,20.0,1
2034,BA:8C:B9:54:50:24,3846880,490743564,4888,6188604,3841992,484554960,0,9365,1725084,9343,1721589,22,3495,2354,17,5365,41,0,65,216660.0,130000.0,-39.0,-36.0,-45.0,-52.0,-44.0,-35.0,-44.0,-47.0,-84.0,-84.0,-81.0,-80.0,45.0,48.0,36.0,28.0,1
2035,62:47:05:9D:EB:15,3844119,486978882,2125,2423720,3841994,484555162,0,4316,3012161,4285,3007180,31,4981,2056,0,2176,56,0,105,229410.0,130000.0,-45.0,-46.0,-40.0,-45.0,-45.0,-46.0,-39.0,-45.0,-84.0,-84.0,-81.0,-80.0,39.0,38.0,41.0,35.0,1
2036,3C:55:76:E8:8F:1F,3924493,691672604,82497,207117240,3841996,484555364,38,38390,7722337,37879,7635518,511,86819,16099,42,82558,8348,38,564,154850.0,51610.0,-45.0,-55.0,-50.0,-41.0,-46.0,-54.0,-48.0,-42.0,-84.0,-84.0,-81.0,-80.0,39.0,29.0,31.0,39.0,1
2037,92:69:1D:31:68:E9,3845989,488195882,3993,3640518,3841996,484555364,0,5123,1134031,4964,1097998,159,36033,2167,12,4229,93,0,55,216660.0,130000.0,-53.0,-47.0,-42.0,-47.0,-55.0,-51.0,-48.0,-50.0,-84.0,-84.0,-81.0,-80.0,31.0,37.0,39.0,33.0,1
2038,CC:2F:71:3F:1F:24,4860114,1627377278,1018118,1142821914,3841996,484555364,364,840479,924419070,839695,924324324,784,94746,812080,15,1018053,106415,361,643,115556.0,28889.0,-70.0,-69.0,-66.0,-70.0,-70.0,-69.0,-66.0,-70.0,-84.0,-84.0,-81.0,-80.0,14.0,15.0,15.0,10.0,1
2039,CC:2F:71:3E:C5:1F,3842939,484670593,941,115027,3841998,484555566,0,3928,330057,3241,248461,687,81596,997,11,1353,25,0,52,130000.0,39000.0,-71.0,-72.0,-69.0,-60.0,-72.0,-72.0,-70.0,-62.0,-84.0,-84.0,-81.0,-80.0,13.0,12.0,12.0,20.0,1
2040,BA:8C:B9:54:50:24,3846886,490744170,4888,6188604,3841998,484555566,0,9365,1725084,9343,1721589,22,3495,2354,17,5365,41,0,65,216660.0,130000.0,-39.0,-36.0,-45.0,-52.0,-44.0,-35.0,-44.0,-47.0,-84.0,-84.0,-81.0,-80.0,45.0,48.0,36.0,28.0,1
2041,62:47:05:9D:EB:15,3844125,486979488,2125,2423720,3842000,484555768,0,4316,3012161,4285,3007180,31,4981,2056,0,2176,56,0,105,229410.0,130000.0,-45.0,-46.0,-40.0,-45.0,-45.0,-46.0,-39.0,-45.0,-84.0,-84.0,-81.0,-80.0,39.0,38.0,41.0,35.0,1
2042,3C:55:76:E8:8F:1F,3924501,691673534,82501,207117766,3842000,484555768,38,38405,7724969,37894,7638150,511,86819,16104,42,82562,8348,38,564,162500.0,48750.0,-45.0,-54.0,-50.0,-41.0,-45.0,-54.0,-49.0,-40.0,-84.0,-84.0,-81.0,-80.0,39.0,30.0,31.0,39.0,1
2043,92:69:1D:31:68:E9,3845993,488196286,3993,3640518,3842000,484555768,0,5123,1134031,4964,1097998,159,36033,2167,12,4229,93,0,55,216660.0,130000.0,-53.0,-47.0,-42.0,-47.0,-55.0,-51.0,-48.0,-50.0,-84.0,-84.0,-81.0,-80.0,31.0,37.0,39.0,33.0,1
2044,CC:2F:71:3F:1F:24,4860327,1627639414,1018327,1143083646,3842000,484555768,364,840671,924674144,839887,924579398,784,94746,812264,15,1018262,106424,361,643,115556.0,28889.0,-70.0,-69.0,-66.0,-71.0,-70.0,-69.0,-66.0,-70.0,-84.0,-84.0,-81.0,-80.0,14.0,15.0,15.0,9.0,1
2045,CC:2F:71:3E:C5:1F,3842941,484670795,941,115027,3842000,484555768,0,3928,330057,3241,248461,687,81596,997,11,1353,25,0,52,130000.0,39000.0,-71.0,-72.0,-69.0,-60.0,-72.0,-72.0,-70.0,-62.0,-84.0,-84.0,-81.0,-80.0,13.0,12.0,12.0,20.0,1
2046,BA:8C:B9:54:50:24,3846888,490744372,4888,6188604,3842000,484555768,0,9365,1725084,9343,1721589,22,3495,2354,17,5365,41,0,65,216660.0,130000.0,-39.0,-36.0,-45.0,-52.0,-44.0,-35.0,-44.0,-47.0,-84.0,-84.0,-81.0,-80.0,45.0,48.0,36.0,28.0,1
2047,62:47:05:9D:EB:15,3844130,486979952,2125,2423720,3842005,484556232,0,4316,3012161,4285,3007180,31,4981,2056,0,2176,56,0,105,229410.0,130000.0,-45.0,-46.0,-40.0,-45.0,-45.0,-46.0,-39.0,-45.0,-84.0,-84.0,-81.0,-80.0,39.0,38.0,41.0,35.0,1
2048,3C:55:76:E8:8F:1F,3924508,691674200,82501,207117766,3842007,484556434,38,38406,7725039,37895,7638220,511,86819,16104,42,82562,8348,38,564,162500.0,48750.0,-48.0,-59.0,-51.0,-45.0,-45.0,-54.0,-49.0,-41.0,-84.0,-84.0,-81.0,-80.0,36.0,25.0,30.0,35.0,1
2049,92:69:1D:31:68:E9,3846002,488197154,3993,3640518,3842009,484556636,0,5123,1134031,4964,1097998,159,36033,2167,12,4229,93,0,55,216660.0,130000.0,-53.0,-47.0,-42.0,-47.0,-55.0,-51.0,-48.0,-50.0,-84.0,-84.0,-81.0,-80.0,31.0,37.0,39.0,33.0,1
2050,CC:2F:71:3F:1F:24,4860544,1627900250,1018535,1143343614,3842009,484556636,364,840861,924928858,840077,924834112,784,94746,812447,15,1018470,106433,361,643,115556.0,28889.0,-68.0,-69.0,-66.0,-70.0,-68.0,-69.0,-65.0,-70.0,-84.0,-84.0,-81.0,-80.0,16.0,15.0,15.0,10.0,1
2051,CC:2F:71:3E:C5:1F,3842950,484671663,941,115027,3842009,484556636,0,3928,330057,3241,248461,687,81596,997,11,1353,25,0,52,130000.0,39000.0,-71.0,-72.0,-69.0,-60.0,-72.0,-72.0,-70.0,-62.0,-84.0,-84.0,-81.0,-80.0,13.0,12.0,12.0,20.0,1
2052,BA:8C:B9:54:50:24,3846898,490745356,4889,6188720,3842009,484556636,0,9369,1725356,9347,1721861,22,3495,2354,17,5366,41,0,65,216660.0,130000.0,-41.0,-34.0,-42.0,-46.0,-44.0,-34.0,-42.0,-46.0,-84.0,-84.0,-81.0,-80.0,43.0,50.0,39.0,34.0,1
2053,62:47:05:9D:EB:15,3844134,486980356,2125,2423720,3842009,484556636,0,4316,3012161,4285,3007180,31,4981,2056,0,2176,56,0,105,229410.0,130000.0,-45.0,-46.0,-40.0,-45.0,-45.0,-46.0,-39.0,-45.0,-84.0,-84.0,-81.0,-80.0,39.0,38.0,41.0,35.0,1
2054,3C:55:76:E8:8F:1F,3924511,691674518,82502,207117882,3842009,484556636,38,38412,7725451,37901,7638632,511,86819,16104,42,82564,8357,38,564,146250.0,1000.0,-49.0,-53.0,-46.0,-44.0,-48.0,-53.0,-46.0,-43.0,-84.0,-84.0,-81.0,-80.0,35.0,31.0,35.0,36.0,1
2055,92:69:1D:31:68:E9,3846003,488197270,3994,3640634,3842009,484556636,0,5125,1134167,4966,1098134,159,36033,2167,12,4230,93,0,55,216660.0,130000.0,-51.0,-47.0,-45.0,-48.0,-55.0,-51.0,-48.0,-50.0,-84.0,-84.0,-81.0,-80.0,33.0,37.0,36.0,32.0,1
2056,CC:2F:71:3F:1F:24,4860762,1628168790,1018751,1143611952,3842011,484556838,364,841055,925187168,840271,925092422,784,94746,812633,15,1018686,106434,361,643,115556.0,28889.0,-68.0,-70.0,-67.0,-72.0,-68.0,-70.0,-66.0,-71.0,-84.0,-84.0,-81.0,-80.0,16.0,14.0,14.0,8.0,1
2057,CC:2F:71:3E:C5:1F,3842953,484671981,942,115143,3842011,484556838,0,3930,330197,3243,248601,687,81596,997,11,1354,25,0,52,144444.0,39000.0,-71.0,-71.0,-70.0,-60.0,-72.0,-72.0,-70.0,-62.0,-84.0,-84.0,-81.0,-80.0,13.0,13.0,11.0,20.0,1
2058,BA:8C:B9:54:50:24,3846900,490745558,4889,6188720,3842011,484556838,0,9370,1725424,9348,1721929,22,3495,2354,17,5366,41,0,65,216660.0,130000.0,-48.0,-35.0,-43.0,-45.0,-44.0,-34.0,-42.0,-46.0,-84.0,-84.0,-81.0,-80.0,36.0,49.0,38.0,35.0,1
2059,62:47:05:9D:EB:15,3844144,486981340,2126,2423836,3842018,484557504,0,4318,3012297,4287,3007316,31,4981,2056,0,2177,56,0,105,229410.0,130000.0,-46.0,-46.0,-39.0,-46.0,-45.0,-46.0,-39.0,-46.0,-85.0,-85.0,-82.0,-80.0,39.0,39.0,43.0,34.0,1
2060,3C:55:76:E8:8F:1F,3924520,691675386,82502,207117882,3842018,484557504,38,38412,7725451,37901,7638632,511,86819,16104,42,82564,8357,38,564,146250.0,1000.0,-49.0,-53.0,-46.0,-44.0,-48.0,-53.0,-46.0,-43.0,-85.0,-85.0,-82.0,-80.0,36.0,32.0,36.0,36.0,1
2061,92:69:1D:31:68:E9,3846012,488198138,3994,3640634,3842018,484557504,0,5125,1134167,4966,1098134,159,36033,2167,12,4230,93,0,55,216660.0,130000.0,-51.0,-47.0,-45.0,-48.0,-55.0,-51.0,-48.0,-50.0,-85.0,-85.0,-82.0,-80.0,34.0,38.0,37.0,32.0,1
2062,CC:2F:71:3F:1F:24,4860986,1628435837,1018968,1143878333,3842018,484557504,364,841253,925437584,840469,925342838,784,94746,812829,15,1018903,106443,361,643,130000.0,43333.0,-69.0,-70.0,-67.0,-72.0,-68.0,-69.0,-66.0,-71.0,-85.0,-85.0,-82.0,-80.0,16.0,15.0,15.0,8.0,1
2063,CC:2F:71:3E:C5:1F,3842960,484672647,942,115143,3842018,484557504,0,3930,330197,3243,248601,687,81596,997,11,1354,25,0,52,144444.0,39000.0,-71.0,-71.0,-70.0,-60.0,-72.0,-72.0,-70.0,-62.0,-85.0,-85.0,-82.0,-80.0,14.0,14.0,12.0,20.0,1
2064,BA:8C:B9:54:50:24,3846907,490746224,4889,6188720,3842018,484557504,0,9372,1725560,9350,1722065,22,3495,2354,17,5366,41,0,65,216660.0,130000.0,-48.0,-35.0,-43.0,-45.0,-44.0,-34.0,-42.0,-46.0,-85.0,-85.0,-82.0,-80.0,37.0,50.0,39.0,35.0,1
2065,62:47:05:9D:EB:15,3844147,486981815,2126,2423836,3842021,484557979,0,4318,3012297,4287,3007316,31,4981,2056,0,2177,56,0,105,229410.0,130000.0,-46.0,-46.0,-39.0,-46.0,-45.0,-46.0,-39.0,-46.0,-85.0,-85.0,-82.0,-80.0,39.0,39.0,43.0,34.0,1
2066,3C:55:76:E8:8F:1F,3924523,691675861,82502,207117882,3842021,484557979,38,38412,7725451,37901,7638632,511,86819,16104,42,82564,8357,38,564,146250.0,1000.0,-49.0,-53.0,-46.0,-44.0,-48.0,-53.0,-46.0,-43.0,-85.0,-85.0,-82.0,-80.0,36.0,32.0,36.0,36.0,1
2067,92:69:1D:31:68:E9,3846015,488198613,3994,3640634,3842021,484557979,0,5125,1134167,4966,1098134,159,36033,2167,12,4230,93,0,55,216660.0,130000.0,-51.0,-47.0,-45.0,-48.0,-55.0,-51.0,-48.0,-50.0,-85.0,-85.0,-82.0,-80.0,34.0,38.0,37.0,32.0,1
2068,CC:2F:71:3F:1F:24,4861201,1628699634,1019180,1144141655,3842021,484557979,364,841455,925702398,840671,925607652,784,94746,813015,15,1019114,106445,361,643,130000.0,43333.0,-69.0,-70.0,-67.0,-72.0,-69.0,-70.0,-67.0,-71.0,-85.0,-85.0,-82.0,-80.0,16.0,15.0,15.0,8.0,1
2069,CC:2F:71:3E:C5:1F,3842963,484673122,942,115143,3842021,484557979,0,3930,330197,3243,248601,687,81596,997,11,1354,25,0,52,144444.0,39000.0,-71.0,-71.0,-70.0,-60.0,-72.0,-72.0,-70.0,-62.0,-85.0,-85.0,-82.0,-80.0,14.0,14.0,12.0,20.0,1
2070,BA:8C:B9:54:50:24,3846910,490746699,4889,6188720,3842021,484557979,0,9372,1725560,9350,1722065,22,3495,2354,17,5366,41,0,65,216660.0,130000.0,-48.0,-35.0,-43.0,-45.0,-44.0,-34.0,-42.0,-46.0,-85.0,-85.0,-82.0,-80.0,37.0,50.0,39.0,35.0,1
2071,62:47:05:9D:EB:15,3844153,486982421,2126,2423836,3842027,484558585,0,4318,3012297,4287,3007316,31,4981,2056,0,2177,56,0,105,229410.0,130000.0,-46.0,-46.0,-39.0,-46.0,-45.0,-46.0,-39.0,-46.0,-85.0,-85.0,-82.0,-80.0,39.0,39.0,43.0,34.0,1
2072,3C:55:76:E8:8F:1F,3924529,691676467,82502,207117882,3842027,484558585,38,38412,7725451,37901,7638632,511,86819,16104,42,82564,8357,38,564,146250.0,1000.0,-49.0,-53.0,-46.0,-44.0,-48.0,-53.0,-46.0,-43.0,-85.0,-85.0,-82.0,-80.0,36.0,32.0,36.0,36.0,1
2073,92:69:1D:31:68:E9,3846021,488199219,3994,3640634,3842027,484558585,0,5125,1134167,4966,1098134,159,36033,2167,12,4230,93,0,55,216660.0,130000.0,-51.0,-47.0,-45.0,-48.0,-55.0,-51.0,-48.0,-50.0,-85.0,-85.0,-82.0,-80.0,34.0,38.0,37.0,32.0,1
2074,CC:2F:71:3F:1F:24,4861416,1628960324,1019388,1144401679,3842028,484558645,364,841652,925962342,840868,925867596,784,94746,813201,15,1019323,106458,361,643,130000.0,39000.0,-70.0,-71.0,-67.0,-68.0,-69.0,-70.0,-67.0,-70.0,-85.0,-85.0,-82.0,-80.0,15.0,14.0,15.0,12.0,1
2075,CC:2F:71:3E:C5:1F,3842970,484673788,942,115143,3842028,484558645,0,3930,330197,3243,248601,687,81596,997,11,1354,25,0,52,144444.0,39000.0,-71.0,-71.0,-70.0,-60.0,-72.0,-72.0,-70.0,-62.0,-85.0,-85.0,-82.0,-80.0,14.0,14.0,12.0,20.0,1
2076,BA:8C:B9:54:50:24,3846917,490747365,4889,6188720,3842028,484558645,0,9372,1725560,9350,1722065,22,3495,2354,17,5366,41,0,65,216660.0,130000.0,-48.0,-35.0,-43.0,-45.0,-44.0,-34.0,-42.0,-46.0,-85.0,-85.0,-82.0,-80.0,37.0,50.0,39.0,35.0,1
2077,62:47:05:9D:EB:15,3844156,486982683,2126,2423836,3842030,484558847,0,4318,3012297,4287,3007316,31,4981,2056,0,2177,56,0,105,229410.0,130000.0,-46.0,-46.0,-39.0,-46.0,-45.0,-46.0,-39.0,-46.0,-85.0,-85.0,-82.0,-80.0,39.0,39.0,43.0,34.0,1
2078,3C:55:76:E8:8F:1F,3924532,691676729,82502,207117882,3842030,484558847,38,38412,7725451,37901,7638632,511,86819,16104,42,82564,8357,38,564,146250.0,1000.0,-49.0,-53.0,-46.0,-44.0,-48.0,-53.0,-46.0,-43.0,-85.0,-85.0,-82.0,-80.0,36.0,32.0,36.0,36.0,1
2079,92:69:1D:31:68:E9,3846028,488200051,3994,3640634,3842034,484559417,0,5125,1134167,4966,1098134,159,36033,2167,12,4230,93,0,55,216660.0,130000.0,-51.0,-47.0,-45.0,-48.0,-55.0,-51.0,-48.0,-50.0,-85.0,-85.0,-82.0,-80.0,34.0,38.0,37.0,32.0,1
2080,CC:2F:71:3F:1F:24,4861645,1629237197,1019611,1144677780,3842034,484559417,364,841858,926223879,841074,926129133,784,94746,813402,15,1019546,106459,361,643,130000.0,43333.0,-69.0,-70.0,-67.0,-72.0,-69.0,-70.0,-66.0,-71.0,-85.0,-85.0,-82.0,-80.0,16.0,15.0,15.0,8.0,1
2081,CC:2F:71:3E:C5:1F,3842978,484674762,942,115143,3842036,484559619,0,3930,330197,3243,248601,687,81596,997,11,1354,25,0,52,144444.0,39000.0,-71.0,-71.0,-70.0,-60.0,-72.0,-72.0,-70.0,-62.0,-85.0,-85.0,-82.0,-80.0,14.0,14.0,12.0,20.0,1
2082,BA:8C:B9:54:50:24,3846927,490748541,4889,6188720,3842038,484559821,0,9372,1725560,9350,1722065,22,3495,2354,17,5366,41,0,65,216660.0,130000.0,-48.0,-35.0,-43.0,-45.0,-44.0,-34.0,-42.0,-46.0,-85.0,-85.0,-82.0,-80.0,37.0,50.0,39.0,35.0,1
2083,62:47:05:9D:EB:15,3844164,486983657,2126,2423836,3842038,484559821,0,4318,3012297,4287,3007316,31,4981,2056,0,2177,56,0,105,229410.0,130000.0,-46.0,-46.0,-39.0,-46.0,-45.0,-46.0,-39.0,-46.0,-85.0,-85.0,-82.0,-80.0,39.0,39.0,43.0,34.0,1
2084,3C:55:76:E8:8F:1F,3924540,691677703,82502,207117882,3842038,484559821,38,38412,7725451,37901,7638632,511,86819,16104,42,82564,8357,38,564,146250.0,1000.0,-49.0,-53.0,-46.0,-44.0,-48.0,-53.0,-46.0,-43.0,-85.0,-85.0,-82.0,-80.0,36.0,32.0,36.0,36.0,1
2085,92:69:1D:31:68:E9,3846032,488200455,3994,3640634,3842038,484559821,0,5125,1134167,4966,1098134,159,36033,2167,12,4230,93,0,55,216660.0,130000.0,-51.0,-47.0,-45.0,-48.0,-55.0,-51.0,-48.0,-50.0,-85.0,-85.0,-82.0,-80.0,34.0,38.0,37.0,32.0,1
2086,CC:2F:71:3F:1F:24,4861861,1629503113,1019823,1144943292,3842038,484559821,364,842053,926482007,841269,926387261,784,94746,813591,15,1019758,106517,361,643,117000.0,39000.0,-69.0,-71.0,-67.0,-72.0,-69.0,-70.0,-67.0,-71.0,-85.0,-85.0,-82.0,-80.0,16.0,14.0,15.0,8.0,1
2087,CC:2F:71:3E:C5:1F,3842980,484674964,942,115143,3842038,484559821,0,3930,330197,3243,248601,687,81596,997,11,1354,25,0,52,144444.0,39000.0,-71.0,-71.0,-70.0,-60.0,-72.0,-72.0,-70.0,-62.0,-85.0,-85.0,-82.0,-80.0,14.0,14.0,12.0,20.0,1
2088,BA:8C:B9:54:50:24,3846927,490748541,4889,6188720,3842038,484559821,0,9372,1725560,9350,1722065,22,3495,2354,17,5366,41,0,65,216660.0,130000.0,-48.0,-35.0,-43.0,-45.0,-44.0,-34.0,-42.0,-46.0,-85.0,-85.0,-82.0,-80.0,37.0,50.0,39.0,35.0,1
2089,62:47:05:9D:EB:15,3844169,486984121,2126,2423836,3842043,484560285,0,4318,3012297,4287,3007316,31,4981,2056,0,2177,56,0,105,229410.0,130000.0,-46.0,-46.0,-39.0,-46.0,-45.0,-46.0,-39.0,-46.0,-85.0,-85.0,-82.0,-80.0,39.0,39.0,43.0,34.0,1
2090,3C:55:76:E8:8F:1F,3924549,691678571,82502,207117882,3842047,484560689,38,38412,7725451,37901,7638632,511,86819,16104,42,82564,8357,38,564,146250.0,1000.0,-49.0,-53.0,-46.0,-44.0,-48.0,-53.0,-46.0,-43.0,-85.0,-85.0,-82.0,-80.0,36.0,32.0,36.0,36.0,1
2091,92:69:1D:31:68:E9,3846041,488201323,3994,3640634,3842047,484560689,0,5125,1134167,4966,1098134,159,36033,2167,12,4230,93,0,55,216660.0,130000.0,-51.0,-47.0,-45.0,-48.0,-55.0,-51.0,-48.0,-50.0,-85.0,-85.0,-82.0,-80.0,34.0,38.0,37.0,32.0,1
2092,CC:2F:71:3F:1F:24,4862077,1629765131,1020030,1145204442,3842047,484560689,364,842248,926743115,841464,926648369,784,94746,813774,15,1019965,106545,361,643,115556.0,28889.0,-68.0,-72.0,-67.0,-71.0,-68.0,-72.0,-67.0,-70.0,-85.0,-85.0,-82.0,-80.0,17.0,13.0,15.0,9.0,1
2093,CC:2F:71:3E:C5:1F,3842989,484675832,942,115143,3842047,484560689,0,3930,330197,3243,248601,687,81596,997,11,1354,25,0,52,144444.0,39000.0,-71.0,-71.0,-70.0,-60.0,-72.0,-72.0,-70.0,-62.0,-85.0,-85.0,-82.0,-80.0,14.0,14.0,12.0,20.0,1
2094,BA:8C:B9:54:50:24,3846936,490749409,4889,6188720,3842047,484560689,0,9372,1725560,9350,1722065,22,3495,2354,17,5366,41,0,65,216660.0,130000.0,-48.0,-35.0,-43.0,-45.0,-44.0,-34.0,-42.0,-46.0,-85.0,-85.0,-82.0,-80.0,37.0,50.0,39.0,35.0,1
2095,62:47:05:9D:EB:15,3844173,486984525,2126,2423836,3842047,484560689,0,4318,3012297,4287,3007316,31,4981,2056,0,2177,56,0,105,229410.0,130000.0,-46.0,-46.0,-39.0,-46.0,-45.0,-46.0,-39.0,-46.0,-85.0,-85.0,-82.0,-81.0,39.0,39.0,43.0,35.0,1
2096,3C:55:76:E8:8F:1F,3924549,691678571,82502,207117882,3842047,484560689,38,38412,7725451,37901,7638632,511,86819,16104,42,82564,8357,38,564,146250.0,1000.0,-49.0,-53.0,-46.0,-44.0,-48.0,-53.0,-46.0,-43.0,-85.0,-85.0,-82.0,-81.0,36.0,32.0,36.0,37.0,1
2097,92:69:1D:31:68:E9,3846041,488201323,3994,3640634,3842047,484560689,0,5125,1134167,4966,1098134,159,36033,2167,12,4230,93,0,55,216660.0,130000.0,-51.0,-47.0,-45.0,-48.0,-55.0,-51.0,-48.0,-50.0,-85.0,-85.0,-82.0,-81.0,34.0,38.0,37.0,33.0,1
2098,CC:2F:71:3F:1F:24,4862282,1630025965,1020235,1145465276,3842047,484560689,364,842438,926997829,841654,926903083,784,94746,813957,15,1020170,106563,361,643,130000.0,43333.0,-69.0,-70.0,-66.0,-69.0,-68.0,-69.0,-66.0,-69.0,-85.0,-85.0,-82.0,-81.0,16.0,15.0,16.0,12.0,1
2099,CC:2F:71:3E:C5:1F,3842989,484675832,942,115143,3842047,484560689,0,3930,330197,3243,248601,687,81596,997,11,1354,25,0,52,144444.0,39000.0,-71.0,-71.0,-70.0,-60.0,-72.0,-72.0,-70.0,-62.0,-85.0,-85.0,-82.0,-81.0,14.0,14.0,12.0,21.0,1
2100,BA:8C:B9:54:50:24,3846936,490749409,4889,6188720,3842047,484560689,0,9372,1725560,9350,1722065,22,3495,2354,17,5366,41,0,65,216660.0,130000.0,-48.0,-35.0,-43.0,-45.0,-44.0,-34.0,-42.0,-46.0,-85.0,-85.0,-82.0,-81.0,37.0,50.0,39.0,36.0,1
2101,62:47:05:9D:EB:15,3844182,486985393,2126,2423836,3842056,484561557,0,4318,3012297,4287,3007316,31,4981,2056,0,2177,56,0,105,229410.0,130000.0,-46.0,-46.0,-39.0,-46.0,-45.0,-46.0,-39.0,-46.0,-85.0,-85.0,-82.0,-81.0,39.0,39.0,43.0,35.0,1
2102,3C:55:76:E8:8F:1F,3924559,691679560,82503,207118003,3842056,484561557,38,38412,7725451,37901,7638632,511,86819,16104,42,82565,8360,38,564,146250.0,1000.0,-49.0,-53.0,-46.0,-44.0,-48.0,-53.0,-46.0,-43.0,-85.0,-85.0,-82.0,-81.0,36.0,32.0,36.0,37.0,1
2103,92:69:1D:31:68:E9,3846050,488202191,3994,3640634,3842056,484561557,0,5125,1134167,4966,1098134,159,36033,2167,12,4230,93,0,55,216660.0,130000.0,-51.0,-47.0,-45.0,-48.0,-55.0,-51.0,-48.0,-50.0,-85.0,-85.0,-82.0,-81.0,34.0,38.0,37.0,33.0,1
2104,CC:2F:71:3F:1F:24,4862509,1630295798,1020453,1145734241,3842056,484561557,364,842639,927253189,841855,927158443,784,94746,814150,15,1020386,106627,361,643,86667.0,14444.0,-67.0,-71.0,-66.0,-71.0,-67.0,-71.0,-66.0,-71.0,-85.0,-85.0,-82.0,-81.0,18.0,14.0,16.0,10.0,1
2105,CC:2F:71:3E:C5:1F,3842999,484676762,942,115143,3842057,484561619,0,3930,330197,3243,248601,687,81596,997,11,1354,25,0,52,144444.0,39000.0,-71.0,-71.0,-70.0,-60.0,-72.0,-72.0,-70.0,-62.0,-85.0,-85.0,-82.0,-81.0,14.0,14.0,12.0,21.0,1
2106,BA:8C:B9:54:50:24,3846946,490750339,4889,6188720,3842057,484561619,0,9372,1725560,9350,1722065,22,3495,2354,17,5366,41,0,65,216660.0,130000.0,-48.0,-35.0,-43.0,-45.0,-44.0,-34.0,-42.0,-46.0,-85.0,-85.0,-82.0,-81.0,37.0,50.0,39.0,36.0,1
2107,62:47:05:9D:EB:15,3844183,486985455,2126,2423836,3842057,484561619,0,4319,3012365,4288,3007384,31,4981,2056,0,2178,56,0,105,229410.0,130000.0,-46.0,-46.0,-39.0,-46.0,-45.0,-46.0,-39.0,-46.0,-86.0,-85.0,-82.0,-81.0,40.0,39.0,43.0,35.0,1
2108,3C:55:76:E8:8F:1F,3924563,691680153,82506,207118534,3842057,484561619,40,38412,7725451,37901,7638632,511,86819,16104,42,82569,8384,40,564,135410.0,1000.0,-49.0,-53.0,-46.0,-44.0,-48.0,-53.0,-46.0,-43.0,-86.0,-85.0,-82.0,-81.0,37.0,32.0,36.0,37.0,1
2109,92:69:1D:31:68:E9,3846051,488202253,3994,3640634,3842057,484561619,0,5127,1134303,4968,1098270,159,36033,2167,12,4231,93,0,55,216660.0,130000.0,-51.0,-47.0,-45.0,-47.0,-51.0,-47.0,-44.0,-46.0,-86.0,-85.0,-82.0,-81.0,35.0,38.0,37.0,34.0,1
2110,CC:2F:71:3F:1F:24,4862725,1630561816,1020666,1145999995,3842059,484561821,364,842832,927509733,842047,927414869,785,94864,814339,15,1020601,106627,361,645,86667.0,14444.0,-68.0,-71.0,-66.0,-71.0,-68.0,-71.0,-66.0,-71.0,-86.0,-85.0,-82.0,-81.0,18.0,14.0,16.0,10.0,1
2111,CC:2F:71:3E:C5:1F,3843001,484676964,942,115143,3842059,484561821,0,3932,330337,3245,248741,687,81596,997,11,1355,25,0,52,144444.0,39000.0,-71.0,-71.0,-69.0,-60.0,-70.0,-70.0,-68.0,-59.0,-86.0,-85.0,-82.0,-81.0,15.0,14.0,13.0,21.0,1
2112,BA:8C:B9:54:50:24,3846948,490750541,4889,6188720,3842059,484561821,0,9374,1725696,9352,1722201,22,3495,2354,17,5367,41,0,65,216660.0,130000.0,-48.0,-35.0,-43.0,-45.0,-45.0,-34.0,-42.0,-45.0,-86.0,-85.0,-82.0,-81.0,38.0,50.0,39.0,36.0,1
2113,62:47:05:9D:EB:15,3844192,486986325,2126,2423836,3842066,484562489,0,4321,3012501,4290,3007520,31,4981,2056,0,2178,56,0,105,229410.0,130000.0,-46.0,-45.0,-39.0,-45.0,-45.0,-46.0,-39.0,-46.0,-86.0,-85.0,-82.0,-81.0,40.0,40.0,43.0,36.0,1
2114,3C:55:76:E8:8F:1F,3924574,691681204,82507,207118655,3842067,484562549,40,38412,7725451,37901,7638632,511,86819,16104,42,82570,8388,40,564,135410.0,1000.0,-49.0,-53.0,-46.0,-44.0,-48.0,-53.0,-46.0,-43.0,-86.0,-86.0,-82.0,-81.0,37.0,33.0,36.0,37.0,1
2115,92:69:1D:31:68:E9,3846061,488203183,3994,3640634,3842067,484562549,0,5127,1134303,4968,1098270,159,36033,2167,12,4231,93,0,55,216660.0,130000.0,-51.0,-47.0,-45.0,-47.0,-51.0,-47.0,-44.0,-46.0,-86.0,-86.0,-82.0,-81.0,35.0,39.0,37.0,34.0,1
2116,CC:2F:71:3F:1F:24,4862941,1630824744,1020874,1146262195,3842067,484562549,364,843030,927772627,842245,927677763,785,94864,814524,15,1020809,106632,361,645,115556.0,28889.0,-68.0,-72.0,-66.0,-71.0,-67.0,-71.0,-66.0,-71.0,-86.0,-86.0,-82.0,-81.0,18.0,14.0,16.0,10.0,1
2117,CC:2F:71:3E:C5:1F,3843009,484677692,942,115143,3842067,484562549,0,3934,330525,3246,248811,688,81714,998,11,1355,25,0,52,144444.0,39000.0,-71.0,-71.0,-69.0,-60.0,-70.0,-70.0,-68.0,-59.0,-86.0,-86.0,-82.0,-81.0,15.0,15.0,13.0,21.0,1
2118,BA:8C:B9:54:50:24,3846956,490751269,4889,6188720,3842067,484562549,0,9374,1725696,9352,1722201,22,3495,2354,17,5367,41,0,65,216660.0,130000.0,-48.0,-35.0,-43.0,-45.0,-45.0,-34.0,-42.0,-45.0,-86.0,-86.0,-82.0,-81.0,38.0,51.0,39.0,36.0,1
2119,62:47:05:9D:EB:15,3844195,486986587,2126,2423836,3842069,484562751,0,4321,3012501,4290,3007520,31,4981,2056,0,2178,56,0,105,229410.0,130000.0,-46.0,-45.0,-39.0,-45.0,-45.0,-46.0,-39.0,-46.0,-86.0,-86.0,-82.0,-81.0,40.0,41.0,43.0,36.0,1
2120,3C:55:76:E8:8F:1F,3924576,691681406,82507,207118655,3842069,484562751,40,38412,7725451,37901,7638632,511,86819,16104,42,82570,8388,40,564,135410.0,1000.0,-49.0,-53.0,-46.0,-44.0,-48.0,-53.0,-46.0,-43.0,-86.0,-86.0,-82.0,-81.0,37.0,33.0,36.0,37.0,1
2121,92:69:1D:31:68:E9,3846065,488203587,3994,3640634,3842071,484562953,0,5127,1134303,4968,1098270,159,36033,2167,12,4231,93,0,55,216660.0,130000.0,-51.0,-47.0,-45.0,-47.0,-51.0,-47.0,-44.0,-46.0,-86.0,-86.0,-82.0,-81.0,35.0,39.0,37.0,34.0,1
2122,CC:2F:71:3F:1F:24,4863168,1631100517,1021097,1146537564,3842071,484562953,364,843244,928041196,842459,927946332,785,94864,814727,15,1021032,106742,361,647,115556.0,28889.0,-68.0,-71.0,-66.0,-72.0,-67.0,-71.0,-66.0,-71.0,-86.0,-86.0,-82.0,-81.0,18.0,15.0,16.0,9.0,1
2123,CC:2F:71:3E:C5:1F,3843017,484678500,942,115143,3842075,484563357,0,3934,330525,3246,248811,688,81714,998,11,1355,25,0,52,144444.0,39000.0,-71.0,-71.0,-69.0,-60.0,-70.0,-70.0,-68.0,-59.0,-86.0,-86.0,-82.0,-81.0,15.0,15.0,13.0,21.0,1
2124,BA:8C:B9:54:50:24,3846964,490752077,4889,6188720,3842075,484563357,0,9374,1725696,9352,1722201,22,3495,2354,17,5367,41,0,65,216660.0,130000.0,-48.0,-35.0,-43.0,-45.0,-45.0,-34.0,-42.0,-45.0,-86.0,-86.0,-82.0,-81.0,38.0,51.0,39.0,36.0,1
2125,62:47:05:9D:EB:15,3844216,486989587,2126,2423836,3842090,484565751,0,4321,3012501,4290,3007520,31,4981,2056,0,2178,56,0,105,229410.0,130000.0,-46.0,-45.0,-39.0,-45.0,-45.0,-46.0,-39.0,-46.0,-86.0,-86.0,-82.0,-81.0,40.0,41.0,43.0,36.0,1
2126,3C:55:76:E8:8F:1F,3924631,691694084,82541,207128333,3842090,484565751,40,38684,7846654,38135,7750801,549,95853,16162,42,82603,8757,40,573,108330.0,1000.0,-46.0,-51.0,-45.0,-40.0,-48.0,-53.0,-47.0,-42.0,-86.0,-86.0,-82.0,-81.0,40.0,35.0,37.0,41.0,1
2127,92:69:1D:31:68:E9,3846087,488206647,3994,3640634,3842093,484566013,0,5127,1134303,4968,1098270,159,36033,2167,12,4231,93,0,55,216660.0,130000.0,-51.0,-47.0,-45.0,-47.0,-51.0,-47.0,-44.0,-46.0,-86.0,-86.0,-82.0,-81.0,35.0,39.0,37.0,34.0,1
2128,CC:2F:71:3F:1F:24,4863496,1631513270,1021403,1146947257,3842093,484566013,364,843545,928450831,842760,928355967,785,94864,815012,15,1021338,106963,361,647,104000.0,26000.0,-67.0,-71.0,-66.0,-71.0,-67.0,-71.0,-66.0,-70.0,-86.0,-86.0,-82.0,-81.0,19.0,15.0,16.0,10.0,1
2129,CC:2F:71:3E:C5:1F,3843037,484681358,942,115143,3842095,484566215,0,3934,330525,3246,248811,688,81714,998,11,1355,25,0,52,144444.0,39000.0,-71.0,-71.0,-69.0,-60.0,-70.0,-70.0,-68.0,-59.0,-86.0,-86.0,-82.0,-81.0,15.0,15.0,13.0,21.0,1
2130,BA:8C:B9:54:50:24,3846984,490754935,4889,6188720,3842095,484566215,0,9375,1725764,9353,1722269,22,3495,2354,17,5367,41,0,65,216660.0,130000.0,-40.0,-37.0,-45.0,-51.0,-45.0,-35.0,-43.0,-46.0,-86.0,-86.0,-82.0,-81.0,46.0,49.0,37.0,30.0,1
2131,62:47:05:9D:EB:15,3844226,486990728,2126,2423836,3842100,484566892,0,4321,3012501,4290,3007520,31,4981,2056,0,2178,56,0,105,229410.0,130000.0,-46.0,-45.0,-39.0,-45.0,-45.0,-46.0,-39.0,-46.0,-86.0,-86.0,-82.0,-81.0,40.0,41.0,43.0,36.0,1
2132,3C:55:76:E8:8F:1F,3924645,691700003,82545,207133111,3842100,484566892,41,38726,7872279,38169,7774832,557,97447,16162,44,82612,8806,41,573,81250.0,1000.0,-50.0,-55.0,-45.0,-44.0,-48.0,-53.0,-45.0,-42.0,-86.0,-86.0,-82.0,-81.0,36.0,31.0,37.0,37.0,1
2133,92:69:1D:31:68:E9,3846094,488207526,3994,3640634,3842100,484566892,0,5127,1134303,4968,1098270,159,36033,2167,12,4231,93,0,55,216660.0,130000.0,-51.0,-47.0,-45.0,-47.0,-51.0,-47.0,-44.0,-46.0,-86.0,-86.0,-82.0,-81.0,35.0,39.0,37.0,34.0,1
2134,CC:2F:71:3F:1F:24,4863717,1631782489,1021617,1147215597,3842100,484566892,364,843744,928715175,842959,928620311,785,94864,815204,15,1021552,106975,361,647,86667.0,14444.0,-67.0,-71.0,-67.0,-70.0,-67.0,-71.0,-66.0,-70.0,-86.0,-86.0,-82.0,-81.0,19.0,15.0,15.0,11.0,1
2135,CC:2F:71:3E:C5:1F,3843042,484682035,942,115143,3842100,484566892,0,3934,330525,3246,248811,688,81714,998,11,1355,25,0,52,144444.0,39000.0,-71.0,-71.0,-69.0,-60.0,-70.0,-70.0,-68.0,-59.0,-86.0,-86.0,-82.0,-81.0,15.0,15.0,13.0,21.0,1
2136,BA:8C:B9:54:50:24,3846989,490755612,4889,6188720,3842100,484566892,0,9375,1725764,9353,1722269,22,3495,2354,17,5367,41,0,65,216660.0,130000.0,-40.0,-37.0,-45.0,-51.0,-45.0,-35.0,-43.0,-46.0,-86.0,-86.0,-82.0,-81.0,46.0,49.0,37.0,30.0,1
2137,62:47:05:9D:EB:15,3844230,486991132,2126,2423836,3842104,484567296,0,4321,3012501,4290,3007520,31,4981,2056,0,2178,56,0,105,229410.0,130000.0,-46.0,-45.0,-39.0,-45.0,-45.0,-46.0,-39.0,-46.0,-86.0,-86.0,-82.0,-81.0,40.0,41.0,43.0,36.0,1
2138,3C:55:76:E8:8F:1F,3924660,691702655,82555,207135299,3842105,484567356,41,38832,7920985,38264,7820453,568,100532,16167,44,82622,8864,41,573,65000.0,1000.0,-47.0,-52.0,-46.0,-40.0,-48.0,-53.0,-46.0,-42.0,-86.0,-86.0,-82.0,-81.0,39.0,34.0,36.0,41.0,1
2139,92:69:1D:31:68:E9,3846101,488208192,3994,3640634,3842107,484567558,0,5127,1134303,4968,1098270,159,36033,2167,12,4231,93,0,55,216660.0,130000.0,-51.0,-47.0,-45.0,-47.0,-51.0,-47.0,-44.0,-46.0,-86.0,-86.0,-82.0,-81.0,35.0,39.0,37.0,34.0,1
2140,CC:2F:71:3F:1F:24,4863953,1632055245,1021846,1147487687,3842107,484567558,364,843958,928977028,843173,928882164,785,94864,815409,15,1021781,106995,361,647,117000.0,39000.0,-68.0,-69.0,-66.0,-70.0,-67.0,-69.0,-66.0,-70.0,-86.0,-86.0,-82.0,-81.0,18.0,17.0,16.0,11.0,1
2141,CC:2F:71:3E:C5:1F,3843051,484682903,942,115143,3842109,484567760,0,3934,330525,3246,248811,688,81714,998,11,1355,25,0,52,144444.0,39000.0,-71.0,-71.0,-69.0,-60.0,-70.0,-70.0,-68.0,-59.0,-86.0,-86.0,-82.0,-81.0,15.0,15.0,13.0,21.0,1
2142,BA:8C:B9:54:50:24,3846998,490756480,4889,6188720,3842109,484567760,0,9375,1725764,9353,1722269,22,3495,2354,17,5367,41,0,65,216660.0,130000.0,-40.0,-37.0,-45.0,-51.0,-45.0,-35.0,-43.0,-46.0,-86.0,-86.0,-82.0,-81.0,46.0,49.0,37.0,30.0,1
2143,62:47:05:9D:EB:15,3844235,486991596,2126,2423836,3842109,484567760,0,4321,3012501,4290,3007520,31,4981,2056,0,2178,56,0,105,229410.0,130000.0,-46.0,-45.0,-39.0,-45.0,-45.0,-46.0,-39.0,-46.0,-86.0,-86.0,-82.0,-81.0,40.0,41.0,43.0,36.0,1
2144,3C:55:76:E8:8F:1F,3924665,691703175,82556,207135415,3842109,484567760,41,38932,7961106,38352,7857208,580,103898,16167,44,82623,8868,41,573,48750.0,1000.0,-49.0,-55.0,-47.0,-44.0,-48.0,-53.0,-47.0,-42.0,-86.0,-86.0,-82.0,-81.0,37.0,31.0,35.0,37.0,1
2145,92:69:1D:31:68:E9,3846103,488208394,3994,3640634,3842109,484567760,0,5127,1134303,4968,1098270,159,36033,2167,12,4231,93,0,55,216660.0,130000.0,-51.0,-47.0,-45.0,-47.0,-51.0,-47.0,-44.0,-46.0,-86.0,-86.0,-82.0,-81.0,35.0,39.0,37.0,34.0,1
2146,CC:2F:71:3F:1F:24,4864170,1632323973,1022061,1147756213,3842109,484567760,364,844155,929238378,843370,929143514,785,94864,815599,15,1021996,107011,361,647,86667.0,14444.0,-68.0,-72.0,-67.0,-72.0,-68.0,-71.0,-66.0,-71.0,-86.0,-86.0,-82.0,-81.0,18.0,14.0,15.0,9.0,1
2147,CC:2F:71:3E:C5:1F,3843051,484682903,942,115143,3842109,484567760,0,3934,330525,3246,248811,688,81714,998,11,1355,25,0,52,144444.0,39000.0,-71.0,-71.0,-69.0,-60.0,-70.0,-70.0,-68.0,-59.0,-86.0,-86.0,-82.0,-81.0,15.0,15.0,13.0,21.0,1
2148,BA:8C:B9:54:50:24,3846998,490756480,4889,6188720,3842109,484567760,0,9375,1725764,9353,1722269,22,3495,2354,17,5367,41,0,65,216660.0,130000.0,-40.0,-37.0,-45.0,-51.0,-45.0,-35.0,-43.0,-46.0,-86.0,-86.0,-82.0,-81.0,46.0,49.0,37.0,30.0,1
2149,62:47:05:9D:EB:15,3844243,486992404,2126,2423836,3842117,484568568,0,4321,3012501,4290,3007520,31,4981,2056,0,2178,56,0,105,229410.0,130000.0,-46.0,-45.0,-39.0,-45.0,-45.0,-46.0,-39.0,-46.0,-86.0,-86.0,-82.0,-81.0,40.0,41.0,43.0,36.0,1
2150,3C:55:76:E8:8F:1F,3924675,691705164,82558,207136596,3842117,484568568,41,38943,7979017,38363,7875119,580,103898,16167,44,82625,8872,41,573,48750.0,1000.0,-50.0,-57.0,-55.0,-43.0,-48.0,-53.0,-49.0,-42.0,-86.0,-86.0,-82.0,-81.0,36.0,29.0,27.0,38.0,1
2151,92:69:1D:31:68:E9,3846111,488209202,3994,3640634,3842117,484568568,0,5127,1134303,4968,1098270,159,36033,2167,12,4231,93,0,55,216660.0,130000.0,-51.0,-47.0,-45.0,-47.0,-51.0,-47.0,-44.0,-46.0,-86.0,-86.0,-82.0,-81.0,35.0,39.0,37.0,34.0,1
2152,CC:2F:71:3F:1F:24,4864400,1632604521,1022283,1148035953,3842117,484568568,364,844355,929508632,843570,929413768,785,94864,815793,15,1022218,107015,361,648,86667.0,14444.0,-68.0,-71.0,-68.0,-74.0,-68.0,-71.0,-67.0,-73.0,-86.0,-86.0,-82.0,-81.0,18.0,15.0,14.0,7.0,1
2153,CC:2F:71:3E:C5:1F,3843060,484683771,942,115143,3842118,484568628,0,3934,330525,3246,248811,688,81714,998,11,1355,25,0,52,144444.0,39000.0,-71.0,-71.0,-69.0,-60.0,-70.0,-70.0,-68.0,-59.0,-86.0,-86.0,-82.0,-81.0,15.0,15.0,13.0,21.0,1
2154,BA:8C:B9:54:50:24,3847007,490757348,4889,6188720,3842118,484568628,0,9375,1725764,9353,1722269,22,3495,2354,17,5367,41,0,65,216660.0,130000.0,-40.0,-37.0,-45.0,-51.0,-45.0,-35.0,-43.0,-46.0,-87.0,-86.0,-82.0,-81.0,47.0,49.0,37.0,30.0,1
2155,62:47:05:9D:EB:15,3844244,486992464,2126,2423836,3842118,484568628,0,4321,3012501,4290,3007520,31,4981,2056,0,2178,56,0,105,229410.0,130000.0,-46.0,-45.0,-39.0,-45.0,-45.0,-46.0,-39.0,-46.0,-87.0,-86.0,-82.0,-81.0,41.0,41.0,43.0,36.0,1
2156,3C:55:76:E8:8F:1F,3924676,691705224,82558,207136596,3842118,484568628,41,38943,7979017,38363,7875119,580,103898,16167,44,82625,8872,41,573,48750.0,1000.0,-50.0,-57.0,-55.0,-43.0,-48.0,-53.0,-49.0,-42.0,-87.0,-86.0,-82.0,-81.0,37.0,29.0,27.0,38.0,1
2157,92:69:1D:31:68:E9,3846112,488209262,3994,3640634,3842118,484568628,0,5127,1134303,4968,1098270,159,36033,2167,12,4231,93,0,55,216660.0,130000.0,-51.0,-47.0,-45.0,-47.0,-51.0,-47.0,-44.0,-46.0,-87.0,-86.0,-82.0,-81.0,36.0,39.0,37.0,34.0,1
2158,CC:2F:71:3F:1F:24,4864614,1632871703,1022496,1148303075,3842118,484568628,364,844552,929770192,843767,929675328,785,94864,815979,15,1022431,107046,361,648,130000.0,39000.0,-68.0,-70.0,-68.0,-73.0,-68.0,-70.0,-67.0,-73.0,-87.0,-86.0,-82.0,-81.0,19.0,16.0,14.0,8.0,1
2159,CC:2F:71:3E:C5:1F,3843062,484683973,942,115143,3842120,484568830,0,3934,330525,3246,248811,688,81714,998,11,1355,25,0,52,144444.0,39000.0,-71.0,-71.0,-69.0,-60.0,-70.0,-70.0,-68.0,-59.0,-87.0,-86.0,-82.0,-81.0,16.0,15.0,13.0,21.0,1
2160,BA:8C:B9:54:50:24,3847009,490757550,4889,6188720,3842120,484568830,0,9375,1725764,9353,1722269,22,3495,2354,17,5367,41,0,65,216660.0,130000.0,-40.0,-37.0,-45.0,-51.0,-45.0,-35.0,-43.0,-46.0,-87.0,-86.0,-82.0,-81.0,47.0,49.0,37.0,30.0,1
2161,62:47:05:9D:EB:15,3844252,486993272,2126,2423836,3842126,484569436,0,4321,3012501,4290,3007520,31,4981,2056,0,2178,56,0,105,229410.0,130000.0,-46.0,-45.0,-39.0,-45.0,-45.0,-46.0,-39.0,-46.0,-87.0,-86.0,-82.0,-81.0,41.0,41.0,43.0,36.0,1
2162,3C:55:76:E8:8F:1F,3924690,691711028,82564,207141592,3842126,484569436,41,38964,8004798,38384,7900900,580,103898,16174,44,82631,8877,41,573,48750.0,1000.0,-47.0,-52.0,-45.0,-42.0,-47.0,-56.0,-50.0,-43.0,-87.0,-86.0,-82.0,-81.0,40.0,34.0,37.0,39.0,1
2163,92:69:1D:31:68:E9,3846120,488210070,3994,3640634,3842126,484569436,0,5127,1134303,4968,1098270,159,36033,2167,12,4231,93,0,55,216660.0,130000.0,-51.0,-47.0,-45.0,-47.0,-51.0,-47.0,-44.0,-46.0,-87.0,-86.0,-82.0,-81.0,36.0,39.0,37.0,34.0,1
2164,CC:2F:71:3F:1F:24,4864838,1633138832,1022712,1148569396,3842126,484569436,364,844748,930023231,843963,929928367,785,94864,816171,15,1022647,107063,361,648,115556.0,28889.0,-69.0,-70.0,-68.0,-73.0,-68.0,-69.0,-67.0,-73.0,-87.0,-86.0,-82.0,-81.0,18.0,16.0,14.0,8.0,1
2165,CC:2F:71:3E:C5:1F,3843068,484684579,942,115143,3842126,484569436,0,3934,330525,3246,248811,688,81714,998,11,1355,25,0,52,144444.0,39000.0,-71.0,-71.0,-69.0,-60.0,-70.0,-70.0,-68.0,-59.0,-87.0,-86.0,-82.0,-81.0,16.0,15.0,13.0,21.0,1
2166,BA:8C:B9:54:50:24,3847015,490758156,4889,6188720,3842126,484569436,0,9375,1725764,9353,1722269,22,3495,2354,17,5367,41,0,65,216660.0,130000.0,-40.0,-37.0,-45.0,-51.0,-45.0,-35.0,-43.0,-46.0,-87.0,-86.0,-82.0,-81.0,47.0,49.0,37.0,30.0,1
2167,62:47:05:9D:EB:15,3844254,486993466,2126,2423836,3842128,484569630,0,4321,3012501,4290,3007520,31,4981,2056,0,2178,56,0,105,229410.0,130000.0,-46.0,-45.0,-39.0,-45.0,-45.0,-46.0,-39.0,-46.0,-87.0,-86.0,-82.0,-82.0,41.0,41.0,43.0,37.0,1
2168,3C:55:76:E8:8F:1F,3924693,691711290,82564,207141592,3842129,484569698,41,38979,8017956,38399,7914058,580,103898,16174,44,82631,8877,41,573,48750.0,1000.0,-48.0,-64.0,-56.0,-44.0,-47.0,-58.0,-49.0,-43.0,-87.0,-86.0,-82.0,-82.0,39.0,22.0,26.0,38.0,1
2169,92:69:1D:31:68:E9,3846123,488210332,3994,3640634,3842129,484569698,0,5127,1134303,4968,1098270,159,36033,2167,12,4231,93,0,55,216660.0,130000.0,-51.0,-47.0,-45.0,-47.0,-51.0,-47.0,-44.0,-46.0,-87.0,-86.0,-82.0,-82.0,36.0,39.0,37.0,35.0,1
2170,CC:2F:71:3F:1F:24,4865053,1633404772,1022922,1148834872,3842131,484569900,364,844944,930285859,844159,930190995,785,94864,816359,15,1022857,107080,361,649,115556.0,28889.0,-69.0,-70.0,-68.0,-74.0,-69.0,-70.0,-67.0,-72.0,-87.0,-86.0,-82.0,-82.0,18.0,16.0,14.0,8.0,1
2171,CC:2F:71:3E:C5:1F,3843075,484685245,942,115143,3842133,484570102,0,3934,330525,3246,248811,688,81714,998,11,1355,25,0,52,144444.0,39000.0,-71.0,-71.0,-69.0,-60.0,-70.0,-70.0,-68.0,-59.0,-87.0,-86.0,-82.0,-82.0,16.0,15.0,13.0,22.0,1
2172,BA:8C:B9:54:50:24,3847022,490758822,4889,6188720,3842133,484570102,0,9375,1725764,9353,1722269,22,3495,2354,17,5367,41,0,65,216660.0,130000.0,-40.0,-37.0,-45.0,-51.0,-45.0,-35.0,-43.0,-46.0,-87.0,-86.0,-82.0,-82.0,47.0,49.0,37.0,31.0,1
2173,62:47:05:9D:EB:15,3844261,486994140,2126,2423836,3842135,484570304,0,4321,3012501,4290,3007520,31,4981,2056,0,2178,56,0,105,229410.0,130000.0,-46.0,-45.0,-39.0,-45.0,-45.0,-46.0,-39.0,-46.0,-87.0,-86.0,-82.0,-82.0,41.0,41.0,43.0,37.0,1
2174,3C:55:76:E8:8F:1F,3924699,691711896,82564,207141592,3842135,484570304,41,38979,8017956,38399,7914058,580,103898,16174,44,82631,8877,41,573,48750.0,1000.0,-48.0,-64.0,-56.0,-44.0,-47.0,-58.0,-49.0,-43.0,-87.0,-86.0,-82.0,-82.0,39.0,22.0,26.0,38.0,1
2175,92:69:1D:31:68:E9,3846129,488210938,3994,3640634,3842135,484570304,0,5127,1134303,4968,1098270,159,36033,2167,12,4231,93,0,55,216660.0,130000.0,-51.0,-47.0,-45.0,-47.0,-51.0,-47.0,-44.0,-46.0,-87.0,-86.0,-82.0,-82.0,36.0,39.0,37.0,35.0,1
2176,CC:2F:71:3F:1F:24,4865265,1633668216,1023130,1149097912,3842135,484570304,364,845141,930550013,844356,930455149,785,94864,816543,15,1023065,107084,361,649,115556.0,28889.0,-69.0,-70.0,-67.0,-73.0,-68.0,-70.0,-67.0,-72.0,-87.0,-86.0,-82.0,-82.0,18.0,16.0,15.0,9.0,1
2177,CC:2F:71:3E:C5:1F,3843077,484685447,942,115143,3842135,484570304,0,3934,330525,3246,248811,688,81714,998,11,1355,25,0,52,144444.0,39000.0,-71.0,-71.0,-69.0,-60.0,-70.0,-70.0,-68.0,-59.0,-87.0,-86.0,-82.0,-82.0,16.0,15.0,13.0,22.0,1
2178,BA:8C:B9:54:50:24,3847024,490759024,4889,6188720,3842135,484570304,0,9375,1725764,9353,1722269,22,3495,2354,17,5367,41,0,65,216660.0,130000.0,-40.0,-37.0,-45.0,-51.0,-45.0,-35.0,-43.0,-46.0,-87.0,-86.0,-82.0,-82.0,47.0,49.0,37.0,31.0,1
2179,62:47:05:9D:EB:15,3844266,486994604,2126,2423836,3842140,484570768,0,4321,3012501,4290,3007520,31,4981,2056,0,2178,56,0,105,229410.0,130000.0,-46.0,-45.0,-39.0,-45.0,-45.0,-46.0,-39.0,-46.0,-87.0,-86.0,-82.0,-82.0,41.0,41.0,43.0,37.0,1
2180,3C:55:76:E8:8F:1F,3924706,691712562,82564,207141592,3842142,484570970,41,39004,8045150,38424,7941252,580,103898,16174,44,82631,8877,41,573,48750.0,1000.0,-47.0,-64.0,-57.0,-44.0,-46.0,-59.0,-50.0,-42.0,-87.0,-86.0,-82.0,-82.0,40.0,22.0,25.0,38.0,1
2181,92:69:1D:31:68:E9,3846136,488211604,3994,3640634,3842142,484570970,0,5127,1134303,4968,1098270,159,36033,2167,12,4231,93,0,55,216660.0,130000.0,-51.0,-47.0,-45.0,-47.0,-51.0,-47.0,-44.0,-46.0,-87.0,-86.0,-82.0,-82.0,36.0,39.0,37.0,35.0,1
2182,CC:2F:71:3F:1F:24,4865486,1633933617,1023344,1149362647,3842142,484570970,364,845340,930805044,844555,930710180,785,94864,816734,15,1023279,107090,361,649,115556.0,28889.0,-69.0,-70.0,-67.0,-73.0,-69.0,-69.0,-67.0,-73.0,-87.0,-86.0,-82.0,-82.0,18.0,16.0,15.0,9.0,1
2183,CC:2F:71:3E:C5:1F,3843086,484686315,942,115143,3842144,484571172,0,3934,330525,3246,248811,688,81714,998,11,1355,25,0,52,144444.0,39000.0,-71.0,-71.0,-69.0,-60.0,-70.0,-70.0,-68.0,-59.0,-87.0,-86.0,-82.0,-82.0,16.0,15.0,13.0,22.0,1
2184,BA:8C:B9:54:50:24,3847033,490759892,4889,6188720,3842144,484571172,0,9375,1725764,9353,1722269,22,3495,2354,17,5367,41,0,65,216660.0,130000.0,-40.0,-37.0,-45.0,-51.0,-45.0,-35.0,-43.0,-46.0,-87.0,-86.0,-82.0,-82.0,47.0,49.0,37.0,31.0,1
2185,62:47:05:9D:EB:15,3844270,486995008,2126,2423836,3842144,484571172,0,4321,3012501,4290,3007520,31,4981,2056,0,2178,56,0,105,229410.0,130000.0,-46.0,-45.0,-39.0,-45.0,-45.0,-46.0,-39.0,-46.0,-87.0,-86.0,-82.0,-82.0,41.0,41.0,43.0,37.0,1
2186,3C:55:76:E8:8F:1F,3924709,691712824,82565,207141652,3842144,484571172,41,39011,8045626,38431,7941728,580,103898,16174,44,82632,8879,41,574,48750.0,1000.0,-47.0,-58.0,-45.0,-43.0,-48.0,-60.0,-48.0,-44.0,-87.0,-86.0,-82.0,-82.0,40.0,28.0,37.0,39.0,1
2187,92:69:1D:31:68:E9,3846139,488211922,3995,3640750,3842144,484571172,0,5129,1134439,4970,1098406,159,36033,2167,12,4232,93,0,55,216660.0,130000.0,-51.0,-47.0,-44.0,-48.0,-51.0,-47.0,-44.0,-47.0,-87.0,-86.0,-82.0,-82.0,36.0,39.0,38.0,34.0,1
2188,CC:2F:71:3F:1F:24,4865700,1634198565,1023556,1149627393,3842144,484571172,364,845535,931060428,844750,930965564,785,94864,816923,15,1023491,107094,361,649,115556.0,28889.0,-69.0,-70.0,-67.0,-73.0,-69.0,-69.0,-67.0,-72.0,-87.0,-86.0,-82.0,-82.0,18.0,16.0,15.0,9.0,1
2189,CC:2F:71:3E:C5:1F,3843087,484686375,943,115203,3842144,484571172,0,3936,330665,3248,248951,688,81714,998,11,1356,25,0,52,144444.0,39000.0,-72.0,-72.0,-68.0,-60.0,-71.0,-71.0,-69.0,-61.0,-87.0,-86.0,-82.0,-82.0,15.0,14.0,14.0,22.0,1
2190,BA:8C:B9:54:50:24,3847034,490760008,4890,6188836,3842144,484571172,0,9380,1726104,9358,1722609,22,3495,2354,17,5368,41,0,65,216660.0,130000.0,-48.0,-35.0,-43.0,-46.0,-43.0,-35.0,-43.0,-47.0,-87.0,-86.0,-82.0,-82.0,39.0,51.0,39.0,36.0,1
2191,62:47:05:9D:EB:15,3844277,486995730,2127,2423952,3842150,484571778,0,4323,3012637,4292,3007656,31,4981,2056,0,2179,56,0,105,229410.0,130000.0,-46.0,-48.0,-39.0,-46.0,-45.0,-46.0,-39.0,-45.0,-87.0,-86.0,-82.0,-82.0,41.0,38.0,43.0,36.0,1
2192,3C:55:76:E8:8F:1F,3924716,691714483,82566,207142705,3842150,484571778,41,39012,8047156,38432,7943258,580,103898,16174,44,82633,8883,41,574,48750.0,1000.0,-47.0,-55.0,-49.0,-42.0,-48.0,-59.0,-47.0,-44.0,-87.0,-86.0,-82.0,-82.0,40.0,31.0,33.0,40.0,1
2193,92:69:1D:31:68:E9,3846147,488212730,3995,3640750,3842152,484571980,0,5129,1134439,4970,1098406,159,36033,2167,12,4232,93,0,55,216660.0,130000.0,-51.0,-47.0,-44.0,-48.0,-51.0,-47.0,-44.0,-47.0,-87.0,-86.0,-82.0,-82.0,36.0,39.0,38.0,34.0,1
2194,CC:2F:71:3F:1F:24,4865920,1634465797,1023768,1149893817,3842152,484571980,364,845729,931317222,844944,931222358,785,94864,817110,15,1023703,107097,361,649,115556.0,28889.0,-69.0,-70.0,-67.0,-72.0,-69.0,-69.0,-67.0,-72.0,-87.0,-86.0,-82.0,-82.0,18.0,16.0,15.0,10.0,1
2195,CC:2F:71:3E:C5:1F,3843096,484687243,943,115203,3842153,484572040,0,3936,330665,3248,248951,688,81714,998,11,1356,25,0,52,144444.0,39000.0,-72.0,-72.0,-68.0,-60.0,-71.0,-71.0,-69.0,-61.0,-87.0,-86.0,-82.0,-82.0,15.0,14.0,14.0,22.0,1
2196,BA:8C:B9:54:50:24,3847043,490760876,4890,6188836,3842153,484572040,0,9380,1726104,9358,1722609,22,3495,2354,17,5368,41,0,65,216660.0,130000.0,-48.0,-35.0,-43.0,-46.0,-43.0,-35.0,-43.0,-47.0,-87.0,-86.0,-82.0,-82.0,39.0,51.0,39.0,36.0,1
2197,62:47:05:9D:EB:15,3844281,486996265,2127,2423952,3842154,484572313,0,4323,3012637,4292,3007656,31,4981,2056,0,2179,56,0,105,229410.0,130000.0,-46.0,-48.0,-39.0,-46.0,-45.0,-46.0,-39.0,-45.0,-87.0,-86.0,-82.0,-82.0,41.0,38.0,43.0,36.0,1
2198,3C:55:76:E8:8F:1F,3924721,691715080,82567,207142767,3842154,484572313,41,39015,8048860,38435,7944962,580,103898,16175,44,82634,8886,41,574,48750.0,1000.0,-49.0,-58.0,-45.0,-45.0,-47.0,-57.0,-47.0,-42.0,-87.0,-86.0,-82.0,-82.0,38.0,28.0,37.0,37.0,1
2199,92:69:1D:31:68:E9,3846149,488213063,3995,3640750,3842154,484572313,0,5129,1134439,4970,1098406,159,36033,2167,12,4232,93,0,55,216660.0,130000.0,-51.0,-47.0,-44.0,-48.0,-51.0,-47.0,-44.0,-47.0,-87.0,-86.0,-82.0,-82.0,36.0,39.0,38.0,34.0,1
2200,CC:2F:71:3F:1F:24,4866133,1634729112,1023979,1150156799,3842154,484572313,364,845924,931572928,845139,931478064,785,94864,817296,15,1023914,107108,361,649,115556.0,28889.0,-69.0,-70.0,-67.0,-73.0,-69.0,-69.0,-67.0,-72.0,-87.0,-86.0,-82.0,-82.0,18.0,16.0,15.0,9.0,1
2201,CC:2F:71:3E:C5:1F,3843097,484687516,943,115203,3842154,484572313,0,3936,330665,3248,248951,688,81714,998,11,1356,25,0,52,144444.0,39000.0,-72.0,-72.0,-68.0,-60.0,-71.0,-71.0,-69.0,-61.0,-87.0,-86.0,-82.0,-82.0,15.0,14.0,14.0,22.0,1
2202,BA:8C:B9:54:50:24,3847046,490761351,4890,6188836,3842156,484572515,0,9380,1726104,9358,1722609,22,3495,2354,17,5368,41,0,65,216660.0,130000.0,-48.0,-35.0,-43.0,-46.0,-43.0,-35.0,-43.0,-47.0,-87.0,-86.0,-82.0,-82.0,39.0,51.0,39.0,36.0,1
2203,62:47:05:9D:EB:15,3844289,486997073,2127,2423952,3842162,484573121,0,4323,3012637,4292,3007656,31,4981,2056,0,2179,56,0,105,229410.0,130000.0,-46.0,-48.0,-39.0,-46.0,-45.0,-46.0,-39.0,-45.0,-87.0,-86.0,-82.0,-82.0,41.0,38.0,43.0,36.0,1
2204,3C:55:76:E8:8F:1F,3924729,691715888,82567,207142767,3842162,484573121,41,39015,8048860,38435,7944962,580,103898,16175,44,82634,8886,41,574,48750.0,1000.0,-49.0,-58.0,-45.0,-45.0,-47.0,-57.0,-47.0,-42.0,-87.0,-86.0,-82.0,-82.0,38.0,28.0,37.0,37.0,1
2205,92:69:1D:31:68:E9,3846157,488213871,3995,3640750,3842162,484573121,0,5129,1134439,4970,1098406,159,36033,2167,12,4232,93,0,55,216660.0,130000.0,-51.0,-47.0,-44.0,-48.0,-51.0,-47.0,-44.0,-47.0,-87.0,-86.0,-82.0,-82.0,36.0,39.0,38.0,34.0,1
2206,CC:2F:71:3F:1F:24,4866360,1634996939,1024198,1150423818,3842162,484573121,364,846135,931838500,845350,931743636,785,94864,817492,15,1024133,107111,361,649,115556.0,28889.0,-69.0,-71.0,-69.0,-72.0,-69.0,-70.0,-68.0,-72.0,-87.0,-86.0,-82.0,-82.0,18.0,15.0,13.0,10.0,1
2207,CC:2F:71:3E:C5:1F,3843105,484688324,943,115203,3842162,484573121,0,3936,330665,3248,248951,688,81714,998,11,1356,25,0,52,144444.0,39000.0,-72.0,-72.0,-68.0,-60.0,-71.0,-71.0,-69.0,-61.0,-87.0,-86.0,-82.0,-82.0,15.0,14.0,14.0,22.0,1
2208,BA:8C:B9:54:50:24,3847052,490761957,4890,6188836,3842162,484573121,0,9380,1726104,9358,1722609,22,3495,2354,17,5368,41,0,65,216660.0,130000.0,-48.0,-35.0,-43.0,-46.0,-43.0,-35.0,-43.0,-47.0,-87.0,-86.0,-82.0,-82.0,39.0,51.0,39.0,36.0,1
2209,62:47:05:9D:EB:15,3844290,486997133,2127,2423952,3842163,484573181,0,4323,3012637,4292,3007656,31,4981,2056,0,2179,56,0,105,229410.0,130000.0,-46.0,-48.0,-39.0,-46.0,-45.0,-46.0,-39.0,-45.0,-87.0,-86.0,-82.0,-82.0,41.0,38.0,43.0,36.0,1
2210,3C:55:76:E8:8F:1F,3924732,691716150,82567,207142767,3842165,484573383,41,39015,8048860,38435,7944962,580,103898,16175,44,82634,8886,41,574,48750.0,1000.0,-49.0,-58.0,-45.0,-45.0,-47.0,-57.0,-47.0,-42.0,-87.0,-86.0,-82.0,-82.0,38.0,28.0,37.0,37.0,1
2211,92:69:1D:31:68:E9,3846160,488214133,3995,3640750,3842165,484573383,0,5129,1134439,4970,1098406,159,36033,2167,12,4232,93,0,55,216660.0,130000.0,-51.0,-47.0,-44.0,-48.0,-51.0,-47.0,-44.0,-47.0,-87.0,-86.0,-82.0,-82.0,36.0,39.0,38.0,34.0,1
2212,CC:2F:71:3F:1F:24,4866578,1635263717,1024411,1150690132,3842167,484573585,364,846331,932098386,845546,932003522,785,94864,817679,15,1024346,107129,361,649,115556.0,28889.0,-68.0,-70.0,-68.0,-73.0,-68.0,-70.0,-67.0,-73.0,-87.0,-86.0,-82.0,-82.0,19.0,16.0,14.0,9.0,1
2213,CC:2F:71:3E:C5:1F,3843110,484688788,943,115203,3842167,484573585,0,3936,330665,3248,248951,688,81714,998,11,1356,25,0,52,144444.0,39000.0,-72.0,-72.0,-68.0,-60.0,-71.0,-71.0,-69.0,-61.0,-87.0,-86.0,-82.0,-82.0,15.0,14.0,14.0,22.0,1
2214,BA:8C:B9:54:50:24,3847057,490762421,4890,6188836,3842167,484573585,0,9380,1726104,9358,1722609,22,3495,2354,17,5368,41,0,65,216660.0,130000.0,-48.0,-35.0,-43.0,-46.0,-43.0,-35.0,-43.0,-47.0,-87.0,-86.0,-82.0,-82.0,39.0,51.0,39.0,36.0,1
2215,62:47:05:9D:EB:15,3844298,486997941,2127,2423952,3842171,484573989,0,4323,3012637,4292,3007656,31,4981,2056,0,2179,56,0,105,229410.0,130000.0,-46.0,-48.0,-39.0,-46.0,-45.0,-46.0,-39.0,-45.0,-87.0,-86.0,-82.0,-82.0,41.0,38.0,43.0,36.0,1
2216,3C:55:76:E8:8F:1F,3924751,691724899,82580,207150910,3842171,484573989,41,39031,8059213,38451,7955315,580,103898,16182,44,82647,8910,41,574,48750.0,1000.0,-50.0,-54.0,-43.0,-42.0,-49.0,-52.0,-41.0,-40.0,-87.0,-86.0,-82.0,-82.0,37.0,32.0,39.0,40.0,1
2217,92:69:1D:31:68:E9,3846166,488214739,3995,3640750,3842171,484573989,0,5129,1134439,4970,1098406,159,36033,2167,12,4232,93,0,55,216660.0,130000.0,-51.0,-47.0,-44.0,-48.0,-51.0,-47.0,-44.0,-47.0,-87.0,-86.0,-82.0,-82.0,36.0,39.0,38.0,34.0,1
2218,CC:2F:71:3F:1F:24,4866792,1635527837,1024621,1150953848,3842171,484573989,364,846523,932356320,845738,932261456,785,94864,817864,15,1024556,107178,361,649,115556.0,28889.0,-70.0,-69.0,-67.0,-71.0,-70.0,-69.0,-66.0,-71.0,-87.0,-86.0,-82.0,-82.0,17.0,17.0,15.0,11.0,1
2219,CC:2F:71:3E:C5:1F,3843114,484689192,943,115203,3842171,484573989,0,3936,330665,3248,248951,688,81714,998,11,1356,25,0,52,144444.0,39000.0,-72.0,-72.0,-68.0,-60.0,-71.0,-71.0,-69.0,-61.0,-87.0,-86.0,-82.0,-82.0,15.0,14.0,14.0,22.0,1
2220,BA:8C:B9:54:50:24,3847061,490762825,4890,6188836,3842171,484573989,0,9380,1726104,9358,1722609,22,3495,2354,17,5368,41,0,65,216660.0,130000.0,-48.0,-35.0,-43.0,-46.0,-43.0,-35.0,-43.0,-47.0,-87.0,-86.0,-82.0,-82.0,39.0,51.0,39.0,36.0,1
2221,62:47:05:9D:EB:15,3844312,486999977,2135,2425462,3842177,484574515,0,4334,3014682,4303,3009701,31,4981,2065,0,2187,56,0,105,229410.0,137640.0,-49.0,-49.0,-41.0,-50.0,-49.0,-49.0,-41.0,-50.0,-87.0,-86.0,-82.0,-82.0,38.0,37.0,41.0,32.0,1
2222,3C:55:76:E8:8F:1F,3924761,691728272,82582,207153555,3842179,484574717,41,39033,8059349,38453,7955451,580,103898,16182,44,82649,8912,41,574,48750.0,1000.0,-50.0,-54.0,-42.0,-44.0,-49.0,-52.0,-41.0,-41.0,-87.0,-86.0,-82.0,-82.0,37.0,32.0,40.0,38.0,1
2223,92:69:1D:31:68:E9,3846174,488215467,3995,3640750,3842179,484574717,0,5129,1134439,4970,1098406,159,36033,2167,12,4232,93,0,55,216660.0,130000.0,-51.0,-47.0,-44.0,-48.0,-51.0,-47.0,-44.0,-47.0,-87.0,-86.0,-82.0,-82.0,36.0,39.0,38.0,34.0,1
2224,CC:2F:71:3F:1F:24,4867028,1635812682,1024849,1151237965,3842179,484574717,364,846729,932623405,845943,932528423,786,94982,818067,15,1024784,107239,361,649,130000.0,43333.0,-70.0,-69.0,-68.0,-71.0,-69.0,-69.0,-67.0,-70.0,-87.0,-86.0,-82.0,-82.0,17.0,17.0,14.0,11.0,1
2225,CC:2F:71:3E:C5:1F,3843122,484689920,943,115203,3842179,484574717,0,3936,330665,3248,248951,688,81714,998,11,1356,25,0,52,144444.0,39000.0,-72.0,-72.0,-68.0,-60.0,-71.0,-71.0,-69.0,-61.0,-87.0,-86.0,-82.0,-82.0,15.0,14.0,14.0,22.0,1
2226,BA:8C:B9:54:50:24,3847071,490763755,4890,6188836,3842181,484574919,0,9380,1726104,9358,1722609,22,3495,2354,17,5368,41,0,65,216660.0,130000.0,-48.0,-35.0,-43.0,-46.0,-43.0,-35.0,-43.0,-47.0,-87.0,-86.0,-82.0,-82.0,39.0,51.0,39.0,36.0,1
2227,62:47:05:9D:EB:15,3844319,487001343,2138,2426424,3842181,484574919,0,4337,3014990,4306,3010009,31,4981,2067,0,2190,56,0,105,229410.0,137640.0,-46.0,-46.0,-39.0,-47.0,-48.0,-48.0,-40.0,-49.0,-87.0,-86.0,-82.0,-82.0,41.0,40.0,43.0,35.0,1
2228,3C:55:76:E8:8F:1F,3924763,691728474,82582,207153555,3842181,484574919,41,39033,8059349,38453,7955451,580,103898,16182,44,82649,8912,41,574,48750.0,1000.0,-50.0,-54.0,-42.0,-44.0,-49.0,-52.0,-41.0,-41.0,-87.0,-86.0,-82.0,-82.0,37.0,32.0,40.0,38.0,1
2229,92:69:1D:31:68:E9,3846176,488215669,3995,3640750,3842181,484574919,0,5129,1134439,4970,1098406,159,36033,2167,12,4232,93,0,55,216660.0,130000.0,-51.0,-47.0,-44.0,-48.0,-51.0,-47.0,-44.0,-47.0,-87.0,-86.0,-82.0,-82.0,36.0,39.0,38.0,34.0,1
2230,CC:2F:71:3F:1F:24,4867695,1636652516,1025514,1152077597,3842181,484574919,364,847120,932923593,846334,932828611,786,94982,818450,15,1025449,107273,361,649,130000.0,43333.0,-70.0,-69.0,-67.0,-70.0,-70.0,-69.0,-67.0,-70.0,-87.0,-86.0,-82.0,-82.0,17.0,17.0,15.0,12.0,1
2231,CC:2F:71:3E:C5:1F,3843124,484690122,943,115203,3842181,484574919,0,3936,330665,3248,248951,688,81714,998,11,1356,25,0,52,144444.0,39000.0,-72.0,-72.0,-68.0,-60.0,-71.0,-71.0,-69.0,-61.0,-87.0,-86.0,-82.0,-82.0,15.0,14.0,14.0,22.0,1
2232,BA:8C:B9:54:50:24,3847071,490763755,4890,6188836,3842181,484574919,0,9380,1726104,9358,1722609,22,3495,2354,17,5368,41,0,65,216660.0,130000.0,-48.0,-35.0,-43.0,-46.0,-43.0,-35.0,-43.0,-47.0,-87.0,-86.0,-82.0,-82.0,39.0,51.0,39.0,36.0,1
2233,62:47:05:9D:EB:15,3844326,487002009,2138,2426424,3842188,484575585,0,4337,3014990,4306,3010009,31,4981,2067,0,2190,56,0,105,229410.0,137640.0,-46.0,-46.0,-39.0,-47.0,-48.0,-48.0,-40.0,-49.0,-87.0,-86.0,-82.0,-82.0,41.0,40.0,43.0,35.0,1
2234,3C:55:76:E8:8F:1F,3924773,691730698,82583,207154911,3842190,484575787,41,39033,8059349,38453,7955451,580,103898,16182,44,82650,8916,41,574,48750.0,1000.0,-50.0,-54.0,-42.0,-44.0,-49.0,-52.0,-41.0,-41.0,-87.0,-86.0,-82.0,-82.0,37.0,32.0,40.0,38.0,1
2235,92:69:1D:31:68:E9,3846185,488216537,3995,3640750,3842190,484575787,0,5130,1134507,4971,1098474,159,36033,2167,12,4232,93,0,55,216660.0,130000.0,-51.0,-47.0,-44.0,-46.0,-51.0,-47.0,-44.0,-47.0,-87.0,-87.0,-82.0,-82.0,36.0,40.0,38.0,36.0,1
2236,CC:2F:71:3F:1F:24,4868117,1637172570,1025927,1152596783,3842190,484575787,364,847402,933188191,846616,933093209,786,94982,818727,15,1025860,107291,361,649,130000.0,43333.0,-70.0,-69.0,-66.0,-70.0,-70.0,-69.0,-66.0,-70.0,-87.0,-87.0,-82.0,-82.0,17.0,18.0,16.0,12.0,1
2237,CC:2F:71:3E:C5:1F,3843133,484690990,943,115203,3842190,484575787,0,3936,330665,3248,248951,688,81714,998,11,1356,25,0,52,144444.0,39000.0,-72.0,-72.0,-68.0,-60.0,-71.0,-71.0,-69.0,-61.0,-87.0,-87.0,-82.0,-82.0,15.0,15.0,14.0,22.0,1
2238,BA:8C:B9:54:50:24,3847080,490764623,4890,6188836,3842190,484575787,0,9380,1726104,9358,1722609,22,3495,2354,17,5368,41,0,65,216660.0,130000.0,-48.0,-35.0,-43.0,-46.0,-43.0,-35.0,-43.0,-47.0,-87.0,-87.0,-82.0,-82.0,39.0,52.0,39.0,36.0,1
2239,62:47:05:9D:EB:15,3844336,487003690,2139,2427235,3842197,484576455,0,4338,3015058,4307,3010077,31,4981,2067,0,2191,56,0,105,229410.0,137640.0,-46.0,-45.0,-39.0,-47.0,-48.0,-48.0,-40.0,-49.0,-86.0,-87.0,-82.0,-82.0,40.0,42.0,43.0,35.0,1
2240,3C:55:76:E8:8F:1F,3924905,691991900,82706,207415243,3842199,484576657,41,39300,8213532,38716,8109162,584,104370,16229,45,82773,9512,41,575,16250.0,2000.0,-52.0,-54.0,-43.0,-44.0,-52.0,-54.0,-43.0,-44.0,-86.0,-87.0,-82.0,-82.0,34.0,33.0,39.0,38.0,1
2241,92:69:1D:31:68:E9,3846195,488217467,3995,3640750,3842200,484576717,0,5130,1134507,4971,1098474,159,36033,2167,12,4232,93,0,55,216660.0,130000.0,-51.0,-47.0,-44.0,-46.0,-51.0,-47.0,-44.0,-47.0,-86.0,-86.0,-82.0,-82.0,35.0,39.0,38.0,36.0,1
2242,CC:2F:71:3F:1F:24,4868781,1638068377,1026581,1153491660,3842200,484576717,364,847938,933844181,847152,933749199,786,94982,819262,15,1026515,107366,361,651,130000.0,39000.0,-70.0,-69.0,-68.0,-71.0,-69.0,-69.0,-67.0,-70.0,-86.0,-86.0,-82.0,-82.0,16.0,17.0,14.0,11.0,1
2243,CC:2F:71:3E:C5:1F,3843145,484692122,943,115203,3842202,484576919,0,3938,330805,3250,249091,688,81714,998,11,1357,25,0,52,144444.0,39000.0,-72.0,-72.0,-67.0,-60.0,-71.0,-72.0,-68.0,-61.0,-86.0,-86.0,-82.0,-82.0,14.0,14.0,15.0,22.0,1
2244,BA:8C:B9:54:50:24,3847095,490766019,4890,6188836,3842205,484577183,0,9386,1726512,9364,1723017,22,3495,2354,17,5369,41,0,65,216660.0,130000.0,-51.0,-35.0,-43.0,-45.0,-47.0,-40.0,-46.0,-49.0,-86.0,-86.0,-82.0,-82.0,35.0,51.0,39.0,37.0,1
2245,62:47:05:9D:EB:15,3844372,487016656,2140,2428046,3842232,484588610,0,4341,3015262,4310,3010281,31,4981,2067,0,2192,56,0,105,229410.0,137640.0,-45.0,-46.0,-39.0,-47.0,-47.0,-47.0,-39.0,-48.0,-86.0,-87.0,-82.0,-82.0,41.0,41.0,43.0,35.0,1
2246,3C:55:76:E8:8F:1F,3925020,692190265,82788,207601655,3842232,484588610,41,39319,8214830,38735,8110460,584,104370,16229,46,82864,9663,41,577,8120.0,1000.0,-50.0,-52.0,-43.0,-42.0,-50.0,-53.0,-44.0,-42.0,-86.0,-87.0,-82.0,-82.0,36.0,35.0,39.0,40.0,1
2247,92:69:1D:31:68:E9,3846227,488229360,3995,3640750,3842232,484588610,0,5133,1134878,4973,1098610,160,36268,2168,12,4232,93,0,55,216660.0,130000.0,-52.0,-47.0,-44.0,-46.0,-51.0,-47.0,-44.0,-47.0,-86.0,-87.0,-82.0,-82.0,34.0,40.0,38.0,36.0,1
2248,CC:2F:71:3F:1F:24,4869080,1638424285,1026848,1153835675,3842232,484588610,364,848173,934160492,847387,934065510,786,94982,819497,15,1026783,107397,361,651,130000.0,43333.0,-70.0,-69.0,-67.0,-71.0,-70.0,-69.0,-67.0,-71.0,-86.0,-87.0,-82.0,-82.0,16.0,18.0,15.0,11.0,1
2249,CC:2F:71:3E:C5:1F,3843175,484703813,943,115203,3842232,484588610,0,3940,330993,3251,249161,689,81832,999,11,1357,25,0,52,144444.0,39000.0,-72.0,-72.0,-68.0,-60.0,-72.0,-72.0,-68.0,-61.0,-86.0,-87.0,-82.0,-82.0,14.0,15.0,14.0,22.0,1
2250,BA:8C:B9:54:50:24,3847122,490777446,4890,6188836,3842232,484588610,0,9386,1726512,9364,1723017,22,3495,2354,17,5369,41,0,65,216660.0,130000.0,-51.0,-35.0,-43.0,-45.0,-47.0,-40.0,-46.0,-49.0,-86.0,-87.0,-82.0,-82.0,35.0,52.0,39.0,37.0,1
2251,62:47:05:9D:EB:15,3844382,487017486,2141,2428162,3842241,484589324,0,4344,3015508,4313,3010527,31,4981,2068,0,2193,56,0,105,229410.0,137640.0,-45.0,-48.0,-41.0,-54.0,-46.0,-46.0,-39.0,-48.0,-86.0,-87.0,-82.0,-82.0,41.0,39.0,41.0,28.0,1
2252,3C:55:76:E8:8F:1F,3925161,692368907,82918,207779381,3842243,484589526,41,39527,8306351,38938,8201419,589,104932,16324,46,82993,9663,41,577,8600.0,1000.0,-52.0,-55.0,-42.0,-45.0,-52.0,-55.0,-45.0,-45.0,-86.0,-87.0,-82.0,-82.0,34.0,32.0,40.0,37.0,1
2253,92:69:1D:31:68:E9,3846238,488230276,3995,3640750,3842243,484589526,0,5133,1134878,4973,1098610,160,36268,2168,12,4232,93,0,55,216660.0,130000.0,-52.0,-47.0,-44.0,-46.0,-51.0,-47.0,-44.0,-47.0,-86.0,-87.0,-82.0,-82.0,34.0,40.0,38.0,36.0,1
2254,CC:2F:71:3F:1F:24,4869342,1638746100,1027096,1154156099,3842246,484590001,364,848396,934463198,847610,934368216,786,94982,819718,15,1027030,107432,361,653,115556.0,28889.0,-70.0,-69.0,-67.0,-71.0,-69.0,-69.0,-66.0,-71.0,-86.0,-87.0,-82.0,-82.0,16.0,18.0,15.0,11.0,1
2255,CC:2F:71:3E:C5:1F,3843189,484705204,943,115203,3842246,484590001,0,3940,330993,3251,249161,689,81832,999,11,1357,25,0,52,144444.0,39000.0,-72.0,-72.0,-68.0,-60.0,-72.0,-72.0,-68.0,-61.0,-86.0,-87.0,-82.0,-82.0,14.0,15.0,14.0,22.0,1
2256,BA:8C:B9:54:50:24,3847136,490778837,4890,6188836,3842246,484590001,0,9386,1726512,9364,1723017,22,3495,2354,17,5369,41,0,65,216660.0,130000.0,-51.0,-35.0,-43.0,-45.0,-47.0,-40.0,-46.0,-49.0,-86.0,-87.0,-82.0,-82.0,35.0,52.0,39.0,37.0,1
2257,62:47:05:9D:EB:15,3844387,487018163,2141,2428162,3842246,484590001,0,4344,3015508,4313,3010527,31,4981,2068,0,2193,56,0,105,229410.0,137640.0,-45.0,-48.0,-41.0,-54.0,-46.0,-46.0,-39.0,-48.0,-87.0,-87.0,-83.0,-82.0,42.0,39.0,42.0,28.0,1
2258,3C:55:76:E8:8F:1F,3925559,693380764,83313,208790763,3842246,484590001,41,39730,8330861,39141,8225929,589,104932,16476,46,83387,9674,41,578,51610.0,5500.0,-51.0,-55.0,-42.0,-45.0,-51.0,-56.0,-45.0,-45.0,-87.0,-87.0,-83.0,-82.0,36.0,32.0,41.0,37.0,1
2259,92:69:1D:31:68:E9,3846241,488230751,3995,3640750,3842246,484590001,0,5133,1134878,4973,1098610,160,36268,2168,12,4232,93,0,55,216660.0,130000.0,-52.0,-47.0,-44.0,-46.0,-51.0,-47.0,-44.0,-47.0,-87.0,-87.0,-83.0,-82.0,35.0,40.0,39.0,36.0,1
2260,CC:2F:71:3F:1F:24,4869588,1639056812,1027338,1154466407,3842250,484590405,364,848613,934752692,847827,934657710,786,94982,819935,15,1027273,107435,361,654,115556.0,28889.0,-70.0,-69.0,-67.0,-70.0,-69.0,-68.0,-66.0,-70.0,-87.0,-87.0,-83.0,-82.0,17.0,18.0,16.0,12.0,1
2261,CC:2F:71:3E:C5:1F,3843193,484705608,943,115203,3842250,484590405,0,3940,330993,3251,249161,689,81832,999,11,1357,25,0,52,144444.0,39000.0,-72.0,-72.0,-68.0,-60.0,-72.0,-72.0,-68.0,-61.0,-87.0,-87.0,-83.0,-82.0,15.0,15.0,15.0,22.0,1
2262,BA:8C:B9:54:50:24,3847140,490779241,4890,6188836,3842250,484590405,0,9386,1726512,9364,1723017,22,3495,2354,17,5369,41,0,65,216660.0,130000.0,-51.0,-35.0,-43.0,-45.0,-47.0,-40.0,-46.0,-49.0,-87.0,-87.0,-83.0,-82.0,36.0,52.0,40.0,37.0,1
2263,62:47:05:9D:EB:15,3844398,487020371,2143,2429502,3842255,484590869,0,4346,3015644,4315,3010663,31,4981,2068,0,2195,56,0,105,229410.0,137640.0,-44.0,-49.0,-40.0,-51.0,-45.0,-47.0,-40.0,-49.0,-87.0,-87.0,-83.0,-83.0,43.0,38.0,43.0,32.0,1
2264,3C:55:76:E8:8F:1F,3926287,695283639,84032,210692770,3842255,484590869,41,39914,8353650,39325,8248718,589,104932,16593,46,84108,9682,41,578,146250.0,48750.0,-51.0,-60.0,-43.0,-43.0,-51.0,-59.0,-43.0,-42.0,-87.0,-87.0,-83.0,-83.0,36.0,27.0,40.0,40.0,1
2265,92:69:1D:31:68:E9,3846250,488231619,3995,3640750,3842255,484590869,0,5133,1134878,4973,1098610,160,36268,2168,12,4232,93,0,55,216660.0,130000.0,-52.0,-47.0,-44.0,-46.0,-51.0,-47.0,-44.0,-47.0,-87.0,-87.0,-83.0,-83.0,35.0,40.0,39.0,37.0,1
2266,CC:2F:71:3F:1F:24,4869818,1639333395,1027563,1154742526,3842255,484590869,364,848814,935010517,848028,934915535,786,94982,820136,15,1027497,107443,361,654,115556.0,28889.0,-68.0,-69.0,-67.0,-70.0,-68.0,-69.0,-67.0,-69.0,-87.0,-87.0,-83.0,-83.0,19.0,18.0,16.0,13.0,1
2267,CC:2F:71:3E:C5:1F,3843198,484706072,943,115203,3842255,484590869,0,3940,330993,3251,249161,689,81832,999,11,1357,25,0,52,144444.0,39000.0,-72.0,-72.0,-68.0,-60.0,-72.0,-72.0,-68.0,-61.0,-87.0,-87.0,-83.0,-83.0,15.0,15.0,15.0,23.0,1
2268,BA:8C:B9:54:50:24,3847145,490779705,4890,6188836,3842255,484590869,0,9386,1726512,9364,1723017,22,3495,2354,17,5369,41,0,65,216660.0,130000.0,-51.0,-35.0,-43.0,-45.0,-47.0,-40.0,-46.0,-49.0,-87.0,-87.0,-83.0,-83.0,36.0,52.0,40.0,38.0,1
2269,62:47:05:9D:EB:15,3844404,487021143,2143,2429502,3842261,484591641,0,4346,3015644,4315,3010663,31,4981,2068,0,2195,56,0,105,229410.0,137640.0,-44.0,-49.0,-40.0,-51.0,-45.0,-47.0,-40.0,-49.0,-87.0,-88.0,-84.0,-84.0,43.0,39.0,44.0,33.0,1
2270,3C:55:76:E8:8F:1F,3926293,695284411,84032,210692770,3842261,484591641,41,39915,8353720,39326,8248788,589,104932,16593,46,84108,9682,41,578,146250.0,48750.0,-52.0,-60.0,-43.0,-44.0,-51.0,-59.0,-43.0,-43.0,-87.0,-88.0,-84.0,-84.0,35.0,28.0,41.0,40.0,1
2271,92:69:1D:31:68:E9,3846258,488232593,3995,3640750,3842263,484591843,0,5133,1134878,4973,1098610,160,36268,2168,12,4232,93,0,55,216660.0,130000.0,-52.0,-47.0,-44.0,-46.0,-51.0,-47.0,-44.0,-47.0,-87.0,-88.0,-84.0,-84.0,35.0,41.0,40.0,38.0,1
2272,CC:2F:71:3F:1F:24,4870041,1639605103,1027778,1155013260,3842263,484591843,364,849006,935266831,848220,935171849,786,94982,820327,15,1027713,107451,361,654,130000.0,39000.0,-70.0,-70.0,-69.0,-71.0,-70.0,-70.0,-68.0,-71.0,-87.0,-88.0,-84.0,-84.0,17.0,18.0,15.0,13.0,1
2273,CC:2F:71:3E:C5:1F,3843206,484707046,943,115203,3842263,484591843,0,3940,330993,3251,249161,689,81832,999,11,1357,25,0,52,144444.0,39000.0,-72.0,-72.0,-68.0,-60.0,-72.0,-72.0,-68.0,-61.0,-87.0,-88.0,-84.0,-84.0,15.0,16.0,16.0,24.0,1
2274,BA:8C:B9:54:50:24,3847153,490780679,4890,6188836,3842263,484591843,0,9386,1726512,9364,1723017,22,3495,2354,17,5369,41,0,65,216660.0,130000.0,-51.0,-35.0,-43.0,-45.0,-47.0,-40.0,-46.0,-49.0,-87.0,-88.0,-84.0,-84.0,36.0,53.0,41.0,39.0,1
2275,62:47:05:9D:EB:15,3844409,487021607,2143,2429502,3842266,484592105,0,4346,3015644,4315,3010663,31,4981,2068,0,2195,56,0,105,229410.0,137640.0,-44.0,-49.0,-40.0,-51.0,-45.0,-47.0,-40.0,-49.0,-87.0,-88.0,-84.0,-85.0,43.0,39.0,44.0,34.0,1
2276,3C:55:76:E8:8F:1F,3926298,695284875,84032,210692770,3842266,484592105,41,39915,8353720,39326,8248788,589,104932,16593,46,84108,9682,41,578,146250.0,48750.0,-52.0,-60.0,-43.0,-44.0,-51.0,-59.0,-43.0,-43.0,-87.0,-88.0,-84.0,-85.0,35.0,28.0,41.0,41.0,1
2277,92:69:1D:31:68:E9,3846261,488232855,3995,3640750,3842266,484592105,0,5133,1134878,4973,1098610,160,36268,2168,12,4232,93,0,55,216660.0,130000.0,-52.0,-47.0,-44.0,-46.0,-51.0,-47.0,-44.0,-47.0,-87.0,-88.0,-84.0,-85.0,35.0,41.0,40.0,39.0,1
2278,CC:2F:71:3F:1F:24,4870254,1639864099,1027988,1155271994,3842266,484592105,364,849189,935507809,848403,935412827,786,94982,820510,15,1027923,107454,361,654,130000.0,43333.0,-74.0,-73.0,-71.0,-75.0,-73.0,-72.0,-71.0,-74.0,-87.0,-88.0,-84.0,-85.0,13.0,15.0,13.0,10.0,1
2279,CC:2F:71:3E:C5:1F,3843209,484707308,943,115203,3842266,484592105,0,3940,330993,3251,249161,689,81832,999,11,1357,25,0,52,144444.0,39000.0,-72.0,-72.0,-68.0,-60.0,-72.0,-72.0,-68.0,-61.0,-87.0,-88.0,-84.0,-85.0,15.0,16.0,16.0,25.0,1
2280,BA:8C:B9:54:50:24,3847156,490780941,4890,6188836,3842266,484592105,0,9386,1726512,9364,1723017,22,3495,2354,17,5369,41,0,65,216660.0,130000.0,-51.0,-35.0,-43.0,-45.0,-47.0,-40.0,-46.0,-49.0,-87.0,-88.0,-84.0,-85.0,36.0,53.0,41.0,40.0,1
2281,62:47:05:9D:EB:15,3844415,487022213,2143,2429502,3842272,484592711,0,4346,3015644,4315,3010663,31,4981,2068,0,2195,56,0,105,229410.0,137640.0,-44.0,-49.0,-40.0,-51.0,-45.0,-47.0,-40.0,-49.0,-87.0,-88.0,-84.0,-85.0,43.0,39.0,44.0,34.0,1
2282,3C:55:76:E8:8F:1F,3926306,695285779,84034,210693068,3842272,484592711,41,39929,8354802,39340,8249870,589,104932,16595,46,84110,9682,41,578,146250.0,48750.0,-45.0,-62.0,-44.0,-40.0,-44.0,-59.0,-43.0,-39.0,-87.0,-88.0,-84.0,-85.0,42.0,26.0,40.0,45.0,1
2283,92:69:1D:31:68:E9,3846267,488233461,3995,3640750,3842272,484592711,0,5133,1134878,4973,1098610,160,36268,2168,12,4232,93,0,55,216660.0,130000.0,-52.0,-47.0,-44.0,-46.0,-51.0,-47.0,-44.0,-47.0,-88.0,-89.0,-85.0,-85.0,36.0,42.0,41.0,39.0,1
2284,CC:2F:71:3F:1F:24,4870481,1640140601,1028207,1155547688,3842274,484592913,364,849381,935765505,848595,935670523,786,94982,820702,15,1028142,107463,361,654,130000.0,39000.0,-74.0,-73.0,-72.0,-74.0,-74.0,-72.0,-71.0,-74.0,-88.0,-89.0,-85.0,-85.0,14.0,16.0,13.0,11.0,1
2285,CC:2F:71:3E:C5:1F,3843217,484708116,943,115203,3842274,484592913,0,3940,330993,3251,249161,689,81832,999,11,1357,25,0,52,144444.0,39000.0,-72.0,-72.0,-68.0,-60.0,-72.0,-72.0,-68.0,-61.0,-88.0,-89.0,-85.0,-85.0,16.0,17.0,17.0,25.0,1
2286,BA:8C:B9:54:50:24,3847164,490781749,4890,6188836,3842274,484592913,0,9386,1726512,9364,1723017,22,3495,2354,17,5369,41,0,65,216660.0,130000.0,-51.0,-35.0,-43.0,-45.0,-47.0,-40.0,-46.0,-49.0,-88.0,-89.0,-85.0,-85.0,37.0,54.0,42.0,40.0,1
2287,62:47:05:9D:EB:15,3844417,487022415,2143,2429502,3842274,484592913,0,4346,3015644,4315,3010663,31,4981,2068,0,2195,56,0,105,229410.0,137640.0,-44.0,-49.0,-40.0,-51.0,-45.0,-47.0,-40.0,-49.0,-88.0,-89.0,-85.0,-85.0,44.0,40.0,45.0,34.0,1
2288,3C:55:76:E8:8F:1F,3926319,695289607,84045,210696694,3842274,484592913,41,39967,8363818,39378,8258886,589,104932,16603,46,84121,9682,41,578,146250.0,48750.0,-45.0,-65.0,-44.0,-40.0,-44.0,-64.0,-43.0,-39.0,-88.0,-89.0,-85.0,-85.0,43.0,24.0,41.0,45.0,1
2289,92:69:1D:31:68:E9,3846269,488233663,3995,3640750,3842274,484592913,0,5133,1134878,4973,1098610,160,36268,2168,12,4232,93,0,55,216660.0,130000.0,-52.0,-47.0,-44.0,-46.0,-51.0,-47.0,-44.0,-47.0,-88.0,-89.0,-85.0,-85.0,36.0,42.0,41.0,39.0,1
2290,CC:2F:71:3F:1F:24,4870698,1640404236,1028423,1155811263,3842275,484592973,364,849573,936009525,848787,935914543,786,94982,820894,15,1028358,107479,361,655,130000.0,43333.0,-70.0,-70.0,-68.0,-71.0,-70.0,-69.0,-68.0,-71.0,-88.0,-89.0,-85.0,-86.0,18.0,19.0,17.0,15.0,1
2291,CC:2F:71:3E:C5:1F,3843218,484708176,943,115203,3842275,484592973,0,3940,330993,3251,249161,689,81832,999,11,1357,25,0,52,144444.0,39000.0,-72.0,-72.0,-68.0,-60.0,-72.0,-72.0,-68.0,-61.0,-88.0,-89.0,-85.0,-86.0,16.0,17.0,17.0,26.0,1
2292,BA:8C:B9:54:50:24,3847167,490782011,4890,6188836,3842277,484593175,0,9386,1726512,9364,1723017,22,3495,2354,17,5369,41,0,65,216660.0,130000.0,-51.0,-35.0,-43.0,-45.0,-47.0,-40.0,-46.0,-49.0,-88.0,-89.0,-85.0,-86.0,37.0,54.0,42.0,41.0,1
2293,62:47:05:9D:EB:15,3844426,487023283,2143,2429502,3842283,484593781,0,4346,3015644,4315,3010663,31,4981,2068,0,2195,56,0,105,229410.0,137640.0,-44.0,-49.0,-40.0,-51.0,-45.0,-47.0,-40.0,-49.0,-88.0,-89.0,-85.0,-86.0,44.0,40.0,45.0,35.0,1
2294,3C:55:76:E8:8F:1F,3926328,695290475,84045,210696694,3842283,484593781,41,39968,8363888,39379,8258956,589,104932,16603,46,84121,9682,41,578,146250.0,48750.0,-45.0,-66.0,-44.0,-40.0,-45.0,-64.0,-43.0,-39.0,-88.0,-89.0,-85.0,-86.0,43.0,23.0,41.0,46.0,1
2295,92:69:1D:31:68:E9,3846278,488234531,3995,3640750,3842283,484593781,0,5133,1134878,4973,1098610,160,36268,2168,12,4232,93,0,55,216660.0,130000.0,-52.0,-47.0,-44.0,-46.0,-51.0,-47.0,-44.0,-47.0,-88.0,-89.0,-85.0,-86.0,36.0,42.0,41.0,40.0,1
2296,CC:2F:71:3F:1F:24,4870920,1640667216,1028637,1156073435,3842283,484593781,364,849761,936252657,848975,936157675,786,94982,821082,15,1028572,107514,361,655,130000.0,43333.0,-71.0,-71.0,-70.0,-73.0,-71.0,-70.0,-69.0,-72.0,-88.0,-89.0,-85.0,-86.0,17.0,18.0,15.0,13.0,1
2297,CC:2F:71:3E:C5:1F,3843226,484708984,943,115203,3842283,484593781,0,3940,330993,3251,249161,689,81832,999,11,1357,25,0,52,144444.0,39000.0,-72.0,-72.0,-68.0,-60.0,-72.0,-72.0,-68.0,-61.0,-88.0,-89.0,-85.0,-86.0,16.0,17.0,17.0,26.0,1
2298,BA:8C:B9:54:50:24,3847173,490782617,4890,6188836,3842283,484593781,0,9386,1726512,9364,1723017,22,3495,2354,17,5369,41,0,65,216660.0,130000.0,-51.0,-35.0,-43.0,-45.0,-47.0,-40.0,-46.0,-49.0,-88.0,-89.0,-85.0,-86.0,37.0,54.0,42.0,41.0,1
2299,62:47:05:9D:EB:15,3844427,487024248,2144,2430467,3842283,484593781,0,4349,3015848,4318,3010867,31,4981,2068,0,2196,56,0,105,229410.0,137640.0,-46.0,-45.0,-39.0,-48.0,-45.0,-47.0,-39.0,-49.0,-88.0,-90.0,-86.0,-87.0,42.0,45.0,47.0,39.0,1
2300,3C:55:76:E8:8F:1F,3926337,695292751,84052,210698768,3842285,484593983,41,39988,8370141,39399,8265209,589,104932,16609,46,84128,9682,41,578,154850.0,48750.0,-44.0,-62.0,-44.0,-40.0,-44.0,-60.0,-44.0,-39.0,-88.0,-90.0,-86.0,-87.0,44.0,28.0,42.0,47.0,1
2301,92:69:1D:31:68:E9,3846280,488234733,3995,3640750,3842285,484593983,0,5133,1134878,4973,1098610,160,36268,2168,12,4232,93,0,55,216660.0,130000.0,-52.0,-47.0,-44.0,-46.0,-51.0,-47.0,-44.0,-47.0,-88.0,-90.0,-86.0,-87.0,36.0,43.0,42.0,41.0,1
2302,CC:2F:71:3F:1F:24,4871133,1640929366,1028846,1156335181,3842287,484594185,364,849948,936498443,849162,936403461,786,94982,821268,15,1028781,107535,361,655,130000.0,43333.0,-72.0,-70.0,-70.0,-72.0,-71.0,-70.0,-69.0,-72.0,-88.0,-90.0,-86.0,-87.0,16.0,20.0,16.0,15.0,1
2303,CC:2F:71:3E:C5:1F,3843230,484709388,943,115203,3842287,484594185,0,3940,330993,3251,249161,689,81832,999,11,1357,25,0,52,144444.0,39000.0,-72.0,-72.0,-68.0,-60.0,-72.0,-72.0,-68.0,-61.0,-88.0,-90.0,-86.0,-87.0,16.0,18.0,18.0,27.0,1
2304,BA:8C:B9:54:50:24,3847177,490783021,4890,6188836,3842287,484594185,0,9386,1726512,9364,1723017,22,3495,2354,17,5369,41,0,65,216660.0,130000.0,-51.0,-35.0,-43.0,-45.0,-47.0,-40.0,-46.0,-49.0,-88.0,-90.0,-86.0,-87.0,37.0,55.0,43.0,42.0,1
2305,62:47:05:9D:EB:15,3844436,487025116,2144,2430467,3842292,484594649,0,4349,3015848,4318,3010867,31,4981,2068,0,2196,56,0,105,229410.0,137640.0,-46.0,-45.0,-39.0,-48.0,-45.0,-47.0,-39.0,-49.0,-88.0,-90.0,-86.0,-87.0,42.0,45.0,47.0,39.0,1
2306,3C:55:76:E8:8F:1F,3927207,697583728,84915,212989079,3842292,484594649,41,40213,8402188,39624,8297256,589,104932,16719,46,84991,9682,41,580,195000.0,97500.0,-50.0,-51.0,-44.0,-43.0,-49.0,-51.0,-44.0,-42.0,-88.0,-90.0,-86.0,-87.0,38.0,39.0,42.0,44.0,1
2307,92:69:1D:31:68:E9,3846287,488235399,3995,3640750,3842292,484594649,0,5133,1134878,4973,1098610,160,36268,2168,12,4232,93,0,55,216660.0,130000.0,-52.0,-47.0,-44.0,-46.0,-51.0,-47.0,-44.0,-47.0,-88.0,-90.0,-86.0,-87.0,36.0,43.0,42.0,41.0,1
2308,CC:2F:71:3F:1F:24,4871352,1641192901,1029060,1156598252,3842292,484594649,364,850137,936742043,849351,936647061,786,94982,821457,15,1028995,107567,361,655,130000.0,43333.0,-71.0,-70.0,-69.0,-72.0,-71.0,-70.0,-68.0,-72.0,-88.0,-90.0,-86.0,-87.0,17.0,20.0,17.0,15.0,1
2309,CC:2F:71:3E:C5:1F,3843236,484709968,944,115319,3842292,484594649,0,3941,331063,3252,249231,689,81832,999,11,1358,25,0,52,144444.0,39000.0,-66.0,-66.0,-65.0,-60.0,-72.0,-72.0,-68.0,-61.0,-88.0,-90.0,-86.0,-87.0,22.0,24.0,21.0,27.0,1
2310,BA:8C:B9:54:50:24,3847182,490783485,4890,6188836,3842292,484594649,0,9386,1726512,9364,1723017,22,3495,2354,17,5369,41,0,65,216660.0,130000.0,-51.0,-35.0,-43.0,-45.0,-47.0,-40.0,-46.0,-49.0,-88.0,-90.0,-86.0,-87.0,37.0,55.0,43.0,42.0,1
2311,62:47:05:9D:EB:15,3844441,487025636,2145,2430583,3842296,484595053,0,4350,3015916,4319,3010935,31,4981,2068,0,2197,56,0,105,229410.0,137640.0,-46.0,-45.0,-39.0,-47.0,-45.0,-46.0,-39.0,-49.0,-89.0,-91.0,-87.0,-88.0,43.0,46.0,48.0,41.0,1
2312,3C:55:76:E8:8F:1F,3927212,697584248,84916,212989195,3842296,484595053,41,40221,8402738,39632,8297806,589,104932,16719,46,84992,9682,41,580,195000.0,97500.0,-45.0,-59.0,-45.0,-40.0,-44.0,-56.0,-43.0,-39.0,-89.0,-91.0,-87.0,-88.0,44.0,32.0,42.0,48.0,1
2313,92:69:1D:31:68:E9,3846292,488235919,3996,3640866,3842296,484595053,0,5135,1135014,4975,1098746,160,36268,2168,12,4233,93,0,55,216660.0,130000.0,-51.0,-48.0,-44.0,-46.0,-51.0,-47.0,-44.0,-47.0,-89.0,-91.0,-87.0,-88.0,38.0,43.0,43.0,42.0,1
2314,CC:2F:71:3F:1F:24,4871564,1641453439,1029266,1156858184,3842298,484595255,364,850321,936984571,849535,936889589,786,94982,821641,15,1029201,107599,361,655,130000.0,43333.0,-71.0,-70.0,-69.0,-72.0,-71.0,-70.0,-69.0,-72.0,-89.0,-91.0,-87.0,-88.0,18.0,21.0,18.0,16.0,1
2315,CC:2F:71:3E:C5:1F,3843242,484710574,944,115319,3842298,484595255,0,3942,331133,3253,249301,689,81832,999,11,1358,25,0,52,144444.0,39000.0,-72.0,-71.0,-69.0,-60.0,-72.0,-72.0,-68.0,-61.0,-89.0,-91.0,-87.0,-88.0,17.0,20.0,18.0,28.0,1
2316,BA:8C:B9:54:50:24,3847189,490784207,4891,6188952,3842298,484595255,0,9392,1726920,9370,1723425,22,3495,2354,17,5370,41,0,65,216660.0,130000.0,-48.0,-35.0,-43.0,-45.0,-43.0,-34.0,-42.0,-46.0,-89.0,-91.0,-87.0,-88.0,41.0,56.0,44.0,43.0,1
2317,62:47:05:9D:EB:15,3844447,487026162,2145,2430583,3842302,484595579,0,4351,3015984,4320,3011003,31,4981,2068,0,2197,56,0,105,229410.0,137640.0,-46.0,-45.0,-39.0,-48.0,-45.0,-46.0,-39.0,-49.0,-89.0,-91.0,-87.0,-89.0,43.0,46.0,48.0,41.0,1
2318,3C:55:76:E8:8F:1F,3927218,697584774,84916,212989195,3842302,484595579,41,40221,8402738,39632,8297806,589,104932,16719,46,84992,9682,41,580,195000.0,97500.0,-45.0,-59.0,-45.0,-40.0,-44.0,-56.0,-43.0,-39.0,-89.0,-91.0,-87.0,-89.0,44.0,32.0,42.0,49.0,1
2319,92:69:1D:31:68:E9,3846298,488236445,3996,3640866,3842302,484595579,0,5135,1135014,4975,1098746,160,36268,2168,12,4233,93,0,55,216660.0,130000.0,-51.0,-48.0,-44.0,-46.0,-51.0,-47.0,-44.0,-47.0,-89.0,-91.0,-87.0,-89.0,38.0,43.0,43.0,43.0,1
2320,CC:2F:71:3F:1F:24,4871774,1641713471,1029472,1157117892,3842302,484595579,364,850505,937228539,849718,937133439,787,95100,821824,15,1029407,107645,361,655,130000.0,43333.0,-71.0,-70.0,-69.0,-72.0,-70.0,-70.0,-69.0,-72.0,-89.0,-91.0,-87.0,-89.0,18.0,21.0,18.0,17.0,1
2321,CC:2F:71:3E:C5:1F,3843247,484710960,944,115319,3842303,484595641,0,3943,331251,3253,249301,690,81950,1000,11,1358,25,0,52,144444.0,39000.0,-72.0,-72.0,-68.0,-60.0,-71.0,-71.0,-67.0,-60.0,-89.0,-91.0,-87.0,-89.0,17.0,19.0,19.0,29.0,1
2322,BA:8C:B9:54:50:24,3847194,490784593,4891,6188952,3842303,484595641,0,9393,1726988,9371,1723493,22,3495,2354,17,5370,41,0,65,216660.0,130000.0,-39.0,-37.0,-45.0,-52.0,-43.0,-34.0,-42.0,-46.0,-89.0,-91.0,-87.0,-89.0,50.0,54.0,42.0,37.0,1
2323,62:47:05:9D:EB:15,3844456,487027165,2145,2430583,3842311,484596582,0,4351,3015984,4320,3011003,31,4981,2068,0,2197,56,0,105,229410.0,137640.0,-46.0,-45.0,-39.0,-48.0,-45.0,-46.0,-39.0,-49.0,-89.0,-91.0,-87.0,-89.0,43.0,46.0,48.0,41.0,1
2324,3C:55:76:E8:8F:1F,3927227,697585777,84916,212989195,3842311,484596582,41,40227,8403198,39637,8298148,590,105050,16720,46,84992,9682,41,580,195000.0,97500.0,-47.0,-49.0,-43.0,-39.0,-46.0,-51.0,-43.0,-39.0,-89.0,-91.0,-88.0,-89.0,42.0,42.0,45.0,50.0,1
2325,92:69:1D:31:68:E9,3846307,488237448,3996,3640866,3842311,484596582,0,5135,1135014,4975,1098746,160,36268,2168,12,4233,93,0,55,216660.0,130000.0,-51.0,-48.0,-44.0,-46.0,-51.0,-47.0,-44.0,-47.0,-89.0,-91.0,-88.0,-89.0,38.0,43.0,44.0,43.0,1
2326,CC:2F:71:3F:1F:24,4871995,1641977810,1029684,1157381228,3842311,484596582,364,850693,937475817,849906,937380717,787,95100,822011,15,1029619,107724,361,655,130000.0,43333.0,-71.0,-70.0,-69.0,-72.0,-70.0,-70.0,-69.0,-71.0,-89.0,-91.0,-88.0,-89.0,18.0,21.0,19.0,17.0,1
2327,CC:2F:71:3E:C5:1F,3843255,484711901,944,115319,3842311,484596582,0,3944,331321,3254,249371,690,81950,1000,11,1358,25,0,52,144444.0,39000.0,-72.0,-72.0,-69.0,-60.0,-71.0,-71.0,-67.0,-60.0,-89.0,-91.0,-88.0,-89.0,17.0,19.0,19.0,29.0,1
2328,BA:8C:B9:54:50:24,3847202,490785534,4891,6188952,3842311,484596582,0,9393,1726988,9371,1723493,22,3495,2354,17,5370,41,0,65,216660.0,130000.0,-39.0,-37.0,-45.0,-52.0,-43.0,-34.0,-42.0,-46.0,-89.0,-91.0,-88.0,-89.0,50.0,54.0,43.0,37.0,1
2329,62:47:05:9D:EB:15,3844459,487027429,2145,2430583,3842314,484596846,0,4351,3015984,4320,3011003,31,4981,2068,0,2197,56,0,105,229410.0,137640.0,-46.0,-45.0,-39.0,-48.0,-45.0,-46.0,-39.0,-49.0,-89.0,-91.0,-88.0,-89.0,43.0,46.0,49.0,41.0,1
2330,3C:55:76:E8:8F:1F,3927230,697586041,84916,212989195,3842314,484596846,41,40244,8404410,39653,8299242,591,105168,16721,46,84992,9682,41,582,195000.0,97500.0,-51.0,-51.0,-46.0,-43.0,-51.0,-51.0,-46.0,-43.0,-89.0,-91.0,-88.0,-89.0,38.0,40.0,42.0,46.0,1
2331,92:69:1D:31:68:E9,3846311,488237772,3996,3640866,3842315,484596906,0,5135,1135014,4975,1098746,160,36268,2168,12,4233,93,0,55,216660.0,130000.0,-51.0,-48.0,-44.0,-46.0,-51.0,-47.0,-44.0,-47.0,-89.0,-91.0,-88.0,-89.0,38.0,43.0,44.0,43.0,1
2332,CC:2F:71:3F:1F:24,4872216,1642244905,1029901,1157647999,3842315,484596906,364,850887,937721514,850100,937626414,787,95100,822204,15,1029835,107755,361,655,130000.0,43333.0,-71.0,-70.0,-69.0,-71.0,-70.0,-70.0,-69.0,-71.0,-89.0,-91.0,-88.0,-89.0,18.0,21.0,19.0,18.0,1
2333,CC:2F:71:3E:C5:1F,3843259,484712225,944,115319,3842315,484596906,0,3944,331321,3254,249371,690,81950,1000,11,1358,25,0,52,144444.0,39000.0,-72.0,-72.0,-69.0,-60.0,-71.0,-71.0,-67.0,-60.0,-89.0,-92.0,-88.0,-90.0,17.0,20.0,19.0,30.0,1
2334,BA:8C:B9:54:50:24,3847206,490785858,4891,6188952,3842315,484596906,0,9393,1726988,9371,1723493,22,3495,2354,17,5370,41,0,65,216660.0,130000.0,-39.0,-37.0,-45.0,-52.0,-43.0,-34.0,-42.0,-46.0,-89.0,-92.0,-88.0,-90.0,50.0,55.0,43.0,38.0,1
2335,62:47:05:9D:EB:15,3844466,487028095,2145,2430583,3842321,484597512,0,4351,3015984,4320,3011003,31,4981,2068,0,2197,56,0,105,229410.0,137640.0,-46.0,-45.0,-39.0,-48.0,-45.0,-46.0,-39.0,-49.0,-89.0,-92.0,-88.0,-90.0,43.0,47.0,49.0,42.0,1
2336,3C:55:76:E8:8F:1F,3927237,697586707,84916,212989195,3842321,484597512,41,40244,8404410,39653,8299242,591,105168,16721,46,84992,9682,41,582,195000.0,97500.0,-51.0,-51.0,-46.0,-43.0,-51.0,-51.0,-46.0,-43.0,-89.0,-92.0,-88.0,-90.0,38.0,41.0,42.0,47.0,1
2337,92:69:1D:31:68:E9,3846318,488238440,3996,3640866,3842322,484597574,0,5135,1135014,4975,1098746,160,36268,2168,12,4233,93,0,55,216660.0,130000.0,-51.0,-48.0,-44.0,-46.0,-51.0,-47.0,-44.0,-47.0,-89.0,-92.0,-88.0,-90.0,38.0,44.0,44.0,44.0,1
2338,CC:2F:71:3F:1F:24,4872433,1642507001,1030111,1157909427,3842322,484597574,364,851075,937970230,850288,937875130,787,95100,822390,15,1030046,107772,361,655,130000.0,43333.0,-71.0,-70.0,-69.0,-72.0,-71.0,-70.0,-69.0,-72.0,-89.0,-92.0,-88.0,-90.0,18.0,22.0,19.0,18.0,1
2339,CC:2F:71:3E:C5:1F,3843268,484713095,944,115319,3842324,484597776,0,3944,331321,3254,249371,690,81950,1000,11,1358,25,0,52,144444.0,39000.0,-72.0,-72.0,-69.0,-60.0,-71.0,-71.0,-67.0,-60.0,-89.0,-92.0,-88.0,-90.0,17.0,20.0,19.0,30.0,1
2340,BA:8C:B9:54:50:24,3847215,490786728,4891,6188952,3842324,484597776,0,9393,1726988,9371,1723493,22,3495,2354,17,5370,41,0,65,216660.0,130000.0,-39.0,-37.0,-45.0,-52.0,-43.0,-34.0,-42.0,-46.0,-89.0,-92.0,-88.0,-90.0,50.0,55.0,43.0,38.0,1
2341,62:47:05:9D:EB:15,3844469,487028359,2145,2430583,3842324,484597776,0,4351,3015984,4320,3011003,31,4981,2068,0,2197,56,0,105,229410.0,137640.0,-46.0,-45.0,-39.0,-48.0,-45.0,-46.0,-39.0,-49.0,-89.0,-92.0,-88.0,-90.0,43.0,47.0,49.0,42.0,1
2342,3C:55:76:E8:8F:1F,3927240,697586971,84916,212989195,3842324,484597776,41,40259,8405484,39667,8300198,592,105286,16722,46,84992,9682,41,582,195000.0,97500.0,-51.0,-51.0,-46.0,-43.0,-50.0,-51.0,-45.0,-43.0,-89.0,-92.0,-88.0,-90.0,38.0,41.0,42.0,47.0,1
2343,92:69:1D:31:68:E9,3846322,488238844,3996,3640866,3842326,484597978,0,5135,1135014,4975,1098746,160,36268,2168,12,4233,93,0,55,216660.0,130000.0,-51.0,-48.0,-44.0,-46.0,-51.0,-47.0,-44.0,-47.0,-89.0,-92.0,-88.0,-90.0,38.0,44.0,44.0,44.0,1
2344,CC:2F:71:3F:1F:24,4872648,1642772035,1030322,1158174057,3842326,484597978,364,851262,938215954,850475,938120854,787,95100,822577,15,1030257,107811,361,655,130000.0,43333.0,-70.0,-70.0,-69.0,-71.0,-70.0,-69.0,-69.0,-71.0,-89.0,-92.0,-88.0,-90.0,19.0,22.0,19.0,19.0,1
2345,CC:2F:71:3E:C5:1F,3843272,484713499,944,115319,3842328,484598180,0,3944,331321,3254,249371,690,81950,1000,11,1358,25,0,52,144444.0,39000.0,-72.0,-72.0,-69.0,-60.0,-71.0,-71.0,-67.0,-60.0,-89.0,-92.0,-88.0,-90.0,17.0,20.0,19.0,30.0,1
2346,BA:8C:B9:54:50:24,3847219,490787132,4891,6188952,3842328,484598180,0,9393,1726988,9371,1723493,22,3495,2354,17,5370,41,0,65,216660.0,130000.0,-39.0,-37.0,-45.0,-52.0,-43.0,-34.0,-42.0,-46.0,-89.0,-92.0,-88.0,-90.0,50.0,55.0,43.0,38.0,1
2347,62:47:05:9D:EB:15,3844476,487029025,2145,2430583,3842331,484598442,0,4351,3015984,4320,3011003,31,4981,2068,0,2197,56,0,105,229410.0,137640.0,-46.0,-45.0,-39.0,-48.0,-45.0,-46.0,-39.0,-49.0,-90.0,-92.0,-88.0,-91.0,44.0,47.0,49.0,43.0,1
2348,3C:55:76:E8:8F:1F,3927250,697588013,84917,212989369,3842333,484598644,41,40269,8406294,39677,8301008,592,105286,16724,46,84993,9682,41,582,195000.0,97500.0,-51.0,-51.0,-46.0,-43.0,-49.0,-50.0,-44.0,-41.0,-90.0,-92.0,-88.0,-91.0,39.0,41.0,42.0,48.0,1
2349,92:69:1D:31:68:E9,3846329,488239510,3996,3640866,3842333,484598644,0,5135,1135014,4975,1098746,160,36268,2168,12,4233,93,0,55,216660.0,130000.0,-51.0,-48.0,-44.0,-46.0,-51.0,-47.0,-44.0,-47.0,-90.0,-92.0,-88.0,-91.0,39.0,44.0,44.0,45.0,1
2350,CC:2F:71:3F:1F:24,4872873,1643036754,1030540,1158438110,3842333,484598644,364,851454,938461323,850667,938366223,787,95100,822769,15,1030475,107836,361,655,130000.0,43333.0,-70.0,-70.0,-69.0,-71.0,-70.0,-69.0,-68.0,-71.0,-90.0,-92.0,-88.0,-91.0,20.0,22.0,19.0,20.0,1
2351,CC:2F:71:3E:C5:1F,3843277,484713963,944,115319,3842333,484598644,0,3944,331321,3254,249371,690,81950,1000,11,1358,25,0,52,144444.0,39000.0,-72.0,-72.0,-69.0,-60.0,-71.0,-71.0,-67.0,-60.0,-90.0,-92.0,-88.0,-91.0,18.0,20.0,19.0,31.0,1
2352,BA:8C:B9:54:50:24,3847224,490787596,4891,6188952,3842333,484598644,0,9393,1726988,9371,1723493,22,3495,2354,17,5370,41,0,65,216660.0,130000.0,-39.0,-37.0,-45.0,-52.0,-43.0,-34.0,-42.0,-46.0,-90.0,-92.0,-88.0,-91.0,51.0,55.0,43.0,39.0,1
2353,62:47:05:9D:EB:15,3844480,487029429,2145,2430583,3842335,484598846,0,4351,3015984,4320,3011003,31,4981,2068,0,2197,56,0,105,229410.0,137640.0,-46.0,-45.0,-39.0,-48.0,-45.0,-46.0,-39.0,-49.0,-90.0,-92.0,-89.0,-91.0,44.0,47.0,50.0,43.0,1
2354,3C:55:76:E8:8F:1F,3927254,697588417,84917,212989369,3842337,484599048,41,40269,8406294,39677,8301008,592,105286,16724,46,84993,9682,41,582,195000.0,97500.0,-51.0,-51.0,-46.0,-43.0,-49.0,-50.0,-44.0,-41.0,-90.0,-92.0,-89.0,-91.0,39.0,41.0,43.0,48.0,1
2355,92:69:1D:31:68:E9,3846333,488239914,3996,3640866,3842337,484599048,0,5135,1135014,4975,1098746,160,36268,2168,12,4233,93,0,55,216660.0,130000.0,-51.0,-48.0,-44.0,-46.0,-51.0,-47.0,-44.0,-47.0,-90.0,-92.0,-89.0,-91.0,39.0,44.0,45.0,45.0,1
2356,CC:2F:71:3F:1F:24,4873085,1643295702,1030748,1158696654,3842337,484599048,364,851637,938703749,850850,938608649,787,95100,822951,15,1030683,107886,361,655,130000.0,43333.0,-70.0,-70.0,-68.0,-72.0,-70.0,-69.0,-68.0,-71.0,-90.0,-92.0,-89.0,-91.0,20.0,22.0,21.0,19.0,1
2357,CC:2F:71:3E:C5:1F,3843281,484714367,944,115319,3842337,484599048,0,3944,331321,3254,249371,690,81950,1000,11,1358,25,0,52,144444.0,39000.0,-72.0,-72.0,-69.0,-60.0,-71.0,-71.0,-67.0,-60.0,-90.0,-92.0,-89.0,-91.0,18.0,20.0,20.0,31.0,1
2358,BA:8C:B9:54:50:24,3847230,490788202,4891,6188952,3842339,484599250,0,9393,1726988,9371,1723493,22,3495,2354,17,5370,41,0,65,216660.0,130000.0,-39.0,-37.0,-45.0,-52.0,-43.0,-34.0,-42.0,-46.0,-90.0,-92.0,-89.0,-91.0,51.0,55.0,44.0,39.0,1
2359,62:47:05:9D:EB:15,3844487,487030095,2145,2430583,3842342,484599512,0,4351,3015984,4320,3011003,31,4981,2068,0,2197,56,0,105,229410.0,137640.0,-46.0,-45.0,-39.0,-48.0,-45.0,-46.0,-39.0,-49.0,-90.0,-93.0,-89.0,-92.0,44.0,48.0,50.0,44.0,1
2360,3C:55:76:E8:8F:1F,3927259,697588881,84917,212989369,3842342,484599512,41,40269,8406294,39677,8301008,592,105286,16724,46,84993,9682,41,582,195000.0,97500.0,-51.0,-51.0,-46.0,-43.0,-49.0,-50.0,-44.0,-41.0,-90.0,-93.0,-89.0,-92.0,39.0,42.0,43.0,49.0,1
2361,92:69:1D:31:68:E9,3846338,488240378,3996,3640866,3842342,484599512,0,5135,1135014,4975,1098746,160,36268,2168,12,4233,93,0,55,216660.0,130000.0,-51.0,-48.0,-44.0,-46.0,-51.0,-47.0,-44.0,-47.0,-90.0,-93.0,-89.0,-92.0,39.0,45.0,45.0,46.0,1
2362,CC:2F:71:3F:1F:24,4873308,1643568954,1030966,1158969442,3842342,484599512,364,851831,938958925,851044,938863825,787,95100,823145,15,1030901,107960,361,657,130000.0,43333.0,-71.0,-70.0,-69.0,-71.0,-70.0,-70.0,-68.0,-71.0,-90.0,-93.0,-89.0,-92.0,19.0,23.0,20.0,21.0,1
2363,CC:2F:71:3E:C5:1F,3843286,484714831,944,115319,3842342,484599512,0,3944,331321,3254,249371,690,81950,1000,11,1358,25,0,52,144444.0,39000.0,-72.0,-72.0,-69.0,-60.0,-71.0,-71.0,-67.0,-60.0,-90.0,-93.0,-89.0,-92.0,18.0,21.0,20.0,32.0,1
2364,BA:8C:B9:54:50:24,3847233,490788464,4891,6188952,3842342,484599512,0,9393,1726988,9371,1723493,22,3495,2354,17,5370,41,0,65,216660.0,130000.0,-39.0,-37.0,-45.0,-52.0,-43.0,-34.0,-42.0,-46.0,-90.0,-93.0,-89.0,-92.0,51.0,56.0,44.0,40.0,1
2365,62:47:05:9D:EB:15,3844493,487030701,2145,2430583,3842348,484600118,0,4351,3015984,4320,3011003,31,4981,2068,0,2197,56,0,105,229410.0,137640.0,-46.0,-45.0,-39.0,-48.0,-45.0,-46.0,-39.0,-49.0,-90.0,-93.0,-89.0,-92.0,44.0,48.0,50.0,44.0,1
2366,3C:55:76:E8:8F:1F,3927265,697589487,84917,212989369,3842348,484600118,41,40269,8406294,39677,8301008,592,105286,16724,46,84993,9682,41,582,195000.0,97500.0,-51.0,-51.0,-46.0,-43.0,-49.0,-50.0,-44.0,-41.0,-90.0,-93.0,-90.0,-93.0,39.0,42.0,44.0,50.0,1
2367,92:69:1D:31:68:E9,3846344,488240984,3996,3640866,3842348,484600118,0,5135,1135014,4975,1098746,160,36268,2168,12,4233,93,0,55,216660.0,130000.0,-51.0,-48.0,-44.0,-46.0,-51.0,-47.0,-44.0,-47.0,-90.0,-93.0,-90.0,-93.0,39.0,45.0,46.0,47.0,1
2368,CC:2F:71:3F:1F:24,4873522,1643832376,1031174,1159232258,3842348,484600118,364,852019,939203341,851232,939108241,787,95100,823333,15,1031109,107990,361,657,130000.0,43333.0,-71.0,-70.0,-68.0,-72.0,-71.0,-70.0,-68.0,-71.0,-90.0,-93.0,-90.0,-93.0,19.0,23.0,22.0,21.0,1
2369,CC:2F:71:3E:C5:1F,3843292,484715437,944,115319,3842348,484600118,0,3946,331461,3256,249511,690,81950,1000,11,1359,25,0,52,144444.0,39000.0,-72.0,-72.0,-69.0,-60.0,-71.0,-71.0,-68.0,-60.0,-90.0,-93.0,-90.0,-93.0,18.0,21.0,21.0,33.0,1
2370,BA:8C:B9:54:50:24,3847239,490789070,4891,6188952,3842348,484600118,0,9395,1727124,9373,1723629,22,3495,2354,17,5371,41,0,65,216660.0,130000.0,-51.0,-35.0,-43.0,-45.0,-42.0,-34.0,-43.0,-47.0,-90.0,-93.0,-90.0,-93.0,39.0,58.0,47.0,48.0,1
2371,62:47:05:9D:EB:15,3844496,487031868,2146,2431548,3842350,484600320,0,4352,3016052,4321,3011071,31,4981,2068,0,2199,56,0,105,216660.0,130000.0,-45.0,-45.0,-39.0,-48.0,-45.0,-46.0,-39.0,-48.0,-90.0,-93.0,-90.0,-93.0,45.0,48.0,51.0,45.0,1
2372,3C:55:76:E8:8F:1F,3927267,697589689,84917,212989369,3842350,484600320,41,40269,8406294,39677,8301008,592,105286,16724,46,84993,9682,41,582,195000.0,97500.0,-51.0,-51.0,-46.0,-43.0,-49.0,-50.0,-44.0,-41.0,-90.0,-93.0,-90.0,-93.0,39.0,42.0,44.0,50.0,1
2373,92:69:1D:31:68:E9,3846347,488241246,3996,3640866,3842351,484600380,0,5137,1135150,4977,1098882,160,36268,2168,12,4234,93,0,55,216660.0,130000.0,-52.0,-48.0,-44.0,-47.0,-51.0,-47.0,-44.0,-47.0,-90.0,-93.0,-90.0,-93.0,38.0,45.0,46.0,46.0,1
2374,CC:2F:71:3F:1F:24,4873741,1644098999,1031390,1159498619,3842351,484600380,364,852213,939450368,851426,939355268,787,95100,823527,15,1031325,108006,361,657,115556.0,28889.0,-70.0,-70.0,-67.0,-72.0,-70.0,-70.0,-67.0,-72.0,-90.0,-93.0,-90.0,-93.0,20.0,23.0,23.0,21.0,1
2375,CC:2F:71:3E:C5:1F,3843295,484715699,944,115319,3842351,484600380,0,3946,331461,3256,249511,690,81950,1000,11,1359,25,0,52,144444.0,39000.0,-72.0,-72.0,-69.0,-60.0,-71.0,-71.0,-68.0,-60.0,-90.0,-93.0,-90.0,-93.0,18.0,21.0,21.0,33.0,1
2376,BA:8C:B9:54:50:24,3847244,490789534,4891,6188952,3842353,484600582,0,9395,1727124,9373,1723629,22,3495,2354,17,5371,41,0,65,216660.0,130000.0,-51.0,-35.0,-43.0,-45.0,-42.0,-34.0,-43.0,-47.0,-90.0,-93.0,-90.0,-93.0,39.0,58.0,47.0,48.0,1
2377,62:47:05:9D:EB:15,3844503,487032534,2146,2431548,3842357,484600986,0,4353,3016120,4322,3011139,31,4981,2068,0,2199,56,0,105,216660.0,130000.0,-46.0,-46.0,-39.0,-46.0,-45.0,-45.0,-39.0,-48.0,-90.0,-93.0,-90.0,-93.0,44.0,47.0,51.0,47.0,1
2378,3C:55:76:E8:8F:1F,3927274,697590355,84917,212989369,3842357,484600986,41,40269,8406294,39677,8301008,592,105286,16724,46,84993,9682,41,582,195000.0,97500.0,-51.0,-51.0,-46.0,-43.0,-49.0,-50.0,-44.0,-41.0,-90.0,-93.0,-90.0,-93.0,39.0,42.0,44.0,50.0,1
2379,92:69:1D:31:68:E9,3846353,488241852,3996,3640866,3842357,484600986,0,5137,1135150,4977,1098882,160,36268,2168,12,4234,93,0,55,216660.0,130000.0,-52.0,-48.0,-44.0,-47.0,-51.0,-47.0,-44.0,-47.0,-90.0,-93.0,-90.0,-93.0,38.0,45.0,46.0,46.0,1
2380,CC:2F:71:3F:1F:24,4873957,1644362905,1031600,1159761919,3842357,484600986,364,852398,939697298,851611,939602198,787,95100,823711,15,1031534,108011,361,657,115556.0,28889.0,-70.0,-70.0,-67.0,-72.0,-69.0,-70.0,-67.0,-72.0,-90.0,-93.0,-90.0,-93.0,20.0,23.0,23.0,21.0,1
2381,CC:2F:71:3E:C5:1F,3843303,484716507,944,115319,3842359,484601188,0,3946,331461,3256,249511,690,81950,1000,11,1359,25,0,52,144444.0,39000.0,-72.0,-72.0,-69.0,-60.0,-71.0,-71.0,-68.0,-60.0,-90.0,-93.0,-90.0,-93.0,18.0,21.0,21.0,33.0,1
2382,BA:8C:B9:54:50:24,3847250,490790140,4891,6188952,3842359,484601188,0,9395,1727124,9373,1723629,22,3495,2354,17,5371,41,0,65,216660.0,130000.0,-51.0,-35.0,-43.0,-45.0,-42.0,-34.0,-43.0,-47.0,-90.0,-93.0,-90.0,-93.0,39.0,58.0,47.0,48.0,1
2383,62:47:05:9D:EB:15,3844505,487032736,2146,2431548,3842359,484601188,0,4353,3016120,4322,3011139,31,4981,2068,0,2199,56,0,105,216660.0,130000.0,-46.0,-46.0,-39.0,-46.0,-45.0,-45.0,-39.0,-48.0,-90.0,-93.0,-90.0,-93.0,44.0,47.0,51.0,47.0,1
2384,3C:55:76:E8:8F:1F,3927276,697590557,84917,212989369,3842359,484601188,41,40270,8406457,39678,8301171,592,105286,16725,46,84993,9682,41,582,195000.0,97500.0,-46.0,-53.0,-45.0,-41.0,-48.0,-51.0,-44.0,-42.0,-90.0,-93.0,-90.0,-93.0,44.0,40.0,45.0,52.0,1
2385,92:69:1D:31:68:E9,3846357,488242256,3996,3640866,3842361,484601390,0,5137,1135150,4977,1098882,160,36268,2168,12,4234,93,0,55,216660.0,130000.0,-52.0,-48.0,-44.0,-47.0,-51.0,-47.0,-44.0,-47.0,-90.0,-93.0,-90.0,-93.0,38.0,45.0,46.0,46.0,1
2386,CC:2F:71:3F:1F:24,4874172,1644625309,1031811,1160023919,3842361,484601390,364,852587,939943350,851800,939848250,787,95100,823899,15,1031746,108023,361,657,130000.0,43333.0,-71.0,-70.0,-68.0,-71.0,-71.0,-70.0,-68.0,-71.0,-90.0,-93.0,-90.0,-93.0,19.0,23.0,22.0,22.0,1
2387,CC:2F:71:3E:C5:1F,3843305,484716709,944,115319,3842361,484601390,0,3946,331461,3256,249511,690,81950,1000,11,1359,25,0,52,144444.0,39000.0,-72.0,-72.0,-69.0,-60.0,-71.0,-71.0,-68.0,-60.0,-90.0,-93.0,-90.0,-93.0,18.0,21.0,21.0,33.0,1
2388,BA:8C:B9:54:50:24,3847252,490790342,4891,6188952,3842361,484601390,0,9395,1727124,9373,1723629,22,3495,2354,17,5371,41,0,65,216660.0,130000.0,-51.0,-35.0,-43.0,-45.0,-42.0,-34.0,-43.0,-47.0,-90.0,-93.0,-90.0,-93.0,39.0,58.0,47.0,48.0,1
2389,62:47:05:9D:EB:15,3844514,487033604,2146,2431548,3842368,484602056,0,4353,3016120,4322,3011139,31,4981,2068,0,2199,56,0,105,216660.0,130000.0,-46.0,-46.0,-39.0,-46.0,-45.0,-45.0,-39.0,-48.0,-90.0,-93.0,-90.0,-93.0,44.0,47.0,51.0,47.0,1
2390,3C:55:76:E8:8F:1F,3927286,697591591,84918,212989535,3842368,484602056,41,40278,8407043,39686,8301757,592,105286,16726,46,84994,9682,41,582,195000.0,97500.0,-43.0,-64.0,-45.0,-39.0,-42.0,-61.0,-44.0,-38.0,-90.0,-93.0,-90.0,-93.0,47.0,29.0,45.0,54.0,1
2391,92:69:1D:31:68:E9,3846364,488242922,3996,3640866,3842368,484602056,0,5137,1135150,4977,1098882,160,36268,2168,12,4234,93,0,55,216660.0,130000.0,-52.0,-48.0,-44.0,-47.0,-51.0,-47.0,-44.0,-47.0,-90.0,-93.0,-90.0,-93.0,38.0,45.0,46.0,46.0,1
2392,CC:2F:71:3F:1F:24,4874391,1644889678,1032022,1160287349,3842369,484602329,364,852773,940188958,851986,940093858,787,95100,824085,15,1031957,108025,361,657,130000.0,43333.0,-71.0,-70.0,-68.0,-71.0,-71.0,-70.0,-68.0,-71.0,-90.0,-93.0,-90.0,-93.0,19.0,23.0,22.0,22.0,1
2393,CC:2F:71:3E:C5:1F,3843313,484717648,944,115319,3842369,484602329,0,3946,331461,3256,249511,690,81950,1000,11,1359,25,0,52,144444.0,39000.0,-72.0,-72.0,-69.0,-60.0,-71.0,-71.0,-68.0,-60.0,-90.0,-93.0,-90.0,-93.0,18.0,21.0,21.0,33.0,1
2394,BA:8C:B9:54:50:24,3847260,490791281,4891,6188952,3842369,484602329,0,9395,1727124,9373,1723629,22,3495,2354,17,5371,41,0,65,216660.0,130000.0,-51.0,-35.0,-43.0,-45.0,-42.0,-34.0,-43.0,-47.0,-90.0,-93.0,-90.0,-93.0,39.0,58.0,47.0,48.0,1
2395,62:47:05:9D:EB:15,3844517,487034079,2146,2431548,3842371,484602531,0,4353,3016120,4322,3011139,31,4981,2068,0,2199,56,0,105,216660.0,130000.0,-46.0,-46.0,-39.0,-46.0,-45.0,-45.0,-39.0,-48.0,-90.0,-93.0,-90.0,-93.0,44.0,47.0,51.0,47.0,1
2396,3C:55:76:E8:8F:1F,3927289,697592066,84918,212989535,3842371,484602531,41,40278,8407043,39686,8301757,592,105286,16726,46,84994,9682,41,582,195000.0,97500.0,-43.0,-64.0,-45.0,-39.0,-42.0,-61.0,-44.0,-38.0,-90.0,-93.0,-90.0,-93.0,47.0,29.0,45.0,54.0,1
2397,92:69:1D:31:68:E9,3846369,488243599,3996,3640866,3842373,484602733,0,5137,1135150,4977,1098882,160,36268,2168,12,4234,93,0,55,216660.0,130000.0,-52.0,-48.0,-44.0,-47.0,-51.0,-47.0,-44.0,-47.0,-90.0,-93.0,-90.0,-93.0,38.0,45.0,46.0,46.0,1
2398,CC:2F:71:3F:1F:24,4874611,1645153651,1032238,1160550918,3842373,484602733,364,852962,940432599,852175,940337499,787,95100,824274,15,1032173,108030,361,659,130000.0,43333.0,-71.0,-70.0,-68.0,-71.0,-71.0,-70.0,-68.0,-71.0,-90.0,-93.0,-90.0,-93.0,19.0,23.0,22.0,22.0,1
2399,CC:2F:71:3E:C5:1F,3843317,484718052,944,115319,3842373,484602733,0,3946,331461,3256,249511,690,81950,1000,11,1359,25,0,52,144444.0,39000.0,-72.0,-72.0,-69.0,-60.0,-71.0,-71.0,-68.0,-60.0,-90.0,-93.0,-90.0,-93.0,18.0,21.0,21.0,33.0,1
2400,BA:8C:B9:54:50:24,3847264,490791685,4891,6188952,3842373,484602733,0,9395,1727124,9373,1723629,22,3495,2354,17,5371,41,0,65,216660.0,130000.0,-51.0,-35.0,-43.0,-45.0,-42.0,-34.0,-43.0,-47.0,-90.0,-93.0,-90.0,-93.0,39.0,58.0,47.0,48.0,1
2401,62:47:05:9D:EB:15,3844524,487034745,2146,2431548,3842378,484603197,0,4353,3016120,4322,3011139,31,4981,2068,0,2199,56,0,105,216660.0,130000.0,-46.0,-46.0,-39.0,-46.0,-45.0,-45.0,-39.0,-48.0,-90.0,-93.0,-90.0,-93.0,44.0,47.0,51.0,47.0,1
2402,3C:55:76:E8:8F:1F,3927296,697592732,84918,212989535,3842378,484603197,41,40278,8407043,39686,8301757,592,105286,16726,46,84994,9682,41,582,195000.0,97500.0,-43.0,-64.0,-45.0,-39.0,-42.0,-61.0,-44.0,-38.0,-90.0,-93.0,-90.0,-93.0,47.0,29.0,45.0,54.0,1
2403,92:69:1D:31:68:E9,3846374,488244063,3996,3640866,3842378,484603197,0,5137,1135150,4977,1098882,160,36268,2168,12,4234,93,0,55,216660.0,130000.0,-52.0,-48.0,-44.0,-47.0,-51.0,-47.0,-44.0,-47.0,-90.0,-93.0,-90.0,-93.0,38.0,45.0,46.0,46.0,1
2404,CC:2F:71:3F:1F:24,4874826,1645414553,1032448,1160811356,3842378,484603197,364,853147,940675275,852360,940580175,787,95100,824459,15,1032383,108031,361,660,130000.0,43333.0,-71.0,-70.0,-68.0,-71.0,-71.0,-70.0,-68.0,-71.0,-90.0,-93.0,-90.0,-93.0,19.0,23.0,22.0,22.0,1
2405,CC:2F:71:3E:C5:1F,3843322,484718516,944,115319,3842378,484603197,0,3946,331461,3256,249511,690,81950,1000,11,1359,25,0,52,144444.0,39000.0,-72.0,-72.0,-69.0,-60.0,-71.0,-71.0,-68.0,-60.0,-90.0,-93.0,-90.0,-93.0,18.0,21.0,21.0,33.0,1
2406,BA:8C:B9:54:50:24,3847269,490792149,4891,6188952,3842378,484603197,0,9395,1727124,9373,1723629,22,3495,2354,17,5371,41,0,65,216660.0,130000.0,-51.0,-35.0,-43.0,-45.0,-42.0,-34.0,-43.0,-47.0,-90.0,-93.0,-90.0,-93.0,39.0,58.0,47.0,48.0,1
2407,62:47:05:9D:EB:15,3844528,487035149,2146,2431548,3842382,484603601,0,4353,3016120,4322,3011139,31,4981,2068,0,2199,56,0,105,216660.0,130000.0,-46.0,-46.0,-39.0,-46.0,-45.0,-45.0,-39.0,-48.0,-90.0,-93.0,-90.0,-93.0,44.0,47.0,51.0,47.0,1
2408,3C:55:76:E8:8F:1F,3927300,697593136,84918,212989535,3842382,484603601,41,40278,8407043,39686,8301757,592,105286,16726,46,84994,9682,41,582,195000.0,97500.0,-43.0,-64.0,-45.0,-39.0,-42.0,-61.0,-44.0,-38.0,-90.0,-93.0,-90.0,-93.0,47.0,29.0,45.0,54.0,1
2409,92:69:1D:31:68:E9,3846378,488244467,3996,3640866,3842382,484603601,0,5137,1135150,4977,1098882,160,36268,2168,12,4234,93,0,55,216660.0,130000.0,-52.0,-48.0,-44.0,-47.0,-51.0,-47.0,-44.0,-47.0,-90.0,-93.0,-90.0,-93.0,38.0,45.0,46.0,46.0,1
2410,CC:2F:71:3F:1F:24,4875042,1645678235,1032658,1161074432,3842384,484603803,364,853336,940924149,852549,940829049,787,95100,824646,15,1032593,108043,361,660,130000.0,43333.0,-71.0,-70.0,-68.0,-71.0,-71.0,-70.0,-68.0,-71.0,-90.0,-93.0,-90.0,-93.0,19.0,23.0,22.0,22.0,1
2411,CC:2F:71:3E:C5:1F,3843328,484719122,944,115319,3842384,484603803,0,3946,331461,3256,249511,690,81950,1000,11,1359,25,0,52,144444.0,39000.0,-72.0,-72.0,-69.0,-60.0,-71.0,-71.0,-68.0,-60.0,-90.0,-93.0,-90.0,-93.0,18.0,21.0,21.0,33.0,1
2412,BA:8C:B9:54:50:24,3847275,490792755,4891,6188952,3842384,484603803,0,9395,1727124,9373,1723629,22,3495,2354,17,5371,41,0,65,216660.0,130000.0,-51.0,-35.0,-43.0,-45.0,-42.0,-34.0,-43.0,-47.0,-90.0,-93.0,-90.0,-93.0,39.0,58.0,47.0,48.0,1
2413,62:47:05:9D:EB:15,3844532,487035553,2146,2431548,3842386,484604005,0,4353,3016120,4322,3011139,31,4981,2068,0,2199,56,0,105,216660.0,130000.0,-46.0,-46.0,-39.0,-46.0,-45.0,-45.0,-39.0,-48.0,-90.0,-93.0,-90.0,-93.0,44.0,47.0,51.0,47.0,1
2414,3C:55:76:E8:8F:1F,3927313,697594808,84927,212990803,3842386,484604005,41,40296,8411991,39704,8306705,592,105286,16731,46,85003,9682,41,582,195000.0,97500.0,-43.0,-64.0,-45.0,-40.0,-43.0,-63.0,-44.0,-39.0,-90.0,-93.0,-90.0,-93.0,47.0,29.0,45.0,53.0,1
2415,92:69:1D:31:68:E9,3846383,488244931,3996,3640866,3842387,484604065,0,5137,1135150,4977,1098882,160,36268,2168,12,4234,93,0,55,216660.0,130000.0,-52.0,-48.0,-44.0,-47.0,-51.0,-47.0,-44.0,-47.0,-90.0,-93.0,-90.0,-93.0,38.0,45.0,46.0,46.0,1
2416,CC:2F:71:3F:1F:24,4875259,1645940606,1032872,1161336541,3842387,484604065,364,853525,941166367,852738,941071267,787,95100,824834,15,1032807,108043,361,661,130000.0,43333.0,-72.0,-71.0,-69.0,-72.0,-72.0,-71.0,-69.0,-72.0,-90.0,-93.0,-90.0,-93.0,18.0,22.0,21.0,21.0,1
2417,CC:2F:71:3E:C5:1F,3843331,484719384,944,115319,3842387,484604065,0,3946,331461,3256,249511,690,81950,1000,11,1359,25,0,52,144444.0,39000.0,-72.0,-72.0,-69.0,-60.0,-71.0,-71.0,-68.0,-60.0,-90.0,-93.0,-90.0,-93.0,18.0,21.0,21.0,33.0,1
2418,BA:8C:B9:54:50:24,3847278,490793017,4891,6188952,3842387,484604065,0,9395,1727124,9373,1723629,22,3495,2354,17,5371,41,0,65,216660.0,130000.0,-51.0,-35.0,-43.0,-45.0,-42.0,-34.0,-43.0,-47.0,-90.0,-93.0,-90.0,-93.0,39.0,58.0,47.0,48.0,1
2419,62:47:05:9D:EB:15,3844539,487036219,2146,2431548,3842393,484604671,0,4353,3016120,4322,3011139,31,4981,2068,0,2199,56,0,105,216660.0,130000.0,-46.0,-46.0,-39.0,-46.0,-45.0,-45.0,-39.0,-48.0,-90.0,-93.0,-90.0,-93.0,44.0,47.0,51.0,47.0,1
2420,3C:55:76:E8:8F:1F,3927322,697595722,84929,212991051,3842393,484604671,41,40310,8413112,39718,8307826,592,105286,16734,46,85005,9682,41,582,206470.0,97500.0,-40.0,-61.0,-42.0,-37.0,-42.0,-60.0,-43.0,-38.0,-90.0,-93.0,-90.0,-93.0,50.0,32.0,48.0,56.0,1
2421,92:69:1D:31:68:E9,3846389,488245537,3996,3640866,3842393,484604671,0,5137,1135150,4977,1098882,160,36268,2168,12,4234,93,0,55,216660.0,130000.0,-52.0,-48.0,-44.0,-47.0,-51.0,-47.0,-44.0,-47.0,-90.0,-93.0,-90.0,-93.0,38.0,45.0,46.0,46.0,1
2422,CC:2F:71:3F:1F:24,4875475,1646202850,1033082,1161598179,3842393,484604671,364,853710,941411891,852923,941316791,787,95100,825019,15,1033017,108050,361,662,130000.0,43333.0,-71.0,-69.0,-69.0,-71.0,-71.0,-69.0,-68.0,-71.0,-90.0,-93.0,-90.0,-93.0,19.0,24.0,21.0,22.0,1
2423,CC:2F:71:3E:C5:1F,3843337,484719990,944,115319,3842393,484604671,0,3946,331461,3256,249511,690,81950,1000,11,1359,25,0,52,144444.0,39000.0,-72.0,-72.0,-69.0,-60.0,-71.0,-71.0,-68.0,-60.0,-90.0,-93.0,-90.0,-93.0,18.0,21.0,21.0,33.0,1
2424,BA:8C:B9:54:50:24,3847286,490793825,4891,6188952,3842395,484604873,0,9395,1727124,9373,1723629,22,3495,2354,17,5371,41,0,65,216660.0,130000.0,-51.0,-35.0,-43.0,-45.0,-42.0,-34.0,-43.0,-47.0,-90.0,-93.0,-90.0,-93.0,39.0,58.0,47.0,48.0,1
2425,62:47:05:9D:EB:15,3844541,487036421,2146,2431548,3842395,484604873,0,4353,3016120,4322,3011139,31,4981,2068,0,2199,56,0,105,216660.0,130000.0,-46.0,-46.0,-39.0,-46.0,-45.0,-45.0,-39.0,-48.0,-90.0,-93.0,-90.0,-93.0,44.0,47.0,51.0,47.0,1
2426,3C:55:76:E8:8F:1F,3927329,697596544,84934,212991671,3842395,484604873,41,40328,8420229,39736,8314943,592,105286,16737,46,85010,9682,41,582,206470.0,97500.0,-45.0,-50.0,-44.0,-40.0,-44.0,-58.0,-44.0,-39.0,-90.0,-93.0,-90.0,-93.0,45.0,43.0,46.0,53.0,1
2427,92:69:1D:31:68:E9,3846393,488245941,3996,3640866,3842397,484605075,0,5137,1135150,4977,1098882,160,36268,2168,12,4234,93,0,55,216660.0,130000.0,-52.0,-48.0,-44.0,-47.0,-51.0,-47.0,-44.0,-47.0,-90.0,-93.0,-90.0,-93.0,38.0,45.0,46.0,46.0,1
2428,CC:2F:71:3F:1F:24,4875693,1646469922,1033296,1161864847,3842397,484605075,364,853897,941660561,853110,941565461,787,95100,825206,15,1033231,108053,361,662,130000.0,43333.0,-71.0,-70.0,-68.0,-72.0,-71.0,-70.0,-68.0,-72.0,-90.0,-93.0,-90.0,-93.0,19.0,23.0,22.0,21.0,1
2429,CC:2F:71:3E:C5:1F,3843341,484720394,944,115319,3842397,484605075,0,3946,331461,3256,249511,690,81950,1000,11,1359,25,0,52,144444.0,39000.0,-72.0,-72.0,-69.0,-60.0,-71.0,-71.0,-68.0,-60.0,-90.0,-93.0,-90.0,-93.0,18.0,21.0,21.0,33.0,1
2430,BA:8C:B9:54:50:24,3847288,490794027,4891,6188952,3842397,484605075,0,9395,1727124,9373,1723629,22,3495,2354,17,5371,41,0,65,216660.0,130000.0,-51.0,-35.0,-43.0,-45.0,-42.0,-34.0,-43.0,-47.0,-90.0,-93.0,-90.0,-93.0,39.0,58.0,47.0,48.0,1
2431,62:47:05:9D:EB:15,3844549,487037213,2146,2431548,3842403,484605665,0,4353,3016120,4322,3011139,31,4981,2068,0,2199,56,0,105,216660.0,130000.0,-46.0,-46.0,-39.0,-46.0,-45.0,-45.0,-39.0,-48.0,-90.0,-93.0,-90.0,-93.0,44.0,47.0,51.0,47.0,1
2432,3C:55:76:E8:8F:1F,3927343,697600953,84940,212995288,3842403,484605665,41,40343,8421433,39751,8316147,592,105286,16740,46,85016,9682,41,582,206470.0,97500.0,-49.0,-52.0,-47.0,-44.0,-49.0,-51.0,-46.0,-43.0,-90.0,-93.0,-90.0,-93.0,41.0,41.0,43.0,49.0,1
2433,92:69:1D:31:68:E9,3846401,488246733,3996,3640866,3842405,484605867,0,5138,1135218,4978,1098950,160,36268,2168,12,4234,93,0,55,216660.0,130000.0,-51.0,-48.0,-44.0,-46.0,-51.0,-48.0,-44.0,-47.0,-90.0,-93.0,-90.0,-93.0,39.0,45.0,46.0,47.0,1
2434,CC:2F:71:3F:1F:24,4875910,1646733660,1033505,1162127793,3842405,484605867,364,854087,941906633,853300,941811533,787,95100,825396,15,1033440,108058,361,662,130000.0,43333.0,-75.0,-74.0,-71.0,-75.0,-75.0,-74.0,-71.0,-75.0,-90.0,-93.0,-90.0,-93.0,15.0,19.0,19.0,18.0,1
2435,CC:2F:71:3E:C5:1F,3843349,484721186,944,115319,3842405,484605867,0,3946,331461,3256,249511,690,81950,1000,11,1359,25,0,52,144444.0,39000.0,-72.0,-72.0,-69.0,-60.0,-71.0,-71.0,-68.0,-60.0,-90.0,-93.0,-90.0,-93.0,18.0,21.0,21.0,33.0,1
2436,BA:8C:B9:54:50:24,3847296,490794819,4891,6188952,3842405,484605867,0,9395,1727124,9373,1723629,22,3495,2354,17,5371,41,0,65,216660.0,130000.0,-51.0,-35.0,-43.0,-45.0,-42.0,-34.0,-43.0,-47.0,-90.0,-93.0,-90.0,-93.0,39.0,58.0,47.0,48.0,1
2437,62:47:05:9D:EB:15,3844553,487037617,2146,2431548,3842407,484606069,0,4353,3016120,4322,3011139,31,4981,2068,0,2199,56,0,105,216660.0,130000.0,-46.0,-46.0,-39.0,-46.0,-45.0,-45.0,-39.0,-48.0,-90.0,-93.0,-90.0,-93.0,44.0,47.0,51.0,47.0,1
2438,3C:55:76:E8:8F:1F,3927347,697601357,84940,212995288,3842407,484606069,41,40343,8421433,39751,8316147,592,105286,16740,46,85016,9682,41,582,206470.0,97500.0,-49.0,-52.0,-47.0,-44.0,-49.0,-51.0,-46.0,-43.0,-90.0,-93.0,-90.0,-93.0,41.0,41.0,43.0,49.0,1
2439,92:69:1D:31:68:E9,3846403,488246935,3996,3640866,3842407,484606069,0,5138,1135218,4978,1098950,160,36268,2168,12,4234,93,0,55,216660.0,130000.0,-51.0,-48.0,-44.0,-46.0,-51.0,-48.0,-44.0,-47.0,-90.0,-93.0,-90.0,-93.0,39.0,45.0,46.0,47.0,1
2440,CC:2F:71:3F:1F:24,4876132,1647003871,1033725,1162397802,3842407,484606069,364,854281,942156550,853494,942061450,787,95100,825589,15,1033660,108059,361,663,130000.0,43333.0,-71.0,-70.0,-68.0,-72.0,-71.0,-70.0,-68.0,-71.0,-90.0,-93.0,-90.0,-93.0,19.0,23.0,22.0,21.0,1
2441,CC:2F:71:3E:C5:1F,3843351,484721388,944,115319,3842407,484606069,0,3946,331461,3256,249511,690,81950,1000,11,1359,25,0,52,144444.0,39000.0,-72.0,-72.0,-69.0,-60.0,-71.0,-71.0,-68.0,-60.0,-90.0,-93.0,-90.0,-93.0,18.0,21.0,21.0,33.0,1
2442,BA:8C:B9:54:50:24,3847300,490795223,4891,6188952,3842409,484606271,0,9395,1727124,9373,1723629,22,3495,2354,17,5371,41,0,65,216660.0,130000.0,-51.0,-35.0,-43.0,-45.0,-42.0,-34.0,-43.0,-47.0,-90.0,-93.0,-90.0,-93.0,39.0,58.0,47.0,48.0,1
2443,62:47:05:9D:EB:15,3844560,487038283,2146,2431548,3842414,484606735,0,4353,3016120,4322,3011139,31,4981,2068,0,2199,56,0,105,216660.0,130000.0,-46.0,-46.0,-39.0,-46.0,-45.0,-45.0,-39.0,-48.0,-90.0,-93.0,-90.0,-93.0,44.0,47.0,51.0,47.0,1
2444,3C:55:76:E8:8F:1F,3927354,697602023,84940,212995288,3842414,484606735,41,40343,8421433,39751,8316147,592,105286,16740,46,85016,9682,41,582,206470.0,97500.0,-49.0,-52.0,-47.0,-44.0,-49.0,-51.0,-46.0,-43.0,-90.0,-93.0,-90.0,-93.0,41.0,41.0,43.0,49.0,1
2445,92:69:1D:31:68:E9,3846410,488247601,3996,3640866,3842414,484606735,0,5138,1135218,4978,1098950,160,36268,2168,12,4234,93,0,55,216660.0,130000.0,-51.0,-48.0,-44.0,-46.0,-51.0,-48.0,-44.0,-47.0,-90.0,-93.0,-90.0,-93.0,39.0,45.0,46.0,47.0,1
2446,CC:2F:71:3F:1F:24,4876349,1647264781,1033935,1162658046,3842414,484606735,364,854466,942400618,853679,942305518,787,95100,825774,15,1033870,108063,361,663,130000.0,43333.0,-71.0,-70.0,-68.0,-72.0,-71.0,-70.0,-68.0,-72.0,-90.0,-93.0,-90.0,-93.0,19.0,23.0,22.0,21.0,1
2447,CC:2F:71:3E:C5:1F,3843358,484722054,944,115319,3842414,484606735,0,3946,331461,3256,249511,690,81950,1000,11,1359,25,0,52,144444.0,39000.0,-72.0,-72.0,-69.0,-60.0,-71.0,-71.0,-68.0,-60.0,-90.0,-93.0,-90.0,-93.0,18.0,21.0,21.0,33.0,1
2448,BA:8C:B9:54:50:24,3847305,490795687,4891,6188952,3842414,484606735,0,9395,1727124,9373,1723629,22,3495,2354,17,5371,41,0,65,216660.0,130000.0,-51.0,-35.0,-43.0,-45.0,-42.0,-34.0,-43.0,-47.0,-90.0,-93.0,-90.0,-93.0,39.0,58.0,47.0,48.0,1
2449,62:47:05:9D:EB:15,3844564,487038607,2147,2431608,3842417,484606999,0,4355,3016256,4324,3011275,31,4981,2068,0,2200,56,0,106,216660.0,130000.0,-46.0,-45.0,-39.0,-47.0,-45.0,-45.0,-39.0,-47.0,-90.0,-93.0,-90.0,-93.0,44.0,48.0,51.0,46.0,1
2450,3C:55:76:E8:8F:1F,3927358,697602403,84941,212995404,3842417,484606999,41,40352,8422049,39760,8316763,592,105286,16740,46,85017,9682,41,582,206470.0,97500.0,-49.0,-52.0,-46.0,-44.0,-47.0,-51.0,-44.0,-42.0,-90.0,-93.0,-90.0,-93.0,41.0,41.0,44.0,49.0,1
2451,92:69:1D:31:68:E9,3846414,488247981,3997,3640982,3842417,484606999,0,5140,1135354,4980,1099086,160,36268,2168,12,4235,93,0,55,216660.0,130000.0,-53.0,-47.0,-42.0,-48.0,-51.0,-47.0,-43.0,-46.0,-90.0,-93.0,-90.0,-93.0,37.0,46.0,48.0,45.0,1
2452,CC:2F:71:3F:1F:24,4876567,1647528939,1034148,1162921738,3842419,484607201,364,854652,942646226,853865,942551126,787,95100,825960,15,1034083,108064,361,663,130000.0,43333.0,-71.0,-70.0,-68.0,-71.0,-71.0,-70.0,-68.0,-71.0,-90.0,-93.0,-90.0,-93.0,19.0,23.0,22.0,22.0,1
2453,CC:2F:71:3E:C5:1F,3843364,484722636,945,115435,3842419,484607201,0,3950,331789,3259,249721,691,82068,1001,11,1360,25,0,52,144444.0,39000.0,-72.0,-71.0,-69.0,-60.0,-73.0,-73.0,-69.0,-61.0,-90.0,-93.0,-90.0,-93.0,18.0,22.0,21.0,33.0,1
2454,BA:8C:B9:54:50:24,3847314,490796533,4892,6189068,3842422,484607465,0,9397,1727260,9375,1723765,22,3495,2354,17,5372,41,0,65,216660.0,130000.0,-48.0,-35.0,-43.0,-45.0,-43.0,-35.0,-42.0,-47.0,-90.0,-93.0,-90.0,-93.0,42.0,58.0,47.0,48.0,1
2455,62:47:05:9D:EB:15,3844571,487039275,2147,2431608,3842424,484607667,0,4355,3016256,4324,3011275,31,4981,2068,0,2200,56,0,106,216660.0,130000.0,-46.0,-45.0,-39.0,-47.0,-45.0,-45.0,-39.0,-47.0,-90.0,-93.0,-90.0,-93.0,44.0,48.0,51.0,46.0,1
2456,3C:55:76:E8:8F:1F,3927365,697603071,84941,212995404,3842424,484607667,41,40365,8422987,39772,8317583,593,105404,16741,46,85017,9682,41,582,206470.0,97500.0,-43.0,-64.0,-45.0,-40.0,-42.0,-63.0,-44.0,-38.0,-90.0,-93.0,-90.0,-93.0,47.0,29.0,45.0,53.0,1
2457,92:69:1D:31:68:E9,3846422,488248709,3997,3640982,3842425,484607727,0,5140,1135354,4980,1099086,160,36268,2168,12,4235,93,0,55,216660.0,130000.0,-53.0,-47.0,-42.0,-48.0,-51.0,-47.0,-43.0,-46.0,-90.0,-93.0,-90.0,-93.0,37.0,46.0,48.0,45.0,1
2458,CC:2F:71:3F:1F:24,4876793,1647797938,1034368,1163190211,3842425,484607727,364,854846,942893253,854059,942798153,787,95100,826154,15,1034303,108068,361,663,117000.0,39000.0,-71.0,-70.0,-68.0,-71.0,-71.0,-70.0,-67.0,-71.0,-90.0,-93.0,-90.0,-93.0,19.0,23.0,22.0,22.0,1
2459,CC:2F:71:3E:C5:1F,3843370,484723162,945,115435,3842425,484607727,0,3950,331789,3259,249721,691,82068,1001,11,1360,25,0,52,144444.0,39000.0,-72.0,-71.0,-69.0,-60.0,-73.0,-73.0,-69.0,-61.0,-90.0,-93.0,-90.0,-93.0,18.0,22.0,21.0,33.0,1
2460,BA:8C:B9:54:50:24,3847317,490796795,4892,6189068,3842425,484607727,0,9397,1727260,9375,1723765,22,3495,2354,17,5372,41,0,65,216660.0,130000.0,-48.0,-35.0,-43.0,-45.0,-43.0,-35.0,-42.0,-47.0,-90.0,-93.0,-90.0,-93.0,42.0,58.0,47.0,48.0,1
2461,62:47:05:9D:EB:15,3844577,487040012,2147,2431608,3842430,484608404,0,4355,3016256,4324,3011275,31,4981,2068,0,2200,56,0,106,216660.0,130000.0,-46.0,-45.0,-39.0,-47.0,-45.0,-45.0,-39.0,-47.0,-90.0,-93.0,-90.0,-93.0,44.0,48.0,51.0,46.0,1
2462,3C:55:76:E8:8F:1F,3927371,697603808,84941,212995404,3842430,484608404,41,40365,8422987,39772,8317583,593,105404,16741,46,85017,9682,41,582,206470.0,97500.0,-43.0,-64.0,-45.0,-40.0,-42.0,-63.0,-44.0,-38.0,-90.0,-93.0,-90.0,-93.0,47.0,29.0,45.0,53.0,1
2463,92:69:1D:31:68:E9,3846427,488249386,3997,3640982,3842430,484608404,0,5140,1135354,4980,1099086,160,36268,2168,12,4235,93,0,55,216660.0,130000.0,-53.0,-47.0,-42.0,-48.0,-51.0,-47.0,-43.0,-46.0,-90.0,-93.0,-90.0,-93.0,37.0,46.0,48.0,45.0,1
2464,CC:2F:71:3F:1F:24,4877010,1648060357,1034578,1163451751,3842432,484608606,364,855034,943139233,854247,943044133,787,95100,826341,15,1034513,108078,361,665,130000.0,43333.0,-71.0,-70.0,-68.0,-72.0,-71.0,-70.0,-68.0,-72.0,-90.0,-93.0,-90.0,-93.0,19.0,23.0,22.0,21.0,1
2465,CC:2F:71:3E:C5:1F,3843377,484724041,945,115435,3842432,484608606,0,3950,331789,3259,249721,691,82068,1001,11,1360,25,0,52,144444.0,39000.0,-72.0,-71.0,-69.0,-60.0,-73.0,-73.0,-69.0,-61.0,-90.0,-93.0,-90.0,-93.0,18.0,22.0,21.0,33.0,1
2466,BA:8C:B9:54:50:24,3847324,490797674,4892,6189068,3842432,484608606,0,9397,1727260,9375,1723765,22,3495,2354,17,5372,41,0,65,216660.0,130000.0,-48.0,-35.0,-43.0,-45.0,-43.0,-35.0,-42.0,-47.0,-90.0,-93.0,-90.0,-93.0,42.0,58.0,47.0,48.0,1
2467,62:47:05:9D:EB:15,3844581,487040416,2147,2431608,3842434,484608808,0,4355,3016256,4324,3011275,31,4981,2068,0,2200,56,0,106,216660.0,130000.0,-46.0,-45.0,-39.0,-47.0,-45.0,-45.0,-39.0,-47.0,-90.0,-93.0,-90.0,-93.0,44.0,48.0,51.0,46.0,1
2468,3C:55:76:E8:8F:1F,3927375,697604212,84941,212995404,3842434,484608808,41,40365,8422987,39772,8317583,593,105404,16741,46,85017,9682,41,582,206470.0,97500.0,-43.0,-64.0,-45.0,-40.0,-42.0,-63.0,-44.0,-38.0,-90.0,-93.0,-90.0,-93.0,47.0,29.0,45.0,53.0,1
2469,92:69:1D:31:68:E9,3846433,488249992,3997,3640982,3842436,484609010,0,5140,1135354,4980,1099086,160,36268,2168,12,4235,93,0,55,216660.0,130000.0,-53.0,-47.0,-42.0,-48.0,-51.0,-47.0,-43.0,-46.0,-90.0,-93.0,-90.0,-93.0,37.0,46.0,48.0,45.0,1
2470,CC:2F:71:3F:1F:24,4877225,1648324191,1034789,1163715181,3842436,484609010,364,855219,943383301,854432,943288201,787,95100,826526,15,1034724,108086,361,665,130000.0,43333.0,-71.0,-70.0,-68.0,-72.0,-71.0,-69.0,-67.0,-71.0,-90.0,-93.0,-90.0,-93.0,19.0,23.0,22.0,21.0,1
2471,CC:2F:71:3E:C5:1F,3843381,484724445,945,115435,3842436,484609010,0,3950,331789,3259,249721,691,82068,1001,11,1360,25,0,52,144444.0,39000.0,-72.0,-71.0,-69.0,-60.0,-73.0,-73.0,-69.0,-61.0,-90.0,-93.0,-90.0,-93.0,18.0,22.0,21.0,33.0,1
2472,BA:8C:B9:54:50:24,3847328,490798078,4892,6189068,3842436,484609010,0,9397,1727260,9375,1723765,22,3495,2354,17,5372,41,0,65,216660.0,130000.0,-48.0,-35.0,-43.0,-45.0,-43.0,-35.0,-42.0,-47.0,-90.0,-93.0,-90.0,-93.0,42.0,58.0,47.0,48.0,1
2473,62:47:05:9D:EB:15,3844588,487041082,2147,2431608,3842441,484609474,0,4355,3016256,4324,3011275,31,4981,2068,0,2200,56,0,106,216660.0,130000.0,-46.0,-45.0,-39.0,-47.0,-45.0,-45.0,-39.0,-47.0,-90.0,-93.0,-90.0,-93.0,44.0,48.0,51.0,46.0,1
2474,3C:55:76:E8:8F:1F,3927382,697604878,84941,212995404,3842441,484609474,41,40365,8422987,39772,8317583,593,105404,16741,46,85017,9682,41,582,206470.0,97500.0,-43.0,-64.0,-45.0,-40.0,-42.0,-63.0,-44.0,-38.0,-90.0,-93.0,-90.0,-93.0,47.0,29.0,45.0,53.0,1
2475,92:69:1D:31:68:E9,3846438,488250456,3997,3640982,3842441,484609474,0,5140,1135354,4980,1099086,160,36268,2168,12,4235,93,0,55,216660.0,130000.0,-53.0,-47.0,-42.0,-48.0,-51.0,-47.0,-43.0,-46.0,-90.0,-93.0,-90.0,-93.0,37.0,46.0,48.0,45.0,1
2476,CC:2F:71:3F:1F:24,4877438,1648586047,1034997,1163976573,3842441,484609474,364,855402,943627137,854615,943532037,787,95100,826709,15,1034932,108098,361,665,130000.0,43333.0,-71.0,-70.0,-67.0,-71.0,-71.0,-69.0,-67.0,-71.0,-90.0,-93.0,-90.0,-93.0,19.0,23.0,23.0,22.0,1
2477,CC:2F:71:3E:C5:1F,3843388,484725111,945,115435,3842443,484609676,0,3950,331789,3259,249721,691,82068,1001,11,1360,25,0,52,144444.0,39000.0,-72.0,-71.0,-69.0,-60.0,-73.0,-73.0,-69.0,-61.0,-90.0,-93.0,-90.0,-93.0,18.0,22.0,21.0,33.0,1
2478,BA:8C:B9:54:50:24,3847336,490798806,4892,6189068,3842444,484609738,0,9397,1727260,9375,1723765,22,3495,2354,17,5372,41,0,65,216660.0,130000.0,-48.0,-35.0,-43.0,-45.0,-43.0,-35.0,-42.0,-47.0,-90.0,-93.0,-90.0,-93.0,42.0,58.0,47.0,48.0,1
2479,62:47:05:9D:EB:15,3844595,487041916,2147,2431608,3842448,484610308,0,4355,3016256,4324,3011275,31,4981,2068,0,2200,56,0,106,216660.0,130000.0,-46.0,-45.0,-39.0,-47.0,-45.0,-45.0,-39.0,-47.0,-90.0,-93.0,-90.0,-93.0,44.0,48.0,51.0,46.0,1
2480,3C:55:76:E8:8F:1F,3927389,697605712,84941,212995404,3842448,484610308,41,40379,8423993,39785,8318471,594,105522,16742,46,85017,9682,41,583,206470.0,97500.0,-46.0,-54.0,-47.0,-43.0,-48.0,-51.0,-45.0,-43.0,-90.0,-93.0,-90.0,-93.0,44.0,39.0,43.0,50.0,1
2481,92:69:1D:31:68:E9,3846445,488251290,3997,3640982,3842448,484610308,0,5140,1135354,4980,1099086,160,36268,2168,12,4235,93,0,55,216660.0,130000.0,-53.0,-47.0,-42.0,-48.0,-51.0,-47.0,-43.0,-46.0,-90.0,-93.0,-90.0,-93.0,37.0,46.0,48.0,45.0,1
2482,CC:2F:71:3F:1F:24,4877671,1648866214,1035223,1164255906,3842448,484610308,364,855603,943886367,854816,943791267,787,95100,826910,15,1035158,108103,361,665,130000.0,43333.0,-71.0,-70.0,-68.0,-71.0,-71.0,-70.0,-67.0,-71.0,-90.0,-93.0,-90.0,-93.0,19.0,23.0,22.0,22.0,1
2483,CC:2F:71:3E:C5:1F,3843393,484725743,945,115435,3842448,484610308,0,3950,331789,3259,249721,691,82068,1001,11,1360,25,0,52,144444.0,39000.0,-72.0,-71.0,-69.0,-60.0,-73.0,-73.0,-69.0,-61.0,-90.0,-93.0,-90.0,-93.0,18.0,22.0,21.0,33.0,1
2484,BA:8C:B9:54:50:24,3847340,490799376,4892,6189068,3842448,484610308,0,9397,1727260,9375,1723765,22,3495,2354,17,5372,41,0,65,216660.0,130000.0,-48.0,-35.0,-43.0,-45.0,-43.0,-35.0,-42.0,-47.0,-90.0,-93.0,-90.0,-93.0,42.0,58.0,47.0,48.0,1
2485,62:47:05:9D:EB:15,3844600,487042380,2147,2431608,3842453,484610772,0,4355,3016256,4324,3011275,31,4981,2068,0,2200,56,0,106,216660.0,130000.0,-46.0,-45.0,-39.0,-47.0,-45.0,-45.0,-39.0,-47.0,-90.0,-93.0,-90.0,-93.0,44.0,48.0,51.0,46.0,1
2486,3C:55:76:E8:8F:1F,3927398,697606676,84943,212995702,3842455,484610974,41,40395,8425279,39801,8319757,594,105522,16745,46,85019,9682,41,583,206470.0,97500.0,-45.0,-49.0,-43.0,-40.0,-44.0,-58.0,-45.0,-40.0,-90.0,-93.0,-90.0,-93.0,45.0,44.0,47.0,53.0,1
2487,92:69:1D:31:68:E9,3846452,488251956,3997,3640982,3842455,484610974,0,5140,1135354,4980,1099086,160,36268,2168,12,4235,93,0,55,216660.0,130000.0,-53.0,-47.0,-42.0,-48.0,-51.0,-47.0,-43.0,-46.0,-90.0,-93.0,-90.0,-93.0,37.0,46.0,48.0,45.0,1
2488,CC:2F:71:3F:1F:24,4877889,1649131510,1035434,1164520536,3842455,484610974,364,855792,944136609,855005,944041509,787,95100,827098,15,1035369,108108,361,665,130000.0,43333.0,-71.0,-70.0,-68.0,-72.0,-71.0,-69.0,-68.0,-71.0,-90.0,-93.0,-90.0,-93.0,19.0,23.0,22.0,21.0,1
2489,CC:2F:71:3E:C5:1F,3843400,484726409,945,115435,3842455,484610974,0,3950,331789,3259,249721,691,82068,1001,11,1360,25,0,52,144444.0,39000.0,-72.0,-71.0,-69.0,-60.0,-73.0,-73.0,-69.0,-61.0,-90.0,-93.0,-90.0,-93.0,18.0,22.0,21.0,33.0,1
2490,BA:8C:B9:54:50:24,3847347,490800042,4892,6189068,3842455,484610974,0,9397,1727260,9375,1723765,22,3495,2354,17,5372,41,0,65,216660.0,130000.0,-48.0,-35.0,-43.0,-45.0,-43.0,-35.0,-42.0,-47.0,-90.0,-93.0,-90.0,-93.0,42.0,58.0,47.0,48.0,1
2491,62:47:05:9D:EB:15,3844605,487042846,2147,2431608,3842458,484611238,0,4355,3016256,4324,3011275,31,4981,2068,0,2200,56,0,106,216660.0,130000.0,-46.0,-45.0,-39.0,-47.0,-45.0,-45.0,-39.0,-47.0,-90.0,-93.0,-90.0,-93.0,44.0,48.0,51.0,46.0,1
2492,3C:55:76:E8:8F:1F,3927402,697607349,84944,212996111,3842458,484611238,41,40418,8427204,39823,8321564,595,105640,16748,46,85020,9682,41,583,206470.0,97500.0,-48.0,-52.0,-44.0,-42.0,-45.0,-50.0,-43.0,-40.0,-90.0,-93.0,-90.0,-93.0,42.0,41.0,46.0,51.0,1
2493,92:69:1D:31:68:E9,3846455,488252220,3997,3640982,3842458,484611238,0,5140,1135354,4980,1099086,160,36268,2168,12,4235,93,0,55,216660.0,130000.0,-53.0,-47.0,-42.0,-48.0,-51.0,-47.0,-43.0,-46.0,-90.0,-93.0,-90.0,-93.0,37.0,46.0,48.0,45.0,1
2494,CC:2F:71:3F:1F:24,4878102,1649391944,1035642,1164780504,3842460,484611440,364,855975,944379021,855188,944283921,787,95100,827281,15,1035577,108130,361,665,130000.0,43333.0,-71.0,-70.0,-69.0,-72.0,-71.0,-70.0,-68.0,-72.0,-90.0,-93.0,-90.0,-93.0,19.0,23.0,21.0,21.0,1
2495,CC:2F:71:3E:C5:1F,3843405,484726875,945,115435,3842460,484611440,0,3950,331789,3259,249721,691,82068,1001,11,1360,25,0,52,144444.0,39000.0,-72.0,-71.0,-69.0,-60.0,-73.0,-73.0,-69.0,-61.0,-90.0,-93.0,-90.0,-93.0,18.0,22.0,21.0,33.0,1
2496,BA:8C:B9:54:50:24,3847352,490800508,4892,6189068,3842460,484611440,0,9397,1727260,9375,1723765,22,3495,2354,17,5372,41,0,65,216660.0,130000.0,-48.0,-35.0,-43.0,-45.0,-43.0,-35.0,-42.0,-47.0,-90.0,-93.0,-90.0,-93.0,42.0,58.0,47.0,48.0,1
2497,62:47:05:9D:EB:15,3844612,487043512,2147,2431608,3842465,484611904,0,4355,3016256,4324,3011275,31,4981,2068,0,2200,56,0,106,216660.0,130000.0,-46.0,-45.0,-39.0,-47.0,-45.0,-45.0,-39.0,-47.0,-90.0,-93.0,-90.0,-93.0,44.0,48.0,51.0,46.0,1
2498,3C:55:76:E8:8F:1F,3927409,697608015,84944,212996111,3842465,484611904,41,40421,8427410,39826,8321770,595,105640,16748,46,85020,9682,41,583,206470.0,97500.0,-49.0,-52.0,-45.0,-43.0,-46.0,-51.0,-43.0,-41.0,-90.0,-93.0,-90.0,-93.0,41.0,41.0,45.0,50.0,1
2499,92:69:1D:31:68:E9,3846462,488252886,3997,3640982,3842465,484611904,0,5140,1135354,4980,1099086,160,36268,2168,12,4235,93,0,55,216660.0,130000.0,-53.0,-47.0,-42.0,-48.0,-51.0,-47.0,-43.0,-46.0,-90.0,-93.0,-90.0,-93.0,37.0,46.0,48.0,45.0,1
2500,CC:2F:71:3F:1F:24,4878328,1649662323,1035863,1165050419,3842465,484611904,364,856171,944627704,855384,944532604,787,95100,827477,15,1035798,108158,361,665,130000.0,43333.0,-71.0,-70.0,-68.0,-72.0,-71.0,-70.0,-68.0,-72.0,-90.0,-93.0,-90.0,-93.0,19.0,23.0,22.0,21.0,1
2501,CC:2F:71:3E:C5:1F,3843410,484727339,945,115435,3842465,484611904,0,3950,331789,3259,249721,691,82068,1001,11,1360,25,0,52,144444.0,39000.0,-72.0,-71.0,-69.0,-60.0,-73.0,-73.0,-69.0,-61.0,-90.0,-93.0,-90.0,-93.0,18.0,22.0,21.0,33.0,1
2502,BA:8C:B9:54:50:24,3847359,490801174,4892,6189068,3842467,484612106,0,9397,1727260,9375,1723765,22,3495,2354,17,5372,41,0,65,216660.0,130000.0,-48.0,-35.0,-43.0,-45.0,-43.0,-35.0,-42.0,-47.0,-90.0,-93.0,-90.0,-93.0,42.0,58.0,47.0,48.0,1
2503,62:47:05:9D:EB:15,3844617,487043976,2147,2431608,3842470,484612368,0,4355,3016256,4324,3011275,31,4981,2068,0,2200,56,0,106,216660.0,130000.0,-46.0,-45.0,-39.0,-47.0,-45.0,-45.0,-39.0,-47.0,-90.0,-93.0,-90.0,-93.0,44.0,48.0,51.0,46.0,1
2504,3C:55:76:E8:8F:1F,3927414,697608479,84944,212996111,3842470,484612368,41,40421,8427410,39826,8321770,595,105640,16748,46,85020,9682,41,583,206470.0,97500.0,-49.0,-52.0,-45.0,-43.0,-46.0,-51.0,-43.0,-41.0,-90.0,-93.0,-90.0,-93.0,41.0,41.0,45.0,50.0,1
2505,92:69:1D:31:68:E9,3846467,488253350,3997,3640982,3842470,484612368,0,5140,1135354,4980,1099086,160,36268,2168,12,4235,93,0,55,216660.0,130000.0,-53.0,-47.0,-42.0,-48.0,-51.0,-47.0,-43.0,-46.0,-90.0,-93.0,-90.0,-93.0,37.0,46.0,48.0,45.0,1
2506,CC:2F:71:3F:1F:24,4878548,1649928075,1036076,1165315505,3842472,484612570,364,856361,944875178,855573,944779964,788,95214,827667,15,1036011,108160,361,665,130000.0,43333.0,-71.0,-70.0,-68.0,-72.0,-71.0,-70.0,-68.0,-72.0,-90.0,-93.0,-90.0,-93.0,19.0,23.0,22.0,21.0,1
2507,CC:2F:71:3E:C5:1F,3843418,484728091,945,115435,3842473,484612656,0,3950,331789,3259,249721,691,82068,1001,11,1360,25,0,52,144444.0,39000.0,-72.0,-71.0,-69.0,-60.0,-73.0,-73.0,-69.0,-61.0,-90.0,-93.0,-90.0,-93.0,18.0,22.0,21.0,33.0,1
2508,BA:8C:B9:54:50:24,3847365,490801724,4892,6189068,3842473,484612656,0,9398,1727328,9376,1723833,22,3495,2354,17,5373,41,0,66,216660.0,130000.0,-48.0,-35.0,-43.0,-45.0,-44.0,-35.0,-42.0,-47.0,-90.0,-93.0,-90.0,-93.0,42.0,58.0,47.0,48.0,1
2509,62:47:05:9D:EB:15,3844625,487044728,2147,2431608,3842478,484613120,0,4356,3016324,4325,3011343,31,4981,2068,0,2200,56,0,106,216660.0,130000.0,-46.0,-46.0,-39.0,-47.0,-45.0,-45.0,-39.0,-47.0,-90.0,-93.0,-90.0,-93.0,44.0,47.0,51.0,46.0,1
2510,3C:55:76:E8:8F:1F,3927425,697609664,84945,212996342,3842480,484613322,41,40431,8428201,39836,8322561,595,105640,16750,46,85021,9682,41,583,206470.0,97500.0,-43.0,-63.0,-45.0,-40.0,-42.0,-60.0,-44.0,-38.0,-90.0,-93.0,-90.0,-93.0,47.0,30.0,45.0,53.0,1
2511,92:69:1D:31:68:E9,3846477,488254304,3997,3640982,3842480,484613322,0,5142,1135490,4982,1099222,160,36268,2168,12,4236,93,0,55,216660.0,130000.0,-51.0,-48.0,-45.0,-46.0,-51.0,-47.0,-43.0,-46.0,-90.0,-93.0,-90.0,-93.0,39.0,45.0,45.0,47.0,1
2512,CC:2F:71:3F:1F:24,4878768,1650194787,1036288,1165581465,3842480,484613322,364,856555,945128956,855763,945033170,792,95786,827860,15,1036223,108173,361,665,130000.0,43333.0,-71.0,-70.0,-69.0,-72.0,-71.0,-70.0,-68.0,-72.0,-90.0,-93.0,-90.0,-93.0,19.0,23.0,21.0,21.0,1
2513,CC:2F:71:3E:C5:1F,3843425,484728757,945,115435,3842480,484613322,0,3952,331929,3261,249861,691,82068,1001,12,1361,26,0,52,144444.0,39000.0,-81.0,-85.0,-75.0,-71.0,-74.0,-75.0,-70.0,-62.0,-90.0,-93.0,-90.0,-93.0,9.0,8.0,15.0,22.0,1
2514,BA:8C:B9:54:50:24,3847373,490802450,4892,6189068,3842481,484613382,0,9399,1727396,9377,1723901,22,3495,2354,17,5373,41,0,66,216660.0,130000.0,-39.0,-36.0,-45.0,-52.0,-43.0,-35.0,-43.0,-48.0,-90.0,-93.0,-90.0,-93.0,51.0,57.0,45.0,41.0,1
2515,62:47:05:9D:EB:15,3844632,487045394,2147,2431608,3842485,484613786,0,4358,3016460,4327,3011479,31,4981,2068,0,2201,56,0,106,216660.0,130000.0,-46.0,-46.0,-39.0,-47.0,-45.0,-46.0,-39.0,-48.0,-90.0,-93.0,-90.0,-93.0,44.0,47.0,51.0,46.0,1
2516,3C:55:76:E8:8F:1F,3927430,697610128,84945,212996342,3842485,484613786,41,40431,8428201,39836,8322561,595,105640,16750,46,85021,9682,41,583,206470.0,97500.0,-43.0,-63.0,-45.0,-40.0,-42.0,-60.0,-44.0,-38.0,-90.0,-93.0,-90.0,-93.0,47.0,30.0,45.0,53.0,1
2517,92:69:1D:31:68:E9,3846482,488254768,3997,3640982,3842485,484613786,0,5142,1135490,4982,1099222,160,36268,2168,12,4236,93,0,55,216660.0,130000.0,-51.0,-48.0,-45.0,-46.0,-51.0,-47.0,-43.0,-46.0,-90.0,-93.0,-90.0,-93.0,39.0,45.0,45.0,47.0,1
2518,CC:2F:71:3F:1F:24,4878984,1650460105,1036499,1165846319,3842485,484613786,364,856740,945374490,855948,945278704,792,95786,828045,15,1036434,108177,361,665,130000.0,43333.0,-72.0,-70.0,-68.0,-72.0,-72.0,-70.0,-68.0,-72.0,-90.0,-93.0,-90.0,-93.0,18.0,23.0,22.0,21.0,1
2519,CC:2F:71:3E:C5:1F,3843430,484729221,945,115435,3842485,484613786,0,3952,331929,3261,249861,691,82068,1001,12,1361,26,0,52,144444.0,39000.0,-81.0,-85.0,-75.0,-71.0,-74.0,-75.0,-70.0,-62.0,-90.0,-93.0,-90.0,-93.0,9.0,8.0,15.0,22.0,1
2520,BA:8C:B9:54:50:24,3847377,490802854,4892,6189068,3842485,484613786,0,9399,1727396,9377,1723901,22,3495,2354,17,5373,41,0,66,216660.0,130000.0,-39.0,-36.0,-45.0,-52.0,-43.0,-35.0,-43.0,-48.0,-90.0,-93.0,-90.0,-93.0,51.0,57.0,45.0,41.0,1
2521,62:47:05:9D:EB:15,3844636,487045798,2147,2431608,3842489,484614190,0,4358,3016460,4327,3011479,31,4981,2068,0,2201,56,0,106,216660.0,130000.0,-46.0,-46.0,-39.0,-47.0,-45.0,-46.0,-39.0,-48.0,-90.0,-93.0,-90.0,-93.0,44.0,47.0,51.0,46.0,1
2522,3C:55:76:E8:8F:1F,3927434,697610532,84945,212996342,3842489,484614190,41,40431,8428201,39836,8322561,595,105640,16750,46,85021,9682,41,583,206470.0,97500.0,-43.0,-63.0,-45.0,-40.0,-42.0,-60.0,-44.0,-38.0,-90.0,-93.0,-90.0,-93.0,47.0,30.0,45.0,53.0,1
2523,92:69:1D:31:68:E9,3846486,488255172,3997,3640982,3842489,484614190,0,5142,1135490,4982,1099222,160,36268,2168,12,4236,93,0,55,216660.0,130000.0,-51.0,-48.0,-45.0,-46.0,-51.0,-47.0,-43.0,-46.0,-90.0,-93.0,-90.0,-93.0,39.0,45.0,45.0,47.0,1
2524,CC:2F:71:3F:1F:24,4879205,1650725408,1036716,1166111218,3842489,484614190,364,856930,945619713,856138,945523927,792,95786,828234,15,1036651,108187,361,667,130000.0,43333.0,-72.0,-71.0,-69.0,-72.0,-71.0,-70.0,-68.0,-71.0,-90.0,-93.0,-90.0,-93.0,18.0,22.0,21.0,21.0,1
2525,CC:2F:71:3E:C5:1F,3843434,484729625,945,115435,3842489,484614190,0,3952,331929,3261,249861,691,82068,1001,12,1361,26,0,52,144444.0,39000.0,-81.0,-85.0,-75.0,-71.0,-74.0,-75.0,-70.0,-62.0,-90.0,-93.0,-90.0,-93.0,9.0,8.0,15.0,22.0,1
2526,BA:8C:B9:54:50:24,3847381,490803258,4892,6189068,3842489,484614190,0,9399,1727396,9377,1723901,22,3495,2354,17,5373,41,0,66,216660.0,130000.0,-39.0,-36.0,-45.0,-52.0,-43.0,-35.0,-43.0,-48.0,-90.0,-93.0,-90.0,-93.0,51.0,57.0,45.0,41.0,1
2527,62:47:05:9D:EB:15,3844642,487047227,2148,2432573,3842494,484614654,0,4359,3016528,4328,3011547,31,4981,2068,0,2202,56,0,106,216660.0,130000.0,-46.0,-46.0,-39.0,-47.0,-45.0,-46.0,-39.0,-47.0,-90.0,-93.0,-90.0,-93.0,44.0,47.0,51.0,46.0,1
2528,3C:55:76:E8:8F:1F,3927441,697611222,84947,212996568,3842494,484614654,41,40445,8429319,39850,8323679,595,105640,16753,46,85023,9682,41,583,206470.0,103230.0,-44.0,-63.0,-45.0,-40.0,-43.0,-60.0,-44.0,-39.0,-90.0,-93.0,-90.0,-93.0,46.0,30.0,45.0,53.0,1
2529,92:69:1D:31:68:E9,3846491,488255636,3997,3640982,3842494,484614654,0,5142,1135490,4982,1099222,160,36268,2168,12,4236,93,0,55,216660.0,130000.0,-51.0,-48.0,-45.0,-46.0,-51.0,-47.0,-43.0,-46.0,-90.0,-93.0,-90.0,-93.0,39.0,45.0,45.0,47.0,1
2530,CC:2F:71:3F:1F:24,4879421,1650987859,1036925,1166373003,3842496,484614856,364,857117,945865504,856325,945769718,792,95786,828421,15,1036860,108188,361,667,130000.0,43333.0,-75.0,-74.0,-72.0,-75.0,-74.0,-73.0,-71.0,-74.0,-90.0,-93.0,-90.0,-93.0,15.0,19.0,18.0,18.0,1
2531,CC:2F:71:3E:C5:1F,3843441,484730291,945,115435,3842496,484614856,0,3952,331929,3261,249861,691,82068,1001,12,1361,26,0,52,144444.0,39000.0,-81.0,-85.0,-75.0,-71.0,-74.0,-75.0,-70.0,-62.0,-90.0,-93.0,-90.0,-93.0,9.0,8.0,15.0,22.0,1
2532,BA:8C:B9:54:50:24,3847388,490803924,4892,6189068,3842496,484614856,0,9400,1727464,9378,1723969,22,3495,2354,17,5373,41,0,66,216660.0,130000.0,-48.0,-35.0,-43.0,-46.0,-43.0,-35.0,-43.0,-48.0,-90.0,-93.0,-90.0,-93.0,42.0,58.0,47.0,47.0,1
2533,62:47:05:9D:EB:15,3844647,487047904,2148,2432573,3842499,484615331,0,4360,3016596,4329,3011615,31,4981,2068,0,2202,56,0,106,216660.0,130000.0,-46.0,-45.0,-39.0,-47.0,-45.0,-46.0,-39.0,-47.0,-90.0,-93.0,-90.0,-93.0,44.0,48.0,51.0,46.0,1
2534,3C:55:76:E8:8F:1F,3927446,697611899,84947,212996568,3842499,484615331,41,40448,8429525,39853,8323885,595,105640,16753,46,85023,9682,41,583,206470.0,103230.0,-44.0,-63.0,-46.0,-40.0,-44.0,-60.0,-45.0,-39.0,-90.0,-93.0,-90.0,-93.0,46.0,30.0,44.0,53.0,1
2535,92:69:1D:31:68:E9,3846496,488256313,3997,3640982,3842499,484615331,0,5142,1135490,4982,1099222,160,36268,2168,12,4236,93,0,55,216660.0,130000.0,-51.0,-48.0,-45.0,-46.0,-51.0,-47.0,-43.0,-46.0,-90.0,-93.0,-90.0,-93.0,39.0,45.0,45.0,47.0,1
2536,CC:2F:71:3F:1F:24,4879634,1651251410,1037135,1166636079,3842499,484615331,364,857307,946114466,856515,946018680,792,95786,828608,15,1037070,108200,361,667,130000.0,43333.0,-75.0,-73.0,-71.0,-75.0,-74.0,-73.0,-71.0,-74.0,-90.0,-93.0,-90.0,-93.0,15.0,20.0,19.0,18.0,1
2537,CC:2F:71:3E:C5:1F,3843444,484730766,945,115435,3842499,484615331,0,3952,331929,3261,249861,691,82068,1001,12,1361,26,0,52,144444.0,39000.0,-81.0,-85.0,-75.0,-71.0,-74.0,-75.0,-70.0,-62.0,-90.0,-93.0,-90.0,-93.0,9.0,8.0,15.0,22.0,1
2538,BA:8C:B9:54:50:24,3847391,490804399,4892,6189068,3842499,484615331,0,9400,1727464,9378,1723969,22,3495,2354,17,5373,41,0,66,216660.0,130000.0,-48.0,-35.0,-43.0,-46.0,-43.0,-35.0,-43.0,-48.0,-90.0,-93.0,-90.0,-93.0,42.0,58.0,47.0,47.0,1
2539,62:47:05:9D:EB:15,3844654,487048570,2148,2432573,3842506,484615997,0,4360,3016596,4329,3011615,31,4981,2068,0,2202,56,0,106,216660.0,130000.0,-46.0,-45.0,-39.0,-47.0,-45.0,-46.0,-39.0,-47.0,-90.0,-93.0,-90.0,-93.0,44.0,48.0,51.0,46.0,1
2540,3C:55:76:E8:8F:1F,3927462,697620979,84956,213004982,3842506,484615997,41,40469,8433224,39874,8327584,595,105640,16764,46,85032,9682,41,583,216660.0,130000.0,-43.0,-61.0,-46.0,-39.0,-45.0,-55.0,-45.0,-41.0,-90.0,-93.0,-90.0,-93.0,47.0,32.0,44.0,54.0,1
2541,92:69:1D:31:68:E9,3846503,488256979,3997,3640982,3842506,484615997,0,5142,1135490,4982,1099222,160,36268,2168,12,4236,93,0,55,216660.0,130000.0,-51.0,-48.0,-45.0,-46.0,-51.0,-47.0,-43.0,-46.0,-90.0,-93.0,-90.0,-93.0,39.0,45.0,45.0,47.0,1
2542,CC:2F:71:3F:1F:24,4879859,1651520401,1037353,1166904404,3842506,484615997,364,857505,946369189,856713,946273403,792,95786,828801,15,1037288,108209,361,668,130000.0,43333.0,-71.0,-70.0,-69.0,-72.0,-71.0,-70.0,-68.0,-72.0,-90.0,-93.0,-90.0,-93.0,19.0,23.0,21.0,21.0,1
2543,CC:2F:71:3E:C5:1F,3843453,484731634,945,115435,3842508,484616199,0,3952,331929,3261,249861,691,82068,1001,12,1361,26,0,52,144444.0,39000.0,-81.0,-85.0,-75.0,-71.0,-74.0,-75.0,-70.0,-62.0,-90.0,-93.0,-90.0,-93.0,9.0,8.0,15.0,22.0,1
2544,BA:8C:B9:54:50:24,3847400,490805267,4892,6189068,3842508,484616199,0,9400,1727464,9378,1723969,22,3495,2354,17,5373,41,0,66,216660.0,130000.0,-48.0,-35.0,-43.0,-46.0,-43.0,-35.0,-43.0,-48.0,-90.0,-93.0,-90.0,-93.0,42.0,58.0,47.0,47.0,1
2545,62:47:05:9D:EB:15,3844656,487048772,2148,2432573,3842508,484616199,0,4360,3016596,4329,3011615,31,4981,2068,0,2202,56,0,106,216660.0,130000.0,-46.0,-45.0,-39.0,-47.0,-45.0,-46.0,-39.0,-47.0,-90.0,-93.0,-90.0,-93.0,44.0,48.0,51.0,46.0,1
2546,3C:55:76:E8:8F:1F,3927464,697621181,84956,213004982,3842508,484616199,41,40483,8434178,39888,8328538,595,105640,16764,46,85032,9682,41,583,216660.0,130000.0,-44.0,-63.0,-46.0,-40.0,-43.0,-62.0,-45.0,-39.0,-90.0,-93.0,-90.0,-93.0,46.0,30.0,44.0,53.0,1
2547,92:69:1D:31:68:E9,3846505,488257181,3997,3640982,3842508,484616199,0,5142,1135490,4982,1099222,160,36268,2168,12,4236,93,0,55,216660.0,130000.0,-51.0,-48.0,-45.0,-46.0,-51.0,-47.0,-43.0,-46.0,-90.0,-93.0,-90.0,-93.0,39.0,45.0,45.0,47.0,1
2548,CC:2F:71:3F:1F:24,4880077,1651785991,1037565,1167169388,3842512,484616603,364,857698,946627193,856906,946531407,792,95786,828986,15,1037500,108214,361,668,130000.0,43333.0,-71.0,-70.0,-68.0,-72.0,-71.0,-70.0,-68.0,-72.0,-90.0,-93.0,-90.0,-93.0,19.0,23.0,22.0,21.0,1
2549,CC:2F:71:3E:C5:1F,3843457,484732038,945,115435,3842512,484616603,0,3952,331929,3261,249861,691,82068,1001,12,1361,26,0,52,144444.0,39000.0,-81.0,-85.0,-75.0,-71.0,-74.0,-75.0,-70.0,-62.0,-90.0,-93.0,-90.0,-93.0,9.0,8.0,15.0,22.0,1
2550,BA:8C:B9:54:50:24,3847404,490805671,4892,6189068,3842512,484616603,0,9400,1727464,9378,1723969,22,3495,2354,17,5373,41,0,66,216660.0,130000.0,-48.0,-35.0,-43.0,-46.0,-43.0,-35.0,-43.0,-48.0,-90.0,-93.0,-90.0,-93.0,42.0,58.0,47.0,47.0,1
2551,62:47:05:9D:EB:15,3844662,487049378,2148,2432573,3842514,484616805,0,4360,3016596,4329,3011615,31,4981,2068,0,2202,56,0,106,216660.0,130000.0,-46.0,-45.0,-39.0,-47.0,-45.0,-46.0,-39.0,-47.0,-90.0,-93.0,-90.0,-93.0,44.0,48.0,51.0,46.0,1
2552,3C:55:76:E8:8F:1F,3927472,697621989,84956,213004982,3842516,484617007,41,40483,8434178,39888,8328538,595,105640,16764,46,85032,9682,41,583,216660.0,130000.0,-44.0,-63.0,-46.0,-40.0,-43.0,-62.0,-45.0,-39.0,-90.0,-93.0,-90.0,-93.0,46.0,30.0,44.0,53.0,1
2553,92:69:1D:31:68:E9,3846513,488257989,3997,3640982,3842516,484617007,0,5142,1135490,4982,1099222,160,36268,2168,12,4236,93,0,55,216660.0,130000.0,-51.0,-48.0,-45.0,-46.0,-51.0,-47.0,-43.0,-46.0,-90.0,-93.0,-90.0,-93.0,39.0,45.0,45.0,47.0,1
2554,CC:2F:71:3F:1F:24,4880293,1652051155,1037777,1167434148,3842516,484617007,364,857896,946886043,857104,946790257,792,95786,829173,15,1037712,108230,361,668,130000.0,43333.0,-71.0,-70.0,-68.0,-71.0,-71.0,-70.0,-68.0,-71.0,-90.0,-93.0,-90.0,-93.0,19.0,23.0,22.0,22.0,1
2555,CC:2F:71:3E:C5:1F,3843462,484732502,945,115435,3842517,484617067,0,3952,331929,3261,249861,691,82068,1001,12,1361,26,0,52,144444.0,39000.0,-81.0,-85.0,-75.0,-71.0,-74.0,-75.0,-70.0,-62.0,-90.0,-93.0,-90.0,-93.0,9.0,8.0,15.0,22.0,1
2556,BA:8C:B9:54:50:24,3847409,490806135,4892,6189068,3842517,484617067,0,9400,1727464,9378,1723969,22,3495,2354,17,5373,41,0,66,216660.0,130000.0,-48.0,-35.0,-43.0,-46.0,-43.0,-35.0,-43.0,-48.0,-90.0,-93.0,-90.0,-93.0,42.0,58.0,47.0,47.0,1
2557,62:47:05:9D:EB:15,3844669,487050044,2148,2432573,3842521,484617471,0,4360,3016596,4329,3011615,31,4981,2068,0,2202,56,0,106,216660.0,130000.0,-46.0,-45.0,-39.0,-47.0,-45.0,-46.0,-39.0,-47.0,-91.0,-93.0,-90.0,-93.0,45.0,48.0,51.0,46.0,1
2558,3C:55:76:E8:8F:1F,3927478,697622627,84957,213005156,3842521,484617471,41,40491,8434852,39896,8329212,595,105640,16766,46,85033,9682,41,583,216660.0,130000.0,-43.0,-62.0,-46.0,-39.0,-42.0,-58.0,-44.0,-38.0,-91.0,-93.0,-90.0,-93.0,48.0,31.0,44.0,54.0,1
2559,92:69:1D:31:68:E9,3846518,488258453,3997,3640982,3842521,484617471,0,5142,1135490,4982,1099222,160,36268,2168,12,4236,93,0,55,216660.0,130000.0,-51.0,-48.0,-45.0,-46.0,-51.0,-47.0,-43.0,-46.0,-91.0,-93.0,-90.0,-93.0,40.0,45.0,45.0,47.0,1
2560,CC:2F:71:3F:1F:24,4880517,1652320661,1037996,1167703190,3842521,484617471,364,858105,947151429,857313,947055643,792,95786,829371,15,1037931,108235,361,668,130000.0,43333.0,-71.0,-70.0,-68.0,-72.0,-71.0,-70.0,-68.0,-72.0,-91.0,-93.0,-90.0,-93.0,20.0,23.0,22.0,21.0,1
2561,CC:2F:71:3E:C5:1F,3843466,484732906,945,115435,3842521,484617471,0,3952,331929,3261,249861,691,82068,1001,12,1361,26,0,52,144444.0,39000.0,-81.0,-85.0,-75.0,-71.0,-74.0,-75.0,-70.0,-62.0,-91.0,-93.0,-90.0,-93.0,10.0,8.0,15.0,22.0,1
2562,BA:8C:B9:54:50:24,3847413,490806539,4892,6189068,3842521,484617471,0,9405,1727804,9383,1724309,22,3495,2354,17,5373,41,0,66,216660.0,130000.0,-39.0,-36.0,-45.0,-51.0,-43.0,-35.0,-44.0,-48.0,-91.0,-93.0,-90.0,-93.0,52.0,57.0,45.0,42.0,1
2563,62:47:05:9D:EB:15,3844673,487050448,2148,2432573,3842525,484617875,0,4360,3016596,4329,3011615,31,4981,2068,0,2202,56,0,106,216660.0,130000.0,-46.0,-45.0,-39.0,-47.0,-45.0,-46.0,-39.0,-47.0,-91.0,-93.0,-90.0,-93.0,45.0,48.0,51.0,46.0,1
2564,3C:55:76:E8:8F:1F,3927484,697623291,84959,213005416,3842525,484617875,41,40499,8435474,39904,8329834,595,105640,16768,46,85035,9682,41,583,216660.0,130000.0,-49.0,-51.0,-45.0,-44.0,-46.0,-52.0,-44.0,-41.0,-91.0,-93.0,-90.0,-93.0,42.0,42.0,45.0,49.0,1
2565,92:69:1D:31:68:E9,3846522,488258857,3997,3640982,3842525,484617875,0,5142,1135490,4982,1099222,160,36268,2168,12,4236,93,0,55,216660.0,130000.0,-51.0,-48.0,-45.0,-46.0,-51.0,-47.0,-43.0,-46.0,-91.0,-93.0,-90.0,-93.0,40.0,45.0,45.0,47.0,1
2566,CC:2F:71:3F:1F:24,4880740,1652587872,1038215,1167969997,3842525,484617875,364,858311,947408511,857519,947312725,792,95786,829568,15,1038150,108244,361,668,130000.0,43333.0,-75.0,-74.0,-72.0,-76.0,-74.0,-73.0,-71.0,-75.0,-91.0,-93.0,-90.0,-93.0,16.0,19.0,18.0,17.0,1
2567,CC:2F:71:3E:C5:1F,3843470,484733310,945,115435,3842525,484617875,0,3952,331929,3261,249861,691,82068,1001,12,1361,26,0,52,144444.0,39000.0,-81.0,-85.0,-75.0,-71.0,-74.0,-75.0,-70.0,-62.0,-91.0,-93.0,-90.0,-93.0,10.0,8.0,15.0,22.0,1
2568,BA:8C:B9:54:50:24,3847417,490806943,4892,6189068,3842525,484617875,0,9405,1727804,9383,1724309,22,3495,2354,17,5373,41,0,66,216660.0,130000.0,-39.0,-36.0,-45.0,-51.0,-43.0,-35.0,-44.0,-48.0,-91.0,-93.0,-90.0,-93.0,52.0,57.0,45.0,42.0,1
2569,62:47:05:9D:EB:15,3844679,487051081,2149,2432742,3842530,484618339,0,4362,3016732,4331,3011751,31,4981,2068,0,2203,56,0,106,216660.0,130000.0,-46.0,-45.0,-39.0,-47.0,-45.0,-46.0,-39.0,-47.0,-91.0,-93.0,-90.0,-93.0,45.0,48.0,51.0,46.0,1
2570,3C:55:76:E8:8F:1F,3927507,697633201,84977,213014862,3842530,484618339,41,40538,8447913,39943,8342273,595,105640,16782,46,85053,9682,41,583,216660.0,130000.0,-49.0,-52.0,-46.0,-44.0,-48.0,-51.0,-45.0,-43.0,-91.0,-93.0,-90.0,-93.0,42.0,41.0,44.0,49.0,1
2571,92:69:1D:31:68:E9,3846527,488259321,3997,3640982,3842530,484618339,0,5142,1135490,4982,1099222,160,36268,2168,12,4236,93,0,55,216660.0,130000.0,-51.0,-48.0,-45.0,-46.0,-51.0,-47.0,-43.0,-46.0,-91.0,-93.0,-90.0,-93.0,40.0,45.0,45.0,47.0,1
2572,CC:2F:71:3F:1F:24,4880958,1652853170,1038428,1168234831,3842530,484618339,364,858509,947674261,857717,947578475,792,95786,829754,15,1038363,108253,361,668,130000.0,43333.0,-71.0,-70.0,-68.0,-72.0,-74.0,-73.0,-71.0,-74.0,-91.0,-93.0,-90.0,-93.0,20.0,23.0,22.0,21.0,1
2573,CC:2F:71:3E:C5:1F,3843475,484733774,945,115435,3842530,484618339,0,3952,331929,3261,249861,691,82068,1001,12,1361,26,0,52,144444.0,39000.0,-81.0,-85.0,-75.0,-71.0,-74.0,-75.0,-70.0,-62.0,-91.0,-93.0,-90.0,-93.0,10.0,8.0,15.0,22.0,1
2574,BA:8C:B9:54:50:24,3847424,490807609,4892,6189068,3842532,484618541,0,9405,1727804,9383,1724309,22,3495,2354,17,5373,41,0,66,216660.0,130000.0,-39.0,-36.0,-45.0,-51.0,-43.0,-35.0,-44.0,-48.0,-91.0,-93.0,-90.0,-93.0,52.0,57.0,45.0,42.0,1
2575,62:47:05:9D:EB:15,3844684,487051654,2150,2432911,3842534,484618743,0,4364,3016868,4333,3011887,31,4981,2068,0,2204,56,0,106,216660.0,130000.0,-46.0,-45.0,-39.0,-47.0,-45.0,-46.0,-39.0,-48.0,-91.0,-93.0,-90.0,-93.0,45.0,48.0,51.0,46.0,1
2576,3C:55:76:E8:8F:1F,3927518,697634549,84984,213015806,3842534,484618743,41,40546,8452861,39951,8347221,595,105640,16788,46,85060,9685,41,583,229410.0,130000.0,-46.0,-52.0,-44.0,-41.0,-47.0,-53.0,-45.0,-43.0,-91.0,-93.0,-90.0,-93.0,45.0,41.0,46.0,52.0,1
2577,92:69:1D:31:68:E9,3846531,488259725,3997,3640982,3842534,484618743,0,5142,1135490,4982,1099222,160,36268,2168,12,4236,93,0,55,216660.0,130000.0,-51.0,-48.0,-45.0,-46.0,-51.0,-47.0,-43.0,-46.0,-91.0,-93.0,-90.0,-93.0,40.0,45.0,45.0,47.0,1
2578,CC:2F:71:3F:1F:24,4881172,1653113818,1038638,1168495075,3842534,484618743,364,858708,947934645,857916,947838859,792,95786,829939,15,1038573,108278,361,668,130000.0,43333.0,-74.0,-73.0,-72.0,-76.0,-74.0,-73.0,-72.0,-75.0,-91.0,-93.0,-90.0,-93.0,17.0,20.0,18.0,17.0,1
2579,CC:2F:71:3E:C5:1F,3843479,484734178,945,115435,3842534,484618743,0,3952,331929,3261,249861,691,82068,1001,12,1361,26,0,52,144444.0,39000.0,-81.0,-85.0,-75.0,-71.0,-74.0,-75.0,-70.0,-62.0,-91.0,-93.0,-90.0,-93.0,10.0,8.0,15.0,22.0,1
2580,BA:8C:B9:54:50:24,3847426,490807811,4892,6189068,3842534,484618743,0,9405,1727804,9383,1724309,22,3495,2354,17,5373,41,0,66,216660.0,130000.0,-39.0,-36.0,-45.0,-51.0,-43.0,-35.0,-44.0,-48.0,-91.0,-93.0,-90.0,-93.0,52.0,57.0,45.0,42.0,1
2581,62:47:05:9D:EB:15,3844690,487052287,2151,2433080,3842539,484619207,0,4365,3016936,4334,3011955,31,4981,2068,0,2205,56,0,106,216660.0,130000.0,-45.0,-47.0,-40.0,-51.0,-45.0,-46.0,-39.0,-48.0,-91.0,-93.0,-90.0,-93.0,46.0,46.0,50.0,42.0,1
2582,3C:55:76:E8:8F:1F,3927524,697635129,84985,213015922,3842539,484619207,41,40556,8453581,39961,8347941,595,105640,16789,46,85061,9685,41,583,229410.0,130000.0,-50.0,-53.0,-45.0,-43.0,-49.0,-52.0,-44.0,-42.0,-90.0,-93.0,-89.0,-92.0,40.0,40.0,44.0,49.0,1
2583,92:69:1D:31:68:E9,3846538,488260391,3997,3640982,3842541,484619409,0,5142,1135490,4982,1099222,160,36268,2168,12,4236,93,0,55,216660.0,130000.0,-51.0,-48.0,-45.0,-46.0,-51.0,-47.0,-43.0,-46.0,-90.0,-93.0,-89.0,-92.0,39.0,45.0,44.0,46.0,1
2584,CC:2F:71:3F:1F:24,4881398,1653384379,1038857,1168764970,3842541,484619409,364,858907,948192626,858115,948096840,792,95786,830133,15,1038792,108279,361,672,130000.0,43333.0,-70.0,-69.0,-68.0,-69.0,-70.0,-69.0,-67.0,-69.0,-90.0,-93.0,-89.0,-92.0,20.0,24.0,21.0,23.0,1
2585,CC:2F:71:3E:C5:1F,3843488,484735046,945,115435,3842543,484619611,0,3952,331929,3261,249861,691,82068,1001,12,1361,26,0,52,144444.0,39000.0,-81.0,-85.0,-75.0,-71.0,-74.0,-75.0,-70.0,-62.0,-90.0,-93.0,-89.0,-92.0,9.0,8.0,14.0,21.0,1
2586,BA:8C:B9:54:50:24,3847435,490808679,4892,6189068,3842543,484619611,0,9405,1727804,9383,1724309,22,3495,2354,17,5373,41,0,66,216660.0,130000.0,-39.0,-36.0,-45.0,-51.0,-43.0,-35.0,-44.0,-48.0,-90.0,-93.0,-89.0,-92.0,51.0,57.0,44.0,41.0,1
2587,62:47:05:9D:EB:15,3844695,487052753,2151,2433080,3842544,484619673,0,4366,3017004,4335,3012023,31,4981,2068,0,2205,56,0,106,216660.0,130000.0,-46.0,-45.0,-40.0,-48.0,-45.0,-46.0,-39.0,-48.0,-90.0,-93.0,-89.0,-92.0,44.0,48.0,49.0,44.0,1
2588,3C:55:76:E8:8F:1F,3927530,697635711,84986,213016038,3842544,484619673,41,40565,8454247,39969,8348489,596,105758,16790,46,85062,9685,41,584,229410.0,130000.0,-44.0,-57.0,-49.0,-40.0,-43.0,-56.0,-46.0,-39.0,-90.0,-93.0,-89.0,-92.0,46.0,36.0,40.0,52.0,1
2589,92:69:1D:31:68:E9,3846542,488260771,3998,3641098,3842544,484619673,0,5144,1135626,4984,1099358,160,36268,2168,12,4237,93,0,55,216660.0,130000.0,-52.0,-47.0,-42.0,-48.0,-51.0,-47.0,-43.0,-47.0,-90.0,-93.0,-89.0,-92.0,38.0,46.0,47.0,44.0,1
2590,CC:2F:71:3F:1F:24,4881615,1653648295,1039069,1169028420,3842546,484619875,364,859096,948441554,858304,948345768,792,95786,830320,15,1039004,108290,361,672,117000.0,39000.0,-70.0,-69.0,-67.0,-69.0,-70.0,-69.0,-67.0,-69.0,-90.0,-92.0,-88.0,-91.0,20.0,23.0,21.0,22.0,1
2591,CC:2F:71:3E:C5:1F,3843494,484735628,946,115551,3842548,484620077,0,3954,332069,3263,250001,691,82068,1001,12,1362,26,0,52,144444.0,39000.0,-78.0,-79.0,-73.0,-70.0,-76.0,-76.0,-71.0,-65.0,-90.0,-92.0,-88.0,-91.0,12.0,13.0,15.0,21.0,1
2592,BA:8C:B9:54:50:24,3847441,490809261,4893,6189184,3842548,484620077,0,9407,1727940,9385,1724445,22,3495,2354,17,5374,41,0,66,216660.0,130000.0,-48.0,-35.0,-43.0,-46.0,-44.0,-35.0,-43.0,-47.0,-90.0,-92.0,-88.0,-91.0,42.0,57.0,45.0,45.0,1
2593,62:47:05:9D:EB:15,3844706,487053908,2153,2433365,3842553,484620543,0,4368,3017140,4337,3012159,31,4981,2068,0,2207,56,0,106,216660.0,130000.0,-46.0,-45.0,-40.0,-48.0,-45.0,-46.0,-39.0,-48.0,-90.0,-92.0,-88.0,-91.0,44.0,47.0,48.0,43.0,1
2594,3C:55:76:E8:8F:1F,3927539,697636581,84986,213016038,3842553,484620543,41,40565,8454247,39969,8348489,596,105758,16790,46,85062,9685,41,584,229410.0,130000.0,-44.0,-57.0,-49.0,-40.0,-43.0,-56.0,-46.0,-39.0,-90.0,-92.0,-88.0,-91.0,46.0,35.0,39.0,51.0,1
2595,92:69:1D:31:68:E9,3846551,488261641,3998,3641098,3842553,484620543,0,5144,1135626,4984,1099358,160,36268,2168,12,4237,93,0,55,216660.0,130000.0,-52.0,-47.0,-42.0,-48.0,-51.0,-47.0,-43.0,-47.0,-90.0,-92.0,-88.0,-91.0,38.0,45.0,46.0,43.0,1
2596,CC:2F:71:3F:1F:24,4881836,1653915225,1039282,1169294622,3842554,484620603,364,859290,948702442,858498,948606656,792,95786,830506,15,1039217,108297,361,672,130000.0,43333.0,-70.0,-69.0,-67.0,-70.0,-70.0,-69.0,-67.0,-69.0,-90.0,-92.0,-88.0,-91.0,20.0,23.0,21.0,21.0,1
2597,CC:2F:71:3E:C5:1F,3843500,484736154,946,115551,3842554,484620603,0,3956,332257,3264,250071,692,82186,1002,12,1362,26,0,52,144444.0,39000.0,-72.0,-71.0,-67.0,-60.0,-74.0,-75.0,-70.0,-63.0,-90.0,-92.0,-88.0,-91.0,18.0,21.0,21.0,31.0,1
2598,BA:8C:B9:54:50:24,3847447,490809787,4893,6189184,3842554,484620603,0,9407,1727940,9385,1724445,22,3495,2354,17,5374,41,0,66,216660.0,130000.0,-48.0,-35.0,-43.0,-46.0,-44.0,-35.0,-43.0,-47.0,-89.0,-91.0,-88.0,-90.0,41.0,56.0,45.0,44.0,1
2599,62:47:05:9D:EB:15,3844710,487054443,2153,2433365,3842557,484621078,0,4368,3017140,4337,3012159,31,4981,2068,0,2207,56,0,106,216660.0,130000.0,-46.0,-45.0,-40.0,-48.0,-45.0,-46.0,-39.0,-48.0,-89.0,-91.0,-88.0,-90.0,43.0,46.0,48.0,42.0,1
2600,3C:55:76:E8:8F:1F,3927545,697637318,84986,213016038,3842559,484621280,41,40565,8454247,39969,8348489,596,105758,16790,46,85062,9685,41,584,229410.0,130000.0,-44.0,-57.0,-49.0,-40.0,-43.0,-56.0,-46.0,-39.0,-89.0,-91.0,-88.0,-90.0,45.0,34.0,39.0,50.0,1
2601,92:69:1D:31:68:E9,3846557,488262378,3998,3641098,3842559,484621280,0,5144,1135626,4984,1099358,160,36268,2168,12,4237,93,0,55,216660.0,130000.0,-52.0,-47.0,-42.0,-48.0,-51.0,-47.0,-43.0,-47.0,-89.0,-91.0,-88.0,-90.0,37.0,44.0,46.0,42.0,1
2602,CC:2F:71:3F:1F:24,4882054,1654182328,1039495,1169561048,3842559,484621280,364,859485,948963446,858693,948867660,792,95786,830693,15,1039430,108300,361,672,130000.0,43333.0,-70.0,-70.0,-68.0,-70.0,-70.0,-69.0,-67.0,-69.0,-89.0,-91.0,-88.0,-90.0,19.0,21.0,20.0,20.0,1
2603,CC:2F:71:3E:C5:1F,3843505,484736831,946,115551,3842559,484621280,0,3956,332257,3264,250071,692,82186,1002,12,1362,26,0,52,144444.0,39000.0,-72.0,-71.0,-67.0,-60.0,-74.0,-75.0,-70.0,-63.0,-89.0,-91.0,-88.0,-90.0,17.0,20.0,21.0,30.0,1
2604,BA:8C:B9:54:50:24,3847452,490810464,4893,6189184,3842559,484621280,0,9407,1727940,9385,1724445,22,3495,2354,17,5374,41,0,66,216660.0,130000.0,-48.0,-35.0,-43.0,-46.0,-44.0,-35.0,-43.0,-47.0,-89.0,-91.0,-88.0,-90.0,41.0,56.0,45.0,44.0,1
2605,62:47:05:9D:EB:15,3844725,487055917,2153,2433365,3842572,484622552,0,4369,3017208,4338,3012227,31,4981,2068,0,2207,56,0,106,216660.0,130000.0,-45.0,-47.0,-40.0,-50.0,-45.0,-46.0,-39.0,-48.0,-89.0,-90.0,-87.0,-89.0,44.0,43.0,47.0,39.0,1
2606,3C:55:76:E8:8F:1F,3927563,697639438,84991,213016886,3842572,484622552,42,40579,8455468,39983,8349710,596,105758,16794,46,85068,9691,42,586,229410.0,130000.0,-46.0,-52.0,-44.0,-41.0,-44.0,-57.0,-44.0,-40.0,-89.0,-90.0,-87.0,-89.0,43.0,38.0,43.0,48.0,1
2607,92:69:1D:31:68:E9,3846570,488263650,3998,3641098,3842572,484622552,0,5147,1135830,4987,1099562,160,36268,2168,12,4237,93,0,55,216660.0,130000.0,-53.0,-47.0,-42.0,-48.0,-52.0,-47.0,-42.0,-47.0,-89.0,-90.0,-87.0,-89.0,36.0,43.0,45.0,41.0,1
2608,CC:2F:71:3F:1F:24,4882602,1654939931,1040030,1170317379,3842572,484622552,479,860030,949741988,859238,949646202,792,95786,831205,15,1039850,108638,476,672,130000.0,39000.0,-70.0,-70.0,-67.0,-70.0,-70.0,-69.0,-67.0,-70.0,-89.0,-90.0,-87.0,-89.0,19.0,20.0,20.0,19.0,1
2609,CC:2F:71:3E:C5:1F,3843518,484738103,946,115551,3842572,484622552,0,3956,332257,3264,250071,692,82186,1002,12,1362,26,0,52,144444.0,39000.0,-72.0,-71.0,-67.0,-60.0,-74.0,-75.0,-70.0,-63.0,-89.0,-90.0,-87.0,-89.0,17.0,19.0,20.0,29.0,1
2610,BA:8C:B9:54:50:24,3847465,490811736,4893,6189184,3842572,484622552,0,9411,1728212,9389,1724717,22,3495,2354,17,5374,41,0,66,216660.0,130000.0,-48.0,-35.0,-43.0,-46.0,-44.0,-35.0,-43.0,-47.0,-89.0,-90.0,-87.0,-89.0,41.0,55.0,44.0,43.0,1
2611,62:47:05:9D:EB:15,3844732,487056628,2154,2433534,3842578,484623094,0,4374,3017618,4342,3012499,32,5119,2069,0,2208,56,0,106,216660.0,130000.0,-46.0,-45.0,-39.0,-48.0,-46.0,-46.0,-39.0,-48.0,-88.0,-90.0,-86.0,-88.0,42.0,45.0,47.0,40.0,1
2612,3C:55:76:E8:8F:1F,3927570,697640098,84992,213017004,3842578,484623094,42,40591,8456378,39995,8350620,596,105758,16795,46,85069,9691,42,587,229410.0,130000.0,-41.0,-59.0,-43.0,-37.0,-43.0,-59.0,-44.0,-39.0,-88.0,-90.0,-86.0,-88.0,47.0,31.0,43.0,51.0,1
2613,92:69:1D:31:68:E9,3846576,488264192,3998,3641098,3842578,484623094,0,5147,1135830,4987,1099562,160,36268,2168,12,4237,93,0,55,216660.0,130000.0,-53.0,-47.0,-42.0,-48.0,-52.0,-47.0,-42.0,-47.0,-88.0,-90.0,-86.0,-88.0,35.0,43.0,44.0,40.0,1
2614,CC:2F:71:3F:1F:24,4882835,1655221246,1040255,1170597950,3842580,484623296,479,860236,950008974,859444,949913188,792,95786,831407,15,1040076,108662,476,672,130000.0,43333.0,-70.0,-69.0,-67.0,-69.0,-70.0,-69.0,-67.0,-70.0,-88.0,-90.0,-86.0,-88.0,18.0,21.0,19.0,19.0,1
2615,CC:2F:71:3E:C5:1F,3843528,484739049,946,115551,3842582,484623498,0,3956,332257,3264,250071,692,82186,1002,12,1362,26,0,52,144444.0,39000.0,-72.0,-71.0,-67.0,-60.0,-74.0,-75.0,-70.0,-63.0,-88.0,-90.0,-86.0,-88.0,16.0,19.0,19.0,28.0,1
2616,BA:8C:B9:54:50:24,3847475,490812682,4893,6189184,3842582,484623498,0,9411,1728212,9389,1724717,22,3495,2354,17,5374,41,0,66,216660.0,130000.0,-48.0,-35.0,-43.0,-46.0,-44.0,-35.0,-43.0,-47.0,-88.0,-90.0,-86.0,-88.0,40.0,55.0,43.0,42.0,1
2617,62:47:05:9D:EB:15,3844736,487057032,2154,2433534,3842582,484623498,0,4374,3017618,4342,3012499,32,5119,2069,0,2208,56,0,106,216660.0,130000.0,-46.0,-45.0,-39.0,-48.0,-46.0,-46.0,-39.0,-48.0,-88.0,-90.0,-86.0,-88.0,42.0,45.0,47.0,40.0,1
2618,3C:55:76:E8:8F:1F,3927574,697640502,84992,213017004,3842582,484623498,42,40600,8457028,40004,8351270,596,105758,16796,46,85069,9691,42,587,229410.0,130000.0,-44.0,-61.0,-46.0,-40.0,-44.0,-59.0,-45.0,-40.0,-88.0,-89.0,-85.0,-87.0,44.0,28.0,39.0,47.0,1
2619,92:69:1D:31:68:E9,3846580,488264596,3998,3641098,3842582,484623498,0,5147,1135830,4987,1099562,160,36268,2168,12,4237,93,0,55,216660.0,130000.0,-53.0,-47.0,-42.0,-48.0,-52.0,-47.0,-42.0,-47.0,-88.0,-89.0,-85.0,-87.0,35.0,42.0,43.0,39.0,1
2620,CC:2F:71:3F:1F:24,4883488,1656038099,1040902,1171414197,3842586,484623902,479,860614,950293862,859822,950198076,792,95786,831772,15,1040723,108685,476,672,130000.0,43333.0,-71.0,-69.0,-67.0,-70.0,-70.0,-69.0,-67.0,-70.0,-88.0,-89.0,-85.0,-87.0,17.0,20.0,18.0,17.0,1
2621,CC:2F:71:3E:C5:1F,3843532,484739453,946,115551,3842586,484623902,0,3956,332257,3264,250071,692,82186,1002,12,1362,26,0,52,144444.0,39000.0,-72.0,-71.0,-67.0,-60.0,-74.0,-75.0,-70.0,-63.0,-88.0,-89.0,-85.0,-87.0,16.0,18.0,18.0,27.0,1
2622,BA:8C:B9:54:50:24,3847479,490813086,4893,6189184,3842586,484623902,0,9411,1728212,9389,1724717,22,3495,2354,17,5374,41,0,66,216660.0,130000.0,-48.0,-35.0,-43.0,-46.0,-44.0,-35.0,-43.0,-47.0,-88.0,-89.0,-85.0,-87.0,40.0,54.0,42.0,41.0,1
2623,62:47:05:9D:EB:15,3844742,487057638,2154,2433534,3842588,484624104,0,4374,3017618,4342,3012499,32,5119,2069,0,2208,56,0,106,216660.0,130000.0,-46.0,-45.0,-39.0,-48.0,-46.0,-46.0,-39.0,-48.0,-88.0,-89.0,-85.0,-87.0,42.0,44.0,46.0,39.0,1
2624,3C:55:76:E8:8F:1F,3927584,697641432,84992,213017004,3842592,484624428,42,40600,8457028,40004,8351270,596,105758,16796,46,85069,9691,42,587,229410.0,130000.0,-44.0,-61.0,-46.0,-40.0,-44.0,-59.0,-45.0,-40.0,-88.0,-89.0,-85.0,-87.0,44.0,28.0,39.0,47.0,1
2625,92:69:1D:31:68:E9,3846590,488265526,3998,3641098,3842592,484624428,0,5148,1135898,4988,1099630,160,36268,2168,12,4237,93,0,55,216660.0,130000.0,-51.0,-48.0,-44.0,-46.0,-51.0,-47.0,-42.0,-47.0,-88.0,-89.0,-85.0,-87.0,37.0,41.0,41.0,41.0,1
2626,CC:2F:71:3F:1F:24,4884083,1656777252,1041491,1172152824,3842592,484624428,479,860989,950582009,860196,950486105,793,95904,832134,15,1041312,108774,476,673,130000.0,39000.0,-70.0,-69.0,-66.0,-70.0,-70.0,-69.0,-66.0,-70.0,-88.0,-89.0,-85.0,-87.0,18.0,20.0,19.0,17.0,1
2627,CC:2F:71:3E:C5:1F,3843538,484739979,946,115551,3842592,484624428,0,3956,332257,3264,250071,692,82186,1002,12,1362,26,0,52,144444.0,39000.0,-72.0,-71.0,-67.0,-60.0,-74.0,-75.0,-70.0,-63.0,-88.0,-89.0,-85.0,-87.0,16.0,18.0,18.0,27.0,1
2628,BA:8C:B9:54:50:24,3847485,490813612,4893,6189184,3842592,484624428,0,9411,1728212,9389,1724717,22,3495,2354,17,5374,41,0,66,216660.0,130000.0,-48.0,-35.0,-43.0,-46.0,-44.0,-35.0,-43.0,-47.0,-88.0,-89.0,-85.0,-87.0,40.0,54.0,42.0,41.0,1
2629,62:47:05:9D:EB:15,3844751,487058428,2154,2433534,3842597,484624894,0,4374,3017618,4342,3012499,32,5119,2069,0,2208,56,0,106,216660.0,130000.0,-46.0,-45.0,-39.0,-48.0,-46.0,-46.0,-39.0,-48.0,-88.0,-89.0,-85.0,-87.0,42.0,44.0,46.0,39.0,1
2630,3C:55:76:E8:8F:1F,3927589,697641898,84992,213017004,3842597,484624894,42,40609,8457694,40012,8351818,597,105876,16797,46,85069,9691,42,587,229410.0,130000.0,-45.0,-57.0,-47.0,-39.0,-42.0,-55.0,-46.0,-36.0,-88.0,-89.0,-85.0,-87.0,43.0,32.0,38.0,48.0,1
2631,92:69:1D:31:68:E9,3846595,488265992,3998,3641098,3842597,484624894,0,5148,1135898,4988,1099630,160,36268,2168,12,4237,93,0,55,216660.0,130000.0,-51.0,-48.0,-44.0,-46.0,-51.0,-47.0,-42.0,-47.0,-88.0,-89.0,-85.0,-87.0,37.0,41.0,41.0,41.0,1
2632,CC:2F:71:3F:1F:24,4884527,1657320155,1041930,1172695261,3842597,484624894,479,861302,950846690,860509,950750786,793,95904,832433,15,1041751,108806,476,673,115556.0,28889.0,-70.0,-69.0,-67.0,-71.0,-69.0,-69.0,-67.0,-70.0,-88.0,-89.0,-85.0,-87.0,18.0,20.0,18.0,16.0,1
2633,CC:2F:71:3E:C5:1F,3843543,484740445,946,115551,3842597,484624894,0,3956,332257,3264,250071,692,82186,1002,12,1362,26,0,52,144444.0,39000.0,-72.0,-71.0,-67.0,-60.0,-74.0,-75.0,-70.0,-63.0,-88.0,-89.0,-85.0,-87.0,16.0,18.0,18.0,27.0,1
2634,BA:8C:B9:54:50:24,3847490,490814078,4893,6189184,3842597,484624894,0,9412,1728280,9390,1724785,22,3495,2354,17,5374,41,0,66,216660.0,130000.0,-51.0,-35.0,-43.0,-45.0,-46.0,-35.0,-43.0,-47.0,-88.0,-89.0,-85.0,-87.0,37.0,54.0,42.0,42.0,1
2635,62:47:05:9D:EB:15,3844755,487058832,2154,2433534,3842601,484625298,0,4376,3017754,4344,3012635,32,5119,2069,0,2208,56,0,106,216660.0,130000.0,-45.0,-46.0,-40.0,-47.0,-46.0,-45.0,-39.0,-48.0,-87.0,-89.0,-85.0,-86.0,42.0,43.0,45.0,39.0,1
2636,3C:55:76:E8:8F:1F,3927593,697642302,84992,213017004,3842601,484625298,42,40609,8457694,40012,8351818,597,105876,16797,46,85069,9691,42,587,229410.0,130000.0,-45.0,-57.0,-47.0,-39.0,-42.0,-55.0,-46.0,-36.0,-87.0,-89.0,-85.0,-86.0,42.0,32.0,38.0,47.0,1
2637,92:69:1D:31:68:E9,3846599,488266396,3998,3641098,3842601,484625298,0,5148,1135898,4988,1099630,160,36268,2168,12,4237,93,0,55,216660.0,130000.0,-51.0,-48.0,-44.0,-46.0,-51.0,-47.0,-42.0,-47.0,-87.0,-89.0,-85.0,-86.0,36.0,41.0,41.0,40.0,1
2638,CC:2F:71:3F:1F:24,4884934,1657831713,1042332,1173206353,3842602,484625360,479,861580,951114127,860787,951018223,793,95904,832705,15,1042153,108813,476,673,115556.0,28889.0,-70.0,-69.0,-67.0,-71.0,-69.0,-69.0,-67.0,-70.0,-87.0,-89.0,-85.0,-86.0,17.0,20.0,18.0,15.0,1
2639,CC:2F:71:3E:C5:1F,3843548,484740911,946,115551,3842602,484625360,0,3958,332397,3266,250211,692,82186,1002,12,1363,26,0,52,144444.0,39000.0,-72.0,-72.0,-68.0,-60.0,-74.0,-75.0,-70.0,-63.0,-87.0,-89.0,-85.0,-86.0,15.0,17.0,17.0,26.0,1
2640,BA:8C:B9:54:50:24,3847496,490814604,4893,6189184,3842603,484625420,0,9415,1728484,9393,1724989,22,3495,2354,17,5374,41,0,66,216660.0,130000.0,-48.0,-35.0,-43.0,-46.0,-48.0,-35.0,-43.0,-46.0,-87.0,-89.0,-85.0,-86.0,39.0,54.0,42.0,40.0,1
2641,62:47:05:9D:EB:15,3844762,487059488,2155,2433664,3842607,484625824,0,4377,3017822,4345,3012703,32,5119,2069,0,2209,56,0,106,216660.0,130000.0,-45.0,-45.0,-39.0,-46.0,-46.0,-45.0,-39.0,-47.0,-87.0,-88.0,-84.0,-85.0,42.0,43.0,45.0,39.0,1
2642,3C:55:76:E8:8F:1F,3927599,697642828,84992,213017004,3842607,484625824,42,40618,8458360,40020,8352366,598,105994,16798,46,85069,9691,42,589,229410.0,130000.0,-47.0,-53.0,-42.0,-41.0,-46.0,-52.0,-42.0,-40.0,-87.0,-88.0,-84.0,-85.0,40.0,35.0,42.0,44.0,1
2643,92:69:1D:31:68:E9,3846605,488266922,3998,3641098,3842607,484625824,0,5148,1135898,4988,1099630,160,36268,2168,12,4237,93,0,55,216660.0,130000.0,-51.0,-48.0,-44.0,-46.0,-51.0,-47.0,-42.0,-47.0,-87.0,-88.0,-84.0,-85.0,36.0,40.0,40.0,39.0,1
2644,CC:2F:71:3F:1F:24,4885153,1658099373,1042546,1173473549,3842607,484625824,479,861783,951382239,860990,951286335,793,95904,832892,15,1042367,108866,476,674,104000.0,26000.0,-70.0,-70.0,-67.0,-71.0,-69.0,-69.0,-66.0,-70.0,-87.0,-88.0,-84.0,-85.0,17.0,18.0,17.0,14.0,1
2645,CC:2F:71:3E:C5:1F,3843565,484746974,946,115551,3842619,484631423,0,3958,332397,3266,250211,692,82186,1002,12,1363,26,0,52,144444.0,39000.0,-72.0,-72.0,-68.0,-60.0,-74.0,-75.0,-70.0,-63.0,-87.0,-88.0,-84.0,-85.0,15.0,16.0,16.0,25.0,1
2646,BA:8C:B9:54:50:24,3847514,490820809,4893,6189184,3842621,484631625,0,9415,1728484,9393,1724989,22,3495,2354,17,5374,41,0,66,216660.0,130000.0,-48.0,-35.0,-43.0,-46.0,-48.0,-35.0,-43.0,-46.0,-87.0,-88.0,-84.0,-85.0,39.0,53.0,41.0,39.0,1
2647,62:47:05:9D:EB:15,3844789,487070915,2155,2433664,3842634,484637251,0,4378,3017890,4346,3012771,32,5119,2069,0,2209,56,0,106,216660.0,130000.0,-45.0,-46.0,-40.0,-46.0,-45.0,-45.0,-39.0,-47.0,-86.0,-88.0,-84.0,-84.0,41.0,42.0,44.0,38.0,1
2648,3C:55:76:E8:8F:1F,3927626,697654255,84992,213017004,3842634,484637251,42,40618,8458360,40020,8352366,598,105994,16798,46,85069,9691,42,589,229410.0,130000.0,-47.0,-53.0,-42.0,-41.0,-46.0,-52.0,-42.0,-40.0,-86.0,-88.0,-84.0,-84.0,39.0,35.0,42.0,43.0,1
2649,92:69:1D:31:68:E9,3846642,488285774,4008,3648523,3842634,484637251,0,5173,1140120,5012,1103617,161,36503,2184,12,4247,101,0,55,216660.0,130000.0,-54.0,-47.0,-42.0,-48.0,-52.0,-49.0,-45.0,-50.0,-86.0,-88.0,-84.0,-84.0,32.0,41.0,42.0,36.0,1
2650,CC:2F:71:3F:1F:24,4885405,1658399474,1042771,1173762223,3842634,484637251,479,861991,951660769,861198,951564865,793,95904,833095,15,1042592,108908,476,674,86667.0,14444.0,-69.0,-69.0,-66.0,-71.0,-68.0,-69.0,-65.0,-71.0,-86.0,-88.0,-84.0,-84.0,17.0,19.0,18.0,13.0,1
2651,CC:2F:71:3E:C5:1F,3843580,484752802,946,115551,3842634,484637251,0,3958,332397,3266,250211,692,82186,1002,12,1363,26,0,52,144444.0,39000.0,-72.0,-72.0,-68.0,-60.0,-74.0,-75.0,-70.0,-63.0,-86.0,-88.0,-84.0,-84.0,14.0,16.0,16.0,24.0,1
2652,BA:8C:B9:54:50:24,3847527,490826435,4893,6189184,3842634,484637251,0,9415,1728484,9393,1724989,22,3495,2354,17,5374,41,0,66,216660.0,130000.0,-48.0,-35.0,-43.0,-46.0,-48.0,-35.0,-43.0,-46.0,-86.0,-88.0,-84.0,-84.0,38.0,53.0,41.0,38.0,1
2653,62:47:05:9D:EB:15,3844796,487071581,2155,2433664,3842641,484637917,0,4378,3017890,4346,3012771,32,5119,2069,0,2209,56,0,106,216660.0,130000.0,-45.0,-46.0,-40.0,-46.0,-45.0,-45.0,-39.0,-47.0,-86.0,-87.0,-83.0,-84.0,41.0,41.0,43.0,38.0,1
2654,3C:55:76:E8:8F:1F,3927636,697655323,84995,213017406,3842641,484637917,42,40639,8460011,40041,8354017,598,105994,16801,46,85072,9691,42,589,229410.0,137640.0,-50.0,-61.0,-56.0,-46.0,-44.0,-52.0,-49.0,-44.0,-86.0,-87.0,-83.0,-84.0,36.0,26.0,27.0,38.0,1
2655,92:69:1D:31:68:E9,3846649,488286440,4008,3648523,3842641,484637917,0,5173,1140120,5012,1103617,161,36503,2184,12,4247,101,0,55,216660.0,130000.0,-54.0,-47.0,-42.0,-48.0,-52.0,-49.0,-45.0,-50.0,-86.0,-87.0,-83.0,-84.0,32.0,40.0,41.0,36.0,1
2656,CC:2F:71:3F:1F:24,4885627,1658663020,1042986,1174025103,3842641,484637917,479,862193,951918854,861400,951822950,793,95904,833286,15,1042806,108908,476,674,86667.0,14444.0,-69.0,-70.0,-67.0,-71.0,-69.0,-69.0,-67.0,-71.0,-86.0,-87.0,-83.0,-84.0,17.0,17.0,16.0,13.0,1
2657,CC:2F:71:3E:C5:1F,3843587,484753468,946,115551,3842641,484637917,0,3958,332397,3266,250211,692,82186,1002,12,1363,26,0,52,144444.0,39000.0,-72.0,-72.0,-68.0,-60.0,-74.0,-75.0,-70.0,-63.0,-86.0,-87.0,-83.0,-84.0,14.0,15.0,15.0,24.0,1
2658,BA:8C:B9:54:50:24,3847537,490827576,4893,6189184,3842644,484638392,0,9415,1728484,9393,1724989,22,3495,2354,17,5374,41,0,66,216660.0,130000.0,-48.0,-35.0,-43.0,-46.0,-48.0,-35.0,-43.0,-46.0,-86.0,-87.0,-83.0,-84.0,38.0,52.0,40.0,38.0,1
2659,62:47:05:9D:EB:15,3844799,487072056,2155,2433664,3842644,484638392,0,4378,3017890,4346,3012771,32,5119,2069,0,2209,56,0,106,216660.0,130000.0,-45.0,-46.0,-40.0,-46.0,-45.0,-45.0,-39.0,-47.0,-85.0,-86.0,-82.0,-83.0,40.0,40.0,42.0,37.0,1
2660,3C:55:76:E8:8F:1F,3927639,697655798,84995,213017406,3842644,484638392,42,40639,8460011,40041,8354017,598,105994,16801,46,85072,9691,42,589,229410.0,137640.0,-50.0,-61.0,-56.0,-46.0,-44.0,-52.0,-49.0,-44.0,-85.0,-86.0,-82.0,-83.0,35.0,25.0,26.0,37.0,1
2661,92:69:1D:31:68:E9,3846652,488286915,4008,3648523,3842644,484638392,0,5173,1140120,5012,1103617,161,36503,2184,12,4247,101,0,55,216660.0,130000.0,-54.0,-47.0,-42.0,-48.0,-52.0,-49.0,-45.0,-50.0,-85.0,-86.0,-82.0,-83.0,31.0,39.0,40.0,35.0,1
2662,CC:2F:71:3F:1F:24,4885839,1658925655,1043193,1174287061,3842646,484638594,479,862386,952175482,861593,952079578,793,95904,833471,15,1043014,108912,476,674,117000.0,39000.0,-69.0,-70.0,-66.0,-70.0,-69.0,-70.0,-66.0,-70.0,-85.0,-86.0,-82.0,-83.0,16.0,16.0,16.0,13.0,1
2663,CC:2F:71:3E:C5:1F,3843594,484754347,946,115551,3842648,484638796,0,3958,332397,3266,250211,692,82186,1002,12,1363,26,0,52,144444.0,39000.0,-72.0,-72.0,-68.0,-60.0,-74.0,-75.0,-70.0,-63.0,-85.0,-86.0,-82.0,-83.0,13.0,14.0,14.0,23.0,1
2664,BA:8C:B9:54:50:24,3847541,490827980,4893,6189184,3842648,484638796,0,9415,1728484,9393,1724989,22,3495,2354,17,5374,41,0,66,216660.0,130000.0,-48.0,-35.0,-43.0,-46.0,-48.0,-35.0,-43.0,-46.0,-85.0,-86.0,-82.0,-83.0,37.0,51.0,39.0,37.0,1
2665,62:47:05:9D:EB:15,3844806,487072722,2155,2433664,3842651,484639058,0,4378,3017890,4346,3012771,32,5119,2069,0,2209,56,0,106,216660.0,130000.0,-45.0,-46.0,-40.0,-46.0,-45.0,-45.0,-39.0,-47.0,-85.0,-86.0,-82.0,-83.0,40.0,40.0,42.0,37.0,1
2666,3C:55:76:E8:8F:1F,3927646,697656464,84995,213017406,3842651,484639058,42,40639,8460011,40041,8354017,598,105994,16801,46,85072,9691,42,589,229410.0,137640.0,-50.0,-61.0,-56.0,-46.0,-44.0,-52.0,-49.0,-44.0,-85.0,-86.0,-82.0,-82.0,35.0,25.0,26.0,36.0,1
2667,92:69:1D:31:68:E9,3846661,488287783,4008,3648523,3842653,484639260,0,5173,1140120,5012,1103617,161,36503,2184,12,4247,101,0,55,216660.0,130000.0,-54.0,-47.0,-42.0,-48.0,-52.0,-49.0,-45.0,-50.0,-85.0,-86.0,-82.0,-82.0,31.0,39.0,40.0,34.0,1
2668,CC:2F:71:3F:1F:24,4886054,1659187769,1043401,1174548509,3842653,484639260,479,862577,952431764,861784,952335860,793,95904,833653,15,1043222,108917,476,674,115556.0,28889.0,-69.0,-70.0,-66.0,-71.0,-69.0,-70.0,-66.0,-71.0,-85.0,-86.0,-82.0,-82.0,16.0,16.0,16.0,11.0,1
2669,CC:2F:71:3E:C5:1F,3843599,484754811,946,115551,3842653,484639260,0,3958,332397,3266,250211,692,82186,1002,12,1363,26,0,52,144444.0,39000.0,-72.0,-72.0,-68.0,-60.0,-74.0,-75.0,-70.0,-63.0,-85.0,-86.0,-82.0,-82.0,13.0,14.0,14.0,22.0,1
2670,BA:8C:B9:54:50:24,3847546,490828444,4893,6189184,3842653,484639260,0,9415,1728484,9393,1724989,22,3495,2354,17,5374,41,0,66,216660.0,130000.0,-48.0,-35.0,-43.0,-46.0,-48.0,-35.0,-43.0,-46.0,-85.0,-86.0,-82.0,-82.0,37.0,51.0,39.0,36.0,1
2671,62:47:05:9D:EB:15,3844813,487073663,2156,2433833,3842657,484639830,0,4381,3018146,4349,3013027,32,5119,2070,0,2210,56,0,106,216660.0,130000.0,-46.0,-46.0,-39.0,-46.0,-45.0,-46.0,-39.0,-46.0,-85.0,-86.0,-82.0,-82.0,39.0,40.0,43.0,36.0,1
2672,3C:55:76:E8:8F:1F,3927652,697657236,84995,213017406,3842657,484639830,42,40639,8460011,40041,8354017,598,105994,16801,46,85072,9691,42,589,229410.0,137640.0,-50.0,-61.0,-56.0,-46.0,-44.0,-52.0,-49.0,-44.0,-85.0,-86.0,-82.0,-82.0,35.0,25.0,26.0,36.0,1
2673,92:69:1D:31:68:E9,3846667,488288555,4008,3648523,3842659,484640032,0,5173,1140120,5012,1103617,161,36503,2184,12,4247,101,0,55,216660.0,130000.0,-54.0,-47.0,-42.0,-48.0,-52.0,-49.0,-45.0,-50.0,-85.0,-86.0,-82.0,-82.0,31.0,39.0,40.0,34.0,1
2674,CC:2F:71:3F:1F:24,4886268,1659448733,1043609,1174808701,3842659,484640032,479,862768,952683808,861975,952587904,793,95904,833836,15,1043429,108918,476,674,115556.0,28889.0,-69.0,-71.0,-66.0,-71.0,-69.0,-70.0,-66.0,-70.0,-85.0,-86.0,-82.0,-82.0,16.0,15.0,16.0,11.0,1
2675,CC:2F:71:3E:C5:1F,3843605,484755583,946,115551,3842659,484640032,0,3958,332397,3266,250211,692,82186,1002,12,1363,26,0,52,144444.0,39000.0,-72.0,-72.0,-68.0,-60.0,-74.0,-75.0,-70.0,-63.0,-85.0,-85.0,-81.0,-81.0,13.0,13.0,13.0,21.0,1
2676,BA:8C:B9:54:50:24,3847552,490829216,4893,6189184,3842659,484640032,0,9415,1728484,9393,1724989,22,3495,2354,17,5374,41,0,66,216660.0,130000.0,-48.0,-35.0,-43.0,-46.0,-48.0,-35.0,-43.0,-46.0,-85.0,-85.0,-81.0,-81.0,37.0,50.0,38.0,35.0,1
2677,62:47:05:9D:EB:15,3844820,487074385,2157,2433949,3842663,484640436,0,4384,3018392,4352,3013273,32,5119,2071,0,2211,56,0,106,216660.0,130000.0,-44.0,-48.0,-39.0,-48.0,-46.0,-47.0,-39.0,-46.0,-85.0,-85.0,-81.0,-81.0,41.0,37.0,42.0,33.0,1
2678,3C:55:76:E8:8F:1F,3927670,697659408,85007,213018972,3842663,484640436,42,40670,8466708,40072,8360714,598,105994,16809,46,85084,9691,42,590,243750.0,146250.0,-46.0,-54.0,-48.0,-44.0,-45.0,-53.0,-47.0,-44.0,-85.0,-85.0,-81.0,-81.0,39.0,31.0,33.0,37.0,1
2679,92:69:1D:31:68:E9,3846671,488288959,4008,3648523,3842663,484640436,0,5173,1140120,5012,1103617,161,36503,2184,12,4247,101,0,55,216660.0,130000.0,-54.0,-47.0,-42.0,-48.0,-52.0,-49.0,-45.0,-50.0,-85.0,-85.0,-81.0,-81.0,31.0,38.0,39.0,33.0,1
2680,CC:2F:71:3F:1F:24,4886490,1659715808,1043826,1175075312,3842664,484640496,479,862974,952946713,862181,952850809,793,95904,834030,15,1043647,108926,476,674,115556.0,28889.0,-68.0,-71.0,-66.0,-71.0,-68.0,-70.0,-66.0,-70.0,-85.0,-85.0,-81.0,-81.0,17.0,14.0,15.0,10.0,1
2681,CC:2F:71:3E:C5:1F,3843610,484756047,946,115551,3842664,484640496,0,3958,332397,3266,250211,692,82186,1002,12,1363,26,0,52,144444.0,39000.0,-72.0,-72.0,-68.0,-60.0,-74.0,-75.0,-70.0,-63.0,-85.0,-85.0,-81.0,-81.0,13.0,13.0,13.0,21.0,1
2682,BA:8C:B9:54:50:24,3847557,490829680,4893,6189184,3842664,484640496,0,9415,1728484,9393,1724989,22,3495,2354,17,5374,41,0,66,216660.0,130000.0,-48.0,-35.0,-43.0,-46.0,-48.0,-35.0,-43.0,-46.0,-85.0,-85.0,-81.0,-81.0,37.0,50.0,38.0,35.0,1
2683,62:47:05:9D:EB:15,3844825,487074849,2157,2433949,3842668,484640900,0,4384,3018392,4352,3013273,32,5119,2071,0,2211,56,0,106,216660.0,130000.0,-44.0,-48.0,-39.0,-48.0,-46.0,-47.0,-39.0,-46.0,-84.0,-85.0,-80.0,-80.0,40.0,37.0,41.0,32.0,1
2684,3C:55:76:E8:8F:1F,3927676,697660046,85008,213019146,3842668,484640900,42,40683,8467724,40085,8361730,598,105994,16811,46,85085,9691,42,590,243750.0,146250.0,-49.0,-56.0,-49.0,-45.0,-49.0,-56.0,-49.0,-44.0,-84.0,-85.0,-80.0,-80.0,35.0,29.0,31.0,35.0,1
2685,92:69:1D:31:68:E9,3846677,488289539,4009,3648639,3842668,484640900,0,5176,1140366,5015,1103863,161,36503,2185,12,4248,101,0,55,229410.0,130000.0,-50.0,-46.0,-44.0,-46.0,-51.0,-48.0,-45.0,-49.0,-84.0,-85.0,-80.0,-80.0,34.0,39.0,36.0,34.0,1
2686,CC:2F:71:3F:1F:24,4886701,1659976274,1044033,1175335374,3842668,484640900,479,863160,953195225,862367,953099321,793,95904,834212,15,1043853,108927,476,674,115556.0,28889.0,-69.0,-70.0,-67.0,-70.0,-69.0,-70.0,-66.0,-71.0,-84.0,-85.0,-80.0,-80.0,15.0,15.0,13.0,10.0,1
2687,CC:2F:71:3E:C5:1F,3843616,484756653,946,115551,3842670,484641102,0,3958,332397,3266,250211,692,82186,1002,12,1363,26,0,52,144444.0,39000.0,-72.0,-72.0,-68.0,-60.0,-74.0,-75.0,-70.0,-63.0,-84.0,-85.0,-80.0,-80.0,12.0,13.0,12.0,20.0,1
2688,BA:8C:B9:54:50:24,3847563,490830286,4893,6189184,3842670,484641102,0,9415,1728484,9393,1724989,22,3495,2354,17,5374,41,0,66,216660.0,130000.0,-48.0,-35.0,-43.0,-46.0,-48.0,-35.0,-43.0,-46.0,-84.0,-85.0,-80.0,-80.0,36.0,50.0,37.0,34.0,1
2689,62:47:05:9D:EB:15,3844829,487075253,2157,2433949,3842672,484641304,0,4384,3018392,4352,3013273,32,5119,2071,0,2211,56,0,106,216660.0,130000.0,-44.0,-48.0,-39.0,-48.0,-46.0,-47.0,-39.0,-46.0,-84.0,-84.0,-80.0,-79.0,40.0,36.0,41.0,31.0,1
2690,3C:55:76:E8:8F:1F,3927681,697660777,85009,213019473,3842672,484641304,42,40698,8469051,40100,8363057,598,105994,16813,46,85086,9691,42,591,243750.0,146250.0,-45.0,-54.0,-48.0,-44.0,-44.0,-54.0,-48.0,-44.0,-84.0,-84.0,-80.0,-79.0,39.0,30.0,32.0,35.0,1
2691,92:69:1D:31:68:E9,3846681,488289943,4009,3648639,3842672,484641304,0,5176,1140366,5015,1103863,161,36503,2185,12,4248,101,0,55,229410.0,130000.0,-50.0,-46.0,-44.0,-46.0,-51.0,-48.0,-45.0,-49.0,-84.0,-84.0,-80.0,-79.0,34.0,38.0,36.0,33.0,1
2692,CC:2F:71:3F:1F:24,4886918,1660241162,1044246,1175599858,3842672,484641304,479,863352,953448671,862559,953352767,793,95904,834400,15,1044067,108970,476,674,130000.0,43333.0,-69.0,-71.0,-67.0,-72.0,-69.0,-71.0,-66.0,-71.0,-84.0,-84.0,-80.0,-79.0,15.0,13.0,13.0,7.0,1
2693,CC:2F:71:3E:C5:1F,3843618,484756855,946,115551,3842672,484641304,0,3958,332397,3266,250211,692,82186,1002,12,1363,26,0,52,144444.0,39000.0,-72.0,-72.0,-68.0,-60.0,-74.0,-75.0,-70.0,-63.0,-84.0,-84.0,-80.0,-79.0,12.0,12.0,12.0,19.0,1
2694,BA:8C:B9:54:50:24,3847565,490830488,4893,6189184,3842672,484641304,0,9415,1728484,9393,1724989,22,3495,2354,17,5374,41,0,66,216660.0,130000.0,-48.0,-35.0,-43.0,-46.0,-48.0,-35.0,-43.0,-46.0,-84.0,-84.0,-80.0,-79.0,36.0,49.0,37.0,33.0,1
2695,62:47:05:9D:EB:15,3844836,487075919,2157,2433949,3842679,484641970,0,4384,3018392,4352,3013273,32,5119,2071,0,2211,56,0,106,216660.0,130000.0,-44.0,-48.0,-39.0,-48.0,-46.0,-47.0,-39.0,-46.0,-83.0,-83.0,-79.0,-79.0,39.0,35.0,40.0,31.0,1
2696,3C:55:76:E8:8F:1F,3927699,697665681,85020,213023711,3842679,484641970,42,40722,8476773,40124,8370779,598,105994,16818,46,85097,9691,42,591,243750.0,146250.0,-45.0,-54.0,-48.0,-44.0,-45.0,-53.0,-47.0,-43.0,-83.0,-83.0,-79.0,-79.0,38.0,29.0,31.0,35.0,1
2697,92:69:1D:31:68:E9,3846688,488290609,4009,3648639,3842679,484641970,0,5176,1140366,5015,1103863,161,36503,2185,12,4248,101,0,55,229410.0,130000.0,-50.0,-46.0,-44.0,-46.0,-51.0,-48.0,-45.0,-49.0,-83.0,-83.0,-79.0,-79.0,33.0,37.0,35.0,33.0,1
2698,CC:2F:71:3F:1F:24,4887138,1660509566,1044459,1175867596,3842679,484641970,479,863554,953715205,862761,953619301,793,95904,834587,15,1044280,109023,476,674,130000.0,43333.0,-69.0,-71.0,-67.0,-72.0,-69.0,-71.0,-66.0,-71.0,-83.0,-83.0,-79.0,-79.0,14.0,12.0,12.0,7.0,1
2699,CC:2F:71:3E:C5:1F,3843625,484757521,946,115551,3842679,484641970,0,3958,332397,3266,250211,692,82186,1002,12,1363,26,0,52,144444.0,39000.0,-72.0,-72.0,-68.0,-60.0,-74.0,-75.0,-70.0,-63.0,-83.0,-83.0,-79.0,-79.0,11.0,11.0,11.0,19.0,1
2700,BA:8C:B9:54:50:24,3847572,490831154,4893,6189184,3842679,484641970,0,9415,1728484,9393,1724989,22,3495,2354,17,5374,41,0,66,216660.0,130000.0,-48.0,-35.0,-43.0,-46.0,-48.0,-35.0,-43.0,-46.0,-83.0,-83.0,-79.0,-79.0,35.0,48.0,36.0,33.0,1
2701,62:47:05:9D:EB:15,3844838,487076121,2157,2433949,3842681,484642172,0,4384,3018392,4352,3013273,32,5119,2071,0,2211,56,0,106,216660.0,130000.0,-44.0,-48.0,-39.0,-48.0,-46.0,-47.0,-39.0,-46.0,-83.0,-83.0,-79.0,-79.0,39.0,35.0,40.0,31.0,1
2702,3C:55:76:E8:8F:1F,3927701,697665883,85020,213023711,3842681,484642172,42,40727,8477115,40129,8371121,598,105994,16818,46,85097,9691,42,591,243750.0,146250.0,-45.0,-54.0,-48.0,-44.0,-44.0,-53.0,-47.0,-44.0,-83.0,-83.0,-79.0,-79.0,38.0,29.0,31.0,35.0,1
2703,92:69:1D:31:68:E9,3846690,488290811,4009,3648639,3842681,484642172,0,5176,1140366,5015,1103863,161,36503,2185,12,4248,101,0,55,229410.0,130000.0,-50.0,-46.0,-44.0,-46.0,-51.0,-48.0,-45.0,-49.0,-83.0,-83.0,-79.0,-79.0,33.0,37.0,35.0,33.0,1
2704,CC:2F:71:3F:1F:24,4887356,1660775961,1044675,1176133789,3842681,484642172,479,863751,953969866,862958,953873962,793,95904,834779,15,1044496,109066,476,674,130000.0,43333.0,-69.0,-71.0,-67.0,-72.0,-69.0,-71.0,-66.0,-71.0,-83.0,-83.0,-79.0,-79.0,14.0,12.0,12.0,7.0,1
2705,CC:2F:71:3E:C5:1F,3843627,484757723,946,115551,3842681,484642172,0,3958,332397,3266,250211,692,82186,1002,12,1363,26,0,52,144444.0,39000.0,-72.0,-72.0,-68.0,-60.0,-74.0,-75.0,-70.0,-63.0,-83.0,-83.0,-79.0,-79.0,11.0,11.0,11.0,19.0,1
2706,BA:8C:B9:54:50:24,3847574,490831356,4893,6189184,3842681,484642172,0,9415,1728484,9393,1724989,22,3495,2354,17,5374,41,0,66,216660.0,130000.0,-48.0,-35.0,-43.0,-46.0,-48.0,-35.0,-43.0,-46.0,-83.0,-83.0,-79.0,-79.0,35.0,48.0,36.0,33.0,1
2707,62:47:05:9D:EB:15,3844845,487076787,2157,2433949,3842688,484642838,0,4385,3018460,4353,3013341,32,5119,2071,0,2211,56,0,106,216660.0,130000.0,-46.0,-46.0,-39.0,-46.0,-46.0,-47.0,-39.0,-46.0,-83.0,-83.0,-79.0,-79.0,37.0,37.0,40.0,33.0,1
2708,3C:55:76:E8:8F:1F,3927708,697666549,85020,213023711,3842688,484642838,42,40727,8477115,40129,8371121,598,105994,16818,46,85097,9691,42,591,243750.0,146250.0,-45.0,-54.0,-48.0,-44.0,-44.0,-53.0,-47.0,-44.0,-83.0,-83.0,-79.0,-79.0,38.0,29.0,31.0,35.0,1
2709,92:69:1D:31:68:E9,3846697,488291477,4009,3648639,3842688,484642838,0,5176,1140366,5015,1103863,161,36503,2185,12,4248,101,0,55,229410.0,130000.0,-50.0,-46.0,-44.0,-46.0,-51.0,-48.0,-45.0,-49.0,-83.0,-83.0,-79.0,-79.0,33.0,37.0,35.0,33.0,1
2710,CC:2F:71:3F:1F:24,4887571,1661037755,1044883,1176394917,3842688,484642838,479,863942,954226134,863149,954130230,793,95904,834962,15,1044704,109104,476,674,115556.0,28889.0,-70.0,-69.0,-68.0,-70.0,-69.0,-69.0,-68.0,-70.0,-83.0,-83.0,-79.0,-79.0,13.0,14.0,11.0,9.0,1
2711,CC:2F:71:3E:C5:1F,3843636,484758591,946,115551,3842690,484643040,0,3958,332397,3266,250211,692,82186,1002,12,1363,26,0,52,144444.0,39000.0,-72.0,-72.0,-68.0,-60.0,-74.0,-75.0,-70.0,-63.0,-83.0,-83.0,-79.0,-79.0,11.0,11.0,11.0,19.0,1
2712,BA:8C:B9:54:50:24,3847583,490832224,4893,6189184,3842690,484643040,0,9415,1728484,9393,1724989,22,3495,2354,17,5374,41,0,66,216660.0,130000.0,-48.0,-35.0,-43.0,-46.0,-48.0,-35.0,-43.0,-46.0,-83.0,-83.0,-79.0,-79.0,35.0,48.0,36.0,33.0,1
2713,62:47:05:9D:EB:15,3844847,487076989,2157,2433949,3842690,484643040,0,4385,3018460,4353,3013341,32,5119,2071,0,2211,56,0,106,216660.0,130000.0,-46.0,-46.0,-39.0,-46.0,-46.0,-47.0,-39.0,-46.0,-83.0,-83.0,-79.0,-79.0,37.0,37.0,40.0,33.0,1
2714,3C:55:76:E8:8F:1F,3927711,697666867,85021,213023827,3842690,484643040,42,40733,8477527,40135,8371533,598,105994,16818,46,85098,9691,42,591,243750.0,146250.0,-51.0,-49.0,-44.0,-43.0,-46.0,-50.0,-43.0,-43.0,-83.0,-83.0,-79.0,-79.0,32.0,34.0,35.0,36.0,1
2715,92:69:1D:31:68:E9,3846702,488292025,4012,3648985,3842690,484643040,0,5182,1140906,5021,1104403,161,36503,2187,12,4251,102,0,55,229410.0,130000.0,-52.0,-47.0,-42.0,-48.0,-51.0,-47.0,-44.0,-47.0,-83.0,-83.0,-79.0,-79.0,31.0,36.0,37.0,31.0,1
2716,CC:2F:71:3F:1F:24,4887786,1661301477,1045092,1176658033,3842694,484643444,479,864131,954477856,863338,954381952,793,95904,835146,15,1044913,109107,476,674,117000.0,39000.0,-68.0,-70.0,-66.0,-70.0,-68.0,-70.0,-66.0,-70.0,-83.0,-83.0,-79.0,-79.0,15.0,13.0,13.0,9.0,1
2717,CC:2F:71:3E:C5:1F,3843641,484759111,947,115667,3842694,484643444,0,3960,332537,3268,250351,692,82186,1002,12,1364,26,0,52,144444.0,39000.0,-71.0,-72.0,-68.0,-60.0,-73.0,-73.0,-69.0,-62.0,-83.0,-83.0,-79.0,-79.0,12.0,11.0,11.0,19.0,1
2718,BA:8C:B9:54:50:24,3847588,490832744,4894,6189300,3842694,484643444,0,9417,1728620,9395,1725125,22,3495,2354,17,5375,41,0,66,216660.0,130000.0,-39.0,-36.0,-46.0,-52.0,-46.0,-35.0,-43.0,-47.0,-83.0,-83.0,-79.0,-79.0,44.0,47.0,33.0,27.0,1
2719,62:47:05:9D:EB:15,3844856,487077913,2158,2434065,3842698,484643848,0,4387,3018596,4355,3013477,32,5119,2071,0,2212,56,0,106,216660.0,130000.0,-46.0,-47.0,-39.0,-44.0,-46.0,-47.0,-39.0,-46.0,-83.0,-83.0,-79.0,-79.0,37.0,36.0,40.0,35.0,1
2720,3C:55:76:E8:8F:1F,3927720,697667805,85022,213023957,3842698,484643848,42,40739,8477974,40141,8371980,598,105994,16819,46,85099,9691,42,591,243750.0,146250.0,-47.0,-54.0,-45.0,-45.0,-47.0,-52.0,-44.0,-43.0,-83.0,-83.0,-79.0,-79.0,36.0,29.0,34.0,34.0,1
2721,92:69:1D:31:68:E9,3846710,488292833,4012,3648985,3842698,484643848,0,5182,1140906,5021,1104403,161,36503,2187,12,4251,102,0,55,229410.0,130000.0,-52.0,-47.0,-42.0,-48.0,-51.0,-47.0,-44.0,-47.0,-83.0,-83.0,-79.0,-79.0,31.0,36.0,37.0,31.0,1
2722,CC:2F:71:3F:1F:24,4888009,1661569580,1045310,1176925672,3842699,484643908,479,864332,954730213,863539,954634309,793,95904,835339,15,1045130,109125,476,674,130000.0,43333.0,-69.0,-70.0,-65.0,-69.0,-68.0,-70.0,-65.0,-69.0,-83.0,-83.0,-79.0,-79.0,14.0,13.0,14.0,10.0,1
2723,CC:2F:71:3E:C5:1F,3843646,484759575,947,115667,3842699,484643908,0,3960,332537,3268,250351,692,82186,1002,12,1364,26,0,52,144444.0,39000.0,-71.0,-72.0,-68.0,-60.0,-73.0,-73.0,-69.0,-62.0,-83.0,-83.0,-79.0,-79.0,12.0,11.0,11.0,19.0,1
2724,BA:8C:B9:54:50:24,3847593,490833208,4894,6189300,3842699,484643908,0,9417,1728620,9395,1725125,22,3495,2354,17,5375,41,0,66,216660.0,130000.0,-39.0,-36.0,-46.0,-52.0,-46.0,-35.0,-43.0,-47.0,-83.0,-83.0,-79.0,-79.0,44.0,47.0,33.0,27.0,1
2725,62:47:05:9D:EB:15,3844862,487078650,2158,2434065,3842704,484644585,0,4387,3018596,4355,3013477,32,5119,2071,0,2212,56,0,106,216660.0,130000.0,-46.0,-47.0,-39.0,-44.0,-46.0,-47.0,-39.0,-46.0,-83.0,-83.0,-79.0,-79.0,37.0,36.0,40.0,35.0,1
2726,3C:55:76:E8:8F:1F,3927726,697668542,85022,213023957,3842704,484644585,42,40748,8478588,40150,8372594,598,105994,16819,46,85099,9691,42,591,243750.0,146250.0,-49.0,-53.0,-47.0,-45.0,-48.0,-53.0,-46.0,-45.0,-83.0,-83.0,-79.0,-79.0,34.0,30.0,32.0,34.0,1
2727,92:69:1D:31:68:E9,3846718,488293772,4012,3648985,3842706,484644787,0,5182,1140906,5021,1104403,161,36503,2187,12,4251,102,0,55,229410.0,130000.0,-52.0,-47.0,-42.0,-48.0,-51.0,-47.0,-44.0,-47.0,-83.0,-83.0,-79.0,-79.0,31.0,36.0,37.0,31.0,1
2728,CC:2F:71:3F:1F:24,4888243,1661860185,1045537,1177215398,3842706,484644787,479,864542,955008899,863749,954912995,793,95904,835545,15,1045358,109140,476,674,130000.0,43333.0,-68.0,-70.0,-67.0,-70.0,-67.0,-70.0,-66.0,-70.0,-83.0,-83.0,-79.0,-79.0,15.0,13.0,12.0,9.0,1
2729,CC:2F:71:3E:C5:1F,3843653,484760454,947,115667,3842706,484644787,0,3960,332537,3268,250351,692,82186,1002,12,1364,26,0,52,144444.0,39000.0,-71.0,-72.0,-68.0,-60.0,-73.0,-73.0,-69.0,-62.0,-83.0,-83.0,-79.0,-79.0,12.0,11.0,11.0,19.0,1
2730,BA:8C:B9:54:50:24,3847600,490834087,4894,6189300,3842706,484644787,0,9418,1728688,9396,1725193,22,3495,2354,17,5375,41,0,66,216660.0,130000.0,-48.0,-35.0,-43.0,-45.0,-46.0,-35.0,-43.0,-46.0,-83.0,-83.0,-79.0,-79.0,35.0,48.0,36.0,34.0,1
2731,62:47:05:9D:EB:15,3844866,487079054,2158,2434065,3842708,484644989,0,4387,3018596,4355,3013477,32,5119,2071,0,2212,56,0,106,216660.0,130000.0,-46.0,-47.0,-39.0,-44.0,-46.0,-47.0,-39.0,-46.0,-83.0,-83.0,-79.0,-79.0,37.0,36.0,40.0,35.0,1
2732,3C:55:76:E8:8F:1F,3927730,697668946,85022,213023957,3842708,484644989,42,40748,8478588,40150,8372594,598,105994,16819,46,85099,9691,42,591,243750.0,146250.0,-49.0,-53.0,-47.0,-45.0,-48.0,-53.0,-46.0,-45.0,-83.0,-83.0,-79.0,-79.0,34.0,30.0,32.0,34.0,1
2733,92:69:1D:31:68:E9,3846720,488293974,4012,3648985,3842708,484644989,0,5182,1140906,5021,1104403,161,36503,2187,12,4251,102,0,55,229410.0,130000.0,-52.0,-47.0,-42.0,-48.0,-51.0,-47.0,-44.0,-47.0,-83.0,-83.0,-79.0,-79.0,31.0,36.0,37.0,31.0,1
2734,CC:2F:71:3F:1F:24,4888454,1662120415,1045746,1177475426,3842708,484644989,479,864734,955262487,863941,955166583,793,95904,835728,15,1045567,109172,476,674,115556.0,28889.0,-68.0,-70.0,-67.0,-71.0,-68.0,-70.0,-66.0,-70.0,-83.0,-83.0,-79.0,-79.0,15.0,13.0,12.0,8.0,1
2735,CC:2F:71:3E:C5:1F,3843655,484760656,947,115667,3842708,484644989,0,3960,332537,3268,250351,692,82186,1002,12,1364,26,0,52,144444.0,39000.0,-71.0,-72.0,-68.0,-60.0,-73.0,-73.0,-69.0,-62.0,-83.0,-83.0,-79.0,-79.0,12.0,11.0,11.0,19.0,1
2736,BA:8C:B9:54:50:24,3847602,490834289,4894,6189300,3842708,484644989,0,9418,1728688,9396,1725193,22,3495,2354,17,5375,41,0,66,216660.0,130000.0,-48.0,-35.0,-43.0,-45.0,-46.0,-35.0,-43.0,-46.0,-83.0,-83.0,-79.0,-79.0,35.0,48.0,36.0,34.0,1
2737,62:47:05:9D:EB:15,3844873,487079720,2158,2434065,3842715,484645655,0,4387,3018596,4355,3013477,32,5119,2071,0,2212,56,0,106,216660.0,130000.0,-46.0,-47.0,-39.0,-44.0,-46.0,-47.0,-39.0,-46.0,-83.0,-83.0,-79.0,-79.0,37.0,36.0,40.0,35.0,1
2738,3C:55:76:E8:8F:1F,3927737,697669612,85022,213023957,3842715,484645655,42,40748,8478588,40150,8372594,598,105994,16819,46,85099,9691,42,591,243750.0,146250.0,-49.0,-53.0,-47.0,-45.0,-48.0,-53.0,-46.0,-45.0,-83.0,-83.0,-79.0,-79.0,34.0,30.0,32.0,34.0,1
2739,92:69:1D:31:68:E9,3846727,488294640,4012,3648985,3842715,484645655,0,5182,1140906,5021,1104403,161,36503,2187,12,4251,102,0,55,229410.0,130000.0,-52.0,-47.0,-42.0,-48.0,-51.0,-47.0,-44.0,-47.0,-83.0,-83.0,-79.0,-79.0,31.0,36.0,37.0,31.0,1
2740,CC:2F:71:3F:1F:24,4888668,1662379327,1045953,1177733672,3842715,484645655,479,864930,955523863,864137,955427959,793,95904,835908,15,1045773,109176,476,674,130000.0,43333.0,-67.0,-70.0,-65.0,-70.0,-67.0,-70.0,-66.0,-70.0,-83.0,-83.0,-79.0,-79.0,16.0,13.0,14.0,9.0,1
2741,CC:2F:71:3E:C5:1F,3843662,484761322,947,115667,3842715,484645655,0,3960,332537,3268,250351,692,82186,1002,12,1364,26,0,52,144444.0,39000.0,-71.0,-72.0,-68.0,-60.0,-73.0,-73.0,-69.0,-62.0,-83.0,-83.0,-79.0,-79.0,12.0,11.0,11.0,19.0,1
2742,BA:8C:B9:54:50:24,3847609,490834955,4894,6189300,3842715,484645655,0,9418,1728688,9396,1725193,22,3495,2354,17,5375,41,0,66,216660.0,130000.0,-48.0,-35.0,-43.0,-45.0,-46.0,-35.0,-43.0,-46.0,-83.0,-83.0,-79.0,-79.0,35.0,48.0,36.0,34.0,1
2743,62:47:05:9D:EB:15,3844876,487079984,2158,2434065,3842718,484645919,0,4387,3018596,4355,3013477,32,5119,2071,0,2212,56,0,106,216660.0,130000.0,-46.0,-47.0,-39.0,-44.0,-46.0,-47.0,-39.0,-46.0,-83.0,-83.0,-79.0,-79.0,37.0,36.0,40.0,35.0,1
2744,3C:55:76:E8:8F:1F,3927740,697669876,85022,213023957,3842718,484645919,42,40748,8478588,40150,8372594,598,105994,16819,46,85099,9691,42,591,243750.0,146250.0,-49.0,-53.0,-47.0,-45.0,-48.0,-53.0,-46.0,-45.0,-83.0,-83.0,-79.0,-79.0,34.0,30.0,32.0,34.0,1
2745,92:69:1D:31:68:E9,3846730,488294904,4012,3648985,3842718,484645919,0,5182,1140906,5021,1104403,161,36503,2187,12,4251,102,0,55,229410.0,130000.0,-52.0,-47.0,-42.0,-48.0,-51.0,-47.0,-44.0,-47.0,-83.0,-83.0,-79.0,-79.0,31.0,36.0,37.0,31.0,1
2746,CC:2F:71:3F:1F:24,4888886,1662643254,1046168,1177997335,3842718,484645919,479,865131,955783237,864337,955687215,794,96022,836099,15,1045989,109178,476,674,130000.0,43333.0,-68.0,-70.0,-66.0,-70.0,-68.0,-70.0,-66.0,-69.0,-83.0,-83.0,-79.0,-79.0,15.0,13.0,13.0,9.0,1
2747,CC:2F:71:3E:C5:1F,3843665,484761586,947,115667,3842718,484645919,0,3960,332537,3268,250351,692,82186,1002,12,1364,26,0,52,144444.0,39000.0,-71.0,-72.0,-68.0,-60.0,-73.0,-73.0,-69.0,-62.0,-83.0,-83.0,-79.0,-79.0,12.0,11.0,11.0,19.0,1
2748,BA:8C:B9:54:50:24,3847613,490835281,4894,6189300,3842719,484645981,0,9418,1728688,9396,1725193,22,3495,2354,17,5375,41,0,66,216660.0,130000.0,-48.0,-35.0,-43.0,-45.0,-46.0,-35.0,-43.0,-46.0,-83.0,-83.0,-79.0,-79.0,35.0,48.0,36.0,34.0,1
2749,62:47:05:9D:EB:15,3844884,487080712,2158,2434065,3842726,484646647,0,4387,3018596,4355,3013477,32,5119,2071,0,2212,56,0,106,216660.0,130000.0,-46.0,-47.0,-39.0,-44.0,-46.0,-47.0,-39.0,-46.0,-83.0,-83.0,-79.0,-79.0,37.0,36.0,40.0,35.0,1
2750,3C:55:76:E8:8F:1F,3927749,697670778,85023,213024131,3842726,484646647,42,40750,8478816,40152,8372822,598,105994,16820,46,85100,9691,42,591,243750.0,146250.0,-51.0,-56.0,-46.0,-42.0,-49.0,-54.0,-46.0,-44.0,-83.0,-83.0,-79.0,-79.0,32.0,27.0,33.0,37.0,1
2751,92:69:1D:31:68:E9,3846739,488295748,4013,3649101,3842726,484646647,0,5185,1141148,5024,1104645,161,36503,2188,12,4252,102,0,55,229410.0,130000.0,-51.0,-47.0,-45.0,-48.0,-51.0,-47.0,-44.0,-48.0,-83.0,-83.0,-79.0,-79.0,32.0,36.0,34.0,31.0,1
2752,CC:2F:71:3F:1F:24,4889099,1662902080,1046373,1178255433,3842726,484646647,479,865318,956033317,864524,955937295,794,96022,836280,15,1046194,109202,476,674,115556.0,28889.0,-69.0,-70.0,-68.0,-71.0,-69.0,-70.0,-68.0,-71.0,-83.0,-83.0,-79.0,-79.0,14.0,13.0,11.0,8.0,1
2753,CC:2F:71:3E:C5:1F,3843675,484762516,947,115667,3842728,484646849,0,3962,332725,3269,250421,693,82304,1003,12,1364,26,0,52,144444.0,39000.0,-71.0,-72.0,-67.0,-60.0,-71.0,-71.0,-67.0,-60.0,-83.0,-83.0,-79.0,-79.0,12.0,11.0,12.0,19.0,1
2754,BA:8C:B9:54:50:24,3847622,490836149,4894,6189300,3842728,484646849,0,9418,1728688,9396,1725193,22,3495,2354,17,5375,41,0,66,216660.0,130000.0,-48.0,-35.0,-43.0,-45.0,-46.0,-35.0,-43.0,-46.0,-83.0,-83.0,-79.0,-79.0,35.0,48.0,36.0,34.0,1
2755,62:47:05:9D:EB:15,3844886,487080914,2158,2434065,3842728,484646849,0,4387,3018596,4355,3013477,32,5119,2071,0,2212,56,0,106,216660.0,130000.0,-46.0,-47.0,-39.0,-44.0,-46.0,-47.0,-39.0,-46.0,-83.0,-83.0,-79.0,-79.0,37.0,36.0,40.0,35.0,1
2756,3C:55:76:E8:8F:1F,3927751,697670980,85023,213024131,3842728,484646849,42,40758,8479398,40160,8373404,598,105994,16821,46,85100,9691,42,592,243750.0,146250.0,-51.0,-53.0,-44.0,-44.0,-50.0,-52.0,-44.0,-43.0,-83.0,-83.0,-79.0,-79.0,32.0,30.0,35.0,35.0,1
2757,92:69:1D:31:68:E9,3846741,488295950,4013,3649101,3842728,484646849,0,5185,1141148,5024,1104645,161,36503,2188,12,4252,102,0,55,229410.0,130000.0,-51.0,-47.0,-45.0,-48.0,-51.0,-47.0,-44.0,-48.0,-83.0,-83.0,-79.0,-79.0,32.0,36.0,34.0,31.0,1
2758,CC:2F:71:3F:1F:24,4889311,1663162564,1046581,1178515513,3842730,484647051,479,865509,956288303,864715,956192281,794,96022,836462,15,1046402,109212,476,674,104000.0,26000.0,-69.0,-71.0,-68.0,-70.0,-69.0,-71.0,-67.0,-70.0,-83.0,-83.0,-79.0,-79.0,14.0,12.0,11.0,9.0,1
2759,CC:2F:71:3E:C5:1F,3843677,484762718,947,115667,3842730,484647051,0,3962,332725,3269,250421,693,82304,1003,12,1364,26,0,52,144444.0,39000.0,-71.0,-72.0,-67.0,-60.0,-71.0,-71.0,-67.0,-60.0,-83.0,-83.0,-79.0,-79.0,12.0,11.0,12.0,19.0,1
2760,BA:8C:B9:54:50:24,3847627,490836615,4894,6189300,3842733,484647315,0,9418,1728688,9396,1725193,22,3495,2354,17,5375,41,0,66,216660.0,130000.0,-48.0,-35.0,-43.0,-45.0,-46.0,-35.0,-43.0,-46.0,-83.0,-83.0,-79.0,-79.0,35.0,48.0,36.0,34.0,1
2761,62:47:05:9D:EB:15,3844894,487081652,2158,2434065,3842736,484647587,0,4387,3018596,4355,3013477,32,5119,2071,0,2212,56,0,106,216660.0,130000.0,-46.0,-47.0,-39.0,-44.0,-46.0,-47.0,-39.0,-46.0,-83.0,-83.0,-79.0,-79.0,37.0,36.0,40.0,35.0,1
2762,3C:55:76:E8:8F:1F,3927762,697671980,85023,213024131,3842739,484647849,42,40773,8480532,40173,8374294,600,106238,16823,46,85100,9691,42,593,243750.0,146250.0,-47.0,-60.0,-50.0,-41.0,-49.0,-54.0,-47.0,-43.0,-83.0,-83.0,-79.0,-79.0,36.0,23.0,29.0,38.0,1
2763,92:69:1D:31:68:E9,3846752,488296950,4013,3649101,3842739,484647849,0,5185,1141148,5024,1104645,161,36503,2188,12,4252,102,0,55,229410.0,130000.0,-51.0,-47.0,-45.0,-48.0,-51.0,-47.0,-44.0,-48.0,-83.0,-83.0,-79.0,-79.0,32.0,36.0,34.0,31.0,1
2764,CC:2F:71:3F:1F:24,4889536,1663428469,1046797,1178780620,3842739,484647849,479,865707,956543155,864913,956447133,794,96022,836652,15,1046618,109216,476,674,115556.0,28889.0,-68.0,-70.0,-67.0,-70.0,-68.0,-70.0,-67.0,-70.0,-83.0,-83.0,-79.0,-79.0,15.0,13.0,12.0,9.0,1
2765,CC:2F:71:3E:C5:1F,3843686,484763516,947,115667,3842739,484647849,0,3962,332725,3269,250421,693,82304,1003,12,1364,26,0,52,144444.0,39000.0,-71.0,-72.0,-67.0,-60.0,-71.0,-71.0,-67.0,-60.0,-83.0,-83.0,-79.0,-79.0,12.0,11.0,12.0,19.0,1
2766,BA:8C:B9:54:50:24,3847633,490837149,4894,6189300,3842739,484647849,0,9418,1728688,9396,1725193,22,3495,2354,17,5375,41,0,66,216660.0,130000.0,-48.0,-35.0,-43.0,-45.0,-46.0,-35.0,-43.0,-46.0,-83.0,-83.0,-79.0,-79.0,35.0,48.0,36.0,34.0,1
2767,62:47:05:9D:EB:15,3844899,487082116,2158,2434065,3842741,484648051,0,4387,3018596,4355,3013477,32,5119,2071,0,2212,56,0,106,216660.0,130000.0,-46.0,-47.0,-39.0,-44.0,-46.0,-47.0,-39.0,-46.0,-83.0,-83.0,-79.0,-79.0,37.0,36.0,40.0,35.0,1
2768,3C:55:76:E8:8F:1F,3927766,697672384,85023,213024131,3842743,484648253,42,40779,8480942,40179,8374704,600,106238,16823,46,85100,9691,42,593,243750.0,146250.0,-50.0,-60.0,-54.0,-43.0,-47.0,-59.0,-50.0,-41.0,-83.0,-83.0,-79.0,-79.0,33.0,23.0,25.0,36.0,1
2769,92:69:1D:31:68:E9,3846758,488297556,4013,3649101,3842745,484648455,0,5185,1141148,5024,1104645,161,36503,2188,12,4252,102,0,55,229410.0,130000.0,-51.0,-47.0,-45.0,-48.0,-51.0,-47.0,-44.0,-48.0,-83.0,-83.0,-79.0,-79.0,32.0,36.0,34.0,31.0,1
2770,CC:2F:71:3F:1F:24,4889757,1663699921,1047012,1179051466,3842745,484648455,479,865903,956805925,865109,956709903,794,96022,836841,15,1046833,109228,476,674,115556.0,28889.0,-70.0,-70.0,-67.0,-70.0,-70.0,-70.0,-67.0,-69.0,-83.0,-83.0,-79.0,-79.0,13.0,13.0,12.0,9.0,1
2771,CC:2F:71:3E:C5:1F,3843692,484764122,947,115667,3842745,484648455,0,3962,332725,3269,250421,693,82304,1003,12,1364,26,0,52,144444.0,39000.0,-71.0,-72.0,-67.0,-60.0,-71.0,-71.0,-67.0,-60.0,-83.0,-83.0,-79.0,-79.0,12.0,11.0,12.0,19.0,1
2772,BA:8C:B9:54:50:24,3847639,490837755,4894,6189300,3842745,484648455,0,9418,1728688,9396,1725193,22,3495,2354,17,5375,41,0,66,216660.0,130000.0,-48.0,-35.0,-43.0,-45.0,-46.0,-35.0,-43.0,-46.0,-83.0,-83.0,-79.0,-79.0,35.0,48.0,36.0,34.0,1
2773,62:47:05:9D:EB:15,3844905,487082722,2158,2434065,3842747,484648657,0,4387,3018596,4355,3013477,32,5119,2071,0,2212,56,0,106,216660.0,130000.0,-46.0,-47.0,-39.0,-44.0,-46.0,-47.0,-39.0,-46.0,-83.0,-83.0,-79.0,-79.0,37.0,36.0,40.0,35.0,1
2774,3C:55:76:E8:8F:1F,3927771,697672937,85024,213024280,3842747,484648657,42,40789,8481733,40189,8375495,600,106238,16825,46,85101,9691,42,593,243750.0,146250.0,-45.0,-55.0,-48.0,-40.0,-45.0,-53.0,-47.0,-39.0,-83.0,-83.0,-79.0,-79.0,38.0,28.0,31.0,39.0,1
2775,92:69:1D:31:68:E9,3846760,488297758,4013,3649101,3842747,484648657,0,5185,1141148,5024,1104645,161,36503,2188,12,4252,102,0,55,229410.0,130000.0,-51.0,-47.0,-45.0,-48.0,-51.0,-47.0,-44.0,-48.0,-83.0,-83.0,-79.0,-79.0,32.0,36.0,34.0,31.0,1
2776,CC:2F:71:3F:1F:24,4889968,1663963293,1047221,1179314636,3842747,484648657,479,866093,957057859,865299,956961837,794,96022,837026,15,1047042,109228,476,674,115556.0,28889.0,-70.0,-70.0,-67.0,-69.0,-70.0,-70.0,-67.0,-69.0,-83.0,-83.0,-79.0,-79.0,13.0,13.0,12.0,10.0,1
2777,CC:2F:71:3E:C5:1F,3843694,484764324,947,115667,3842747,484648657,0,3962,332725,3269,250421,693,82304,1003,12,1364,26,0,52,144444.0,39000.0,-71.0,-72.0,-67.0,-60.0,-71.0,-71.0,-67.0,-60.0,-83.0,-83.0,-79.0,-79.0,12.0,11.0,12.0,19.0,1
2778,BA:8C:B9:54:50:24,3847641,490837957,4894,6189300,3842747,484648657,0,9420,1728824,9398,1725329,22,3495,2354,17,5376,41,0,66,216660.0,130000.0,-39.0,-36.0,-46.0,-52.0,-44.0,-35.0,-44.0,-48.0,-83.0,-83.0,-79.0,-79.0,44.0,47.0,33.0,27.0,1
2779,62:47:05:9D:EB:15,3844914,487084512,2158,2434065,3842756,484650447,0,4389,3018732,4357,3013613,32,5119,2071,0,2213,56,0,106,216660.0,130000.0,-46.0,-45.0,-39.0,-46.0,-46.0,-47.0,-39.0,-46.0,-83.0,-84.0,-79.0,-79.0,37.0,39.0,40.0,33.0,1
2780,3C:55:76:E8:8F:1F,3927780,697674727,85024,213024280,3842756,484650447,42,40789,8481733,40189,8375495,600,106238,16825,46,85101,9691,42,593,243750.0,146250.0,-45.0,-55.0,-48.0,-40.0,-45.0,-53.0,-47.0,-39.0,-83.0,-84.0,-79.0,-79.0,38.0,29.0,31.0,39.0,1
2781,92:69:1D:31:68:E9,3846769,488299548,4013,3649101,3842756,484650447,0,5185,1141148,5024,1104645,161,36503,2188,12,4252,102,0,55,229410.0,130000.0,-51.0,-47.0,-45.0,-48.0,-51.0,-47.0,-44.0,-48.0,-83.0,-84.0,-79.0,-79.0,32.0,37.0,34.0,31.0,1
2782,CC:2F:71:3F:1F:24,4890184,1664224529,1047428,1179574082,3842756,484650447,479,866282,957308281,865488,957212259,794,96022,837208,15,1047249,109256,476,674,130000.0,43333.0,-70.0,-70.0,-68.0,-70.0,-70.0,-70.0,-67.0,-69.0,-83.0,-84.0,-79.0,-79.0,13.0,14.0,11.0,9.0,1
2783,CC:2F:71:3E:C5:1F,3843703,484766114,947,115667,3842756,484650447,0,3962,332725,3269,250421,693,82304,1003,12,1364,26,0,52,144444.0,39000.0,-71.0,-72.0,-67.0,-60.0,-71.0,-71.0,-67.0,-60.0,-83.0,-84.0,-79.0,-79.0,12.0,12.0,12.0,19.0,1
2784,BA:8C:B9:54:50:24,3847650,490839747,4894,6189300,3842756,484650447,0,9420,1728824,9398,1725329,22,3495,2354,17,5376,41,0,66,216660.0,130000.0,-39.0,-36.0,-46.0,-52.0,-44.0,-35.0,-44.0,-48.0,-83.0,-84.0,-79.0,-79.0,44.0,48.0,33.0,27.0,1
2785,62:47:05:9D:EB:15,3844916,487084714,2158,2434065,3842758,484650649,0,4389,3018732,4357,3013613,32,5119,2071,0,2213,56,0,106,216660.0,130000.0,-46.0,-45.0,-39.0,-46.0,-46.0,-47.0,-39.0,-46.0,-83.0,-84.0,-79.0,-78.0,37.0,39.0,40.0,32.0,1
2786,3C:55:76:E8:8F:1F,3927783,697675053,85025,213024404,3842758,484650649,42,40797,8482347,40197,8376109,600,106238,16826,46,85102,9691,42,593,243750.0,146250.0,-49.0,-51.0,-45.0,-44.0,-48.0,-50.0,-44.0,-42.0,-83.0,-84.0,-79.0,-78.0,34.0,33.0,34.0,34.0,1
2787,92:69:1D:31:68:E9,3846771,488299750,4013,3649101,3842758,484650649,0,5185,1141148,5024,1104645,161,36503,2188,12,4252,102,0,55,229410.0,130000.0,-51.0,-47.0,-45.0,-48.0,-51.0,-47.0,-44.0,-48.0,-83.0,-84.0,-79.0,-78.0,32.0,37.0,34.0,30.0,1
2788,CC:2F:71:3F:1F:24,4890405,1664491594,1047647,1179840945,3842758,484650649,479,866481,957563078,865687,957467056,794,96022,837402,15,1047468,109297,476,674,130000.0,43333.0,-70.0,-70.0,-68.0,-70.0,-70.0,-70.0,-67.0,-69.0,-83.0,-84.0,-79.0,-78.0,13.0,14.0,11.0,8.0,1
2789,CC:2F:71:3E:C5:1F,3843707,484767440,947,115667,3842760,484651773,0,3962,332725,3269,250421,693,82304,1003,12,1364,26,0,52,144444.0,39000.0,-71.0,-72.0,-67.0,-60.0,-71.0,-71.0,-67.0,-60.0,-83.0,-84.0,-79.0,-78.0,12.0,12.0,12.0,18.0,1
2790,BA:8C:B9:54:50:24,3847654,490841073,4894,6189300,3842760,484651773,0,9420,1728824,9398,1725329,22,3495,2354,17,5376,41,0,66,216660.0,130000.0,-39.0,-36.0,-46.0,-52.0,-44.0,-35.0,-44.0,-48.0,-83.0,-84.0,-79.0,-78.0,44.0,48.0,33.0,26.0,1
2791,62:47:05:9D:EB:15,3844925,487086504,2158,2434065,3842767,484652439,0,4389,3018732,4357,3013613,32,5119,2071,0,2213,56,0,106,216660.0,130000.0,-46.0,-45.0,-39.0,-46.0,-46.0,-47.0,-39.0,-46.0,-83.0,-84.0,-79.0,-78.0,37.0,39.0,40.0,32.0,1
2792,3C:55:76:E8:8F:1F,3927793,697677053,85026,213024614,3842767,484652439,42,40813,8483473,40213,8377235,600,106238,16827,46,85103,9691,42,593,243750.0,146250.0,-50.0,-53.0,-49.0,-44.0,-50.0,-51.0,-46.0,-43.0,-83.0,-84.0,-79.0,-78.0,33.0,31.0,30.0,34.0,1
2793,92:69:1D:31:68:E9,3846780,488301540,4013,3649101,3842767,484652439,0,5185,1141148,5024,1104645,161,36503,2188,12,4252,102,0,55,229410.0,130000.0,-51.0,-47.0,-45.0,-48.0,-51.0,-47.0,-44.0,-48.0,-83.0,-84.0,-79.0,-78.0,32.0,37.0,34.0,30.0,1
2794,CC:2F:71:3F:1F:24,4890625,1664756758,1047858,1180104319,3842767,484652439,479,866675,957819836,865881,957723814,794,96022,837587,15,1047679,109319,476,674,130000.0,43333.0,-70.0,-68.0,-66.0,-69.0,-69.0,-68.0,-66.0,-69.0,-83.0,-84.0,-79.0,-78.0,13.0,16.0,13.0,9.0,1
2795,CC:2F:71:3E:C5:1F,3843716,484768308,947,115667,3842769,484652641,0,3962,332725,3269,250421,693,82304,1003,12,1364,26,0,52,144444.0,39000.0,-71.0,-72.0,-67.0,-60.0,-71.0,-71.0,-67.0,-60.0,-83.0,-84.0,-79.0,-78.0,12.0,12.0,12.0,18.0,1
2796,BA:8C:B9:54:50:24,3847663,490841941,4894,6189300,3842769,484652641,0,9420,1728824,9398,1725329,22,3495,2354,17,5376,41,0,66,216660.0,130000.0,-39.0,-36.0,-46.0,-52.0,-44.0,-35.0,-44.0,-48.0,-83.0,-84.0,-79.0,-78.0,44.0,48.0,33.0,26.0,1
2797,62:47:05:9D:EB:15,3844930,487088103,2158,2434065,3842772,484654038,0,4389,3018732,4357,3013613,32,5119,2071,0,2213,56,0,106,216660.0,130000.0,-46.0,-45.0,-39.0,-46.0,-46.0,-47.0,-39.0,-46.0,-83.0,-84.0,-79.0,-78.0,37.0,39.0,40.0,32.0,1
2798,3C:55:76:E8:8F:1F,3927799,697678864,85027,213024826,3842772,484654038,42,40825,8484331,40225,8378093,600,106238,16828,46,85104,9691,42,593,258080.0,146250.0,-43.0,-52.0,-52.0,-43.0,-44.0,-51.0,-51.0,-44.0,-83.0,-84.0,-79.0,-78.0,40.0,32.0,27.0,35.0,1
2799,92:69:1D:31:68:E9,3846785,488303139,4013,3649101,3842772,484654038,0,5185,1141148,5024,1104645,161,36503,2188,12,4252,102,0,55,229410.0,130000.0,-51.0,-47.0,-45.0,-48.0,-51.0,-47.0,-44.0,-48.0,-83.0,-84.0,-79.0,-79.0,32.0,37.0,34.0,31.0,1
2800,CC:2F:71:3F:1F:24,4890839,1665021247,1048067,1180367209,3842772,484654038,479,866863,958068622,866069,957972600,794,96022,837773,15,1047888,109349,476,674,115556.0,28889.0,-69.0,-70.0,-66.0,-71.0,-69.0,-70.0,-66.0,-72.0,-83.0,-84.0,-79.0,-79.0,14.0,14.0,13.0,8.0,1
2801,CC:2F:71:3E:C5:1F,3843721,484769907,947,115667,3842774,484654240,0,3962,332725,3269,250421,693,82304,1003,12,1364,26,0,52,144444.0,39000.0,-71.0,-72.0,-67.0,-60.0,-71.0,-71.0,-67.0,-60.0,-83.0,-84.0,-79.0,-79.0,12.0,12.0,12.0,19.0,1
2802,BA:8C:B9:54:50:24,3847668,490843540,4894,6189300,3842774,484654240,0,9420,1728824,9398,1725329,22,3495,2354,17,5376,41,0,66,216660.0,130000.0,-39.0,-36.0,-46.0,-52.0,-44.0,-35.0,-44.0,-48.0,-83.0,-84.0,-79.0,-79.0,44.0,48.0,33.0,27.0,1
2803,62:47:05:9D:EB:15,3844936,487088709,2158,2434065,3842778,484654644,0,4389,3018732,4357,3013613,32,5119,2071,0,2213,56,0,106,216660.0,130000.0,-46.0,-45.0,-39.0,-46.0,-46.0,-47.0,-39.0,-46.0,-83.0,-84.0,-79.0,-79.0,37.0,39.0,40.0,33.0,1
2804,3C:55:76:E8:8F:1F,3927806,697679530,85027,213024826,3842779,484654704,42,40827,8484587,40227,8378349,600,106238,16830,46,85104,9691,42,593,258080.0,146250.0,-48.0,-50.0,-44.0,-45.0,-45.0,-51.0,-51.0,-44.0,-83.0,-84.0,-79.0,-79.0,35.0,34.0,35.0,34.0,1
2805,92:69:1D:31:68:E9,3846794,488304007,4013,3649101,3842781,484654906,0,5185,1141148,5024,1104645,161,36503,2188,12,4252,102,0,55,229410.0,130000.0,-51.0,-47.0,-45.0,-48.0,-51.0,-47.0,-44.0,-48.0,-83.0,-84.0,-79.0,-79.0,32.0,37.0,34.0,31.0,1
2806,CC:2F:71:3F:1F:24,4891059,1665284721,1048278,1180629815,3842781,484654906,479,867056,958323856,866262,958227834,794,96022,837957,15,1048099,109380,476,674,86667.0,14444.0,-70.0,-70.0,-67.0,-73.0,-70.0,-70.0,-67.0,-71.0,-83.0,-84.0,-79.0,-79.0,13.0,14.0,12.0,6.0,1
2807,CC:2F:71:3E:C5:1F,3843728,484770573,947,115667,3842781,484654906,0,3962,332725,3269,250421,693,82304,1003,12,1364,26,0,52,144444.0,39000.0,-71.0,-72.0,-67.0,-60.0,-71.0,-71.0,-67.0,-60.0,-83.0,-84.0,-79.0,-79.0,12.0,12.0,12.0,19.0,1
2808,BA:8C:B9:54:50:24,3847675,490844206,4894,6189300,3842781,484654906,0,9420,1728824,9398,1725329,22,3495,2354,17,5376,41,0,66,216660.0,130000.0,-39.0,-36.0,-46.0,-52.0,-44.0,-35.0,-44.0,-48.0,-83.0,-84.0,-79.0,-79.0,44.0,48.0,33.0,27.0,1
2809,62:47:05:9D:EB:15,3844939,487088971,2158,2434065,3842781,484654906,0,4389,3018732,4357,3013613,32,5119,2071,0,2213,56,0,106,216660.0,130000.0,-46.0,-45.0,-39.0,-46.0,-46.0,-47.0,-39.0,-46.0,-83.0,-84.0,-79.0,-79.0,37.0,39.0,40.0,33.0,1
2810,3C:55:76:E8:8F:1F,3927818,697685958,85035,213030850,3842783,484655108,42,40846,8489524,40246,8383286,600,106238,16837,46,85112,9692,42,593,258080.0,146250.0,-45.0,-52.0,-48.0,-42.0,-45.0,-49.0,-48.0,-41.0,-83.0,-84.0,-79.0,-79.0,38.0,32.0,31.0,37.0,1
2811,92:69:1D:31:68:E9,3846798,488304411,4013,3649101,3842785,484655310,0,5185,1141148,5024,1104645,161,36503,2188,12,4252,102,0,55,229410.0,130000.0,-51.0,-47.0,-45.0,-48.0,-51.0,-47.0,-44.0,-48.0,-83.0,-84.0,-79.0,-79.0,32.0,37.0,34.0,31.0,1
2812,CC:2F:71:3F:1F:24,4891284,1665557457,1048499,1180902147,3842785,484655310,479,867264,958589748,866470,958493726,794,96022,838157,15,1048320,109381,476,674,86667.0,14444.0,-68.0,-69.0,-66.0,-73.0,-68.0,-69.0,-66.0,-72.0,-83.0,-84.0,-79.0,-79.0,15.0,15.0,13.0,6.0,1
2813,CC:2F:71:3E:C5:1F,3843732,484770977,947,115667,3842785,484655310,0,3962,332725,3269,250421,693,82304,1003,12,1364,26,0,52,144444.0,39000.0,-71.0,-72.0,-67.0,-60.0,-71.0,-71.0,-67.0,-60.0,-83.0,-84.0,-79.0,-79.0,12.0,12.0,12.0,19.0,1
2814,BA:8C:B9:54:50:24,3847679,490844610,4894,6189300,3842785,484655310,0,9420,1728824,9398,1725329,22,3495,2354,17,5376,41,0,66,216660.0,130000.0,-39.0,-36.0,-46.0,-52.0,-44.0,-35.0,-44.0,-48.0,-83.0,-84.0,-79.0,-79.0,44.0,48.0,33.0,27.0,1
2815,62:47:05:9D:EB:15,3844947,487089779,2158,2434065,3842789,484655714,0,4389,3018732,4357,3013613,32,5119,2071,0,2213,56,0,106,216660.0,130000.0,-46.0,-45.0,-39.0,-46.0,-46.0,-47.0,-39.0,-46.0,-83.0,-84.0,-79.0,-79.0,37.0,39.0,40.0,33.0,1
2816,3C:55:76:E8:8F:1F,3927824,697686564,85035,213030850,3842789,484655714,42,40846,8489524,40246,8383286,600,106238,16837,46,85112,9692,42,593,258080.0,146250.0,-45.0,-52.0,-48.0,-42.0,-45.0,-49.0,-48.0,-41.0,-83.0,-84.0,-79.0,-79.0,38.0,32.0,31.0,37.0,1
2817,92:69:1D:31:68:E9,3846802,488304815,4013,3649101,3842789,484655714,0,5185,1141148,5024,1104645,161,36503,2188,12,4252,102,0,55,229410.0,130000.0,-51.0,-47.0,-45.0,-48.0,-51.0,-47.0,-44.0,-48.0,-83.0,-84.0,-79.0,-79.0,32.0,37.0,34.0,31.0,1
2818,CC:2F:71:3F:1F:24,4891496,1665819613,1048707,1181163899,3842789,484655714,479,867457,958843420,866663,958747398,794,96022,838344,15,1048528,109444,476,674,104000.0,26000.0,-67.0,-69.0,-66.0,-70.0,-67.0,-69.0,-66.0,-70.0,-83.0,-84.0,-79.0,-79.0,16.0,15.0,13.0,9.0,1
2819,CC:2F:71:3E:C5:1F,3843736,484771381,947,115667,3842789,484655714,0,3962,332725,3269,250421,693,82304,1003,12,1364,26,0,52,144444.0,39000.0,-71.0,-72.0,-67.0,-60.0,-71.0,-71.0,-67.0,-60.0,-83.0,-84.0,-79.0,-79.0,12.0,12.0,12.0,19.0,1
2820,BA:8C:B9:54:50:24,3847684,490845074,4894,6189300,3842790,484655774,0,9420,1728824,9398,1725329,22,3495,2354,17,5376,41,0,66,216660.0,130000.0,-39.0,-36.0,-46.0,-52.0,-44.0,-35.0,-44.0,-48.0,-83.0,-84.0,-79.0,-79.0,44.0,48.0,33.0,27.0,1
2821,62:47:05:9D:EB:15,3844952,487090243,2158,2434065,3842794,484656178,0,4389,3018732,4357,3013613,32,5119,2071,0,2213,56,0,106,216660.0,130000.0,-46.0,-45.0,-39.0,-46.0,-46.0,-47.0,-39.0,-46.0,-83.0,-84.0,-79.0,-79.0,37.0,39.0,40.0,33.0,1
2822,3C:55:76:E8:8F:1F,3927830,697687202,85036,213031024,3842794,484656178,42,40858,8490468,40258,8384230,600,106238,16839,46,85113,9692,42,593,258080.0,146250.0,-43.0,-55.0,-50.0,-41.0,-43.0,-53.0,-48.0,-40.0,-83.0,-84.0,-79.0,-79.0,40.0,29.0,29.0,38.0,1
2823,92:69:1D:31:68:E9,3846809,488305481,4013,3649101,3842796,484656380,0,5185,1141148,5024,1104645,161,36503,2188,12,4252,102,0,55,229410.0,130000.0,-51.0,-47.0,-45.0,-48.0,-51.0,-47.0,-44.0,-48.0,-83.0,-84.0,-79.0,-79.0,32.0,37.0,34.0,31.0,1
2824,CC:2F:71:3F:1F:24,4891714,1666086405,1048918,1181430025,3842796,484656380,479,867652,959104566,866858,959008544,794,96022,838530,15,1048738,109475,476,674,117000.0,39000.0,-69.0,-70.0,-66.0,-71.0,-69.0,-69.0,-65.0,-70.0,-83.0,-84.0,-79.0,-79.0,14.0,14.0,13.0,8.0,1
2825,CC:2F:71:3E:C5:1F,3843743,484772047,947,115667,3842796,484656380,0,3962,332725,3269,250421,693,82304,1003,12,1364,26,0,52,144444.0,39000.0,-71.0,-72.0,-67.0,-60.0,-71.0,-71.0,-67.0,-60.0,-83.0,-84.0,-79.0,-79.0,12.0,12.0,12.0,19.0,1
2826,BA:8C:B9:54:50:24,3847690,490845680,4894,6189300,3842796,484656380,0,9420,1728824,9398,1725329,22,3495,2354,17,5376,41,0,66,216660.0,130000.0,-39.0,-36.0,-46.0,-52.0,-44.0,-35.0,-44.0,-48.0,-83.0,-84.0,-79.0,-79.0,44.0,48.0,33.0,27.0,1
2827,62:47:05:9D:EB:15,3844956,487090647,2158,2434065,3842798,484656582,0,4389,3018732,4357,3013613,32,5119,2071,0,2213,56,0,106,216660.0,130000.0,-46.0,-45.0,-39.0,-46.0,-46.0,-47.0,-39.0,-46.0,-83.0,-84.0,-79.0,-79.0,37.0,39.0,40.0,33.0,1
2828,3C:55:76:E8:8F:1F,3927835,697687736,85037,213031154,3842798,484656582,42,40876,8491735,40276,8385497,600,106238,16840,46,85114,9692,42,593,258080.0,146250.0,-46.0,-54.0,-49.0,-41.0,-45.0,-53.0,-48.0,-39.0,-83.0,-84.0,-79.0,-79.0,37.0,30.0,30.0,38.0,1
2829,92:69:1D:31:68:E9,3846811,488305683,4013,3649101,3842798,484656582,0,5185,1141148,5024,1104645,161,36503,2188,12,4252,102,0,55,229410.0,130000.0,-51.0,-47.0,-45.0,-48.0,-51.0,-47.0,-44.0,-48.0,-83.0,-84.0,-79.0,-79.0,32.0,37.0,34.0,31.0,1
2830,CC:2F:71:3F:1F:24,4891934,1666357235,1049136,1181700653,3842798,484656582,479,867850,959362101,867056,959266079,794,96022,838724,15,1048957,109481,476,674,115556.0,28889.0,-69.0,-70.0,-67.0,-72.0,-69.0,-70.0,-66.0,-71.0,-83.0,-84.0,-79.0,-79.0,14.0,14.0,12.0,7.0,1
2831,CC:2F:71:3E:C5:1F,3843745,484772249,947,115667,3842798,484656582,0,3962,332725,3269,250421,693,82304,1003,12,1364,26,0,52,144444.0,39000.0,-71.0,-72.0,-67.0,-60.0,-71.0,-71.0,-67.0,-60.0,-83.0,-84.0,-79.0,-79.0,12.0,12.0,12.0,19.0,1
2832,BA:8C:B9:54:50:24,3847692,490845882,4894,6189300,3842798,484656582,0,9420,1728824,9398,1725329,22,3495,2354,17,5376,41,0,66,216660.0,130000.0,-39.0,-36.0,-46.0,-52.0,-44.0,-35.0,-44.0,-48.0,-83.0,-84.0,-79.0,-79.0,44.0,48.0,33.0,27.0,1
2833,62:47:05:9D:EB:15,3844973,487095314,2159,2435030,3842814,484660284,0,4391,3018868,4359,3013749,32,5119,2071,0,2214,56,0,106,216660.0,130000.0,-46.0,-45.0,-39.0,-46.0,-45.0,-47.0,-39.0,-46.0,-83.0,-84.0,-79.0,-79.0,37.0,39.0,40.0,33.0,1
2834,3C:55:76:E8:8F:1F,3927863,697695122,85049,213034838,3842814,484660284,42,40897,8499418,40297,8393180,600,106238,16847,46,85126,9692,42,593,258080.0,146250.0,-51.0,-61.0,-44.0,-43.0,-50.0,-58.0,-44.0,-43.0,-83.0,-84.0,-79.0,-79.0,32.0,23.0,35.0,36.0,1
2835,92:69:1D:31:68:E9,3846827,488309385,4013,3649101,3842814,484660284,0,5186,1141216,5025,1104713,161,36503,2188,12,4252,102,0,55,229410.0,130000.0,-52.0,-48.0,-44.0,-46.0,-51.0,-47.0,-44.0,-47.0,-83.0,-84.0,-79.0,-79.0,31.0,36.0,35.0,33.0,1
2836,CC:2F:71:3F:1F:24,4892173,1666639186,1049359,1181978902,3842814,484660284,479,868056,959628707,867262,959532685,794,96022,838925,15,1049180,109493,476,675,115556.0,28889.0,-69.0,-70.0,-68.0,-71.0,-69.0,-70.0,-67.0,-71.0,-83.0,-84.0,-79.0,-79.0,14.0,14.0,11.0,8.0,1
2837,CC:2F:71:3E:C5:1F,3843763,484776153,947,115667,3842816,484660486,0,3962,332725,3269,250421,693,82304,1003,12,1364,26,0,52,144444.0,39000.0,-71.0,-72.0,-67.0,-60.0,-71.0,-71.0,-67.0,-60.0,-83.0,-84.0,-79.0,-79.0,12.0,12.0,12.0,19.0,1
2838,BA:8C:B9:54:50:24,3847710,490849786,4894,6189300,3842816,484660486,0,9420,1728824,9398,1725329,22,3495,2354,17,5376,41,0,66,216660.0,130000.0,-39.0,-36.0,-46.0,-52.0,-44.0,-35.0,-44.0,-48.0,-83.0,-84.0,-79.0,-79.0,44.0,48.0,33.0,27.0,1
2839,62:47:05:9D:EB:15,3844975,487095516,2159,2435030,3842816,484660486,0,4391,3018868,4359,3013749,32,5119,2071,0,2214,56,0,106,216660.0,130000.0,-46.0,-45.0,-39.0,-46.0,-45.0,-47.0,-39.0,-46.0,-83.0,-84.0,-79.0,-79.0,37.0,39.0,40.0,33.0,1
2840,3C:55:76:E8:8F:1F,3927870,697696065,85054,213035579,3842816,484660486,42,40912,8504808,40312,8398570,600,106238,16851,46,85131,9692,42,593,258080.0,154850.0,-48.0,-55.0,-47.0,-44.0,-50.0,-58.0,-46.0,-44.0,-83.0,-84.0,-79.0,-79.0,35.0,29.0,32.0,35.0,1
2841,92:69:1D:31:68:E9,3846829,488309587,4013,3649101,3842816,484660486,0,5186,1141216,5025,1104713,161,36503,2188,12,4252,102,0,55,229410.0,130000.0,-52.0,-48.0,-44.0,-46.0,-51.0,-47.0,-44.0,-47.0,-83.0,-84.0,-79.0,-79.0,31.0,36.0,35.0,33.0,1
2842,CC:2F:71:3F:1F:24,4892616,1667165127,1049800,1182504641,3842816,484660486,479,868352,959902559,867558,959806537,794,96022,839214,15,1049621,109500,476,675,115556.0,28889.0,-69.0,-70.0,-68.0,-72.0,-68.0,-70.0,-67.0,-71.0,-83.0,-84.0,-79.0,-79.0,14.0,14.0,11.0,7.0,1
2843,CC:2F:71:3E:C5:1F,3843767,484776557,947,115667,3842820,484660890,0,3962,332725,3269,250421,693,82304,1003,12,1364,26,0,52,144444.0,39000.0,-71.0,-72.0,-67.0,-60.0,-71.0,-71.0,-67.0,-60.0,-83.0,-84.0,-79.0,-79.0,12.0,12.0,12.0,19.0,1
2844,BA:8C:B9:54:50:24,3847714,490850190,4894,6189300,3842820,484660890,0,9420,1728824,9398,1725329,22,3495,2354,17,5376,41,0,66,216660.0,130000.0,-39.0,-36.0,-46.0,-52.0,-44.0,-35.0,-44.0,-48.0,-83.0,-84.0,-79.0,-79.0,44.0,48.0,33.0,27.0,1
2845,62:47:05:9D:EB:15,3844982,487096182,2159,2435030,3842823,484661152,0,4391,3018868,4359,3013749,32,5119,2071,0,2214,56,0,106,216660.0,130000.0,-46.0,-45.0,-39.0,-46.0,-45.0,-47.0,-39.0,-46.0,-83.0,-84.0,-79.0,-79.0,37.0,39.0,40.0,33.0,1
2846,3C:55:76:E8:8F:1F,3927880,697697001,85055,213035647,3842825,484661354,42,40920,8505356,40320,8399118,600,106238,16851,46,85132,9692,42,593,258080.0,154850.0,-51.0,-59.0,-44.0,-43.0,-50.0,-58.0,-44.0,-43.0,-83.0,-84.0,-79.0,-79.0,32.0,25.0,35.0,36.0,1
2847,92:69:1D:31:68:E9,3846838,488310455,4013,3649101,3842825,484661354,0,5186,1141216,5025,1104713,161,36503,2188,12,4252,102,0,55,229410.0,130000.0,-52.0,-48.0,-44.0,-46.0,-51.0,-47.0,-44.0,-47.0,-83.0,-84.0,-79.0,-79.0,31.0,36.0,35.0,33.0,1
2848,CC:2F:71:3F:1F:24,4893228,1667926822,1050403,1183265468,3842825,484661354,479,868732,960192904,867938,960096882,794,96022,839578,15,1050223,109521,476,675,115556.0,28889.0,-69.0,-69.0,-67.0,-71.0,-69.0,-69.0,-66.0,-70.0,-83.0,-84.0,-79.0,-79.0,14.0,15.0,12.0,8.0,1
2849,CC:2F:71:3E:C5:1F,3843772,484777021,947,115667,3842825,484661354,0,3962,332725,3269,250421,693,82304,1003,12,1364,26,0,52,144444.0,39000.0,-71.0,-72.0,-67.0,-60.0,-71.0,-71.0,-67.0,-60.0,-83.0,-84.0,-79.0,-79.0,12.0,12.0,12.0,19.0,1
2850,BA:8C:B9:54:50:24,3847719,490850654,4894,6189300,3842825,484661354,0,9420,1728824,9398,1725329,22,3495,2354,17,5376,41,0,66,216660.0,130000.0,-39.0,-36.0,-46.0,-52.0,-44.0,-35.0,-44.0,-48.0,-83.0,-84.0,-79.0,-79.0,44.0,48.0,33.0,27.0,1
2851,62:47:05:9D:EB:15,3844988,487096836,2160,2435146,3842828,484661690,0,4392,3018936,4360,3013817,32,5119,2071,0,2215,56,0,106,216660.0,130000.0,-46.0,-45.0,-39.0,-47.0,-45.0,-46.0,-39.0,-46.0,-83.0,-84.0,-79.0,-79.0,37.0,39.0,40.0,32.0,1
2852,3C:55:76:E8:8F:1F,3927885,697697521,85056,213035763,3842829,484661758,42,40928,8505904,40328,8399666,600,106238,16851,46,85133,9692,42,593,258080.0,154850.0,-45.0,-55.0,-49.0,-42.0,-44.0,-53.0,-47.0,-40.0,-83.0,-84.0,-79.0,-79.0,38.0,29.0,30.0,37.0,1
2853,92:69:1D:31:68:E9,3846843,488310975,4014,3649217,3842829,484661758,0,5188,1141352,5027,1104849,161,36503,2188,12,4253,102,0,55,229410.0,130000.0,-51.0,-48.0,-44.0,-46.0,-51.0,-47.0,-44.0,-47.0,-83.0,-84.0,-79.0,-79.0,32.0,36.0,35.0,33.0,1
2854,CC:2F:71:3F:1F:24,4893447,1668195226,1050618,1183533468,3842829,484661758,479,868933,960454440,868139,960358418,794,96022,839767,15,1050439,109524,476,675,115556.0,28889.0,-69.0,-69.0,-67.0,-71.0,-68.0,-69.0,-67.0,-71.0,-83.0,-84.0,-79.0,-79.0,14.0,15.0,12.0,8.0,1
2855,CC:2F:71:3E:C5:1F,3843777,484777541,948,115783,3842829,484661758,0,3964,332865,3271,250561,693,82304,1003,12,1365,26,0,52,144444.0,39000.0,-72.0,-72.0,-69.0,-60.0,-71.0,-72.0,-68.0,-60.0,-83.0,-84.0,-79.0,-79.0,11.0,12.0,10.0,19.0,1
2856,BA:8C:B9:54:50:24,3847726,490851376,4895,6189416,3842831,484661960,0,9426,1729232,9404,1725737,22,3495,2354,17,5377,41,0,66,216660.0,130000.0,-48.0,-35.0,-43.0,-45.0,-42.0,-35.0,-43.0,-47.0,-83.0,-84.0,-79.0,-79.0,35.0,49.0,36.0,34.0,1
2857,62:47:05:9D:EB:15,3844994,487097370,2160,2435146,3842834,484662224,0,4393,3019004,4361,3013885,32,5119,2071,0,2215,56,0,106,216660.0,130000.0,-47.0,-45.0,-39.0,-46.0,-45.0,-46.0,-39.0,-46.0,-83.0,-84.0,-79.0,-79.0,36.0,39.0,40.0,33.0,1
2858,3C:55:76:E8:8F:1F,3927893,697698415,85059,213036191,3842834,484662224,42,40937,8506659,40336,8400303,601,106356,16853,46,85136,9692,42,594,258080.0,154850.0,-43.0,-53.0,-46.0,-39.0,-43.0,-53.0,-46.0,-40.0,-83.0,-84.0,-79.0,-79.0,40.0,31.0,33.0,40.0,1
2859,92:69:1D:31:68:E9,3846849,488311501,4014,3649217,3842835,484662284,0,5188,1141352,5027,1104849,161,36503,2188,12,4253,102,0,55,229410.0,130000.0,-51.0,-48.0,-44.0,-46.0,-51.0,-47.0,-44.0,-47.0,-83.0,-84.0,-79.0,-79.0,32.0,36.0,35.0,33.0,1
2860,CC:2F:71:3F:1F:24,4893664,1668457744,1050829,1183795460,3842835,484662284,479,869127,960708188,868333,960612166,794,96022,839952,15,1050650,109525,476,675,115556.0,28889.0,-69.0,-70.0,-67.0,-72.0,-69.0,-69.0,-67.0,-71.0,-83.0,-84.0,-79.0,-79.0,14.0,14.0,12.0,7.0,1
2861,CC:2F:71:3E:C5:1F,3843783,484778067,948,115783,3842835,484662284,0,3964,332865,3271,250561,693,82304,1003,12,1365,26,0,52,144444.0,39000.0,-72.0,-72.0,-69.0,-60.0,-71.0,-72.0,-68.0,-60.0,-83.0,-84.0,-79.0,-79.0,11.0,12.0,10.0,19.0,1
2862,BA:8C:B9:54:50:24,3847730,490851700,4895,6189416,3842835,484662284,0,9426,1729232,9404,1725737,22,3495,2354,17,5377,41,0,66,216660.0,130000.0,-48.0,-35.0,-43.0,-45.0,-42.0,-35.0,-43.0,-47.0,-83.0,-84.0,-79.0,-79.0,35.0,49.0,36.0,34.0,1
2863,62:47:05:9D:EB:15,3845000,487098107,2160,2435146,3842840,484662961,0,4393,3019004,4361,3013885,32,5119,2071,0,2215,56,0,106,216660.0,130000.0,-47.0,-45.0,-39.0,-46.0,-45.0,-46.0,-39.0,-46.0,-83.0,-84.0,-79.0,-79.0,36.0,39.0,40.0,33.0,1
2864,3C:55:76:E8:8F:1F,3927901,697699354,85059,213036191,3842842,484663163,42,40947,8507377,40346,8401021,601,106356,16854,46,85136,9692,42,594,258080.0,154850.0,-45.0,-55.0,-48.0,-42.0,-45.0,-55.0,-47.0,-42.0,-83.0,-84.0,-79.0,-79.0,38.0,29.0,31.0,37.0,1
2865,92:69:1D:31:68:E9,3846856,488312380,4014,3649217,3842842,484663163,0,5188,1141352,5027,1104849,161,36503,2188,12,4253,102,0,55,229410.0,130000.0,-51.0,-48.0,-44.0,-46.0,-51.0,-47.0,-44.0,-47.0,-83.0,-84.0,-79.0,-79.0,32.0,36.0,35.0,33.0,1
2866,CC:2F:71:3F:1F:24,4893883,1668726007,1051041,1184062844,3842842,484663163,479,869324,960968326,868530,960872304,794,96022,840140,15,1050862,109560,476,675,115556.0,28889.0,-68.0,-70.0,-66.0,-69.0,-68.0,-69.0,-65.0,-69.0,-83.0,-84.0,-79.0,-79.0,15.0,14.0,13.0,10.0,1
2867,CC:2F:71:3E:C5:1F,3843790,484778946,948,115783,3842842,484663163,0,3964,332865,3271,250561,693,82304,1003,12,1365,26,0,52,144444.0,39000.0,-72.0,-72.0,-69.0,-60.0,-71.0,-72.0,-68.0,-60.0,-83.0,-84.0,-79.0,-79.0,11.0,12.0,10.0,19.0,1
2868,BA:8C:B9:54:50:24,3847737,490852579,4895,6189416,3842842,484663163,0,9426,1729232,9404,1725737,22,3495,2354,17,5377,41,0,66,216660.0,130000.0,-48.0,-35.0,-43.0,-45.0,-42.0,-35.0,-43.0,-47.0,-83.0,-84.0,-79.0,-79.0,35.0,49.0,36.0,34.0,1
2869,62:47:05:9D:EB:15,3845005,487098573,2160,2435146,3842845,484663427,0,4393,3019004,4361,3013885,32,5119,2071,0,2215,56,0,106,216660.0,130000.0,-47.0,-45.0,-39.0,-46.0,-45.0,-46.0,-39.0,-46.0,-83.0,-84.0,-79.0,-79.0,36.0,39.0,40.0,33.0,1
2870,3C:55:76:E8:8F:1F,3927904,697699618,85059,213036191,3842845,484663427,42,40947,8507377,40346,8401021,601,106356,16854,46,85136,9692,42,594,258080.0,154850.0,-45.0,-55.0,-48.0,-42.0,-45.0,-55.0,-47.0,-42.0,-83.0,-84.0,-79.0,-79.0,38.0,29.0,31.0,37.0,1
2871,92:69:1D:31:68:E9,3846859,488312644,4014,3649217,3842845,484663427,0,5188,1141352,5027,1104849,161,36503,2188,12,4253,102,0,55,229410.0,130000.0,-51.0,-48.0,-44.0,-46.0,-51.0,-47.0,-44.0,-47.0,-83.0,-84.0,-79.0,-79.0,32.0,36.0,35.0,33.0,1
2872,CC:2F:71:3F:1F:24,4894101,1668989936,1051256,1184326509,3842845,484663427,479,869529,961224189,868735,961128167,794,96022,840333,15,1051077,109565,476,675,115556.0,28889.0,-70.0,-71.0,-68.0,-74.0,-69.0,-70.0,-67.0,-73.0,-83.0,-84.0,-79.0,-79.0,13.0,13.0,11.0,5.0,1
2873,CC:2F:71:3E:C5:1F,3843794,484779272,948,115783,3842846,484663489,0,3966,333053,3272,250631,694,82422,1004,12,1365,26,0,52,144444.0,39000.0,-71.0,-71.0,-69.0,-60.0,-71.0,-71.0,-68.0,-60.0,-83.0,-84.0,-79.0,-79.0,12.0,13.0,10.0,19.0,1
2874,BA:8C:B9:54:50:24,3847741,490852905,4895,6189416,3842846,484663489,0,9426,1729232,9404,1725737,22,3495,2354,17,5377,41,0,66,216660.0,130000.0,-48.0,-35.0,-43.0,-45.0,-42.0,-35.0,-43.0,-47.0,-83.0,-84.0,-79.0,-79.0,35.0,49.0,36.0,34.0,1
2875,62:47:05:9D:EB:15,3845013,487099301,2160,2435146,3842853,484664155,0,4393,3019004,4361,3013885,32,5119,2071,0,2215,56,0,106,216660.0,130000.0,-47.0,-45.0,-39.0,-46.0,-45.0,-46.0,-39.0,-46.0,-83.0,-84.0,-79.0,-79.0,36.0,39.0,40.0,33.0,1
2876,3C:55:76:E8:8F:1F,3927912,697700346,85059,213036191,3842853,484664155,42,40967,8508789,40365,8402315,602,106474,16855,46,85136,9692,42,594,258080.0,154850.0,-47.0,-57.0,-45.0,-45.0,-47.0,-55.0,-45.0,-44.0,-83.0,-84.0,-79.0,-79.0,36.0,27.0,34.0,34.0,1
2877,92:69:1D:31:68:E9,3846867,488313372,4014,3649217,3842853,484664155,0,5188,1141352,5027,1104849,161,36503,2188,12,4253,102,0,55,229410.0,130000.0,-51.0,-48.0,-44.0,-46.0,-51.0,-47.0,-44.0,-47.0,-83.0,-84.0,-79.0,-79.0,32.0,36.0,35.0,33.0,1
2878,CC:2F:71:3F:1F:24,4894322,1669256194,1051469,1184592039,3842853,484664155,479,869731,961490524,868937,961394502,794,96022,840523,15,1051290,109612,476,675,65000.0,14444.0,-68.0,-69.0,-66.0,-73.0,-68.0,-69.0,-66.0,-72.0,-83.0,-84.0,-79.0,-79.0,15.0,15.0,13.0,6.0,1
2879,CC:2F:71:3E:C5:1F,3843801,484779938,948,115783,3842853,484664155,0,3966,333053,3272,250631,694,82422,1004,12,1365,26,0,52,144444.0,39000.0,-71.0,-71.0,-69.0,-60.0,-71.0,-71.0,-68.0,-60.0,-83.0,-84.0,-79.0,-79.0,12.0,13.0,10.0,19.0,1
2880,BA:8C:B9:54:50:24,3847750,490853773,4895,6189416,3842855,484664357,0,9426,1729232,9404,1725737,22,3495,2354,17,5377,41,0,66,216660.0,130000.0,-48.0,-35.0,-43.0,-45.0,-42.0,-35.0,-43.0,-47.0,-83.0,-84.0,-79.0,-79.0,35.0,49.0,36.0,34.0,1
2881,62:47:05:9D:EB:15,3845018,487099933,2160,2435146,3842858,484664787,0,4393,3019004,4361,3013885,32,5119,2071,0,2215,56,0,106,216660.0,130000.0,-47.0,-45.0,-39.0,-46.0,-45.0,-46.0,-39.0,-46.0,-84.0,-84.0,-79.0,-79.0,37.0,39.0,40.0,33.0,1
2882,3C:55:76:E8:8F:1F,3927917,697700978,85059,213036191,3842858,484664787,42,40981,8509797,40378,8403205,603,106592,16856,46,85136,9692,42,595,258080.0,154850.0,-46.0,-51.0,-50.0,-41.0,-44.0,-50.0,-48.0,-40.0,-84.0,-84.0,-79.0,-79.0,38.0,33.0,29.0,38.0,1
2883,92:69:1D:31:68:E9,3846872,488314004,4014,3649217,3842858,484664787,0,5188,1141352,5027,1104849,161,36503,2188,12,4253,102,0,55,229410.0,130000.0,-51.0,-48.0,-44.0,-46.0,-51.0,-47.0,-44.0,-47.0,-84.0,-84.0,-79.0,-79.0,33.0,36.0,35.0,33.0,1
2884,CC:2F:71:3F:1F:24,4894533,1669515694,1051675,1184850907,3842858,484664787,479,869922,961739758,869128,961643736,794,96022,840709,15,1051496,109632,476,675,117000.0,39000.0,-68.0,-69.0,-67.0,-71.0,-68.0,-69.0,-67.0,-71.0,-84.0,-84.0,-79.0,-79.0,16.0,15.0,12.0,8.0,1
2885,CC:2F:71:3E:C5:1F,3843808,484780772,948,115783,3842860,484664989,0,3966,333053,3272,250631,694,82422,1004,12,1365,26,0,52,144444.0,39000.0,-71.0,-71.0,-69.0,-60.0,-71.0,-71.0,-68.0,-60.0,-84.0,-84.0,-79.0,-79.0,13.0,13.0,10.0,19.0,1
2886,BA:8C:B9:54:50:24,3847755,490854405,4895,6189416,3842860,484664989,0,9426,1729232,9404,1725737,22,3495,2354,17,5377,41,0,66,216660.0,130000.0,-48.0,-35.0,-43.0,-45.0,-42.0,-35.0,-43.0,-47.0,-84.0,-84.0,-79.0,-79.0,36.0,49.0,36.0,34.0,1
2887,62:47:05:9D:EB:15,3845025,487100599,2160,2435146,3842865,484665453,0,4393,3019004,4361,3013885,32,5119,2071,0,2215,56,0,106,216660.0,130000.0,-47.0,-45.0,-39.0,-46.0,-45.0,-46.0,-39.0,-46.0,-84.0,-84.0,-79.0,-79.0,37.0,39.0,40.0,33.0,1
2888,3C:55:76:E8:8F:1F,3927961,697742313,85094,213076658,3842867,484665655,42,41009,8518173,40406,8411581,603,106592,16868,46,85171,9696,42,596,270830.0,162500.0,-49.0,-55.0,-48.0,-45.0,-47.0,-53.0,-47.0,-43.0,-84.0,-84.0,-79.0,-79.0,35.0,29.0,31.0,34.0,1
2889,92:69:1D:31:68:E9,3846881,488314872,4014,3649217,3842867,484665655,0,5188,1141352,5027,1104849,161,36503,2188,12,4253,102,0,55,229410.0,130000.0,-51.0,-48.0,-44.0,-46.0,-51.0,-47.0,-44.0,-47.0,-84.0,-84.0,-79.0,-79.0,33.0,36.0,35.0,33.0,1
2890,CC:2F:71:3F:1F:24,4894759,1669785861,1051892,1185120206,3842867,484665655,479,870130,962008779,869336,961912757,794,96022,840902,15,1051713,109644,476,675,130000.0,43333.0,-68.0,-70.0,-67.0,-72.0,-68.0,-69.0,-66.0,-72.0,-84.0,-84.0,-79.0,-79.0,16.0,14.0,12.0,7.0,1
2891,CC:2F:71:3E:C5:1F,3843815,484781438,948,115783,3842867,484665655,0,3966,333053,3272,250631,694,82422,1004,12,1365,26,0,52,144444.0,39000.0,-71.0,-71.0,-69.0,-60.0,-71.0,-71.0,-68.0,-60.0,-84.0,-84.0,-79.0,-79.0,13.0,13.0,10.0,19.0,1
2892,BA:8C:B9:54:50:24,3847762,490855071,4895,6189416,3842867,484665655,0,9426,1729232,9404,1725737,22,3495,2354,17,5377,41,0,66,216660.0,130000.0,-48.0,-35.0,-43.0,-45.0,-42.0,-35.0,-43.0,-47.0,-84.0,-84.0,-79.0,-79.0,36.0,49.0,36.0,34.0,1
2893,62:47:05:9D:EB:15,3845030,487101065,2160,2435146,3842870,484665919,0,4393,3019004,4361,3013885,32,5119,2071,0,2215,56,0,106,216660.0,130000.0,-47.0,-45.0,-39.0,-46.0,-45.0,-46.0,-39.0,-46.0,-84.0,-84.0,-79.0,-79.0,37.0,39.0,40.0,33.0,1
2894,3C:55:76:E8:8F:1F,3928018,697821526,85148,213155607,3842870,484665919,42,41095,8536431,40492,8429839,603,106592,16910,46,85225,9703,42,596,286760.0,172050.0,-48.0,-58.0,-44.0,-43.0,-48.0,-56.0,-46.0,-44.0,-84.0,-84.0,-79.0,-79.0,36.0,26.0,35.0,36.0,1
2895,92:69:1D:31:68:E9,3846886,488315338,4014,3649217,3842872,484666121,0,5188,1141352,5027,1104849,161,36503,2188,12,4253,102,0,55,229410.0,130000.0,-51.0,-48.0,-44.0,-46.0,-51.0,-47.0,-44.0,-47.0,-84.0,-84.0,-79.0,-79.0,33.0,36.0,35.0,33.0,1
2896,CC:2F:71:3F:1F:24,4894977,1670055489,1052105,1185389368,3842872,484666121,479,870329,962273111,869534,962176971,795,96140,841092,15,1051926,109661,476,675,130000.0,43333.0,-68.0,-69.0,-66.0,-71.0,-68.0,-69.0,-66.0,-71.0,-84.0,-84.0,-79.0,-79.0,16.0,15.0,13.0,8.0,1
2897,CC:2F:71:3E:C5:1F,3843821,484782038,948,115783,3842873,484666255,0,3966,333053,3272,250631,694,82422,1004,12,1365,26,0,52,144444.0,39000.0,-71.0,-71.0,-69.0,-60.0,-71.0,-71.0,-68.0,-60.0,-84.0,-84.0,-79.0,-79.0,13.0,13.0,10.0,19.0,1
2898,BA:8C:B9:54:50:24,3847769,490855739,4895,6189416,3842874,484666323,0,9426,1729232,9404,1725737,22,3495,2354,17,5377,41,0,66,216660.0,130000.0,-48.0,-35.0,-43.0,-45.0,-42.0,-35.0,-43.0,-47.0,-84.0,-84.0,-79.0,-79.0,36.0,49.0,36.0,34.0,1
2899,62:47:05:9D:EB:15,3845036,487101671,2160,2435146,3842876,484666525,0,4393,3019004,4361,3013885,32,5119,2071,0,2215,56,0,106,216660.0,130000.0,-47.0,-45.0,-39.0,-46.0,-45.0,-46.0,-39.0,-46.0,-84.0,-84.0,-79.0,-79.0,37.0,39.0,40.0,33.0,1
2900,3C:55:76:E8:8F:1F,3928028,697823032,85150,213156058,3842878,484666974,42,41113,8538387,40508,8431234,605,107153,16914,46,85227,9703,42,596,286760.0,172050.0,-46.0,-52.0,-46.0,-42.0,-47.0,-54.0,-45.0,-42.0,-84.0,-84.0,-79.0,-79.0,38.0,32.0,33.0,37.0,1
2901,92:69:1D:31:68:E9,3846893,488316251,4014,3649217,3842879,484667034,0,5188,1141352,5027,1104849,161,36503,2188,12,4253,102,0,55,229410.0,130000.0,-51.0,-48.0,-44.0,-46.0,-51.0,-47.0,-44.0,-47.0,-84.0,-84.0,-79.0,-79.0,33.0,36.0,35.0,33.0,1
2902,CC:2F:71:3F:1F:24,4895193,1670319588,1052314,1185652554,3842879,484667034,479,870533,962536747,869738,962440607,795,96140,841282,15,1052134,109669,476,675,130000.0,43333.0,-68.0,-70.0,-66.0,-72.0,-68.0,-69.0,-65.0,-72.0,-84.0,-84.0,-79.0,-79.0,16.0,14.0,13.0,7.0,1
2903,CC:2F:71:3E:C5:1F,3843827,484782817,948,115783,3842879,484667034,0,3966,333053,3272,250631,694,82422,1004,12,1365,26,0,52,144444.0,39000.0,-71.0,-71.0,-69.0,-60.0,-71.0,-71.0,-68.0,-60.0,-84.0,-84.0,-79.0,-79.0,13.0,13.0,10.0,19.0,1
2904,BA:8C:B9:54:50:24,3847774,490856450,4895,6189416,3842879,484667034,0,9426,1729232,9404,1725737,22,3495,2354,17,5377,41,0,66,216660.0,130000.0,-48.0,-35.0,-43.0,-45.0,-42.0,-35.0,-43.0,-47.0,-84.0,-84.0,-79.0,-79.0,36.0,49.0,36.0,34.0,1
2905,62:47:05:9D:EB:15,3845043,487102584,2160,2435146,3842883,484667438,0,4393,3019004,4361,3013885,32,5119,2071,0,2215,56,0,106,216660.0,130000.0,-47.0,-45.0,-39.0,-46.0,-45.0,-46.0,-39.0,-46.0,-84.0,-84.0,-79.0,-79.0,37.0,39.0,40.0,33.0,1
2906,3C:55:76:E8:8F:1F,3928137,698018160,85254,213350722,3842883,484667438,42,41210,8577603,40605,8470450,605,107153,16962,46,85331,9714,42,596,286760.0,172050.0,-50.0,-56.0,-50.0,-46.0,-46.0,-53.0,-49.0,-42.0,-84.0,-84.0,-79.0,-79.0,34.0,28.0,29.0,33.0,1
2907,92:69:1D:31:68:E9,3846897,488316655,4014,3649217,3842883,484667438,0,5188,1141352,5027,1104849,161,36503,2188,12,4253,102,0,55,229410.0,130000.0,-51.0,-48.0,-44.0,-46.0,-51.0,-47.0,-44.0,-47.0,-84.0,-84.0,-79.0,-79.0,33.0,36.0,35.0,33.0,1
2908,CC:2F:71:3F:1F:24,4895413,1670586563,1052526,1185918474,3842887,484668089,479,870723,962789981,869928,962693841,795,96140,841469,15,1052347,109698,476,675,115556.0,28889.0,-69.0,-71.0,-67.0,-73.0,-69.0,-70.0,-67.0,-72.0,-84.0,-84.0,-79.0,-79.0,15.0,13.0,12.0,6.0,1
2909,CC:2F:71:3E:C5:1F,3843835,484783872,948,115783,3842887,484668089,0,3966,333053,3272,250631,694,82422,1004,12,1365,26,0,52,144444.0,39000.0,-71.0,-71.0,-69.0,-60.0,-71.0,-71.0,-68.0,-60.0,-84.0,-84.0,-79.0,-79.0,13.0,13.0,10.0,19.0,1
2910,BA:8C:B9:54:50:24,3847782,490857505,4895,6189416,3842887,484668089,0,9426,1729232,9404,1725737,22,3495,2354,17,5377,41,0,66,216660.0,130000.0,-48.0,-35.0,-43.0,-45.0,-42.0,-35.0,-43.0,-47.0,-84.0,-84.0,-79.0,-79.0,36.0,49.0,36.0,34.0,1
2911,62:47:05:9D:EB:15,3845049,487103437,2160,2435146,3842889,484668291,0,4396,3019208,4364,3014089,32,5119,2071,0,2216,56,0,106,216660.0,130000.0,-42.0,-51.0,-40.0,-51.0,-45.0,-46.0,-39.0,-46.0,-84.0,-84.0,-79.0,-79.0,42.0,33.0,39.0,28.0,1
2912,3C:55:76:E8:8F:1F,3929367,700916450,86478,216248159,3842889,484668291,42,41630,8682857,41023,8575143,607,107714,17211,46,86555,9822,42,604,258080.0,154850.0,-47.0,-52.0,-51.0,-41.0,-50.0,-55.0,-51.0,-44.0,-84.0,-84.0,-79.0,-79.0,37.0,32.0,28.0,38.0,1
2913,92:69:1D:31:68:E9,3846903,488317508,4014,3649217,3842889,484668291,0,5190,1141488,5029,1104985,161,36503,2188,12,4254,102,0,55,229410.0,130000.0,-52.0,-47.0,-42.0,-48.0,-51.0,-47.0,-44.0,-47.0,-84.0,-84.0,-79.0,-79.0,32.0,37.0,37.0,31.0,1
2914,CC:2F:71:3F:1F:24,4895644,1670869398,1052755,1186201107,3842889,484668291,479,870938,963064220,870143,962968080,795,96140,841673,15,1052576,109698,476,675,115556.0,28889.0,-68.0,-71.0,-66.0,-72.0,-68.0,-70.0,-66.0,-71.0,-84.0,-84.0,-79.0,-79.0,16.0,13.0,13.0,7.0,1
2915,CC:2F:71:3E:C5:1F,3843838,484784299,948,115783,3842890,484668516,0,3968,333193,3274,250771,694,82422,1004,12,1366,26,0,52,144444.0,39000.0,-72.0,-71.0,-69.0,-60.0,-72.0,-72.0,-69.0,-61.0,-84.0,-84.0,-79.0,-79.0,12.0,13.0,10.0,19.0,1
2916,BA:8C:B9:54:50:24,3847789,490858418,4895,6189416,3842894,484669002,0,9428,1729368,9406,1725873,22,3495,2354,17,5378,41,0,66,216660.0,130000.0,-48.0,-35.0,-43.0,-46.0,-43.0,-35.0,-42.0,-46.0,-84.0,-84.0,-79.0,-79.0,36.0,49.0,36.0,33.0,1
2917,62:47:05:9D:EB:15,3845058,487104552,2160,2435146,3842898,484669406,0,4396,3019208,4364,3014089,32,5119,2071,0,2216,56,0,106,216660.0,130000.0,-42.0,-51.0,-40.0,-51.0,-45.0,-46.0,-39.0,-46.0,-84.0,-84.0,-79.0,-79.0,42.0,33.0,39.0,28.0,1
2918,3C:55:76:E8:8F:1F,3929503,701140124,86605,216470718,3842898,484669406,42,41759,8724866,41150,8616591,609,108275,17287,46,86682,9824,42,605,270830.0,162500.0,-45.0,-51.0,-51.0,-41.0,-48.0,-55.0,-50.0,-44.0,-84.0,-84.0,-79.0,-79.0,39.0,33.0,28.0,38.0,1
2919,92:69:1D:31:68:E9,3846912,488318623,4014,3649217,3842898,484669406,0,5190,1141488,5029,1104985,161,36503,2188,12,4254,102,0,55,229410.0,130000.0,-52.0,-47.0,-42.0,-48.0,-51.0,-47.0,-44.0,-47.0,-84.0,-84.0,-79.0,-79.0,32.0,37.0,37.0,31.0,1
2920,CC:2F:71:3F:1F:24,4895867,1671136565,1052969,1186467159,3842898,484669406,479,871131,963317802,870336,963221662,795,96140,841863,15,1052790,109732,476,675,117000.0,39000.0,-69.0,-70.0,-67.0,-72.0,-69.0,-70.0,-67.0,-72.0,-84.0,-84.0,-79.0,-79.0,15.0,14.0,12.0,7.0,1
2921,CC:2F:71:3E:C5:1F,3843846,484785189,948,115783,3842898,484669406,0,3968,333193,3274,250771,694,82422,1004,12,1366,26,0,52,144444.0,39000.0,-72.0,-71.0,-69.0,-60.0,-72.0,-72.0,-69.0,-61.0,-84.0,-84.0,-79.0,-79.0,12.0,13.0,10.0,19.0,1
2922,BA:8C:B9:54:50:24,3847795,490859024,4895,6189416,3842900,484669608,0,9428,1729368,9406,1725873,22,3495,2354,17,5378,41,0,66,216660.0,130000.0,-48.0,-35.0,-43.0,-46.0,-43.0,-35.0,-42.0,-46.0,-84.0,-84.0,-79.0,-79.0,36.0,49.0,36.0,33.0,1
2923,62:47:05:9D:EB:15,3845062,487105203,2160,2435146,3842902,484670057,0,4396,3019208,4364,3014089,32,5119,2071,0,2216,56,0,106,216660.0,130000.0,-42.0,-51.0,-40.0,-51.0,-45.0,-46.0,-39.0,-46.0,-84.0,-83.0,-79.0,-79.0,42.0,32.0,39.0,28.0,1
2924,3C:55:76:E8:8F:1F,3929524,701144010,86620,216473751,3842904,484670259,42,41786,8737562,41175,8628726,611,108836,17296,46,86697,9824,42,608,270830.0,162500.0,-45.0,-51.0,-49.0,-40.0,-46.0,-52.0,-47.0,-41.0,-84.0,-83.0,-79.0,-79.0,39.0,32.0,30.0,39.0,1
2925,92:69:1D:31:68:E9,3846918,488319476,4014,3649217,3842904,484670259,0,5190,1141488,5029,1104985,161,36503,2188,12,4254,102,0,55,229410.0,130000.0,-52.0,-47.0,-42.0,-48.0,-51.0,-47.0,-44.0,-47.0,-84.0,-83.0,-79.0,-79.0,32.0,36.0,37.0,31.0,1
2926,CC:2F:71:3F:1F:24,4896083,1671401974,1053179,1186731715,3842904,484670259,479,871325,963577462,870530,963481322,795,96140,842048,15,1053000,109745,476,677,115556.0,28889.0,-69.0,-70.0,-66.0,-72.0,-69.0,-70.0,-65.0,-72.0,-84.0,-83.0,-79.0,-79.0,15.0,13.0,13.0,7.0,1
2927,CC:2F:71:3E:C5:1F,3843852,484786042,948,115783,3842904,484670259,0,3968,333193,3274,250771,694,82422,1004,12,1366,26,0,52,144444.0,39000.0,-72.0,-71.0,-69.0,-60.0,-72.0,-72.0,-69.0,-61.0,-84.0,-83.0,-79.0,-79.0,12.0,12.0,10.0,19.0,1
2928,BA:8C:B9:54:50:24,3847801,490859877,4895,6189416,3842906,484670461,0,9428,1729368,9406,1725873,22,3495,2354,17,5378,41,0,66,216660.0,130000.0,-48.0,-35.0,-43.0,-46.0,-43.0,-35.0,-42.0,-46.0,-84.0,-83.0,-79.0,-79.0,36.0,48.0,36.0,33.0,1
2929,62:47:05:9D:EB:15,3845069,487105869,2160,2435146,3842909,484670723,0,4396,3019208,4364,3014089,32,5119,2071,0,2216,56,0,106,216660.0,130000.0,-42.0,-51.0,-40.0,-51.0,-45.0,-46.0,-39.0,-46.0,-84.0,-83.0,-79.0,-79.0,42.0,32.0,39.0,28.0,1
2930,3C:55:76:E8:8F:1F,3929533,701144954,86624,216474231,3842909,484670723,42,41807,8739313,41196,8630477,611,108836,17302,46,86701,9827,42,608,286760.0,1000.0,-46.0,-58.0,-50.0,-45.0,-47.0,-55.0,-47.0,-44.0,-84.0,-83.0,-79.0,-79.0,38.0,25.0,29.0,34.0,1
2931,92:69:1D:31:68:E9,3846925,488320142,4014,3649217,3842911,484670925,0,5190,1141488,5029,1104985,161,36503,2188,12,4254,102,0,55,229410.0,130000.0,-52.0,-47.0,-42.0,-48.0,-51.0,-47.0,-44.0,-47.0,-84.0,-83.0,-79.0,-79.0,32.0,36.0,37.0,31.0,1
2932,CC:2F:71:3F:1F:24,4896307,1671667597,1053396,1186996672,3842911,484670925,479,871523,963830813,870728,963734673,795,96140,842240,15,1053217,109750,476,677,130000.0,43333.0,-69.0,-71.0,-67.0,-69.0,-68.0,-71.0,-66.0,-71.0,-84.0,-83.0,-79.0,-79.0,15.0,12.0,12.0,10.0,1
2933,CC:2F:71:3E:C5:1F,3843859,484786708,948,115783,3842911,484670925,0,3968,333193,3274,250771,694,82422,1004,12,1366,26,0,52,144444.0,39000.0,-72.0,-71.0,-69.0,-60.0,-72.0,-72.0,-69.0,-61.0,-84.0,-83.0,-79.0,-79.0,12.0,12.0,10.0,19.0,1
2934,BA:8C:B9:54:50:24,3847806,490860341,4895,6189416,3842911,484670925,0,9429,1729436,9407,1725941,22,3495,2354,17,5378,41,0,66,216660.0,130000.0,-39.0,-36.0,-45.0,-51.0,-42.0,-35.0,-43.0,-47.0,-84.0,-83.0,-79.0,-79.0,45.0,47.0,34.0,28.0,1
2935,62:47:05:9D:EB:15,3845074,487106546,2160,2435146,3842914,484671400,0,4396,3019208,4364,3014089,32,5119,2071,0,2216,56,0,106,216660.0,130000.0,-42.0,-51.0,-40.0,-51.0,-45.0,-46.0,-39.0,-46.0,-84.0,-83.0,-79.0,-79.0,42.0,32.0,39.0,28.0,1
2936,3C:55:76:E8:8F:1F,3929548,701146888,86632,216475286,3842916,484671602,42,41816,8744723,41205,8635887,611,108836,17308,46,86709,9830,42,608,286760.0,1000.0,-43.0,-57.0,-50.0,-40.0,-44.0,-56.0,-48.0,-42.0,-84.0,-83.0,-79.0,-79.0,41.0,26.0,29.0,39.0,1
2937,92:69:1D:31:68:E9,3846930,488320819,4014,3649217,3842916,484671602,0,5190,1141488,5029,1104985,161,36503,2188,12,4254,102,0,55,229410.0,130000.0,-52.0,-47.0,-42.0,-48.0,-51.0,-47.0,-44.0,-47.0,-84.0,-83.0,-79.0,-79.0,32.0,36.0,37.0,31.0,1
2938,CC:2F:71:3F:1F:24,4896523,1671931704,1053607,1187260102,3842916,484671602,479,871716,964087327,870921,963991187,795,96140,842426,15,1053428,109755,476,677,130000.0,43333.0,-68.0,-71.0,-66.0,-71.0,-67.0,-70.0,-66.0,-71.0,-84.0,-83.0,-79.0,-79.0,16.0,12.0,13.0,8.0,1
2939,CC:2F:71:3E:C5:1F,3843864,484787385,948,115783,3842916,484671602,0,3968,333193,3274,250771,694,82422,1004,12,1366,26,0,52,144444.0,39000.0,-72.0,-71.0,-69.0,-60.0,-72.0,-72.0,-69.0,-61.0,-84.0,-83.0,-79.0,-79.0,12.0,12.0,10.0,19.0,1
2940,BA:8C:B9:54:50:24,3847811,490861018,4895,6189416,3842916,484671602,0,9429,1729436,9407,1725941,22,3495,2354,17,5378,41,0,66,216660.0,130000.0,-39.0,-36.0,-45.0,-51.0,-42.0,-35.0,-43.0,-47.0,-84.0,-83.0,-79.0,-79.0,45.0,47.0,34.0,28.0,1
2941,62:47:05:9D:EB:15,3845081,487107212,2160,2435146,3842921,484672066,0,4396,3019208,4364,3014089,32,5119,2071,0,2216,56,0,106,216660.0,130000.0,-42.0,-51.0,-40.0,-51.0,-45.0,-46.0,-39.0,-46.0,-84.0,-83.0,-79.0,-79.0,42.0,32.0,39.0,28.0,1
2942,3C:55:76:E8:8F:1F,3929570,701154531,86649,216482465,3842921,484672066,42,41855,8759910,41244,8651074,611,108836,17321,46,86726,9860,42,610,243750.0,146250.0,-47.0,-59.0,-49.0,-45.0,-46.0,-57.0,-46.0,-43.0,-84.0,-83.0,-79.0,-79.0,37.0,24.0,30.0,34.0,1
2943,92:69:1D:31:68:E9,3846935,488321283,4014,3649217,3842921,484672066,0,5190,1141488,5029,1104985,161,36503,2188,12,4254,102,0,55,229410.0,130000.0,-52.0,-47.0,-42.0,-48.0,-51.0,-47.0,-44.0,-47.0,-84.0,-83.0,-79.0,-79.0,32.0,36.0,37.0,31.0,1
2944,CC:2F:71:3F:1F:24,4896744,1672201834,1053823,1187529768,3842921,484672066,479,871910,964345411,871115,964249271,795,96140,842615,15,1053644,109765,476,677,117000.0,39000.0,-68.0,-71.0,-66.0,-72.0,-68.0,-70.0,-66.0,-71.0,-84.0,-83.0,-79.0,-79.0,16.0,12.0,13.0,7.0,1
2945,CC:2F:71:3E:C5:1F,3843869,484787849,948,115783,3842921,484672066,0,3968,333193,3274,250771,694,82422,1004,12,1366,26,0,52,144444.0,39000.0,-72.0,-71.0,-69.0,-60.0,-72.0,-72.0,-69.0,-61.0,-84.0,-83.0,-79.0,-79.0,12.0,12.0,10.0,19.0,1
2946,BA:8C:B9:54:50:24,3847816,490861482,4895,6189416,3842921,484672066,0,9429,1729436,9407,1725941,22,3495,2354,17,5378,41,0,66,216660.0,130000.0,-39.0,-36.0,-45.0,-51.0,-42.0,-35.0,-43.0,-47.0,-84.0,-83.0,-79.0,-79.0,45.0,47.0,34.0,28.0,1
2947,62:47:05:9D:EB:15,3845085,487107616,2160,2435146,3842925,484672470,0,4396,3019208,4364,3014089,32,5119,2071,0,2216,56,0,106,216660.0,130000.0,-42.0,-51.0,-40.0,-51.0,-45.0,-46.0,-39.0,-46.0,-84.0,-83.0,-79.0,-79.0,42.0,32.0,39.0,28.0,1
2948,3C:55:76:E8:8F:1F,3929574,701154935,86649,216482465,3842925,484672470,42,41861,8760320,41250,8651484,611,108836,17321,46,86726,9860,42,610,243750.0,146250.0,-48.0,-60.0,-46.0,-45.0,-47.0,-59.0,-46.0,-44.0,-84.0,-83.0,-79.0,-79.0,36.0,23.0,33.0,34.0,1
2949,92:69:1D:31:68:E9,3846939,488321687,4014,3649217,3842925,484672470,0,5190,1141488,5029,1104985,161,36503,2188,12,4254,102,0,55,229410.0,130000.0,-52.0,-47.0,-42.0,-48.0,-51.0,-47.0,-44.0,-47.0,-84.0,-83.0,-79.0,-79.0,32.0,36.0,37.0,31.0,1
2950,CC:2F:71:3F:1F:24,4896965,1672476080,1054040,1187803610,3842925,484672470,479,872113,964614519,871318,964518379,795,96140,842806,15,1053861,109772,476,677,130000.0,43333.0,-68.0,-70.0,-67.0,-71.0,-67.0,-69.0,-66.0,-70.0,-84.0,-83.0,-79.0,-79.0,16.0,13.0,12.0,8.0,1
2951,CC:2F:71:3E:C5:1F,3843873,484788253,948,115783,3842925,484672470,0,3968,333193,3274,250771,694,82422,1004,12,1366,26,0,52,144444.0,39000.0,-72.0,-71.0,-69.0,-60.0,-72.0,-72.0,-69.0,-61.0,-84.0,-83.0,-79.0,-79.0,12.0,12.0,10.0,19.0,1
2952,BA:8C:B9:54:50:24,3847822,490862088,4895,6189416,3842927,484672672,0,9429,1729436,9407,1725941,22,3495,2354,17,5378,41,0,66,216660.0,130000.0,-39.0,-36.0,-45.0,-51.0,-42.0,-35.0,-43.0,-47.0,-84.0,-83.0,-79.0,-79.0,45.0,47.0,34.0,28.0,1
2953,62:47:05:9D:EB:15,3845089,487108020,2160,2435146,3842929,484672874,0,4396,3019208,4364,3014089,32,5119,2071,0,2216,56,0,106,216660.0,130000.0,-42.0,-51.0,-40.0,-51.0,-45.0,-46.0,-39.0,-46.0,-84.0,-83.0,-79.0,-79.0,42.0,32.0,39.0,28.0,1
2954,3C:55:76:E8:8F:1F,3929578,701155339,86649,216482465,3842929,484672874,42,41861,8760320,41250,8651484,611,108836,17321,46,86726,9860,42,610,243750.0,146250.0,-48.0,-60.0,-46.0,-45.0,-47.0,-59.0,-46.0,-44.0,-84.0,-83.0,-79.0,-79.0,36.0,23.0,33.0,34.0,1
2955,92:69:1D:31:68:E9,3846943,488322091,4014,3649217,3842929,484672874,0,5190,1141488,5029,1104985,161,36503,2188,12,4254,102,0,55,229410.0,130000.0,-52.0,-47.0,-42.0,-48.0,-51.0,-47.0,-44.0,-47.0,-84.0,-83.0,-79.0,-79.0,32.0,36.0,37.0,31.0,1
2956,CC:2F:71:3F:1F:24,4897189,1672744999,1054259,1188072065,3842930,484672934,479,872315,964878264,871520,964782124,795,96140,842999,15,1054080,109772,476,677,130000.0,43333.0,-67.0,-69.0,-66.0,-70.0,-67.0,-69.0,-66.0,-70.0,-84.0,-83.0,-79.0,-79.0,17.0,14.0,13.0,9.0,1
2957,CC:2F:71:3E:C5:1F,3843880,484788919,948,115783,3842932,484673136,0,3968,333193,3274,250771,694,82422,1004,12,1366,26,0,52,144444.0,39000.0,-72.0,-71.0,-69.0,-60.0,-72.0,-72.0,-69.0,-61.0,-84.0,-83.0,-79.0,-79.0,12.0,12.0,10.0,19.0,1
2958,BA:8C:B9:54:50:24,3847827,490862552,4895,6189416,3842932,484673136,0,9429,1729436,9407,1725941,22,3495,2354,17,5378,41,0,66,216660.0,130000.0,-39.0,-36.0,-45.0,-51.0,-42.0,-35.0,-43.0,-47.0,-84.0,-83.0,-79.0,-79.0,45.0,47.0,34.0,28.0,1
2959,62:47:05:9D:EB:15,3845094,487108484,2160,2435146,3842934,484673338,0,4396,3019208,4364,3014089,32,5119,2071,0,2216,56,0,106,216660.0,130000.0,-42.0,-51.0,-40.0,-51.0,-45.0,-46.0,-39.0,-46.0,-84.0,-83.0,-79.0,-79.0,42.0,32.0,39.0,28.0,1
2960,3C:55:76:E8:8F:1F,3929599,701169991,86665,216496653,3842934,484673338,42,41900,8768504,41289,8659668,611,108836,17342,46,86742,9865,42,613,243750.0,146250.0,-48.0,-60.0,-46.0,-45.0,-48.0,-59.0,-46.0,-44.0,-84.0,-83.0,-79.0,-79.0,36.0,23.0,33.0,34.0,1
2961,92:69:1D:31:68:E9,3846948,488322555,4014,3649217,3842934,484673338,0,5190,1141488,5029,1104985,161,36503,2188,12,4254,102,0,55,229410.0,130000.0,-52.0,-47.0,-42.0,-48.0,-51.0,-47.0,-44.0,-47.0,-84.0,-83.0,-79.0,-79.0,32.0,36.0,37.0,31.0,1
2962,CC:2F:71:3F:1F:24,4897405,1673008681,1054469,1188335141,3842936,484673540,479,872512,965135654,871717,965039514,795,96140,843185,15,1054290,109779,476,677,130000.0,43333.0,-67.0,-70.0,-66.0,-71.0,-67.0,-69.0,-66.0,-70.0,-84.0,-83.0,-79.0,-79.0,17.0,13.0,13.0,8.0,1
2963,CC:2F:71:3E:C5:1F,3843884,484789323,948,115783,3842936,484673540,0,3968,333193,3274,250771,694,82422,1004,12,1366,26,0,52,144444.0,39000.0,-72.0,-71.0,-69.0,-60.0,-72.0,-72.0,-69.0,-61.0,-84.0,-83.0,-79.0,-79.0,12.0,12.0,10.0,19.0,1
2964,BA:8C:B9:54:50:24,3847833,490863158,4895,6189416,3842938,484673742,0,9429,1729436,9407,1725941,22,3495,2354,17,5378,41,0,66,216660.0,130000.0,-39.0,-36.0,-45.0,-51.0,-42.0,-35.0,-43.0,-47.0,-84.0,-83.0,-79.0,-79.0,45.0,47.0,34.0,28.0,1
2965,62:47:05:9D:EB:15,3845100,487109090,2160,2435146,3842940,484673944,0,4396,3019208,4364,3014089,32,5119,2071,0,2216,56,0,106,216660.0,130000.0,-42.0,-51.0,-40.0,-51.0,-45.0,-46.0,-39.0,-46.0,-84.0,-83.0,-79.0,-79.0,42.0,32.0,39.0,28.0,1
2966,3C:55:76:E8:8F:1F,3929614,701172382,86674,216498438,3842940,484673944,42,41920,8773839,41309,8665003,611,108836,17348,46,86751,9865,42,613,258080.0,146250.0,-49.0,-60.0,-47.0,-45.0,-48.0,-59.0,-46.0,-44.0,-84.0,-83.0,-79.0,-79.0,35.0,23.0,32.0,34.0,1
2967,92:69:1D:31:68:E9,3846954,488323161,4014,3649217,3842940,484673944,0,5190,1141488,5029,1104985,161,36503,2188,12,4254,102,0,55,229410.0,130000.0,-52.0,-47.0,-42.0,-48.0,-51.0,-47.0,-44.0,-47.0,-84.0,-83.0,-79.0,-79.0,32.0,36.0,37.0,31.0,1
2968,CC:2F:71:3F:1F:24,4897621,1673272421,1054681,1188598477,3842940,484673944,479,872707,965395262,871912,965299122,795,96140,843370,15,1054502,109789,476,677,130000.0,43333.0,-67.0,-70.0,-65.0,-71.0,-67.0,-69.0,-66.0,-70.0,-84.0,-83.0,-79.0,-79.0,17.0,13.0,14.0,8.0,1
2969,CC:2F:71:3E:C5:1F,3843888,484789727,948,115783,3842940,484673944,0,3968,333193,3274,250771,694,82422,1004,12,1366,26,0,52,144444.0,39000.0,-72.0,-71.0,-69.0,-60.0,-72.0,-72.0,-69.0,-61.0,-84.0,-83.0,-79.0,-79.0,12.0,12.0,10.0,19.0,1
2970,BA:8C:B9:54:50:24,3847835,490863360,4895,6189416,3842940,484673944,0,9429,1729436,9407,1725941,22,3495,2354,17,5378,41,0,66,216660.0,130000.0,-39.0,-36.0,-45.0,-51.0,-42.0,-35.0,-43.0,-47.0,-84.0,-83.0,-79.0,-79.0,45.0,47.0,34.0,28.0,1
2971,62:47:05:9D:EB:15,3845105,487109554,2160,2435146,3842945,484674408,0,4396,3019208,4364,3014089,32,5119,2071,0,2216,56,0,106,216660.0,130000.0,-42.0,-51.0,-40.0,-51.0,-45.0,-46.0,-39.0,-46.0,-84.0,-83.0,-79.0,-79.0,42.0,32.0,39.0,28.0,1
2972,3C:55:76:E8:8F:1F,3929619,701172846,86674,216498438,3842945,484674408,42,41920,8773839,41309,8665003,611,108836,17348,46,86751,9865,42,613,258080.0,146250.0,-49.0,-60.0,-47.0,-45.0,-48.0,-59.0,-46.0,-44.0,-84.0,-83.0,-79.0,-79.0,35.0,23.0,32.0,34.0,1
2973,92:69:1D:31:68:E9,3846959,488323625,4014,3649217,3842945,484674408,0,5190,1141488,5029,1104985,161,36503,2188,12,4254,102,0,55,229410.0,130000.0,-52.0,-47.0,-42.0,-48.0,-51.0,-47.0,-44.0,-47.0,-84.0,-83.0,-79.0,-79.0,32.0,36.0,37.0,31.0,1
2974,CC:2F:71:3F:1F:24,4897855,1673542434,1054908,1188867824,3842947,484674610,479,872921,965656843,872126,965560703,795,96140,843575,15,1054729,109799,476,677,130000.0,43333.0,-67.0,-70.0,-66.0,-70.0,-67.0,-70.0,-66.0,-70.0,-84.0,-83.0,-79.0,-79.0,17.0,13.0,13.0,9.0,1
2975,CC:2F:71:3E:C5:1F,3843895,484790393,948,115783,3842947,484674610,0,3968,333193,3274,250771,694,82422,1004,12,1366,26,0,52,144444.0,39000.0,-72.0,-71.0,-69.0,-60.0,-72.0,-72.0,-69.0,-61.0,-84.0,-83.0,-79.0,-79.0,12.0,12.0,10.0,19.0,1
2976,BA:8C:B9:54:50:24,3847842,490864026,4895,6189416,3842947,484674610,0,9429,1729436,9407,1725941,22,3495,2354,17,5378,41,0,66,216660.0,130000.0,-39.0,-36.0,-45.0,-51.0,-42.0,-35.0,-43.0,-47.0,-84.0,-83.0,-79.0,-79.0,45.0,47.0,34.0,28.0,1
2977,62:47:05:9D:EB:15,3845109,487109958,2160,2435146,3842949,484674812,0,4396,3019208,4364,3014089,32,5119,2071,0,2216,56,0,106,216660.0,130000.0,-42.0,-51.0,-40.0,-51.0,-45.0,-46.0,-39.0,-46.0,-84.0,-84.0,-79.0,-80.0,42.0,33.0,39.0,29.0,1
2978,3C:55:76:E8:8F:1F,3929638,701185519,86689,216510707,3842949,484674812,42,41946,8786854,41335,8678018,611,108836,17362,46,86766,9865,42,613,258080.0,146250.0,-49.0,-59.0,-48.0,-46.0,-46.0,-59.0,-49.0,-42.0,-84.0,-84.0,-79.0,-80.0,35.0,25.0,31.0,34.0,1
2979,92:69:1D:31:68:E9,3846963,488324029,4014,3649217,3842949,484674812,0,5190,1141488,5029,1104985,161,36503,2188,12,4254,102,0,55,229410.0,130000.0,-52.0,-47.0,-42.0,-48.0,-51.0,-47.0,-44.0,-47.0,-84.0,-84.0,-79.0,-80.0,32.0,37.0,37.0,32.0,1
2980,CC:2F:71:3F:1F:24,4898069,1673806198,1055120,1189131386,3842949,484674812,479,873106,965902325,872311,965806185,795,96140,843760,15,1054941,109800,476,677,130000.0,43333.0,-67.0,-70.0,-67.0,-71.0,-67.0,-70.0,-66.0,-71.0,-84.0,-84.0,-79.0,-80.0,17.0,14.0,12.0,9.0,1
2981,CC:2F:71:3E:C5:1F,3843897,484790595,948,115783,3842949,484674812,0,3968,333193,3274,250771,694,82422,1004,12,1366,26,0,52,144444.0,39000.0,-72.0,-71.0,-69.0,-60.0,-72.0,-72.0,-69.0,-61.0,-84.0,-84.0,-79.0,-80.0,12.0,13.0,10.0,20.0,1
2982,BA:8C:B9:54:50:24,3847846,490864430,4895,6189416,3842951,484675014,0,9429,1729436,9407,1725941,22,3495,2354,17,5378,41,0,66,216660.0,130000.0,-39.0,-36.0,-45.0,-51.0,-42.0,-35.0,-43.0,-47.0,-84.0,-84.0,-79.0,-80.0,45.0,48.0,34.0,29.0,1
2983,62:47:05:9D:EB:15,3845116,487110624,2160,2435146,3842956,484675478,0,4396,3019208,4364,3014089,32,5119,2071,0,2216,56,0,106,216660.0,130000.0,-42.0,-51.0,-40.0,-51.0,-45.0,-46.0,-39.0,-46.0,-84.0,-84.0,-79.0,-80.0,42.0,33.0,39.0,29.0,1
2984,3C:55:76:E8:8F:1F,3929677,701210289,86721,216534811,3842956,484675478,42,41999,8804810,41388,8695974,611,108836,17391,46,86798,9865,42,613,286760.0,162500.0,-44.0,-56.0,-52.0,-41.0,-44.0,-57.0,-50.0,-41.0,-84.0,-84.0,-79.0,-80.0,40.0,28.0,27.0,39.0,1
2985,92:69:1D:31:68:E9,3846970,488324695,4014,3649217,3842956,484675478,0,5190,1141488,5029,1104985,161,36503,2188,12,4254,102,0,55,229410.0,130000.0,-52.0,-47.0,-42.0,-48.0,-51.0,-47.0,-44.0,-47.0,-84.0,-84.0,-79.0,-80.0,32.0,37.0,37.0,32.0,1
2986,CC:2F:71:3F:1F:24,4898288,1674073120,1055332,1189397642,3842956,484675478,479,873293,966150897,872498,966054757,795,96140,843947,15,1055153,109809,476,677,130000.0,39000.0,-68.0,-72.0,-67.0,-74.0,-68.0,-71.0,-66.0,-73.0,-84.0,-84.0,-79.0,-80.0,16.0,12.0,12.0,6.0,1
2987,CC:2F:71:3E:C5:1F,3843904,484791261,948,115783,3842956,484675478,0,3968,333193,3274,250771,694,82422,1004,12,1366,26,0,52,144444.0,39000.0,-72.0,-71.0,-69.0,-60.0,-72.0,-72.0,-69.0,-61.0,-84.0,-84.0,-79.0,-80.0,12.0,13.0,10.0,20.0,1
2988,BA:8C:B9:54:50:24,3847851,490864894,4895,6189416,3842956,484675478,0,9429,1729436,9407,1725941,22,3495,2354,17,5378,41,0,66,216660.0,130000.0,-39.0,-36.0,-45.0,-51.0,-42.0,-35.0,-43.0,-47.0,-84.0,-84.0,-79.0,-80.0,45.0,48.0,34.0,29.0,1
2989,62:47:05:9D:EB:15,3845118,487110826,2160,2435146,3842958,484675680,0,4396,3019208,4364,3014089,32,5119,2071,0,2216,56,0,106,216660.0,130000.0,-42.0,-51.0,-40.0,-51.0,-45.0,-46.0,-39.0,-46.0,-84.0,-84.0,-79.0,-80.0,42.0,33.0,39.0,29.0,1
2990,3C:55:76:E8:8F:1F,3929682,701210753,86722,216534871,3842960,484675882,42,42004,8805154,41393,8696318,611,108836,17391,46,86799,9865,42,613,286760.0,162500.0,-45.0,-55.0,-47.0,-45.0,-43.0,-54.0,-47.0,-42.0,-84.0,-84.0,-79.0,-80.0,39.0,29.0,32.0,35.0,1
2991,92:69:1D:31:68:E9,3846975,488325215,4015,3649333,3842960,484675882,0,5192,1141624,5031,1105121,161,36503,2188,12,4255,102,0,56,229410.0,130000.0,-54.0,-47.0,-42.0,-48.0,-51.0,-47.0,-43.0,-46.0,-84.0,-84.0,-79.0,-80.0,30.0,37.0,37.0,32.0,1
2992,CC:2F:71:3F:1F:24,4898504,1674339528,1055544,1189663646,3842960,484675882,479,873480,966399459,872685,966303319,795,96140,844134,15,1055364,109836,476,677,117000.0,39000.0,-69.0,-71.0,-67.0,-73.0,-69.0,-70.0,-66.0,-73.0,-84.0,-84.0,-79.0,-80.0,15.0,13.0,12.0,7.0,1
2993,CC:2F:71:3E:C5:1F,3843909,484791781,949,115899,3842960,484675882,0,3970,333333,3276,250911,694,82422,1004,12,1367,26,0,52,144444.0,39000.0,-72.0,-71.0,-70.0,-60.0,-72.0,-72.0,-69.0,-61.0,-85.0,-84.0,-80.0,-81.0,13.0,13.0,10.0,21.0,1
2994,BA:8C:B9:54:50:24,3847856,490865414,4896,6189532,3842960,484675882,0,9431,1729572,9409,1726077,22,3495,2354,17,5379,41,0,66,216660.0,130000.0,-40.0,-37.0,-46.0,-52.0,-43.0,-35.0,-43.0,-47.0,-85.0,-84.0,-80.0,-81.0,45.0,47.0,34.0,29.0,1
2995,62:47:05:9D:EB:15,3845127,487111672,2161,2435262,3842966,484676410,0,4398,3019344,4366,3014225,32,5119,2071,0,2217,56,0,106,229410.0,130000.0,-47.0,-47.0,-39.0,-45.0,-46.0,-46.0,-39.0,-46.0,-85.0,-84.0,-80.0,-81.0,38.0,37.0,41.0,36.0,1
2996,3C:55:76:E8:8F:1F,3929696,701219364,86730,216542954,3842966,484676410,42,42029,8809258,41416,8700186,613,109072,17403,46,86807,9865,42,615,286760.0,162500.0,-46.0,-53.0,-49.0,-40.0,-47.0,-54.0,-48.0,-43.0,-85.0,-84.0,-80.0,-81.0,39.0,31.0,31.0,41.0,1
2997,92:69:1D:31:68:E9,3846981,488325743,4015,3649333,3842966,484676410,0,5192,1141624,5031,1105121,161,36503,2188,12,4255,102,0,56,229410.0,130000.0,-54.0,-47.0,-42.0,-48.0,-51.0,-47.0,-43.0,-46.0,-85.0,-84.0,-80.0,-81.0,31.0,37.0,38.0,33.0,1
2998,CC:2F:71:3F:1F:24,4898734,1674609761,1055765,1189933089,3842969,484676672,479,873679,966650043,872884,966553903,795,96140,844333,15,1055586,109862,476,677,86667.0,14444.0,-69.0,-71.0,-66.0,-74.0,-69.0,-70.0,-66.0,-74.0,-85.0,-84.0,-80.0,-81.0,16.0,13.0,14.0,7.0,1
2999,CC:2F:71:3E:C5:1F,3843918,484792571,949,115899,3842969,484676672,0,3970,333333,3276,250911,694,82422,1004,12,1367,26,0,52,144444.0,39000.0,-72.0,-71.0,-70.0,-60.0,-72.0,-72.0,-69.0,-61.0,-85.0,-84.0,-80.0,-81.0,13.0,13.0,10.0,21.0,1
3000,BA:8C:B9:54:50:24,3847865,490866204,4896,6189532,3842969,484676672,0,9431,1729572,9409,1726077,22,3495,2354,17,5379,41,0,66,216660.0,130000.0,-40.0,-37.0,-46.0,-52.0,-43.0,-35.0,-43.0,-47.0,-85.0,-84.0,-80.0,-81.0,45.0,47.0,34.0,29.0,1
3001,62:47:05:9D:EB:15,3845133,487112409,2161,2435262,3842972,484677147,0,4398,3019344,4366,3014225,32,5119,2071,0,2217,56,0,106,229410.0,130000.0,-47.0,-47.0,-39.0,-45.0,-46.0,-46.0,-39.0,-46.0,-85.0,-85.0,-81.0,-82.0,38.0,38.0,42.0,37.0,1
3002,3C:55:76:E8:8F:1F,3929732,701224723,86760,216547576,3842972,484677147,42,42063,8828475,41450,8719403,613,109072,17419,46,86837,9865,42,615,286760.0,172050.0,-46.0,-56.0,-46.0,-45.0,-47.0,-55.0,-47.0,-45.0,-85.0,-85.0,-81.0,-82.0,39.0,29.0,35.0,37.0,1
3003,92:69:1D:31:68:E9,3846987,488326480,4015,3649333,3842972,484677147,0,5192,1141624,5031,1105121,161,36503,2188,12,4255,102,0,56,229410.0,130000.0,-54.0,-47.0,-42.0,-48.0,-51.0,-47.0,-43.0,-46.0,-85.0,-85.0,-81.0,-82.0,31.0,38.0,39.0,34.0,1
3004,CC:2F:71:3F:1F:24,4898950,1674875876,1055976,1190198527,3842974,484677349,479,873867,966898773,873072,966802633,795,96140,844521,15,1055797,109862,476,677,86667.0,14444.0,-70.0,-71.0,-66.0,-75.0,-69.0,-71.0,-66.0,-74.0,-85.0,-85.0,-81.0,-82.0,15.0,14.0,15.0,7.0,1
3005,CC:2F:71:3E:C5:1F,3843923,484793248,949,115899,3842974,484677349,0,3970,333333,3276,250911,694,82422,1004,12,1367,26,0,52,144444.0,39000.0,-72.0,-71.0,-70.0,-60.0,-72.0,-72.0,-69.0,-61.0,-85.0,-85.0,-81.0,-82.0,13.0,14.0,11.0,22.0,1
3006,BA:8C:B9:54:50:24,3847870,490866881,4896,6189532,3842974,484677349,0,9431,1729572,9409,1726077,22,3495,2354,17,5379,41,0,66,216660.0,130000.0,-40.0,-37.0,-46.0,-52.0,-43.0,-35.0,-43.0,-47.0,-85.0,-85.0,-81.0,-82.0,45.0,48.0,35.0,30.0,1
3007,62:47:05:9D:EB:15,3845139,487113015,2161,2435262,3842978,484677753,0,4398,3019344,4366,3014225,32,5119,2071,0,2217,56,0,106,229410.0,130000.0,-47.0,-47.0,-39.0,-45.0,-46.0,-46.0,-39.0,-46.0,-85.0,-85.0,-81.0,-82.0,38.0,38.0,42.0,37.0,1
3008,3C:55:76:E8:8F:1F,3929754,701227892,86776,216550139,3842978,484677753,42,42096,8840807,41483,8731735,613,109072,17430,46,86853,9866,42,616,270830.0,162500.0,-49.0,-55.0,-48.0,-46.0,-48.0,-55.0,-46.0,-45.0,-85.0,-85.0,-81.0,-82.0,36.0,30.0,33.0,36.0,1
3009,92:69:1D:31:68:E9,3846993,488327086,4015,3649333,3842978,484677753,0,5192,1141624,5031,1105121,161,36503,2188,12,4255,102,0,56,229410.0,130000.0,-54.0,-47.0,-42.0,-48.0,-51.0,-47.0,-43.0,-46.0,-85.0,-85.0,-81.0,-82.0,31.0,38.0,39.0,34.0,1
3010,CC:2F:71:3F:1F:24,4899163,1675138570,1056185,1190460817,3842978,484677753,479,874053,967144381,873258,967048241,795,96140,844707,15,1056006,109868,476,677,115556.0,28889.0,-70.0,-72.0,-66.0,-74.0,-70.0,-72.0,-65.0,-74.0,-85.0,-85.0,-81.0,-82.0,15.0,13.0,15.0,8.0,1
3011,CC:2F:71:3E:C5:1F,3843927,484793652,949,115899,3842978,484677753,0,3970,333333,3276,250911,694,82422,1004,12,1367,26,0,52,144444.0,39000.0,-72.0,-71.0,-70.0,-60.0,-72.0,-72.0,-69.0,-61.0,-85.0,-85.0,-81.0,-82.0,13.0,14.0,11.0,22.0,1
3012,BA:8C:B9:54:50:24,3847874,490867285,4896,6189532,3842978,484677753,0,9431,1729572,9409,1726077,22,3495,2354,17,5379,41,0,66,216660.0,130000.0,-40.0,-37.0,-46.0,-52.0,-43.0,-35.0,-43.0,-47.0,-85.0,-85.0,-81.0,-82.0,45.0,48.0,35.0,30.0,1
3013,62:47:05:9D:EB:15,3845145,487113541,2161,2435262,3842984,484678279,0,4398,3019344,4366,3014225,32,5119,2071,0,2217,56,0,106,229410.0,130000.0,-47.0,-47.0,-39.0,-45.0,-46.0,-46.0,-39.0,-46.0,-86.0,-86.0,-82.0,-83.0,39.0,39.0,43.0,38.0,1
3014,3C:55:76:E8:8F:1F,3929781,701280952,86797,216602673,3842984,484678279,42,42122,8843139,41509,8734067,613,109072,17436,46,86874,9866,42,616,270830.0,162500.0,-48.0,-55.0,-46.0,-46.0,-48.0,-55.0,-45.0,-45.0,-86.0,-86.0,-82.0,-83.0,38.0,31.0,36.0,37.0,1
3015,92:69:1D:31:68:E9,3846999,488327612,4015,3649333,3842984,484678279,0,5192,1141624,5031,1105121,161,36503,2188,12,4255,102,0,56,229410.0,130000.0,-54.0,-47.0,-42.0,-48.0,-51.0,-47.0,-43.0,-46.0,-86.0,-86.0,-82.0,-83.0,32.0,39.0,40.0,35.0,1
3016,CC:2F:71:3F:1F:24,4899387,1675407197,1056403,1190728918,3842984,484678279,479,874249,967393063,873454,967296923,795,96140,844903,15,1056224,109878,476,677,115556.0,28889.0,-70.0,-72.0,-65.0,-75.0,-70.0,-72.0,-65.0,-75.0,-86.0,-86.0,-82.0,-83.0,16.0,14.0,17.0,8.0,1
3017,CC:2F:71:3E:C5:1F,3843933,484794178,949,115899,3842984,484678279,0,3972,333521,3277,250981,695,82540,1005,12,1367,26,0,52,144444.0,39000.0,-73.0,-71.0,-70.0,-61.0,-73.0,-72.0,-70.0,-61.0,-86.0,-86.0,-82.0,-83.0,13.0,15.0,12.0,22.0,1
3018,BA:8C:B9:54:50:24,3847880,490867811,4896,6189532,3842984,484678279,0,9431,1729572,9409,1726077,22,3495,2354,17,5379,41,0,66,216660.0,130000.0,-40.0,-37.0,-46.0,-52.0,-43.0,-35.0,-43.0,-47.0,-86.0,-86.0,-82.0,-83.0,46.0,49.0,36.0,31.0,1
3019,62:47:05:9D:EB:15,3845151,487114267,2161,2435262,3842990,484679005,0,4398,3019344,4366,3014225,32,5119,2071,0,2217,56,0,106,229410.0,130000.0,-47.0,-47.0,-39.0,-45.0,-46.0,-46.0,-39.0,-46.0,-86.0,-87.0,-83.0,-84.0,39.0,40.0,44.0,39.0,1
3020,3C:55:76:E8:8F:1F,3929787,701281678,86797,216602673,3842990,484679005,42,42125,8843593,41511,8734205,614,109388,17437,46,86874,9866,42,617,270830.0,162500.0,-44.0,-51.0,-45.0,-38.0,-46.0,-53.0,-45.0,-42.0,-86.0,-87.0,-83.0,-84.0,42.0,36.0,38.0,46.0,1
3021,92:69:1D:31:68:E9,3847005,488328338,4015,3649333,3842990,484679005,0,5192,1141624,5031,1105121,161,36503,2188,12,4255,102,0,56,229410.0,130000.0,-54.0,-47.0,-42.0,-48.0,-51.0,-47.0,-43.0,-46.0,-86.0,-87.0,-83.0,-84.0,32.0,40.0,41.0,36.0,1
3022,CC:2F:71:3F:1F:24,4899601,1675669539,1056611,1190990534,3842990,484679005,479,874433,967637017,873637,967540759,796,96258,845087,15,1056432,109886,476,677,115556.0,28889.0,-70.0,-72.0,-66.0,-75.0,-70.0,-72.0,-66.0,-75.0,-86.0,-87.0,-83.0,-84.0,16.0,15.0,17.0,9.0,1
3023,CC:2F:71:3E:C5:1F,3843939,484794904,949,115899,3842990,484679005,0,3972,333521,3277,250981,695,82540,1005,12,1367,26,0,52,144444.0,39000.0,-73.0,-71.0,-70.0,-61.0,-73.0,-72.0,-70.0,-61.0,-86.0,-87.0,-83.0,-84.0,13.0,16.0,13.0,23.0,1
3024,BA:8C:B9:54:50:24,3847889,490868799,4896,6189532,3842993,484679267,0,9431,1729572,9409,1726077,22,3495,2354,17,5379,41,0,66,216660.0,130000.0,-40.0,-37.0,-46.0,-52.0,-43.0,-35.0,-43.0,-47.0,-86.0,-87.0,-83.0,-84.0,46.0,50.0,37.0,32.0,1
3025,62:47:05:9D:EB:15,3845157,487114791,2161,2435262,3842996,484679529,0,4398,3019344,4366,3014225,32,5119,2071,0,2217,56,0,106,229410.0,130000.0,-47.0,-47.0,-39.0,-45.0,-46.0,-46.0,-39.0,-46.0,-86.0,-87.0,-83.0,-84.0,39.0,40.0,44.0,39.0,1
3026,3C:55:76:E8:8F:1F,3929797,701282834,86801,216603305,3842996,484679529,42,42143,8845045,41528,8735551,615,109494,17440,46,86878,9868,42,617,270830.0,162500.0,-45.0,-52.0,-44.0,-43.0,-45.0,-53.0,-47.0,-41.0,-87.0,-87.0,-83.0,-85.0,42.0,35.0,39.0,42.0,1
3027,92:69:1D:31:68:E9,3847012,488328922,4015,3649333,3842997,484679589,0,5192,1141624,5031,1105121,161,36503,2188,12,4255,102,0,56,229410.0,130000.0,-54.0,-47.0,-42.0,-48.0,-51.0,-47.0,-43.0,-46.0,-87.0,-87.0,-83.0,-85.0,33.0,40.0,41.0,37.0,1
3028,CC:2F:71:3F:1F:24,4899817,1675930163,1056818,1191250372,3842999,484679791,479,874615,967879369,873819,967783111,796,96258,845269,15,1056639,109903,476,677,115556.0,28889.0,-71.0,-73.0,-67.0,-76.0,-71.0,-74.0,-68.0,-76.0,-87.0,-87.0,-83.0,-85.0,16.0,14.0,16.0,9.0,1
3029,CC:2F:71:3E:C5:1F,3843948,484795690,949,115899,3842999,484679791,0,3972,333521,3277,250981,695,82540,1005,12,1367,26,0,52,144444.0,39000.0,-73.0,-71.0,-70.0,-61.0,-73.0,-72.0,-70.0,-61.0,-87.0,-87.0,-83.0,-85.0,14.0,16.0,13.0,24.0,1
3030,BA:8C:B9:54:50:24,3847895,490869323,4896,6189532,3842999,484679791,0,9431,1729572,9409,1726077,22,3495,2354,17,5379,41,0,66,216660.0,130000.0,-40.0,-37.0,-46.0,-52.0,-43.0,-35.0,-43.0,-47.0,-87.0,-87.0,-83.0,-85.0,47.0,50.0,37.0,33.0,1
3031,62:47:05:9D:EB:15,3845162,487115255,2161,2435262,3843001,484679993,0,4398,3019344,4366,3014225,32,5119,2071,0,2217,56,0,106,229410.0,130000.0,-47.0,-47.0,-39.0,-45.0,-46.0,-46.0,-39.0,-46.0,-87.0,-87.0,-83.0,-85.0,40.0,40.0,44.0,40.0,1
3032,3C:55:76:E8:8F:1F,3929815,701290504,86814,216610511,3843001,484679993,42,42175,8854069,41559,8744469,616,109600,17452,46,86891,9868,42,617,286760.0,162500.0,-48.0,-55.0,-47.0,-45.0,-48.0,-54.0,-46.0,-45.0,-87.0,-87.0,-83.0,-85.0,39.0,32.0,36.0,40.0,1
3033,92:69:1D:31:68:E9,3847018,488329528,4015,3649333,3843003,484680195,0,5192,1141624,5031,1105121,161,36503,2188,12,4255,102,0,56,229410.0,130000.0,-54.0,-47.0,-42.0,-48.0,-51.0,-47.0,-43.0,-46.0,-87.0,-87.0,-83.0,-85.0,33.0,40.0,41.0,37.0,1
3034,CC:2F:71:3F:1F:24,4900032,1676195781,1057029,1191515586,3843003,484680195,479,874802,968127941,874006,968031683,796,96258,845456,15,1056850,109949,476,677,86667.0,14444.0,-74.0,-76.0,-70.0,-78.0,-73.0,-75.0,-69.0,-78.0,-87.0,-88.0,-84.0,-86.0,13.0,12.0,14.0,8.0,1
3035,CC:2F:71:3E:C5:1F,3843953,484796154,949,115899,3843004,484680255,0,3972,333521,3277,250981,695,82540,1005,12,1367,26,0,52,144444.0,39000.0,-73.0,-71.0,-70.0,-61.0,-73.0,-72.0,-70.0,-61.0,-87.0,-88.0,-84.0,-86.0,14.0,17.0,14.0,25.0,1
3036,BA:8C:B9:54:50:24,3847900,490869787,4896,6189532,3843004,484680255,0,9431,1729572,9409,1726077,22,3495,2354,17,5379,41,0,66,216660.0,130000.0,-40.0,-37.0,-46.0,-52.0,-43.0,-35.0,-43.0,-47.0,-87.0,-88.0,-84.0,-86.0,47.0,51.0,38.0,34.0,1
3037,62:47:05:9D:EB:15,3845169,487115921,2161,2435262,3843008,484680659,0,4398,3019344,4366,3014225,32,5119,2071,0,2217,56,0,106,229410.0,130000.0,-47.0,-47.0,-39.0,-45.0,-46.0,-46.0,-39.0,-46.0,-87.0,-88.0,-84.0,-86.0,40.0,41.0,45.0,41.0,1
3038,3C:55:76:E8:8F:1F,3929895,701343286,86886,216662567,3843009,484680719,42,42247,8880352,41630,8770646,617,109706,17488,46,86963,9868,42,617,286760.0,172050.0,-46.0,-53.0,-49.0,-45.0,-47.0,-53.0,-49.0,-45.0,-87.0,-88.0,-84.0,-86.0,41.0,35.0,35.0,41.0,1
3039,92:69:1D:31:68:E9,3847024,488330052,4015,3649333,3843009,484680719,0,5193,1141692,5032,1105189,161,36503,2188,12,4255,102,0,56,229410.0,130000.0,-52.0,-49.0,-45.0,-49.0,-52.0,-48.0,-43.0,-46.0,-87.0,-88.0,-84.0,-86.0,35.0,39.0,39.0,37.0,1
3040,CC:2F:71:3F:1F:24,4900255,1676462235,1057244,1191781314,3843011,484680921,479,874994,968374736,874198,968278478,796,96258,845648,15,1057065,109949,476,677,86667.0,14444.0,-72.0,-75.0,-71.0,-77.0,-71.0,-74.0,-70.0,-76.0,-87.0,-88.0,-84.0,-86.0,15.0,13.0,13.0,9.0,1
3041,CC:2F:71:3E:C5:1F,3843960,484796820,949,115899,3843011,484680921,0,3972,333521,3277,250981,695,82540,1005,12,1367,26,0,52,144444.0,39000.0,-73.0,-71.0,-70.0,-61.0,-73.0,-72.0,-70.0,-61.0,-87.0,-88.0,-84.0,-86.0,14.0,17.0,14.0,25.0,1
3042,BA:8C:B9:54:50:24,3847907,490870453,4896,6189532,3843011,484680921,0,9431,1729572,9409,1726077,22,3495,2354,17,5379,41,0,66,216660.0,130000.0,-40.0,-37.0,-46.0,-52.0,-43.0,-35.0,-43.0,-47.0,-87.0,-88.0,-84.0,-86.0,47.0,51.0,38.0,34.0,1
3043,62:47:05:9D:EB:15,3845175,487116447,2161,2435262,3843014,484681185,0,4398,3019344,4366,3014225,32,5119,2071,0,2217,56,0,106,229410.0,130000.0,-47.0,-47.0,-39.0,-45.0,-46.0,-46.0,-39.0,-46.0,-88.0,-89.0,-85.0,-87.0,41.0,42.0,46.0,42.0,1
3044,3C:55:76:E8:8F:1F,3930185,702020670,87171,217339485,3843014,484681185,42,42382,8915657,41764,8805833,618,109824,17581,46,87248,9868,42,617,286760.0,172050.0,-45.0,-50.0,-49.0,-44.0,-46.0,-52.0,-48.0,-45.0,-88.0,-89.0,-85.0,-87.0,43.0,39.0,36.0,43.0,1
3045,92:69:1D:31:68:E9,3847029,488330518,4015,3649333,3843014,484681185,0,5193,1141692,5032,1105189,161,36503,2188,12,4255,102,0,56,229410.0,130000.0,-52.0,-49.0,-45.0,-49.0,-52.0,-48.0,-43.0,-46.0,-88.0,-89.0,-85.0,-87.0,36.0,40.0,40.0,38.0,1
3046,CC:2F:71:3F:1F:24,4900465,1676722809,1057451,1192041624,3843014,484681185,479,875177,968618586,874381,968522328,796,96258,845830,15,1057271,109997,476,677,130000.0,39000.0,-72.0,-74.0,-72.0,-75.0,-72.0,-74.0,-71.0,-75.0,-88.0,-89.0,-85.0,-87.0,16.0,15.0,13.0,12.0,1
3047,CC:2F:71:3E:C5:1F,3843965,484797286,949,115899,3843016,484681387,0,3972,333521,3277,250981,695,82540,1005,12,1367,26,0,52,144444.0,39000.0,-73.0,-71.0,-70.0,-61.0,-73.0,-72.0,-70.0,-61.0,-88.0,-89.0,-85.0,-87.0,15.0,18.0,15.0,26.0,1
3048,BA:8C:B9:54:50:24,3847912,490870919,4896,6189532,3843016,484681387,0,9431,1729572,9409,1726077,22,3495,2354,17,5379,41,0,66,216660.0,130000.0,-40.0,-37.0,-46.0,-52.0,-43.0,-35.0,-43.0,-47.0,-88.0,-89.0,-85.0,-87.0,48.0,52.0,39.0,35.0,1
3049,62:47:05:9D:EB:15,3845181,487117053,2161,2435262,3843020,484681791,0,4398,3019344,4366,3014225,32,5119,2071,0,2217,56,0,106,229410.0,130000.0,-47.0,-47.0,-39.0,-45.0,-46.0,-46.0,-39.0,-46.0,-88.0,-90.0,-86.0,-88.0,41.0,43.0,47.0,43.0,1
3050,3C:55:76:E8:8F:1F,3930262,702095042,87242,217413251,3843020,484681791,42,42468,8952292,41850,8842468,618,109824,17629,46,87319,9868,42,617,270830.0,162500.0,-44.0,-49.0,-50.0,-45.0,-45.0,-50.0,-50.0,-45.0,-88.0,-90.0,-86.0,-88.0,44.0,41.0,36.0,43.0,1
3051,92:69:1D:31:68:E9,3847035,488331124,4015,3649333,3843020,484681791,0,5193,1141692,5032,1105189,161,36503,2188,12,4255,102,0,56,229410.0,130000.0,-52.0,-49.0,-45.0,-49.0,-52.0,-48.0,-43.0,-46.0,-88.0,-90.0,-86.0,-88.0,36.0,41.0,41.0,39.0,1
3052,CC:2F:71:3F:1F:24,4900696,1676988392,1057676,1192306601,3843020,484681791,479,875379,968866101,874583,968769843,796,96258,846032,15,1057496,110026,476,677,130000.0,43333.0,-68.0,-70.0,-68.0,-71.0,-67.0,-70.0,-68.0,-71.0,-88.0,-90.0,-86.0,-88.0,20.0,20.0,18.0,17.0,1
3053,CC:2F:71:3E:C5:1F,3843969,484797690,949,115899,3843020,484681791,0,3974,333661,3279,251121,695,82540,1005,12,1368,26,0,52,144444.0,39000.0,-72.0,-71.0,-70.0,-61.0,-73.0,-72.0,-70.0,-61.0,-88.0,-90.0,-86.0,-88.0,16.0,19.0,16.0,27.0,1
3054,BA:8C:B9:54:50:24,3847916,490871323,4896,6189532,3843020,484681791,0,9433,1729708,9411,1726213,22,3495,2354,17,5380,41,0,66,216660.0,130000.0,-49.0,-35.0,-42.0,-46.0,-43.0,-35.0,-44.0,-48.0,-88.0,-90.0,-86.0,-88.0,39.0,55.0,44.0,42.0,1
3055,62:47:05:9D:EB:15,3845184,487117315,2161,2435262,3843023,484682053,0,4400,3019480,4368,3014361,32,5119,2071,0,2218,56,0,106,229410.0,130000.0,-43.0,-50.0,-39.0,-51.0,-46.0,-47.0,-39.0,-46.0,-89.0,-90.0,-87.0,-89.0,46.0,40.0,48.0,38.0,1
3056,3C:55:76:E8:8F:1F,3930267,702095506,87242,217413251,3843025,484682255,42,42475,8952770,41857,8842946,618,109824,17629,46,87319,9868,42,617,270830.0,162500.0,-45.0,-48.0,-52.0,-46.0,-44.0,-48.0,-51.0,-45.0,-89.0,-90.0,-87.0,-89.0,44.0,42.0,35.0,43.0,1
3057,92:69:1D:31:68:E9,3847040,488331588,4015,3649333,3843025,484682255,0,5193,1141692,5032,1105189,161,36503,2188,12,4255,102,0,56,229410.0,130000.0,-52.0,-49.0,-45.0,-49.0,-52.0,-48.0,-43.0,-46.0,-89.0,-90.0,-87.0,-89.0,37.0,41.0,42.0,40.0,1
3058,CC:2F:71:3F:1F:24,4900912,1677248879,1057887,1192566624,3843025,484682255,479,875568,969109701,874772,969013443,796,96258,846221,15,1057708,110032,476,677,130000.0,43333.0,-69.0,-71.0,-67.0,-73.0,-69.0,-71.0,-66.0,-73.0,-89.0,-90.0,-87.0,-89.0,20.0,19.0,20.0,16.0,1
3059,CC:2F:71:3E:C5:1F,3843974,484798154,949,115899,3843025,484682255,0,3974,333661,3279,251121,695,82540,1005,12,1368,26,0,52,144444.0,39000.0,-72.0,-71.0,-70.0,-61.0,-73.0,-72.0,-70.0,-61.0,-89.0,-90.0,-87.0,-89.0,17.0,19.0,17.0,28.0,1
3060,BA:8C:B9:54:50:24,3847921,490871787,4896,6189532,3843025,484682255,0,9433,1729708,9411,1726213,22,3495,2354,17,5380,41,0,66,216660.0,130000.0,-49.0,-35.0,-42.0,-46.0,-43.0,-35.0,-44.0,-48.0,-89.0,-90.0,-87.0,-89.0,40.0,55.0,45.0,43.0,1
3061,62:47:05:9D:EB:15,3845213,487128944,2161,2435262,3843052,484693682,0,4400,3019480,4368,3014361,32,5119,2071,0,2218,56,0,106,229410.0,130000.0,-43.0,-50.0,-39.0,-51.0,-46.0,-47.0,-39.0,-46.0,-89.0,-91.0,-87.0,-90.0,46.0,41.0,48.0,39.0,1
3062,3C:55:76:E8:8F:1F,3930539,702498964,87487,217805282,3843052,484693682,42,42725,9147666,42107,9037842,618,109824,17785,46,87564,9868,42,618,286760.0,172050.0,-50.0,-54.0,-49.0,-47.0,-50.0,-54.0,-49.0,-47.0,-89.0,-91.0,-87.0,-90.0,39.0,37.0,38.0,43.0,1
3063,92:69:1D:31:68:E9,3847067,488343015,4015,3649333,3843052,484693682,0,5196,1142063,5034,1105325,162,36738,2189,12,4255,102,0,56,229410.0,130000.0,-52.0,-48.0,-44.0,-46.0,-52.0,-48.0,-43.0,-47.0,-89.0,-91.0,-87.0,-90.0,37.0,43.0,43.0,44.0,1
3064,CC:2F:71:3F:1F:24,4901153,1677529622,1058101,1192835940,3843052,484693682,479,875755,969358285,874959,969262027,796,96258,846408,15,1057921,110107,476,677,104000.0,26000.0,-69.0,-72.0,-66.0,-75.0,-68.0,-72.0,-65.0,-74.0,-89.0,-91.0,-87.0,-90.0,20.0,19.0,21.0,15.0,1
3065,CC:2F:71:3E:C5:1F,3844001,484809581,949,115899,3843052,484693682,0,3974,333661,3279,251121,695,82540,1005,12,1368,26,0,52,144444.0,39000.0,-72.0,-71.0,-70.0,-61.0,-73.0,-72.0,-70.0,-61.0,-89.0,-91.0,-87.0,-90.0,17.0,20.0,17.0,29.0,1
3066,BA:8C:B9:54:50:24,3847948,490883214,4896,6189532,3843052,484693682,0,9433,1729708,9411,1726213,22,3495,2354,17,5380,41,0,66,216660.0,130000.0,-49.0,-35.0,-42.0,-46.0,-43.0,-35.0,-44.0,-48.0,-89.0,-91.0,-87.0,-90.0,40.0,56.0,45.0,44.0,1
3067,62:47:05:9D:EB:15,3845218,487129408,2161,2435262,3843057,484694146,0,4400,3019480,4368,3014361,32,5119,2071,0,2218,56,0,106,229410.0,130000.0,-43.0,-50.0,-39.0,-51.0,-46.0,-47.0,-39.0,-46.0,-89.0,-91.0,-87.0,-90.0,46.0,41.0,48.0,39.0,1
3068,3C:55:76:E8:8F:1F,3930629,702594083,87572,217899937,3843057,484694146,42,42811,9188176,42193,9078352,618,109824,17838,46,87649,9868,42,618,286760.0,172050.0,-51.0,-55.0,-49.0,-47.0,-49.0,-54.0,-48.0,-45.0,-89.0,-91.0,-87.0,-90.0,38.0,36.0,38.0,43.0,1
3069,92:69:1D:31:68:E9,3847072,488343479,4015,3649333,3843057,484694146,0,5196,1142063,5034,1105325,162,36738,2189,12,4255,102,0,56,229410.0,130000.0,-52.0,-48.0,-44.0,-46.0,-52.0,-48.0,-43.0,-47.0,-89.0,-91.0,-87.0,-90.0,37.0,43.0,43.0,44.0,1
3070,CC:2F:71:3F:1F:24,4901366,1677792750,1058309,1193098604,3843057,484694146,479,875940,969603777,875144,969507519,796,96258,846593,15,1058130,110163,476,677,65000.0,13000.0,-69.0,-72.0,-65.0,-74.0,-69.0,-72.0,-65.0,-74.0,-89.0,-91.0,-87.0,-90.0,20.0,19.0,22.0,16.0,1
3071,CC:2F:71:3E:C5:1F,3844008,484810247,949,115899,3843059,484694348,0,3974,333661,3279,251121,695,82540,1005,12,1368,26,0,52,144444.0,39000.0,-72.0,-71.0,-70.0,-61.0,-73.0,-72.0,-70.0,-61.0,-89.0,-91.0,-87.0,-90.0,17.0,20.0,17.0,29.0,1
3072,BA:8C:B9:54:50:24,3847955,490883880,4896,6189532,3843059,484694348,0,9433,1729708,9411,1726213,22,3495,2354,17,5380,41,0,66,216660.0,130000.0,-49.0,-35.0,-42.0,-46.0,-43.0,-35.0,-44.0,-48.0,-89.0,-91.0,-87.0,-90.0,40.0,56.0,45.0,44.0,1
3073,62:47:05:9D:EB:15,3845225,487130463,2161,2435262,3843064,484695201,0,4400,3019480,4368,3014361,32,5119,2071,0,2218,56,0,106,229410.0,130000.0,-43.0,-50.0,-39.0,-51.0,-46.0,-47.0,-39.0,-46.0,-89.0,-91.0,-87.0,-90.0,46.0,41.0,48.0,39.0,1
3074,3C:55:76:E8:8F:1F,3930704,702630983,87640,217935782,3843064,484695201,42,42977,9354638,42357,9244324,620,110314,17927,46,87717,9868,42,618,286760.0,172050.0,-51.0,-55.0,-49.0,-47.0,-48.0,-54.0,-48.0,-43.0,-89.0,-91.0,-87.0,-90.0,38.0,36.0,38.0,43.0,1
3075,92:69:1D:31:68:E9,3847079,488344534,4015,3649333,3843064,484695201,0,5196,1142063,5034,1105325,162,36738,2189,12,4255,102,0,56,229410.0,130000.0,-52.0,-48.0,-44.0,-46.0,-52.0,-48.0,-43.0,-47.0,-89.0,-91.0,-87.0,-90.0,37.0,43.0,43.0,44.0,1
3076,CC:2F:71:3F:1F:24,4901582,1678053077,1058516,1193357674,3843066,484695403,479,876123,969846189,875327,969749931,796,96258,846776,15,1058337,110165,476,677,86667.0,13000.0,-69.0,-72.0,-66.0,-75.0,-69.0,-71.0,-65.0,-74.0,-89.0,-92.0,-88.0,-91.0,20.0,20.0,22.0,16.0,1
3077,CC:2F:71:3E:C5:1F,3844015,484811302,949,115899,3843066,484695403,0,3974,333661,3279,251121,695,82540,1005,12,1368,26,0,52,144444.0,39000.0,-72.0,-71.0,-70.0,-61.0,-73.0,-72.0,-70.0,-61.0,-89.0,-92.0,-88.0,-91.0,17.0,21.0,18.0,30.0,1
3078,BA:8C:B9:54:50:24,3847962,490884935,4896,6189532,3843066,484695403,0,9433,1729708,9411,1726213,22,3495,2354,17,5380,41,0,66,216660.0,130000.0,-49.0,-35.0,-42.0,-46.0,-43.0,-35.0,-44.0,-48.0,-89.0,-92.0,-88.0,-91.0,40.0,57.0,46.0,45.0,1
3079,62:47:05:9D:EB:15,3845231,487131245,2161,2435262,3843070,484695983,0,4400,3019480,4368,3014361,32,5119,2071,0,2218,56,0,106,229410.0,130000.0,-43.0,-50.0,-39.0,-51.0,-46.0,-47.0,-39.0,-46.0,-89.0,-92.0,-88.0,-91.0,46.0,42.0,49.0,40.0,1
3080,3C:55:76:E8:8F:1F,3930880,703041613,87807,218345368,3843073,484696245,42,43060,9385077,42439,9274528,621,110549,17971,46,87884,9869,42,618,286760.0,172050.0,-50.0,-55.0,-50.0,-47.0,-49.0,-54.0,-49.0,-45.0,-89.0,-92.0,-88.0,-91.0,39.0,37.0,38.0,44.0,1
3081,92:69:1D:31:68:E9,3847088,488345578,4015,3649333,3843073,484696245,0,5196,1142063,5034,1105325,162,36738,2189,12,4255,102,0,56,229410.0,130000.0,-52.0,-48.0,-44.0,-46.0,-52.0,-48.0,-43.0,-47.0,-89.0,-92.0,-88.0,-91.0,37.0,44.0,44.0,45.0,1
3082,CC:2F:71:3F:1F:24,4901860,1678355400,1058785,1193658953,3843075,484696447,479,876353,970105821,875557,970009563,796,96258,847004,15,1058605,110166,476,677,86667.0,14444.0,-70.0,-72.0,-67.0,-75.0,-69.0,-72.0,-66.0,-75.0,-89.0,-92.0,-88.0,-91.0,19.0,20.0,21.0,16.0,1
3083,CC:2F:71:3E:C5:1F,3844024,484812346,949,115899,3843075,484696447,0,3974,333661,3279,251121,695,82540,1005,12,1368,26,0,52,144444.0,39000.0,-72.0,-71.0,-70.0,-61.0,-73.0,-72.0,-70.0,-61.0,-89.0,-92.0,-88.0,-91.0,17.0,21.0,18.0,30.0,1
3084,BA:8C:B9:54:50:24,3847971,490885979,4896,6189532,3843075,484696447,0,9433,1729708,9411,1726213,22,3495,2354,17,5380,41,0,66,216660.0,130000.0,-49.0,-35.0,-42.0,-46.0,-43.0,-35.0,-44.0,-48.0,-90.0,-92.0,-89.0,-91.0,41.0,57.0,47.0,45.0,1
3085,62:47:05:9D:EB:15,3845238,487131911,2161,2435262,3843077,484696649,0,4400,3019480,4368,3014361,32,5119,2071,0,2218,56,0,106,229410.0,130000.0,-43.0,-50.0,-39.0,-51.0,-46.0,-47.0,-39.0,-46.0,-90.0,-92.0,-89.0,-91.0,47.0,42.0,50.0,40.0,1
3086,3C:55:76:E8:8F:1F,3930955,703084865,87878,218388216,3843077,484696649,42,43195,9492952,42574,9382403,621,110549,18037,46,87955,9869,42,618,286760.0,162500.0,-47.0,-54.0,-48.0,-41.0,-46.0,-53.0,-48.0,-41.0,-90.0,-92.0,-89.0,-91.0,43.0,38.0,41.0,50.0,1
3087,92:69:1D:31:68:E9,3847096,488346758,4015,3649333,3843081,484697425,0,5196,1142063,5034,1105325,162,36738,2189,12,4255,102,0,56,229410.0,130000.0,-52.0,-48.0,-44.0,-46.0,-52.0,-48.0,-43.0,-47.0,-90.0,-92.0,-89.0,-91.0,38.0,44.0,45.0,45.0,1
3088,CC:2F:71:3F:1F:24,4902081,1678623354,1059000,1193925929,3843081,484697425,479,876547,970358043,875751,970261785,796,96258,847198,15,1058821,110221,476,677,86667.0,13000.0,-69.0,-72.0,-67.0,-75.0,-69.0,-71.0,-66.0,-74.0,-90.0,-92.0,-89.0,-91.0,21.0,20.0,22.0,16.0,1
3089,CC:2F:71:3E:C5:1F,3844030,484813324,949,115899,3843081,484697425,0,3974,333661,3279,251121,695,82540,1005,12,1368,26,0,52,144444.0,39000.0,-72.0,-71.0,-70.0,-61.0,-73.0,-72.0,-70.0,-61.0,-90.0,-92.0,-89.0,-91.0,18.0,21.0,19.0,30.0,1
3090,BA:8C:B9:54:50:24,3847979,490887159,4896,6189532,3843083,484697627,0,9433,1729708,9411,1726213,22,3495,2354,17,5380,41,0,66,216660.0,130000.0,-49.0,-35.0,-42.0,-46.0,-43.0,-35.0,-44.0,-48.0,-90.0,-92.0,-89.0,-91.0,41.0,57.0,47.0,45.0,1
3091,62:47:05:9D:EB:15,3845248,487133293,2161,2435262,3843087,484698031,0,4400,3019480,4368,3014361,32,5119,2071,0,2218,56,0,106,229410.0,130000.0,-43.0,-50.0,-39.0,-51.0,-46.0,-47.0,-39.0,-46.0,-90.0,-93.0,-89.0,-92.0,47.0,43.0,50.0,41.0,1
3092,3C:55:76:E8:8F:1F,3931037,703190346,87950,218492315,3843087,484698031,42,43299,9564318,42676,9453249,623,111069,18091,46,88027,9869,42,618,286760.0,172050.0,-50.0,-55.0,-50.0,-46.0,-50.0,-55.0,-50.0,-46.0,-90.0,-93.0,-89.0,-92.0,40.0,38.0,39.0,46.0,1
3093,92:69:1D:31:68:E9,3847102,488347364,4015,3649333,3843087,484698031,0,5196,1142063,5034,1105325,162,36738,2189,12,4255,102,0,56,229410.0,130000.0,-52.0,-48.0,-44.0,-46.0,-52.0,-48.0,-43.0,-47.0,-90.0,-93.0,-89.0,-92.0,38.0,45.0,45.0,46.0,1
3094,CC:2F:71:3F:1F:24,4902299,1678889544,1059212,1194191513,3843087,484698031,479,876735,970608169,875939,970511911,796,96258,847385,15,1059033,110222,476,677,86667.0,14444.0,-69.0,-71.0,-66.0,-74.0,-69.0,-71.0,-65.0,-74.0,-90.0,-93.0,-89.0,-92.0,21.0,22.0,23.0,18.0,1
3095,CC:2F:71:3E:C5:1F,3844038,484814338,949,115899,3843089,484698439,0,3974,333661,3279,251121,695,82540,1005,12,1368,26,0,52,144444.0,39000.0,-72.0,-71.0,-70.0,-61.0,-73.0,-72.0,-70.0,-61.0,-90.0,-93.0,-89.0,-92.0,18.0,22.0,19.0,31.0,1
3096,BA:8C:B9:54:50:24,3847986,490888031,4896,6189532,3843090,484698499,0,9433,1729708,9411,1726213,22,3495,2354,17,5380,41,0,66,216660.0,130000.0,-49.0,-35.0,-42.0,-46.0,-43.0,-35.0,-44.0,-48.0,-90.0,-93.0,-89.0,-92.0,41.0,58.0,47.0,46.0,1
3097,62:47:05:9D:EB:15,3845253,487133963,2161,2435262,3843092,484698701,0,4400,3019480,4368,3014361,32,5119,2071,0,2218,56,0,106,229410.0,130000.0,-43.0,-50.0,-39.0,-51.0,-46.0,-47.0,-39.0,-46.0,-90.0,-93.0,-90.0,-93.0,47.0,43.0,51.0,42.0,1
3098,3C:55:76:E8:8F:1F,3931670,704811301,88578,220112600,3843092,484698701,42,43629,9704831,43004,9593242,625,111589,18279,46,88655,9874,42,619,286760.0,172050.0,-51.0,-56.0,-50.0,-46.0,-50.0,-55.0,-49.0,-45.0,-90.0,-93.0,-90.0,-93.0,39.0,37.0,40.0,47.0,1
3099,92:69:1D:31:68:E9,3847107,488348034,4015,3649333,3843092,484698701,0,5196,1142063,5034,1105325,162,36738,2189,12,4255,102,0,56,229410.0,130000.0,-52.0,-48.0,-44.0,-46.0,-52.0,-48.0,-43.0,-47.0,-90.0,-93.0,-90.0,-93.0,38.0,45.0,46.0,47.0,1
3100,CC:2F:71:3F:1F:24,4902523,1679156253,1059429,1194457350,3843094,484698903,479,876931,970855428,876135,970759170,796,96258,847581,15,1059250,110242,476,677,115556.0,28889.0,-69.0,-71.0,-66.0,-73.0,-69.0,-71.0,-66.0,-73.0,-90.0,-93.0,-90.0,-93.0,21.0,22.0,24.0,20.0,1
3101,CC:2F:71:3E:C5:1F,3844043,484814802,949,115899,3843094,484698903,0,3974,333661,3279,251121,695,82540,1005,12,1368,26,0,52,144444.0,39000.0,-72.0,-71.0,-70.0,-61.0,-73.0,-72.0,-70.0,-61.0,-90.0,-93.0,-90.0,-93.0,18.0,22.0,20.0,32.0,1
3102,BA:8C:B9:54:50:24,3847992,490888813,4896,6189532,3843096,484699281,0,9433,1729708,9411,1726213,22,3495,2354,17,5380,41,0,66,216660.0,130000.0,-49.0,-35.0,-42.0,-46.0,-43.0,-35.0,-44.0,-48.0,-90.0,-93.0,-90.0,-93.0,41.0,58.0,48.0,47.0,1
3103,62:47:05:9D:EB:15,3845261,487134947,2161,2435262,3843100,484699685,0,4400,3019480,4368,3014361,32,5119,2071,0,2218,56,0,106,229410.0,130000.0,-43.0,-50.0,-39.0,-51.0,-46.0,-47.0,-39.0,-46.0,-90.0,-92.0,-89.0,-93.0,47.0,42.0,50.0,42.0,1
3104,3C:55:76:E8:8F:1F,3932036,705858192,88936,221158507,3843100,484699685,42,43749,9742856,43122,9630777,627,112079,18339,46,89013,9889,42,623,286760.0,172050.0,-47.0,-52.0,-47.0,-43.0,-47.0,-52.0,-47.0,-43.0,-90.0,-92.0,-89.0,-93.0,43.0,40.0,42.0,50.0,1
3105,92:69:1D:31:68:E9,3847115,488349018,4015,3649333,3843100,484699685,0,5196,1142063,5034,1105325,162,36738,2189,12,4255,102,0,56,229410.0,130000.0,-52.0,-48.0,-44.0,-46.0,-52.0,-48.0,-43.0,-47.0,-90.0,-92.0,-89.0,-93.0,38.0,44.0,45.0,47.0,1
3106,CC:2F:71:3F:1F:24,4902749,1679432539,1059649,1194732854,3843100,484699685,479,877126,971114910,876330,971018652,796,96258,847775,15,1059470,110288,476,677,65000.0,13000.0,-73.0,-75.0,-70.0,-78.0,-72.0,-74.0,-69.0,-77.0,-90.0,-92.0,-89.0,-93.0,17.0,17.0,19.0,15.0,1
3107,CC:2F:71:3E:C5:1F,3844049,484815584,949,115899,3843100,484699685,0,3974,333661,3279,251121,695,82540,1005,12,1368,26,0,52,144444.0,39000.0,-72.0,-71.0,-70.0,-61.0,-73.0,-72.0,-70.0,-61.0,-90.0,-92.0,-89.0,-93.0,18.0,21.0,19.0,32.0,1
3108,BA:8C:B9:54:50:24,3847996,490889217,4896,6189532,3843100,484699685,0,9433,1729708,9411,1726213,22,3495,2354,17,5380,41,0,66,216660.0,130000.0,-49.0,-35.0,-42.0,-46.0,-43.0,-35.0,-44.0,-48.0,-90.0,-92.0,-89.0,-93.0,41.0,57.0,47.0,47.0,1
3109,62:47:05:9D:EB:15,3845268,487135789,2161,2435262,3843107,484700527,0,4400,3019480,4368,3014361,32,5119,2071,0,2218,56,0,106,229410.0,130000.0,-43.0,-50.0,-39.0,-51.0,-46.0,-47.0,-39.0,-46.0,-90.0,-92.0,-89.0,-93.0,47.0,42.0,50.0,42.0,1
3110,3C:55:76:E8:8F:1F,3932198,706251833,89091,221551306,3843107,484700527,42,43810,9755690,43181,9643121,629,112569,18374,46,89169,9904,42,623,286760.0,172050.0,-47.0,-56.0,-48.0,-45.0,-47.0,-55.0,-49.0,-45.0,-90.0,-92.0,-89.0,-93.0,43.0,36.0,41.0,48.0,1
3111,92:69:1D:31:68:E9,3847122,488349860,4015,3649333,3843107,484700527,0,5196,1142063,5034,1105325,162,36738,2189,12,4255,102,0,56,229410.0,130000.0,-52.0,-48.0,-44.0,-46.0,-52.0,-48.0,-43.0,-47.0,-90.0,-92.0,-89.0,-93.0,38.0,44.0,45.0,47.0,1
3112,CC:2F:71:3F:1F:24,4902967,1679695915,1059860,1194995388,3843107,484700527,479,877312,971361956,876516,971265698,796,96258,847960,15,1059680,110288,476,677,86667.0,14444.0,-73.0,-75.0,-70.0,-78.0,-72.0,-74.0,-70.0,-77.0,-90.0,-92.0,-89.0,-93.0,17.0,17.0,19.0,15.0,1
3113,CC:2F:71:3E:C5:1F,3844056,484816426,949,115899,3843107,484700527,0,3974,333661,3279,251121,695,82540,1005,12,1368,26,0,52,144444.0,39000.0,-72.0,-71.0,-70.0,-61.0,-73.0,-72.0,-70.0,-61.0,-90.0,-92.0,-89.0,-93.0,18.0,21.0,19.0,32.0,1
3114,BA:8C:B9:54:50:24,3848003,490890059,4896,6189532,3843107,484700527,0,9433,1729708,9411,1726213,22,3495,2354,17,5380,41,0,66,216660.0,130000.0,-49.0,-35.0,-42.0,-46.0,-43.0,-35.0,-44.0,-48.0,-90.0,-92.0,-89.0,-93.0,41.0,57.0,47.0,47.0,1
3115,62:47:05:9D:EB:15,3845272,487136193,2161,2435262,3843111,484700931,0,4400,3019480,4368,3014361,32,5119,2071,0,2218,56,0,106,229410.0,130000.0,-43.0,-50.0,-39.0,-51.0,-46.0,-47.0,-39.0,-46.0,-90.0,-92.0,-89.0,-93.0,47.0,42.0,50.0,42.0,1
3116,3C:55:76:E8:8F:1F,3932351,706680816,89240,221979885,3843111,484700931,42,43870,9771232,43241,9658663,629,112569,18402,46,89292,9904,42,623,286760.0,172050.0,-47.0,-55.0,-50.0,-45.0,-49.0,-55.0,-50.0,-45.0,-90.0,-92.0,-89.0,-93.0,43.0,37.0,39.0,48.0,1
3117,92:69:1D:31:68:E9,3847126,488350264,4015,3649333,3843111,484700931,0,5196,1142063,5034,1105325,162,36738,2189,12,4255,102,0,56,229410.0,130000.0,-52.0,-48.0,-44.0,-46.0,-52.0,-48.0,-43.0,-47.0,-90.0,-92.0,-89.0,-93.0,38.0,44.0,45.0,47.0,1
3118,CC:2F:71:3F:1F:24,4903184,1679959111,1060071,1195257978,3843113,484701133,479,877497,971607448,876701,971511190,796,96258,848145,15,1059892,110293,476,677,115556.0,28889.0,-72.0,-75.0,-70.0,-77.0,-72.0,-74.0,-70.0,-77.0,-90.0,-92.0,-89.0,-93.0,18.0,17.0,19.0,16.0,1
3119,CC:2F:71:3E:C5:1F,3844062,484817032,949,115899,3843113,484701133,0,3974,333661,3279,251121,695,82540,1005,12,1368,26,0,52,144444.0,39000.0,-72.0,-71.0,-70.0,-61.0,-73.0,-72.0,-70.0,-61.0,-90.0,-92.0,-89.0,-93.0,18.0,21.0,19.0,32.0,1
3120,BA:8C:B9:54:50:24,3848009,490890665,4896,6189532,3843113,484701133,0,9433,1729708,9411,1726213,22,3495,2354,17,5380,41,0,66,216660.0,130000.0,-49.0,-35.0,-42.0,-46.0,-43.0,-35.0,-44.0,-48.0,-90.0,-92.0,-89.0,-93.0,41.0,57.0,47.0,47.0,1
3121,62:47:05:9D:EB:15,3845277,487136657,2161,2435262,3843116,484701395,0,4401,3019548,4369,3014429,32,5119,2071,0,2218,56,0,106,229410.0,130000.0,-47.0,-46.0,-39.0,-45.0,-46.0,-47.0,-39.0,-46.0,-90.0,-92.0,-89.0,-93.0,43.0,46.0,50.0,48.0,1
3122,3C:55:76:E8:8F:1F,3932473,707001481,89357,222300086,3843116,484701395,43,43936,9796720,43307,9684151,629,112569,18429,46,89436,9910,43,626,286760.0,172050.0,-48.0,-55.0,-49.0,-45.0,-47.0,-54.0,-48.0,-44.0,-90.0,-92.0,-89.0,-93.0,42.0,37.0,40.0,48.0,1
3123,92:69:1D:31:68:E9,3847135,488351132,4015,3649333,3843120,484701799,0,5196,1142063,5034,1105325,162,36738,2189,12,4255,102,0,56,229410.0,130000.0,-52.0,-48.0,-44.0,-46.0,-52.0,-48.0,-43.0,-47.0,-90.0,-92.0,-89.0,-93.0,38.0,44.0,45.0,47.0,1
3124,CC:2F:71:3F:1F:24,4903405,1680221456,1060285,1195519657,3843120,484701799,479,877686,971848199,876890,971751941,796,96258,848334,15,1060106,110304,476,677,115556.0,28889.0,-68.0,-71.0,-66.0,-73.0,-68.0,-71.0,-65.0,-73.0,-90.0,-92.0,-89.0,-93.0,22.0,21.0,23.0,20.0,1
3125,CC:2F:71:3E:C5:1F,3844069,484817698,949,115899,3843120,484701799,0,3974,333661,3279,251121,695,82540,1005,12,1368,26,0,52,144444.0,39000.0,-72.0,-71.0,-70.0,-61.0,-73.0,-72.0,-70.0,-61.0,-90.0,-93.0,-89.0,-93.0,18.0,22.0,19.0,32.0,1
3126,BA:8C:B9:54:50:24,3848016,490891331,4896,6189532,3843120,484701799,0,9433,1729708,9411,1726213,22,3495,2354,17,5380,41,0,66,216660.0,130000.0,-49.0,-35.0,-42.0,-46.0,-43.0,-35.0,-44.0,-48.0,-90.0,-93.0,-89.0,-93.0,41.0,58.0,47.0,47.0,1
3127,62:47:05:9D:EB:15,3845285,487137385,2162,2435322,3843123,484702063,0,4402,3019616,4370,3014497,32,5119,2071,0,2219,56,0,106,229410.0,130000.0,-47.0,-46.0,-39.0,-46.0,-46.0,-47.0,-39.0,-46.0,-90.0,-93.0,-89.0,-93.0,43.0,47.0,50.0,47.0,1
3128,3C:55:76:E8:8F:1F,3932896,708183260,89773,223481197,3843123,484702063,43,44155,9894833,43525,9782146,630,112687,18516,46,89852,9917,43,626,286760.0,172050.0,-47.0,-55.0,-50.0,-45.0,-49.0,-54.0,-49.0,-45.0,-90.0,-93.0,-89.0,-93.0,43.0,38.0,39.0,48.0,1
3129,92:69:1D:31:68:E9,3847139,488351512,4016,3649449,3843123,484702063,0,5198,1142199,5036,1105461,162,36738,2189,12,4256,102,0,56,229410.0,130000.0,-52.0,-49.0,-44.0,-47.0,-52.0,-48.0,-43.0,-47.0,-90.0,-93.0,-89.0,-93.0,38.0,44.0,45.0,46.0,1
3130,CC:2F:71:3F:1F:24,4903617,1680483468,1060494,1195781405,3843123,484702063,479,877871,972093691,877075,971997433,796,96258,848519,15,1060315,110312,476,677,115556.0,28889.0,-69.0,-71.0,-66.0,-73.0,-68.0,-70.0,-65.0,-73.0,-90.0,-93.0,-89.0,-93.0,21.0,22.0,23.0,20.0,1
3131,CC:2F:71:3E:C5:1F,3844077,484818739,954,116676,3843123,484702063,0,3980,334476,3285,251936,695,82540,1010,12,1373,26,0,52,144444.0,43333.0,-73.0,-72.0,-69.0,-60.0,-72.0,-71.0,-69.0,-60.0,-90.0,-93.0,-89.0,-93.0,17.0,21.0,20.0,33.0,1
3132,BA:8C:B9:54:50:24,3848020,490891711,4897,6189648,3843123,484702063,0,9435,1729844,9413,1726349,22,3495,2354,17,5381,41,0,66,216660.0,130000.0,-48.0,-35.0,-42.0,-46.0,-45.0,-35.0,-43.0,-47.0,-90.0,-93.0,-89.0,-93.0,42.0,58.0,47.0,47.0,1
3133,62:47:05:9D:EB:15,3845291,487137991,2162,2435322,3843129,484702669,0,4403,3019684,4371,3014565,32,5119,2071,0,2219,56,0,106,229410.0,130000.0,-47.0,-46.0,-39.0,-46.0,-46.0,-47.0,-39.0,-46.0,-90.0,-93.0,-89.0,-93.0,43.0,47.0,50.0,47.0,1
3134,3C:55:76:E8:8F:1F,3933826,711006458,90697,226303789,3843129,484702669,43,44375,9932006,43745,9819319,630,112687,18624,46,90803,9930,43,626,286760.0,172050.0,-50.0,-56.0,-51.0,-45.0,-50.0,-56.0,-51.0,-45.0,-90.0,-93.0,-89.0,-93.0,40.0,37.0,38.0,48.0,1
3135,92:69:1D:31:68:E9,3847145,488352118,4016,3649449,3843129,484702669,0,5198,1142199,5036,1105461,162,36738,2189,12,4256,102,0,56,229410.0,130000.0,-52.0,-49.0,-44.0,-47.0,-52.0,-48.0,-43.0,-47.0,-90.0,-93.0,-89.0,-93.0,38.0,44.0,45.0,46.0,1
3136,CC:2F:71:3F:1F:24,4903835,1680751602,1060706,1196048933,3843129,484702669,479,878059,972342461,877263,972246203,796,96258,848707,15,1060527,110330,476,677,115556.0,28889.0,-68.0,-71.0,-66.0,-73.0,-68.0,-70.0,-66.0,-72.0,-90.0,-93.0,-89.0,-93.0,22.0,22.0,23.0,20.0,1
3137,CC:2F:71:3E:C5:1F,3844084,484819405,954,116676,3843130,484702729,0,3980,334476,3285,251936,695,82540,1010,12,1373,26,0,52,144444.0,43333.0,-73.0,-72.0,-69.0,-60.0,-72.0,-71.0,-69.0,-60.0,-90.0,-93.0,-89.0,-93.0,17.0,21.0,20.0,33.0,1
3138,BA:8C:B9:54:50:24,3848027,490892377,4897,6189648,3843130,484702729,0,9435,1729844,9413,1726349,22,3495,2354,17,5381,41,0,66,216660.0,130000.0,-48.0,-35.0,-42.0,-46.0,-45.0,-35.0,-43.0,-47.0,-90.0,-93.0,-89.0,-93.0,42.0,58.0,47.0,47.0,1
3139,62:47:05:9D:EB:15,3845294,487138253,2162,2435322,3843132,484702931,0,4403,3019684,4371,3014565,32,5119,2071,0,2219,56,0,106,229410.0,130000.0,-47.0,-46.0,-39.0,-46.0,-46.0,-47.0,-39.0,-46.0,-90.0,-93.0,-89.0,-93.0,43.0,47.0,50.0,47.0,1
3140,3C:55:76:E8:8F:1F,3934054,711622126,90921,226918922,3843133,484703204,43,44468,9950540,43838,9837853,630,112687,18669,46,91033,9930,43,626,270830.0,162500.0,-48.0,-56.0,-49.0,-45.0,-47.0,-55.0,-49.0,-45.0,-90.0,-93.0,-89.0,-93.0,42.0,37.0,40.0,48.0,1
3141,92:69:1D:31:68:E9,3847149,488352653,4016,3649449,3843133,484703204,0,5198,1142199,5036,1105461,162,36738,2189,12,4256,102,0,56,229410.0,130000.0,-52.0,-49.0,-44.0,-47.0,-52.0,-48.0,-43.0,-47.0,-90.0,-93.0,-89.0,-93.0,38.0,44.0,45.0,46.0,1
3142,CC:2F:71:3F:1F:24,4904066,1681030216,1060931,1196326810,3843135,484703406,479,878263,972602339,877467,972506081,796,96258,848911,15,1060752,110368,476,677,86667.0,14444.0,-69.0,-71.0,-67.0,-73.0,-69.0,-71.0,-66.0,-73.0,-90.0,-93.0,-89.0,-93.0,21.0,22.0,22.0,20.0,1
3143,CC:2F:71:3E:C5:1F,3844089,484820082,954,116676,3843135,484703406,0,3980,334476,3285,251936,695,82540,1010,12,1373,26,0,52,144444.0,43333.0,-73.0,-72.0,-69.0,-60.0,-72.0,-71.0,-69.0,-60.0,-90.0,-93.0,-89.0,-93.0,17.0,21.0,20.0,33.0,1
3144,BA:8C:B9:54:50:24,3848032,490893054,4897,6189648,3843135,484703406,0,9436,1729912,9414,1726417,22,3495,2354,17,5381,41,0,66,216660.0,130000.0,-40.0,-37.0,-46.0,-52.0,-44.0,-35.0,-44.0,-48.0,-90.0,-93.0,-89.0,-93.0,50.0,56.0,43.0,41.0,1
3145,62:47:05:9D:EB:15,3845301,487139132,2162,2435322,3843139,484703810,0,4403,3019684,4371,3014565,32,5119,2071,0,2219,56,0,106,229410.0,130000.0,-47.0,-46.0,-39.0,-46.0,-46.0,-47.0,-39.0,-46.0,-90.0,-92.0,-89.0,-92.0,43.0,46.0,50.0,46.0,1
3146,3C:55:76:E8:8F:1F,3934088,711643263,90949,226939453,3843139,484703810,43,44517,9969387,43887,9856700,630,112687,18702,46,91061,9930,43,626,286760.0,172050.0,-50.0,-55.0,-51.0,-46.0,-49.0,-55.0,-50.0,-45.0,-90.0,-92.0,-89.0,-92.0,40.0,37.0,38.0,46.0,1
3147,92:69:1D:31:68:E9,3847155,488353259,4016,3649449,3843139,484703810,0,5198,1142199,5036,1105461,162,36738,2189,12,4256,102,0,56,229410.0,130000.0,-52.0,-49.0,-44.0,-47.0,-52.0,-48.0,-43.0,-47.0,-90.0,-92.0,-89.0,-92.0,38.0,43.0,45.0,45.0,1
3148,CC:2F:71:3F:1F:24,4904279,1681290062,1061140,1196586252,3843139,484703810,479,878449,972846537,877653,972750279,796,96258,849096,15,1060961,110368,476,677,86667.0,14444.0,-69.0,-71.0,-67.0,-73.0,-69.0,-71.0,-66.0,-73.0,-90.0,-92.0,-89.0,-92.0,21.0,21.0,22.0,19.0,1
3149,CC:2F:71:3E:C5:1F,3844093,484820486,954,116676,3843139,484703810,0,3980,334476,3285,251936,695,82540,1010,12,1373,26,0,52,144444.0,43333.0,-73.0,-72.0,-69.0,-60.0,-72.0,-71.0,-69.0,-60.0,-90.0,-92.0,-89.0,-92.0,17.0,20.0,20.0,32.0,1
3150,BA:8C:B9:54:50:24,3848036,490893458,4897,6189648,3843139,484703810,0,9436,1729912,9414,1726417,22,3495,2354,17,5381,41,0,66,216660.0,130000.0,-40.0,-37.0,-46.0,-52.0,-44.0,-35.0,-44.0,-48.0,-90.0,-92.0,-89.0,-92.0,50.0,55.0,43.0,40.0,1
3151,62:47:05:9D:EB:15,3845306,487139596,2162,2435322,3843144,484704274,0,4403,3019684,4371,3014565,32,5119,2071,0,2219,56,0,106,229410.0,130000.0,-47.0,-46.0,-39.0,-46.0,-46.0,-47.0,-39.0,-46.0,-90.0,-92.0,-89.0,-92.0,43.0,46.0,50.0,46.0,1
3152,3C:55:76:E8:8F:1F,3934245,712039157,91101,227334883,3843144,484704274,43,44568,9977629,43938,9864942,630,112687,18730,46,91213,9930,43,626,286760.0,172050.0,-48.0,-55.0,-47.0,-45.0,-48.0,-54.0,-47.0,-45.0,-90.0,-92.0,-89.0,-92.0,42.0,37.0,42.0,47.0,1
3153,92:69:1D:31:68:E9,3847160,488353723,4016,3649449,3843144,484704274,0,5198,1142199,5036,1105461,162,36738,2189,12,4256,102,0,56,229410.0,130000.0,-52.0,-49.0,-44.0,-47.0,-52.0,-48.0,-43.0,-47.0,-90.0,-92.0,-89.0,-92.0,38.0,43.0,45.0,45.0,1
3154,CC:2F:71:3F:1F:24,4904494,1681552874,1061350,1196848600,3843144,484704274,479,878636,973092261,877840,972996003,796,96258,849283,15,1061170,110382,476,677,115556.0,28889.0,-69.0,-72.0,-66.0,-73.0,-69.0,-71.0,-66.0,-73.0,-90.0,-92.0,-89.0,-92.0,21.0,20.0,23.0,19.0,1
3155,CC:2F:71:3E:C5:1F,3844098,484820950,954,116676,3843144,484704274,0,3980,334476,3285,251936,695,82540,1010,12,1373,26,0,52,144444.0,43333.0,-73.0,-72.0,-69.0,-60.0,-72.0,-71.0,-69.0,-60.0,-90.0,-92.0,-89.0,-92.0,17.0,20.0,20.0,32.0,1
3156,BA:8C:B9:54:50:24,3848043,490894124,4897,6189648,3843146,484704476,0,9436,1729912,9414,1726417,22,3495,2354,17,5381,41,0,66,216660.0,130000.0,-40.0,-37.0,-46.0,-52.0,-44.0,-35.0,-44.0,-48.0,-90.0,-92.0,-89.0,-92.0,50.0,55.0,43.0,40.0,1
3157,62:47:05:9D:EB:15,3845311,487140062,2162,2435322,3843149,484704740,0,4403,3019684,4371,3014565,32,5119,2071,0,2219,56,0,106,229410.0,130000.0,-47.0,-46.0,-39.0,-46.0,-46.0,-47.0,-39.0,-46.0,-90.0,-92.0,-89.0,-92.0,43.0,46.0,50.0,46.0,1
3158,3C:55:76:E8:8F:1F,3934255,712040486,91106,227335746,3843149,484704740,43,44584,9978947,43954,9866260,630,112687,18734,46,91218,9930,43,626,286760.0,172050.0,-48.0,-56.0,-48.0,-45.0,-48.0,-55.0,-48.0,-44.0,-89.0,-92.0,-89.0,-92.0,41.0,36.0,41.0,47.0,1
3159,92:69:1D:31:68:E9,3847165,488354189,4016,3649449,3843149,484704740,0,5198,1142199,5036,1105461,162,36738,2189,12,4256,102,0,56,229410.0,130000.0,-52.0,-49.0,-44.0,-47.0,-52.0,-48.0,-43.0,-47.0,-89.0,-92.0,-89.0,-92.0,37.0,43.0,45.0,45.0,1
3160,CC:2F:71:3F:1F:24,4904710,1681813640,1061559,1197108698,3843151,484704942,479,878821,973336373,878024,973239997,797,96376,849467,15,1061380,110398,476,678,115556.0,28889.0,-68.0,-70.0,-66.0,-72.0,-68.0,-70.0,-65.0,-72.0,-89.0,-92.0,-89.0,-92.0,21.0,22.0,23.0,20.0,1
3161,CC:2F:71:3E:C5:1F,3844105,484821618,954,116676,3843151,484704942,0,3980,334476,3285,251936,695,82540,1010,12,1373,26,0,52,144444.0,43333.0,-73.0,-72.0,-69.0,-60.0,-72.0,-71.0,-69.0,-60.0,-89.0,-92.0,-89.0,-92.0,16.0,20.0,20.0,32.0,1
3162,BA:8C:B9:54:50:24,3848048,490894590,4897,6189648,3843151,484704942,0,9436,1729912,9414,1726417,22,3495,2354,17,5381,41,0,66,216660.0,130000.0,-40.0,-37.0,-46.0,-52.0,-44.0,-35.0,-44.0,-48.0,-89.0,-92.0,-89.0,-92.0,49.0,55.0,43.0,40.0,1
3163,62:47:05:9D:EB:15,3845316,487140526,2162,2435322,3843154,484705204,0,4403,3019684,4371,3014565,32,5119,2071,0,2219,56,0,106,229410.0,130000.0,-47.0,-46.0,-39.0,-46.0,-46.0,-47.0,-39.0,-46.0,-89.0,-92.0,-89.0,-92.0,42.0,46.0,50.0,46.0,1
3164,3C:55:76:E8:8F:1F,3934266,712042273,91112,227337069,3843154,484705204,43,44601,9983547,43971,9870860,630,112687,18739,46,91224,9930,43,626,286760.0,172050.0,-48.0,-56.0,-48.0,-45.0,-47.0,-54.0,-47.0,-44.0,-89.0,-92.0,-89.0,-92.0,41.0,36.0,41.0,47.0,1
3165,92:69:1D:31:68:E9,3847172,488354855,4016,3649449,3843156,484705406,0,5198,1142199,5036,1105461,162,36738,2189,12,4256,102,0,56,229410.0,130000.0,-52.0,-49.0,-44.0,-47.0,-52.0,-48.0,-43.0,-47.0,-89.0,-92.0,-89.0,-92.0,37.0,43.0,45.0,45.0,1
3166,CC:2F:71:3F:1F:24,4904932,1682078029,1061776,1197372623,3843156,484705406,479,879014,973584750,878217,973488374,797,96376,849657,15,1061597,110400,476,678,115556.0,28889.0,-68.0,-70.0,-66.0,-72.0,-68.0,-70.0,-66.0,-72.0,-89.0,-92.0,-89.0,-92.0,21.0,22.0,23.0,20.0,1
3167,CC:2F:71:3E:C5:1F,3844113,484822400,955,116792,3843158,484705608,0,3983,334722,3288,252182,695,82540,1011,12,1374,26,0,53,144444.0,43333.0,-72.0,-72.0,-69.0,-60.0,-73.0,-73.0,-70.0,-61.0,-89.0,-92.0,-89.0,-92.0,17.0,20.0,20.0,32.0,1
3168,BA:8C:B9:54:50:24,3848055,490895256,4897,6189648,3843158,484705608,0,9436,1729912,9414,1726417,22,3495,2354,17,5381,41,0,66,216660.0,130000.0,-40.0,-37.0,-46.0,-52.0,-44.0,-35.0,-44.0,-48.0,-89.0,-92.0,-89.0,-92.0,49.0,55.0,43.0,40.0,1
3169,62:47:05:9D:EB:15,3845324,487141256,2162,2435322,3843162,484705934,0,4403,3019684,4371,3014565,32,5119,2071,0,2219,56,0,106,229410.0,130000.0,-47.0,-46.0,-39.0,-46.0,-46.0,-47.0,-39.0,-46.0,-89.0,-92.0,-89.0,-92.0,42.0,46.0,50.0,46.0,1
3170,3C:55:76:E8:8F:1F,3934275,712043259,91113,227337325,3843162,484705934,43,44619,9984951,43988,9872146,631,112805,18742,46,91225,9930,43,628,286760.0,172050.0,-47.0,-57.0,-51.0,-43.0,-48.0,-56.0,-48.0,-45.0,-89.0,-92.0,-89.0,-92.0,42.0,35.0,38.0,49.0,1
3171,92:69:1D:31:68:E9,3847178,488355383,4016,3649449,3843162,484705934,0,5198,1142199,5036,1105461,162,36738,2189,12,4256,102,0,56,229410.0,130000.0,-52.0,-49.0,-44.0,-47.0,-52.0,-48.0,-43.0,-47.0,-89.0,-92.0,-89.0,-92.0,37.0,43.0,45.0,45.0,1
3172,CC:2F:71:3F:1F:24,4905150,1682341655,1061988,1197635721,3843162,484705934,479,879203,973833572,878406,973737196,797,96376,849844,15,1061809,110423,476,678,115556.0,28889.0,-68.0,-70.0,-66.0,-72.0,-68.0,-70.0,-66.0,-72.0,-89.0,-92.0,-89.0,-92.0,21.0,22.0,23.0,20.0,1
3173,CC:2F:71:3E:C5:1F,3844117,484822726,955,116792,3843162,484705934,0,3985,334910,3289,252252,696,82658,1012,12,1374,26,0,53,144444.0,43333.0,-73.0,-72.0,-69.0,-61.0,-73.0,-73.0,-70.0,-61.0,-89.0,-92.0,-89.0,-92.0,16.0,20.0,20.0,31.0,1
3174,BA:8C:B9:54:50:24,3848059,490895582,4897,6189648,3843162,484705934,0,9436,1729912,9414,1726417,22,3495,2354,17,5381,41,0,66,216660.0,130000.0,-40.0,-37.0,-46.0,-52.0,-44.0,-35.0,-44.0,-48.0,-89.0,-92.0,-89.0,-92.0,49.0,55.0,43.0,40.0,1
3175,62:47:05:9D:EB:15,3845328,487141660,2162,2435322,3843166,484706338,0,4403,3019684,4371,3014565,32,5119,2071,0,2219,56,0,106,229410.0,130000.0,-47.0,-46.0,-39.0,-46.0,-46.0,-47.0,-39.0,-46.0,-89.0,-92.0,-89.0,-92.0,42.0,46.0,50.0,46.0,1
3176,3C:55:76:E8:8F:1F,3934281,712043865,91113,227337325,3843168,484706540,43,44626,9985429,43995,9872624,631,112805,18742,46,91225,9930,43,628,286760.0,172050.0,-47.0,-56.0,-51.0,-41.0,-47.0,-56.0,-51.0,-42.0,-89.0,-92.0,-89.0,-92.0,42.0,36.0,38.0,51.0,1
3177,92:69:1D:31:68:E9,3847184,488355989,4016,3649449,3843168,484706540,0,5198,1142199,5036,1105461,162,36738,2189,12,4256,102,0,56,229410.0,130000.0,-52.0,-49.0,-44.0,-47.0,-52.0,-48.0,-43.0,-47.0,-89.0,-92.0,-89.0,-92.0,37.0,43.0,45.0,45.0,1
3178,CC:2F:71:3F:1F:24,4905370,1682606105,1062202,1197899565,3843168,484706540,479,879390,974077928,878593,973981552,797,96376,850031,15,1062023,110428,476,678,115556.0,28889.0,-68.0,-70.0,-66.0,-72.0,-68.0,-70.0,-66.0,-72.0,-89.0,-92.0,-89.0,-92.0,21.0,22.0,23.0,20.0,1
3179,CC:2F:71:3E:C5:1F,3844124,484823392,955,116792,3843169,484706600,0,3985,334910,3289,252252,696,82658,1012,12,1374,26,0,53,144444.0,43333.0,-73.0,-72.0,-69.0,-61.0,-73.0,-73.0,-70.0,-61.0,-89.0,-92.0,-89.0,-92.0,16.0,20.0,20.0,31.0,1
3180,BA:8C:B9:54:50:24,3848066,490896248,4897,6189648,3843169,484706600,0,9436,1729912,9414,1726417,22,3495,2354,17,5381,41,0,66,216660.0,130000.0,-40.0,-37.0,-46.0,-52.0,-44.0,-35.0,-44.0,-48.0,-89.0,-92.0,-89.0,-92.0,49.0,55.0,43.0,40.0,1
3181,62:47:05:9D:EB:15,3845333,487142124,2162,2435322,3843171,484706802,0,4403,3019684,4371,3014565,32,5119,2071,0,2219,56,0,106,229410.0,130000.0,-47.0,-46.0,-39.0,-46.0,-46.0,-47.0,-39.0,-46.0,-89.0,-92.0,-89.0,-92.0,42.0,46.0,50.0,46.0,1
3182,3C:55:76:E8:8F:1F,3934437,712440318,91266,227733516,3843171,484706802,43,44669,9993077,44038,9880272,631,112805,18768,46,91378,9930,43,628,286760.0,172050.0,-46.0,-54.0,-50.0,-41.0,-49.0,-55.0,-50.0,-45.0,-89.0,-92.0,-89.0,-92.0,43.0,38.0,39.0,51.0,1
3183,92:69:1D:31:68:E9,3847187,488356251,4016,3649449,3843171,484706802,0,5198,1142199,5036,1105461,162,36738,2189,12,4256,102,0,56,229410.0,130000.0,-52.0,-49.0,-44.0,-47.0,-52.0,-48.0,-43.0,-47.0,-89.0,-92.0,-89.0,-92.0,37.0,43.0,45.0,45.0,1
3184,CC:2F:71:3F:1F:24,4905589,1682869700,1062417,1198162836,3843172,484706864,479,879581,974323183,878784,974226807,797,96376,850222,15,1062238,110447,476,678,130000.0,43333.0,-68.0,-70.0,-66.0,-72.0,-68.0,-70.0,-66.0,-72.0,-89.0,-92.0,-89.0,-92.0,21.0,22.0,23.0,20.0,1
3185,CC:2F:71:3E:C5:1F,3844127,484823656,955,116792,3843172,484706864,0,3985,334910,3289,252252,696,82658,1012,12,1374,26,0,53,144444.0,43333.0,-73.0,-72.0,-69.0,-61.0,-73.0,-73.0,-70.0,-61.0,-89.0,-92.0,-89.0,-92.0,16.0,20.0,20.0,31.0,1
3186,BA:8C:B9:54:50:24,3848069,490896512,4897,6189648,3843172,484706864,0,9436,1729912,9414,1726417,22,3495,2354,17,5381,41,0,66,216660.0,130000.0,-40.0,-37.0,-46.0,-52.0,-44.0,-35.0,-44.0,-48.0,-89.0,-92.0,-89.0,-92.0,49.0,55.0,43.0,40.0,1
3187,62:47:05:9D:EB:15,3845340,487142792,2162,2435322,3843178,484707470,0,4403,3019684,4371,3014565,32,5119,2071,0,2219,56,0,106,229410.0,130000.0,-47.0,-46.0,-39.0,-46.0,-46.0,-47.0,-39.0,-46.0,-89.0,-92.0,-89.0,-92.0,42.0,46.0,50.0,46.0,1
3188,3C:55:76:E8:8F:1F,3934445,712442342,91267,227734872,3843178,484707470,43,44679,9993924,44047,9881001,632,112923,18771,46,91379,9930,43,628,286760.0,172050.0,-46.0,-54.0,-49.0,-41.0,-47.0,-54.0,-49.0,-42.0,-89.0,-92.0,-89.0,-92.0,43.0,38.0,40.0,51.0,1
3189,92:69:1D:31:68:E9,3847194,488356919,4016,3649449,3843178,484707470,0,5200,1142335,5038,1105597,162,36738,2189,12,4257,102,0,56,229410.0,130000.0,-52.0,-48.0,-44.0,-47.0,-52.0,-48.0,-44.0,-47.0,-89.0,-92.0,-89.0,-92.0,37.0,44.0,45.0,45.0,1
3190,CC:2F:71:3F:1F:24,4905803,1683130498,1062625,1198423028,3843178,484707470,479,879764,974565595,878967,974469219,797,96376,850405,15,1062446,110453,476,678,130000.0,43333.0,-68.0,-70.0,-66.0,-72.0,-68.0,-70.0,-66.0,-72.0,-89.0,-92.0,-89.0,-92.0,21.0,22.0,23.0,20.0,1
3191,CC:2F:71:3E:C5:1F,3844133,484824262,955,116792,3843178,484707470,0,3985,334910,3289,252252,696,82658,1012,12,1374,26,0,53,144444.0,43333.0,-73.0,-72.0,-69.0,-61.0,-73.0,-73.0,-70.0,-61.0,-89.0,-92.0,-89.0,-92.0,16.0,20.0,20.0,31.0,1
3192,BA:8C:B9:54:50:24,3848075,490897118,4897,6189648,3843178,484707470,0,9438,1730048,9416,1726553,22,3495,2354,17,5382,41,0,67,216660.0,130000.0,-48.0,-35.0,-42.0,-45.0,-44.0,-36.0,-44.0,-48.0,-89.0,-92.0,-89.0,-92.0,41.0,57.0,47.0,47.0,1
3193,62:47:05:9D:EB:15,3845343,487143054,2162,2435322,3843181,484707732,0,4405,3019820,4373,3014701,32,5119,2071,0,2220,56,0,107,229410.0,130000.0,-43.0,-49.0,-39.0,-47.0,-46.0,-47.0,-38.0,-46.0,-89.0,-92.0,-89.0,-92.0,46.0,43.0,50.0,45.0,1
3194,3C:55:76:E8:8F:1F,3934448,712442604,91267,227734872,3843181,484707732,43,44680,9993994,44048,9881071,632,112923,18771,46,91379,9930,43,628,286760.0,172050.0,-47.0,-55.0,-50.0,-41.0,-46.0,-54.0,-49.0,-41.0,-89.0,-92.0,-89.0,-92.0,42.0,37.0,39.0,51.0,1
3195,92:69:1D:31:68:E9,3847197,488357181,4016,3649449,3843181,484707732,0,5200,1142335,5038,1105597,162,36738,2189,12,4257,102,0,56,229410.0,130000.0,-52.0,-48.0,-44.0,-47.0,-52.0,-48.0,-44.0,-47.0,-89.0,-92.0,-89.0,-92.0,37.0,44.0,45.0,45.0,1
3196,CC:2F:71:3F:1F:24,4906012,1683390468,1062831,1198682736,3843181,484707732,479,879947,974806583,879150,974710207,797,96376,850588,15,1062651,110458,476,678,130000.0,43333.0,-68.0,-70.0,-66.0,-72.0,-68.0,-70.0,-66.0,-72.0,-89.0,-92.0,-89.0,-92.0,21.0,22.0,23.0,20.0,1
3197,CC:2F:71:3E:C5:1F,3844138,484824726,955,116792,3843183,484707934,0,3985,334910,3289,252252,696,82658,1012,12,1374,26,0,53,144444.0,43333.0,-73.0,-72.0,-69.0,-61.0,-73.0,-73.0,-70.0,-61.0,-89.0,-92.0,-89.0,-92.0,16.0,20.0,20.0,31.0,1
3198,BA:8C:B9:54:50:24,3848080,490897582,4897,6189648,3843183,484707934,0,9438,1730048,9416,1726553,22,3495,2354,17,5382,41,0,67,216660.0,130000.0,-48.0,-35.0,-42.0,-45.0,-44.0,-36.0,-44.0,-48.0,-89.0,-92.0,-89.0,-92.0,41.0,57.0,47.0,47.0,1
3199,62:47:05:9D:EB:15,3845349,487143660,2162,2435322,3843187,484708338,0,4405,3019820,4373,3014701,32,5119,2071,0,2220,56,0,107,229410.0,130000.0,-43.0,-49.0,-39.0,-47.0,-46.0,-47.0,-38.0,-46.0,-89.0,-92.0,-89.0,-92.0,46.0,43.0,50.0,45.0,1
3200,3C:55:76:E8:8F:1F,3934454,712443210,91267,227734872,3843187,484708338,43,44680,9993994,44048,9881071,632,112923,18771,46,91379,9930,43,628,286760.0,172050.0,-47.0,-55.0,-50.0,-41.0,-46.0,-54.0,-49.0,-41.0,-89.0,-92.0,-89.0,-92.0,42.0,37.0,39.0,51.0,1
3201,92:69:1D:31:68:E9,3847203,488357787,4016,3649449,3843187,484708338,0,5200,1142335,5038,1105597,162,36738,2189,12,4257,102,0,56,229410.0,130000.0,-52.0,-48.0,-44.0,-47.0,-52.0,-48.0,-44.0,-47.0,-89.0,-91.0,-88.0,-91.0,37.0,43.0,44.0,44.0,1
3202,CC:2F:71:3F:1F:24,4906224,1683649582,1063037,1198941244,3843187,484708338,479,880128,975047367,879331,974950991,797,96376,850769,15,1062858,110459,476,678,130000.0,43333.0,-68.0,-70.0,-66.0,-72.0,-67.0,-70.0,-66.0,-72.0,-89.0,-91.0,-88.0,-91.0,21.0,21.0,22.0,19.0,1
3203,CC:2F:71:3E:C5:1F,3844142,484825130,955,116792,3843187,484708338,0,3985,334910,3289,252252,696,82658,1012,12,1374,26,0,53,144444.0,43333.0,-73.0,-72.0,-69.0,-61.0,-73.0,-73.0,-70.0,-61.0,-89.0,-91.0,-88.0,-91.0,16.0,19.0,19.0,30.0,1
3204,BA:8C:B9:54:50:24,3848086,490898188,4897,6189648,3843189,484708540,0,9438,1730048,9416,1726553,22,3495,2354,17,5382,41,0,67,216660.0,130000.0,-48.0,-35.0,-42.0,-45.0,-44.0,-36.0,-44.0,-48.0,-89.0,-91.0,-88.0,-91.0,41.0,56.0,46.0,46.0,1
3205,62:47:05:9D:EB:15,3845352,487143922,2162,2435322,3843190,484708600,0,4405,3019820,4373,3014701,32,5119,2071,0,2220,56,0,107,229410.0,130000.0,-43.0,-49.0,-39.0,-47.0,-46.0,-47.0,-38.0,-46.0,-89.0,-91.0,-88.0,-91.0,46.0,42.0,49.0,44.0,1
3206,3C:55:76:E8:8F:1F,3934473,712447931,91281,227739129,3843192,484708802,43,44712,10003023,44080,9890100,632,112923,18789,46,91393,9930,43,628,286760.0,172050.0,-50.0,-55.0,-51.0,-46.0,-50.0,-55.0,-51.0,-45.0,-89.0,-91.0,-88.0,-91.0,39.0,36.0,37.0,45.0,1
3207,92:69:1D:31:68:E9,3847208,488358251,4016,3649449,3843192,484708802,0,5200,1142335,5038,1105597,162,36738,2189,12,4257,102,0,56,229410.0,130000.0,-52.0,-48.0,-44.0,-47.0,-52.0,-48.0,-44.0,-47.0,-89.0,-91.0,-88.0,-91.0,37.0,43.0,44.0,44.0,1
3208,CC:2F:71:3F:1F:24,4906446,1683915127,1063252,1199206123,3843194,484709004,479,880322,975294395,879525,975198019,797,96376,850963,15,1063073,110467,476,678,130000.0,43333.0,-68.0,-70.0,-66.0,-72.0,-68.0,-70.0,-66.0,-72.0,-89.0,-91.0,-88.0,-91.0,21.0,21.0,22.0,19.0,1
3209,CC:2F:71:3E:C5:1F,3844149,484825796,955,116792,3843194,484709004,0,3985,334910,3289,252252,696,82658,1012,12,1374,26,0,53,144444.0,43333.0,-73.0,-72.0,-69.0,-61.0,-73.0,-73.0,-70.0,-61.0,-89.0,-91.0,-88.0,-91.0,16.0,19.0,19.0,30.0,1
3210,BA:8C:B9:54:50:24,3848091,490898652,4897,6189648,3843194,484709004,0,9438,1730048,9416,1726553,22,3495,2354,17,5382,41,0,67,216660.0,130000.0,-48.0,-35.0,-42.0,-45.0,-44.0,-36.0,-44.0,-48.0,-89.0,-91.0,-88.0,-91.0,41.0,56.0,46.0,46.0,1
3211,62:47:05:9D:EB:15,3845359,487144801,2162,2435322,3843197,484709479,0,4405,3019820,4373,3014701,32,5119,2071,0,2220,56,0,107,229410.0,130000.0,-43.0,-49.0,-39.0,-47.0,-46.0,-47.0,-38.0,-46.0,-89.0,-91.0,-88.0,-91.0,46.0,42.0,49.0,44.0,1
3212,3C:55:76:E8:8F:1F,3934629,712805158,91430,228095477,3843199,484709681,43,44799,10027488,44167,9914565,632,112923,18845,46,91542,9943,43,628,286760.0,172050.0,-48.0,-57.0,-49.0,-45.0,-47.0,-56.0,-49.0,-45.0,-89.0,-91.0,-88.0,-91.0,41.0,34.0,39.0,46.0,1
3213,92:69:1D:31:68:E9,3847215,488359130,4016,3649449,3843199,484709681,0,5200,1142335,5038,1105597,162,36738,2189,12,4257,102,0,56,229410.0,130000.0,-52.0,-48.0,-44.0,-47.0,-52.0,-48.0,-44.0,-47.0,-89.0,-91.0,-88.0,-91.0,37.0,43.0,44.0,44.0,1
3214,CC:2F:71:3F:1F:24,4906659,1684175996,1063460,1199466315,3843199,484709681,479,880504,975536803,879707,975440427,797,96376,851145,15,1063281,110471,476,678,130000.0,43333.0,-68.0,-70.0,-66.0,-72.0,-68.0,-70.0,-66.0,-72.0,-89.0,-91.0,-88.0,-91.0,21.0,21.0,22.0,19.0,1
3215,CC:2F:71:3E:C5:1F,3844154,484826473,955,116792,3843199,484709681,0,3985,334910,3289,252252,696,82658,1012,12,1374,26,0,53,144444.0,43333.0,-73.0,-72.0,-69.0,-61.0,-73.0,-73.0,-70.0,-61.0,-89.0,-91.0,-88.0,-91.0,16.0,19.0,19.0,30.0,1
3216,BA:8C:B9:54:50:24,3848096,490899329,4897,6189648,3843199,484709681,0,9438,1730048,9416,1726553,22,3495,2354,17,5382,41,0,67,216660.0,130000.0,-48.0,-35.0,-42.0,-45.0,-44.0,-36.0,-44.0,-48.0,-89.0,-91.0,-88.0,-91.0,41.0,56.0,46.0,46.0,1
3217,62:47:05:9D:EB:15,3845365,487145407,2162,2435322,3843203,484710085,0,4405,3019820,4373,3014701,32,5119,2071,0,2220,56,0,107,229410.0,130000.0,-43.0,-49.0,-39.0,-47.0,-46.0,-47.0,-38.0,-46.0,-89.0,-91.0,-88.0,-91.0,46.0,42.0,49.0,44.0,1
3218,3C:55:76:E8:8F:1F,3934637,712806258,91434,228096173,3843203,484710085,43,44812,10028490,44180,9915567,632,112923,18848,46,91546,9947,43,628,286760.0,172050.0,-47.0,-56.0,-50.0,-41.0,-46.0,-54.0,-49.0,-41.0,-89.0,-91.0,-88.0,-91.0,42.0,35.0,38.0,50.0,1
3219,92:69:1D:31:68:E9,3847219,488359534,4016,3649449,3843203,484710085,0,5200,1142335,5038,1105597,162,36738,2189,12,4257,102,0,56,229410.0,130000.0,-52.0,-48.0,-44.0,-47.0,-52.0,-48.0,-44.0,-47.0,-89.0,-91.0,-88.0,-91.0,37.0,43.0,44.0,44.0,1
3220,CC:2F:71:3F:1F:24,4906878,1684445750,1063673,1199735463,3843205,484710287,479,880694,975788561,879897,975692185,797,96376,851335,15,1063494,110476,476,678,130000.0,43333.0,-68.0,-71.0,-66.0,-72.0,-68.0,-70.0,-66.0,-72.0,-89.0,-91.0,-88.0,-91.0,21.0,20.0,22.0,19.0,1
3221,CC:2F:71:3E:C5:1F,3844161,484827139,955,116792,3843206,484710347,0,3985,334910,3289,252252,696,82658,1012,12,1374,26,0,53,144444.0,43333.0,-73.0,-72.0,-69.0,-61.0,-73.0,-73.0,-70.0,-61.0,-89.0,-91.0,-88.0,-91.0,16.0,19.0,19.0,30.0,1
3222,BA:8C:B9:54:50:24,3848103,490899995,4897,6189648,3843206,484710347,0,9438,1730048,9416,1726553,22,3495,2354,17,5382,41,0,67,216660.0,130000.0,-48.0,-35.0,-42.0,-45.0,-44.0,-36.0,-44.0,-48.0,-89.0,-91.0,-88.0,-91.0,41.0,56.0,46.0,46.0,1
3223,62:47:05:9D:EB:15,3845370,487145871,2162,2435322,3843208,484710549,0,4405,3019820,4373,3014701,32,5119,2071,0,2220,56,0,107,229410.0,130000.0,-43.0,-49.0,-39.0,-47.0,-46.0,-47.0,-38.0,-46.0,-90.0,-92.0,-89.0,-92.0,47.0,43.0,50.0,45.0,1
3224,3C:55:76:E8:8F:1F,3934791,713200721,91583,228490172,3843208,484710549,43,44865,10036978,44233,9924055,632,112923,18874,46,91695,9947,43,628,286760.0,172050.0,-48.0,-56.0,-52.0,-44.0,-46.0,-53.0,-51.0,-41.0,-90.0,-92.0,-89.0,-92.0,42.0,36.0,37.0,48.0,1
3225,92:69:1D:31:68:E9,3847224,488359998,4016,3649449,3843208,484710549,0,5200,1142335,5038,1105597,162,36738,2189,12,4257,102,0,56,229410.0,130000.0,-52.0,-48.0,-44.0,-47.0,-52.0,-48.0,-44.0,-47.0,-90.0,-92.0,-89.0,-92.0,38.0,44.0,45.0,45.0,1
3226,CC:2F:71:3F:1F:24,4907095,1684710691,1063887,1200000142,3843208,484710549,479,880884,976032276,880087,975935900,797,96376,851525,15,1063708,110500,476,678,115556.0,28889.0,-69.0,-70.0,-67.0,-74.0,-69.0,-70.0,-67.0,-73.0,-90.0,-92.0,-89.0,-92.0,21.0,22.0,22.0,18.0,1
3227,CC:2F:71:3E:C5:1F,3844163,484827341,955,116792,3843208,484710549,0,3985,334910,3289,252252,696,82658,1012,12,1374,26,0,53,144444.0,43333.0,-73.0,-72.0,-69.0,-61.0,-73.0,-73.0,-70.0,-61.0,-90.0,-92.0,-89.0,-92.0,17.0,20.0,20.0,31.0,1
3228,BA:8C:B9:54:50:24,3848105,490900197,4897,6189648,3843208,484710549,0,9438,1730048,9416,1726553,22,3495,2354,17,5382,41,0,67,216660.0,130000.0,-48.0,-35.0,-42.0,-45.0,-44.0,-36.0,-44.0,-48.0,-90.0,-92.0,-89.0,-92.0,42.0,57.0,47.0,47.0,1
3229,62:47:05:9D:EB:15,3845376,487146477,2162,2435322,3843214,484711155,0,4405,3019820,4373,3014701,32,5119,2071,0,2220,56,0,107,229410.0,130000.0,-43.0,-49.0,-39.0,-47.0,-46.0,-47.0,-38.0,-46.0,-90.0,-92.0,-89.0,-92.0,47.0,43.0,50.0,45.0,1
3230,3C:55:76:E8:8F:1F,3934798,713201457,91584,228490302,3843214,484711155,43,44871,10037425,44239,9924502,632,112923,18875,46,91696,9947,43,628,286760.0,172050.0,-45.0,-54.0,-52.0,-41.0,-44.0,-53.0,-50.0,-40.0,-90.0,-92.0,-89.0,-92.0,45.0,38.0,37.0,51.0,1
3231,92:69:1D:31:68:E9,3847230,488360604,4016,3649449,3843214,484711155,0,5200,1142335,5038,1105597,162,36738,2189,12,4257,102,0,56,229410.0,130000.0,-52.0,-48.0,-44.0,-47.0,-52.0,-48.0,-44.0,-47.0,-90.0,-92.0,-89.0,-92.0,38.0,44.0,45.0,45.0,1
3232,CC:2F:71:3F:1F:24,4907310,1684973043,1064096,1200261888,3843214,484711155,479,881068,976277652,880271,976181276,797,96376,851709,15,1063917,110500,476,678,115556.0,28889.0,-68.0,-70.0,-67.0,-72.0,-67.0,-70.0,-67.0,-72.0,-90.0,-92.0,-89.0,-92.0,22.0,22.0,22.0,20.0,1
3233,CC:2F:71:3E:C5:1F,3844169,484827947,955,116792,3843214,484711155,0,3985,334910,3289,252252,696,82658,1012,12,1374,26,0,53,144444.0,43333.0,-73.0,-72.0,-69.0,-61.0,-73.0,-73.0,-70.0,-61.0,-90.0,-92.0,-89.0,-92.0,17.0,20.0,20.0,31.0,1
3234,BA:8C:B9:54:50:24,3848111,490900803,4897,6189648,3843214,484711155,0,9438,1730048,9416,1726553,22,3495,2354,17,5382,41,0,67,216660.0,130000.0,-48.0,-35.0,-42.0,-45.0,-44.0,-36.0,-44.0,-48.0,-90.0,-92.0,-89.0,-92.0,42.0,57.0,47.0,47.0,1
3235,62:47:05:9D:EB:15,3845379,487146739,2162,2435322,3843217,484711417,0,4405,3019820,4373,3014701,32,5119,2071,0,2220,56,0,107,229410.0,130000.0,-43.0,-49.0,-39.0,-47.0,-46.0,-47.0,-38.0,-46.0,-90.0,-92.0,-89.0,-92.0,47.0,43.0,50.0,45.0,1
3236,3C:55:76:E8:8F:1F,3934807,713202955,91590,228491538,3843217,484711417,43,44898,10042431,44266,9929508,632,112923,18881,46,91702,9947,43,628,286760.0,172050.0,-45.0,-54.0,-52.0,-41.0,-45.0,-53.0,-50.0,-41.0,-90.0,-92.0,-89.0,-92.0,45.0,38.0,37.0,51.0,1
3237,92:69:1D:31:68:E9,3847233,488360866,4016,3649449,3843217,484711417,0,5200,1142335,5038,1105597,162,36738,2189,12,4257,102,0,56,229410.0,130000.0,-52.0,-48.0,-44.0,-47.0,-52.0,-48.0,-44.0,-47.0,-90.0,-92.0,-89.0,-92.0,38.0,44.0,45.0,45.0,1
3238,CC:2F:71:3F:1F:24,4907520,1685233031,1064303,1200521614,3843217,484711417,479,881249,976518408,880452,976422032,797,96376,851890,15,1064124,110508,476,678,130000.0,39000.0,-67.0,-71.0,-68.0,-73.0,-67.0,-71.0,-67.0,-72.0,-90.0,-92.0,-89.0,-92.0,23.0,21.0,21.0,19.0,1
3239,CC:2F:71:3E:C5:1F,3844172,484828209,955,116792,3843217,484711417,0,3985,334910,3289,252252,696,82658,1012,12,1374,26,0,53,144444.0,43333.0,-73.0,-72.0,-69.0,-61.0,-73.0,-73.0,-70.0,-61.0,-90.0,-92.0,-89.0,-92.0,17.0,20.0,20.0,31.0,1
3240,BA:8C:B9:54:50:24,3848116,490901267,4897,6189648,3843219,484711619,0,9438,1730048,9416,1726553,22,3495,2354,17,5382,41,0,67,216660.0,130000.0,-48.0,-35.0,-42.0,-45.0,-44.0,-36.0,-44.0,-48.0,-90.0,-92.0,-89.0,-92.0,42.0,57.0,47.0,47.0,1
3241,62:47:05:9D:EB:15,3845390,487148133,2166,2436050,3843224,484712083,0,4412,3020621,4380,3015502,32,5119,2075,0,2224,56,0,108,229410.0,130000.0,-47.0,-45.0,-38.0,-45.0,-47.0,-46.0,-39.0,-47.0,-90.0,-92.0,-89.0,-92.0,43.0,47.0,51.0,47.0,1
3242,3C:55:76:E8:8F:1F,3934814,713203621,91590,228491538,3843224,484712083,43,44905,10042909,44273,9929986,632,112923,18881,46,91702,9947,43,628,286760.0,172050.0,-45.0,-54.0,-52.0,-41.0,-45.0,-54.0,-52.0,-40.0,-90.0,-92.0,-89.0,-92.0,45.0,38.0,37.0,51.0,1
3243,92:69:1D:31:68:E9,3847240,488361532,4016,3649449,3843224,484712083,0,5200,1142335,5038,1105597,162,36738,2189,12,4257,102,0,56,229410.0,130000.0,-52.0,-48.0,-44.0,-47.0,-52.0,-48.0,-44.0,-47.0,-90.0,-92.0,-89.0,-92.0,38.0,44.0,45.0,45.0,1
3244,CC:2F:71:3F:1F:24,4907734,1685493271,1064510,1200781188,3843224,484712083,479,881436,976762706,880638,976666216,798,96490,852077,15,1064331,110537,476,678,130000.0,43333.0,-67.0,-71.0,-67.0,-72.0,-67.0,-71.0,-67.0,-72.0,-90.0,-92.0,-89.0,-92.0,23.0,21.0,22.0,20.0,1
3245,CC:2F:71:3E:C5:1F,3844179,484828875,955,116792,3843224,484712083,0,3985,334910,3289,252252,696,82658,1012,12,1374,26,0,53,144444.0,43333.0,-73.0,-72.0,-69.0,-61.0,-73.0,-73.0,-70.0,-61.0,-90.0,-92.0,-89.0,-92.0,17.0,20.0,20.0,31.0,1
3246,BA:8C:B9:54:50:24,3848121,490901731,4897,6189648,3843224,484712083,0,9438,1730048,9416,1726553,22,3495,2354,17,5382,41,0,67,216660.0,130000.0,-48.0,-35.0,-42.0,-45.0,-44.0,-36.0,-44.0,-48.0,-90.0,-92.0,-89.0,-92.0,42.0,57.0,47.0,47.0,1
3247,62:47:05:9D:EB:15,3845396,487148681,2166,2436050,3843230,484712631,0,4412,3020621,4380,3015502,32,5119,2075,0,2224,56,0,108,229410.0,130000.0,-47.0,-45.0,-38.0,-45.0,-47.0,-46.0,-39.0,-47.0,-90.0,-92.0,-89.0,-92.0,43.0,47.0,51.0,47.0,1
3248,3C:55:76:E8:8F:1F,3934824,713204746,91592,228491913,3843232,484712833,43,44920,10044011,44288,9931088,632,112923,18882,46,91704,9947,43,628,286760.0,172050.0,-46.0,-55.0,-52.0,-41.0,-45.0,-54.0,-52.0,-40.0,-90.0,-92.0,-89.0,-92.0,44.0,37.0,37.0,51.0,1
3249,92:69:1D:31:68:E9,3847250,488362484,4016,3649449,3843234,484713035,0,5201,1142403,5039,1105665,162,36738,2189,12,4257,102,0,56,229410.0,130000.0,-52.0,-47.0,-42.0,-48.0,-52.0,-48.0,-43.0,-47.0,-90.0,-92.0,-89.0,-92.0,38.0,45.0,47.0,44.0,1
3250,CC:2F:71:3F:1F:24,4907964,1685765450,1064730,1201052415,3843234,484713035,479,881640,977015382,880839,976918438,801,96944,852280,15,1064551,110584,476,681,130000.0,43333.0,-67.0,-71.0,-67.0,-72.0,-67.0,-71.0,-67.0,-72.0,-90.0,-92.0,-89.0,-92.0,23.0,21.0,22.0,20.0,1
3251,CC:2F:71:3E:C5:1F,3844189,484829827,955,116792,3843234,484713035,0,3985,334910,3289,252252,696,82658,1012,12,1374,26,0,53,144444.0,43333.0,-73.0,-72.0,-69.0,-61.0,-73.0,-73.0,-70.0,-61.0,-90.0,-92.0,-89.0,-92.0,17.0,20.0,20.0,31.0,1
3252,BA:8C:B9:54:50:24,3848132,490902809,4897,6189648,3843235,484713161,0,9438,1730048,9416,1726553,22,3495,2354,17,5382,41,0,67,216660.0,130000.0,-48.0,-35.0,-42.0,-45.0,-44.0,-36.0,-44.0,-48.0,-90.0,-92.0,-89.0,-92.0,42.0,57.0,47.0,47.0,1
3253,62:47:05:9D:EB:15,3845403,487149413,2166,2436050,3843237,484713363,0,4412,3020621,4380,3015502,32,5119,2075,0,2224,56,0,108,229410.0,130000.0,-47.0,-45.0,-38.0,-45.0,-47.0,-46.0,-39.0,-47.0,-90.0,-92.0,-89.0,-92.0,43.0,47.0,51.0,47.0,1
3254,3C:55:76:E8:8F:1F,3934830,713205392,91593,228492029,3843237,484713363,43,44928,10044595,44296,9931672,632,112923,18883,46,91705,9947,43,628,286760.0,172050.0,-48.0,-56.0,-46.0,-45.0,-46.0,-54.0,-45.0,-43.0,-90.0,-92.0,-89.0,-92.0,42.0,36.0,43.0,47.0,1
3255,92:69:1D:31:68:E9,3847255,488363014,4016,3649449,3843239,484713565,0,5201,1142403,5039,1105665,162,36738,2189,12,4257,102,0,56,229410.0,130000.0,-52.0,-47.0,-42.0,-48.0,-52.0,-48.0,-43.0,-47.0,-90.0,-92.0,-89.0,-92.0,38.0,45.0,47.0,44.0,1
3256,CC:2F:71:3F:1F:24,4908179,1686027872,1064940,1201314307,3843239,484713565,479,881826,977259608,881025,977162664,801,96944,852466,15,1064761,110616,476,681,130000.0,43333.0,-67.0,-71.0,-67.0,-72.0,-67.0,-71.0,-67.0,-72.0,-90.0,-92.0,-89.0,-92.0,23.0,21.0,22.0,20.0,1
3257,CC:2F:71:3E:C5:1F,3844194,484830357,955,116792,3843239,484713565,0,3985,334910,3289,252252,696,82658,1012,12,1374,26,0,53,144444.0,43333.0,-73.0,-72.0,-69.0,-61.0,-73.0,-73.0,-70.0,-61.0,-90.0,-92.0,-89.0,-92.0,17.0,20.0,20.0,31.0,1
3258,BA:8C:B9:54:50:24,3848136,490903213,4897,6189648,3843239,484713565,0,9438,1730048,9416,1726553,22,3495,2354,17,5382,41,0,67,216660.0,130000.0,-48.0,-35.0,-42.0,-45.0,-44.0,-36.0,-44.0,-48.0,-90.0,-92.0,-89.0,-92.0,42.0,57.0,47.0,47.0,1
3259,62:47:05:9D:EB:15,3845409,487150019,2166,2436050,3843243,484713969,0,4412,3020621,4380,3015502,32,5119,2075,0,2224,56,0,108,229410.0,130000.0,-47.0,-45.0,-38.0,-45.0,-47.0,-46.0,-39.0,-47.0,-90.0,-92.0,-89.0,-92.0,43.0,47.0,51.0,47.0,1
3260,3C:55:76:E8:8F:1F,3934958,713519338,91715,228805369,3843243,484713969,43,44971,10051866,44339,9938943,632,112923,18901,46,91827,9948,43,628,270830.0,162500.0,-45.0,-55.0,-52.0,-40.0,-45.0,-54.0,-51.0,-40.0,-90.0,-92.0,-89.0,-92.0,45.0,37.0,37.0,52.0,1
3261,92:69:1D:31:68:E9,3847259,488363418,4016,3649449,3843243,484713969,0,5201,1142403,5039,1105665,162,36738,2189,12,4257,102,0,56,229410.0,130000.0,-52.0,-47.0,-42.0,-48.0,-52.0,-48.0,-43.0,-47.0,-90.0,-92.0,-89.0,-92.0,38.0,45.0,47.0,44.0,1
3262,CC:2F:71:3F:1F:24,4908394,1686291556,1065150,1201577527,3843244,484714029,479,882014,977505460,881213,977408516,801,96944,852654,15,1064971,110688,476,681,130000.0,43333.0,-67.0,-71.0,-67.0,-72.0,-67.0,-71.0,-67.0,-72.0,-90.0,-92.0,-89.0,-92.0,23.0,21.0,22.0,20.0,1
3263,CC:2F:71:3E:C5:1F,3844199,484830821,955,116792,3843244,484714029,0,3985,334910,3289,252252,696,82658,1012,12,1374,26,0,53,144444.0,43333.0,-73.0,-72.0,-69.0,-61.0,-73.0,-73.0,-70.0,-61.0,-90.0,-92.0,-89.0,-92.0,17.0,20.0,20.0,31.0,1
3264,BA:8C:B9:54:50:24,3848141,490903677,4897,6189648,3843244,484714029,0,9438,1730048,9416,1726553,22,3495,2354,17,5382,41,0,67,216660.0,130000.0,-48.0,-35.0,-42.0,-45.0,-44.0,-36.0,-44.0,-48.0,-90.0,-92.0,-89.0,-92.0,42.0,57.0,47.0,47.0,1
3265,62:47:05:9D:EB:15,3845415,487150599,2167,2436166,3843248,484714433,0,4413,3020689,4381,3015570,32,5119,2075,0,2225,56,0,108,229410.0,130000.0,-45.0,-49.0,-40.0,-51.0,-46.0,-47.0,-39.0,-47.0,-90.0,-91.0,-88.0,-91.0,45.0,42.0,48.0,40.0,1
3266,3C:55:76:E8:8F:1F,3934964,713519918,91716,228805485,3843248,484714433,43,44974,10052072,44342,9939149,632,112923,18901,46,91828,9948,43,628,270830.0,162500.0,-43.0,-52.0,-50.0,-38.0,-44.0,-53.0,-50.0,-40.0,-90.0,-91.0,-88.0,-91.0,47.0,39.0,38.0,53.0,1
3267,92:69:1D:31:68:E9,3847265,488363998,4017,3649565,3843248,484714433,0,5203,1142539,5041,1105801,162,36738,2189,12,4258,102,0,56,229410.0,130000.0,-52.0,-48.0,-44.0,-47.0,-52.0,-47.0,-43.0,-47.0,-90.0,-91.0,-88.0,-91.0,38.0,43.0,44.0,44.0,1
3268,CC:2F:71:3F:1F:24,4908624,1686567877,1065375,1201853382,3843249,484714495,479,882214,977761854,881413,977664910,801,96944,852853,15,1065196,110748,476,682,115556.0,28889.0,-71.0,-75.0,-71.0,-77.0,-71.0,-74.0,-71.0,-76.0,-90.0,-91.0,-88.0,-91.0,19.0,16.0,17.0,14.0,1
3269,CC:2F:71:3E:C5:1F,3844205,484831403,956,116908,3843249,484714495,0,3987,335050,3291,252392,696,82658,1012,12,1375,26,0,53,130000.0,39000.0,-73.0,-72.0,-69.0,-60.0,-71.0,-70.0,-66.0,-60.0,-90.0,-91.0,-88.0,-91.0,17.0,19.0,19.0,31.0,1
3270,BA:8C:B9:54:50:24,3848147,490904259,4898,6189764,3843249,484714495,0,9440,1730184,9418,1726689,22,3495,2354,17,5383,41,0,67,216660.0,130000.0,-48.0,-35.0,-43.0,-45.0,-46.0,-35.0,-43.0,-47.0,-90.0,-91.0,-88.0,-91.0,42.0,56.0,45.0,46.0,1
3271,62:47:05:9D:EB:15,3845422,487151189,2167,2436166,3843255,484715023,0,4414,3020757,4382,3015638,32,5119,2075,0,2225,56,0,108,229410.0,130000.0,-47.0,-45.0,-38.0,-45.0,-46.0,-47.0,-39.0,-47.0,-89.0,-90.0,-87.0,-91.0,42.0,45.0,49.0,46.0,1
3272,3C:55:76:E8:8F:1F,3934971,713520508,91716,228805485,3843255,484715023,43,44986,10052992,44352,9939833,634,113159,18903,46,91828,9948,43,628,270830.0,162500.0,-44.0,-54.0,-44.0,-41.0,-45.0,-54.0,-46.0,-41.0,-89.0,-90.0,-87.0,-91.0,45.0,36.0,43.0,50.0,1
3273,92:69:1D:31:68:E9,3847274,488364790,4017,3649565,3843257,484715225,0,5203,1142539,5041,1105801,162,36738,2189,12,4258,102,0,56,229410.0,130000.0,-52.0,-48.0,-44.0,-47.0,-52.0,-47.0,-43.0,-47.0,-89.0,-90.0,-87.0,-91.0,37.0,42.0,43.0,44.0,1
3274,CC:2F:71:3F:1F:24,4908838,1686828539,1065581,1202113314,3843257,484715225,479,882400,978010366,881599,977913422,801,96944,853035,15,1065402,110748,476,682,115556.0,28889.0,-71.0,-75.0,-71.0,-77.0,-70.0,-74.0,-70.0,-76.0,-89.0,-90.0,-87.0,-91.0,18.0,15.0,16.0,14.0,1
3275,CC:2F:71:3E:C5:1F,3844213,484832133,956,116908,3843257,484715225,0,3989,335238,3292,252462,697,82776,1013,12,1375,26,0,53,130000.0,39000.0,-73.0,-72.0,-69.0,-60.0,-71.0,-70.0,-66.0,-60.0,-89.0,-90.0,-87.0,-91.0,16.0,18.0,18.0,31.0,1
3276,BA:8C:B9:54:50:24,3848155,490904989,4898,6189764,3843257,484715225,0,9440,1730184,9418,1726689,22,3495,2354,17,5383,41,0,67,216660.0,130000.0,-48.0,-35.0,-43.0,-45.0,-46.0,-35.0,-43.0,-47.0,-89.0,-90.0,-87.0,-91.0,41.0,55.0,44.0,46.0,1
3277,62:47:05:9D:EB:15,3845427,487151653,2167,2436166,3843260,484715487,0,4414,3020757,4382,3015638,32,5119,2075,0,2225,56,0,108,229410.0,130000.0,-47.0,-45.0,-38.0,-45.0,-46.0,-47.0,-39.0,-47.0,-89.0,-90.0,-87.0,-91.0,42.0,45.0,49.0,46.0,1
3278,3C:55:76:E8:8F:1F,3934979,713521506,91719,228806019,3843260,484715487,43,45017,10055514,44383,9942355,634,113159,18910,46,91831,9948,43,629,270830.0,162500.0,-48.0,-57.0,-47.0,-45.0,-48.0,-57.0,-47.0,-45.0,-89.0,-90.0,-87.0,-91.0,41.0,33.0,40.0,46.0,1
3279,92:69:1D:31:68:E9,3847277,488365052,4017,3649565,3843260,484715487,0,5203,1142539,5041,1105801,162,36738,2189,12,4258,102,0,56,229410.0,130000.0,-52.0,-48.0,-44.0,-47.0,-52.0,-47.0,-43.0,-47.0,-89.0,-90.0,-87.0,-91.0,37.0,42.0,43.0,44.0,1
3280,CC:2F:71:3F:1F:24,4909053,1687094985,1065793,1202379498,3843260,484715487,479,882594,978264190,881793,978167246,801,96944,853224,15,1065614,110755,476,683,115556.0,28889.0,-71.0,-75.0,-71.0,-76.0,-70.0,-74.0,-70.0,-75.0,-89.0,-90.0,-87.0,-91.0,18.0,15.0,16.0,15.0,1
3281,CC:2F:71:3E:C5:1F,3844216,484832395,956,116908,3843260,484715487,0,3989,335238,3292,252462,697,82776,1013,12,1375,26,0,53,130000.0,39000.0,-73.0,-72.0,-69.0,-60.0,-71.0,-70.0,-66.0,-60.0,-89.0,-90.0,-87.0,-91.0,16.0,18.0,18.0,31.0,1
3282,BA:8C:B9:54:50:24,3848158,490905251,4898,6189764,3843260,484715487,0,9440,1730184,9418,1726689,22,3495,2354,17,5383,41,0,67,216660.0,130000.0,-48.0,-35.0,-43.0,-45.0,-46.0,-35.0,-43.0,-47.0,-89.0,-90.0,-87.0,-91.0,41.0,55.0,44.0,46.0,1
3283,62:47:05:9D:EB:15,3845435,487152594,2167,2436166,3843268,484716428,0,4414,3020757,4382,3015638,32,5119,2075,0,2225,56,0,108,229410.0,130000.0,-47.0,-45.0,-38.0,-45.0,-46.0,-47.0,-39.0,-47.0,-89.0,-90.0,-87.0,-91.0,42.0,45.0,49.0,46.0,1
3284,3C:55:76:E8:8F:1F,3934987,713522447,91719,228806019,3843268,484716428,43,45031,10056520,44396,9943243,635,113277,18911,46,91831,9948,43,629,270830.0,162500.0,-45.0,-55.0,-52.0,-41.0,-44.0,-54.0,-51.0,-40.0,-90.0,-90.0,-88.0,-91.0,45.0,35.0,36.0,50.0,1
3285,92:69:1D:31:68:E9,3847285,488365993,4017,3649565,3843268,484716428,0,5203,1142539,5041,1105801,162,36738,2189,12,4258,102,0,56,229410.0,130000.0,-52.0,-48.0,-44.0,-47.0,-52.0,-47.0,-43.0,-47.0,-90.0,-90.0,-88.0,-91.0,38.0,42.0,44.0,44.0,1
3286,CC:2F:71:3F:1F:24,4909270,1687356234,1066002,1202639806,3843268,484716428,479,882785,978514710,881984,978417766,801,96944,853410,15,1065823,110757,476,683,115556.0,28889.0,-67.0,-71.0,-68.0,-73.0,-67.0,-70.0,-67.0,-72.0,-90.0,-90.0,-88.0,-91.0,23.0,19.0,20.0,18.0,1
3287,CC:2F:71:3E:C5:1F,3844224,484833336,956,116908,3843268,484716428,0,3989,335238,3292,252462,697,82776,1013,12,1375,26,0,53,130000.0,39000.0,-73.0,-72.0,-69.0,-60.0,-71.0,-70.0,-66.0,-60.0,-90.0,-90.0,-88.0,-91.0,17.0,18.0,19.0,31.0,1
3288,BA:8C:B9:54:50:24,3848168,490906394,4898,6189764,3843270,484716630,0,9440,1730184,9418,1726689,22,3495,2354,17,5383,41,0,67,216660.0,130000.0,-48.0,-35.0,-43.0,-45.0,-46.0,-35.0,-43.0,-47.0,-90.0,-90.0,-88.0,-91.0,42.0,55.0,45.0,46.0,1
3289,62:47:05:9D:EB:15,3845438,487152856,2167,2436166,3843271,484716690,0,4414,3020757,4382,3015638,32,5119,2075,0,2225,56,0,108,229410.0,130000.0,-47.0,-45.0,-38.0,-45.0,-46.0,-47.0,-39.0,-47.0,-90.0,-90.0,-88.0,-91.0,43.0,45.0,50.0,46.0,1
3290,3C:55:76:E8:8F:1F,3934996,713523694,91725,228807004,3843271,484716690,43,45058,10065647,44423,9952370,635,113277,18918,46,91837,9954,43,630,270830.0,162500.0,-48.0,-56.0,-46.0,-45.0,-47.0,-56.0,-46.0,-44.0,-90.0,-90.0,-88.0,-91.0,42.0,34.0,42.0,46.0,1
3291,92:69:1D:31:68:E9,3847290,488366457,4017,3649565,3843273,484716892,0,5203,1142539,5041,1105801,162,36738,2189,12,4258,102,0,56,229410.0,130000.0,-52.0,-48.0,-44.0,-47.0,-52.0,-47.0,-43.0,-47.0,-90.0,-90.0,-88.0,-91.0,38.0,42.0,44.0,44.0,1
3292,CC:2F:71:3F:1F:24,4909489,1687623027,1066216,1202906135,3843273,484716892,479,882979,978763238,882178,978666294,801,96944,853602,15,1066037,110760,476,683,117000.0,39000.0,-67.0,-71.0,-67.0,-73.0,-67.0,-71.0,-67.0,-72.0,-89.0,-90.0,-87.0,-90.0,22.0,19.0,20.0,17.0,1
3293,CC:2F:71:3E:C5:1F,3844229,484833800,956,116908,3843273,484716892,0,3989,335238,3292,252462,697,82776,1013,12,1375,26,0,53,130000.0,39000.0,-73.0,-72.0,-69.0,-60.0,-71.0,-70.0,-66.0,-60.0,-89.0,-90.0,-87.0,-90.0,16.0,18.0,18.0,30.0,1
3294,BA:8C:B9:54:50:24,3848171,490906656,4898,6189764,3843273,484716892,0,9440,1730184,9418,1726689,22,3495,2354,17,5383,41,0,67,216660.0,130000.0,-48.0,-35.0,-43.0,-45.0,-46.0,-35.0,-43.0,-47.0,-89.0,-90.0,-87.0,-90.0,41.0,55.0,44.0,45.0,1
3295,62:47:05:9D:EB:15,3845446,487153830,2167,2436166,3843279,484717664,0,4414,3020757,4382,3015638,32,5119,2075,0,2225,56,0,108,229410.0,130000.0,-47.0,-45.0,-38.0,-45.0,-46.0,-47.0,-39.0,-47.0,-89.0,-90.0,-87.0,-90.0,42.0,45.0,49.0,45.0,1
3296,3C:55:76:E8:8F:1F,3935043,713619988,91764,228902324,3843279,484717664,43,45085,10070943,44450,9957666,635,113277,18929,46,91876,9954,43,630,286760.0,162500.0,-46.0,-55.0,-52.0,-41.0,-45.0,-55.0,-52.0,-41.0,-89.0,-90.0,-87.0,-90.0,43.0,35.0,35.0,49.0,1
3297,92:69:1D:31:68:E9,3847297,488367297,4017,3649565,3843280,484717732,0,5203,1142539,5041,1105801,162,36738,2189,12,4258,102,0,56,229410.0,130000.0,-52.0,-48.0,-44.0,-47.0,-52.0,-47.0,-43.0,-47.0,-89.0,-90.0,-87.0,-90.0,37.0,42.0,43.0,43.0,1
3298,CC:2F:71:3F:1F:24,4909708,1687890111,1066427,1203172245,3843281,484717866,479,883172,979019758,882371,978922814,801,96944,853789,15,1066248,110767,476,683,115556.0,28889.0,-68.0,-72.0,-68.0,-73.0,-67.0,-71.0,-67.0,-72.0,-89.0,-90.0,-87.0,-90.0,21.0,18.0,19.0,17.0,1
3299,CC:2F:71:3E:C5:1F,3844237,484834774,956,116908,3843281,484717866,0,3989,335238,3292,252462,697,82776,1013,12,1375,26,0,53,130000.0,39000.0,-73.0,-72.0,-69.0,-60.0,-71.0,-70.0,-66.0,-60.0,-89.0,-90.0,-87.0,-90.0,16.0,18.0,18.0,30.0,1
3300,BA:8C:B9:54:50:24,3848179,490907630,4898,6189764,3843281,484717866,0,9440,1730184,9418,1726689,22,3495,2354,17,5383,41,0,67,216660.0,130000.0,-48.0,-35.0,-43.0,-45.0,-46.0,-35.0,-43.0,-47.0,-89.0,-90.0,-87.0,-90.0,41.0,55.0,44.0,45.0,1
3301,62:47:05:9D:EB:15,3845450,487154234,2167,2436166,3843283,484718068,0,4414,3020757,4382,3015638,32,5119,2075,0,2225,56,0,108,229410.0,130000.0,-47.0,-45.0,-38.0,-45.0,-46.0,-47.0,-39.0,-47.0,-89.0,-90.0,-87.0,-90.0,42.0,45.0,49.0,45.0,1
3302,3C:55:76:E8:8F:1F,3935058,713624663,91775,228906595,3843283,484718068,43,45117,10079637,44482,9966360,635,113277,18941,46,91887,9954,43,630,286760.0,1000.0,-42.0,-51.0,-49.0,-38.0,-44.0,-53.0,-48.0,-40.0,-89.0,-90.0,-87.0,-90.0,47.0,39.0,38.0,52.0,1
3303,92:69:1D:31:68:E9,3847301,488367693,4017,3649565,3843284,484718128,0,5203,1142539,5041,1105801,162,36738,2189,12,4258,102,0,56,229410.0,130000.0,-52.0,-48.0,-44.0,-47.0,-52.0,-47.0,-43.0,-47.0,-89.0,-90.0,-87.0,-90.0,37.0,42.0,43.0,43.0,1
3304,CC:2F:71:3F:1F:24,4909923,1688154907,1066637,1203436577,3843286,484718330,479,883364,979274676,882563,979177732,801,96944,853976,15,1066458,110796,476,683,115556.0,26000.0,-67.0,-71.0,-66.0,-73.0,-67.0,-71.0,-65.0,-74.0,-89.0,-90.0,-87.0,-90.0,22.0,19.0,21.0,17.0,1
3305,CC:2F:71:3E:C5:1F,3844242,484835238,956,116908,3843286,484718330,0,3989,335238,3292,252462,697,82776,1013,12,1375,26,0,53,130000.0,39000.0,-73.0,-72.0,-69.0,-60.0,-71.0,-70.0,-66.0,-60.0,-89.0,-90.0,-87.0,-90.0,16.0,18.0,18.0,30.0,1
3306,BA:8C:B9:54:50:24,3848184,490908094,4898,6189764,3843286,484718330,0,9440,1730184,9418,1726689,22,3495,2354,17,5383,41,0,67,216660.0,130000.0,-48.0,-35.0,-43.0,-45.0,-46.0,-35.0,-43.0,-47.0,-89.0,-90.0,-87.0,-90.0,41.0,55.0,44.0,45.0,1
3307,62:47:05:9D:EB:15,3845457,487154900,2167,2436166,3843290,484718734,0,4414,3020757,4382,3015638,32,5119,2075,0,2225,56,0,108,229410.0,130000.0,-47.0,-45.0,-38.0,-45.0,-46.0,-47.0,-39.0,-47.0,-89.0,-90.0,-87.0,-90.0,42.0,45.0,49.0,45.0,1
3308,3C:55:76:E8:8F:1F,3935067,713625515,91777,228906781,3843290,484718734,43,45134,10080925,44499,9967648,635,113277,18943,46,91889,9954,43,630,286760.0,162500.0,-47.0,-50.0,-48.0,-43.0,-45.0,-49.0,-49.0,-42.0,-89.0,-90.0,-87.0,-90.0,42.0,40.0,39.0,47.0,1
3309,92:69:1D:31:68:E9,3847307,488368299,4017,3649565,3843290,484718734,0,5203,1142539,5041,1105801,162,36738,2189,12,4258,102,0,56,229410.0,130000.0,-52.0,-48.0,-44.0,-47.0,-52.0,-47.0,-43.0,-47.0,-89.0,-90.0,-87.0,-90.0,37.0,42.0,43.0,43.0,1
3310,CC:2F:71:3F:1F:24,4910137,1688419979,1066847,1203701245,3843290,484718734,479,883562,979532026,882761,979435082,801,96944,854165,15,1066667,110804,476,683,115556.0,28889.0,-69.0,-70.0,-67.0,-74.0,-69.0,-70.0,-67.0,-74.0,-89.0,-90.0,-87.0,-90.0,20.0,20.0,20.0,16.0,1
3311,CC:2F:71:3E:C5:1F,3844246,484835642,956,116908,3843290,484718734,0,3989,335238,3292,252462,697,82776,1013,12,1375,26,0,53,130000.0,39000.0,-73.0,-72.0,-69.0,-60.0,-71.0,-70.0,-66.0,-60.0,-89.0,-90.0,-87.0,-90.0,16.0,18.0,18.0,30.0,1
3312,BA:8C:B9:54:50:24,3848188,490908498,4898,6189764,3843290,484718734,0,9440,1730184,9418,1726689,22,3495,2354,17,5383,41,0,67,216660.0,130000.0,-48.0,-35.0,-43.0,-45.0,-46.0,-35.0,-43.0,-47.0,-89.0,-90.0,-87.0,-90.0,41.0,55.0,44.0,45.0,1
3313,62:47:05:9D:EB:15,3845459,487155102,2167,2436166,3843292,484718936,0,4414,3020757,4382,3015638,32,5119,2075,0,2225,56,0,108,229410.0,130000.0,-47.0,-45.0,-38.0,-45.0,-46.0,-47.0,-39.0,-47.0,-89.0,-90.0,-87.0,-90.0,42.0,45.0,49.0,45.0,1
3314,3C:55:76:E8:8F:1F,3935072,713626190,91778,228907052,3843294,484719138,43,45143,10081844,44508,9968567,635,113277,18945,46,91890,9954,43,630,286760.0,162500.0,-46.0,-53.0,-48.0,-41.0,-46.0,-53.0,-47.0,-41.0,-89.0,-90.0,-87.0,-90.0,43.0,37.0,39.0,49.0,1
3315,92:69:1D:31:68:E9,3847313,488368905,4017,3649565,3843296,484719340,0,5203,1142539,5041,1105801,162,36738,2189,12,4258,102,0,56,229410.0,130000.0,-52.0,-48.0,-44.0,-47.0,-52.0,-47.0,-43.0,-47.0,-89.0,-90.0,-87.0,-90.0,37.0,42.0,43.0,43.0,1
3316,CC:2F:71:3F:1F:24,4910364,1688691072,1067068,1203971732,3843296,484719340,479,883762,979789763,882961,979692819,801,96944,854361,15,1066888,110905,476,683,78000.0,13000.0,-69.0,-71.0,-66.0,-74.0,-69.0,-71.0,-66.0,-73.0,-89.0,-90.0,-87.0,-90.0,20.0,19.0,21.0,16.0,1
3317,CC:2F:71:3E:C5:1F,3844252,484836248,956,116908,3843296,484719340,0,3989,335238,3292,252462,697,82776,1013,12,1375,26,0,53,130000.0,39000.0,-73.0,-72.0,-69.0,-60.0,-71.0,-70.0,-66.0,-60.0,-89.0,-90.0,-87.0,-90.0,16.0,18.0,18.0,30.0,1
3318,BA:8C:B9:54:50:24,3848194,490909104,4898,6189764,3843296,484719340,0,9440,1730184,9418,1726689,22,3495,2354,17,5383,41,0,67,216660.0,130000.0,-48.0,-35.0,-43.0,-45.0,-46.0,-35.0,-43.0,-47.0,-89.0,-90.0,-87.0,-90.0,41.0,55.0,44.0,45.0,1
3319,62:47:05:9D:EB:15,3845466,487155768,2167,2436166,3843299,484719602,0,4414,3020757,4382,3015638,32,5119,2075,0,2225,56,0,108,229410.0,130000.0,-47.0,-45.0,-38.0,-45.0,-46.0,-47.0,-39.0,-47.0,-90.0,-90.0,-87.0,-90.0,43.0,45.0,49.0,45.0,1
3320,3C:55:76:E8:8F:1F,3935088,713633260,91789,228913658,3843299,484719602,43,45179,10090906,44544,9977629,635,113277,18956,46,91901,9954,43,630,286760.0,162500.0,-48.0,-53.0,-47.0,-41.0,-47.0,-53.0,-47.0,-41.0,-90.0,-90.0,-87.0,-90.0,42.0,37.0,40.0,49.0,1
3321,92:69:1D:31:68:E9,3847316,488369167,4017,3649565,3843299,484719602,0,5203,1142539,5041,1105801,162,36738,2189,12,4258,102,0,56,229410.0,130000.0,-52.0,-48.0,-44.0,-47.0,-52.0,-47.0,-43.0,-47.0,-90.0,-90.0,-87.0,-90.0,38.0,42.0,43.0,43.0,1
3322,CC:2F:71:3F:1F:24,4910575,1688954790,1067276,1204235188,3843299,484719602,479,883954,980044729,883153,979947785,801,96944,854548,15,1067097,110905,476,683,86667.0,14444.0,-69.0,-71.0,-67.0,-74.0,-69.0,-71.0,-66.0,-73.0,-90.0,-90.0,-87.0,-90.0,21.0,19.0,20.0,16.0,1
3323,CC:2F:71:3E:C5:1F,3844255,484836510,956,116908,3843299,484719602,0,3989,335238,3292,252462,697,82776,1013,12,1375,26,0,53,130000.0,39000.0,-73.0,-72.0,-69.0,-60.0,-71.0,-70.0,-66.0,-60.0,-90.0,-90.0,-87.0,-90.0,17.0,18.0,18.0,30.0,1
3324,BA:8C:B9:54:50:24,3848199,490909568,4898,6189764,3843301,484719804,0,9440,1730184,9418,1726689,22,3495,2354,17,5383,41,0,67,216660.0,130000.0,-48.0,-35.0,-43.0,-45.0,-46.0,-35.0,-43.0,-47.0,-90.0,-90.0,-87.0,-90.0,42.0,55.0,44.0,45.0,1
3325,62:47:05:9D:EB:15,3845473,487156436,2167,2436166,3843306,484720270,0,4415,3020825,4383,3015706,32,5119,2075,0,2225,56,0,108,229410.0,130000.0,-47.0,-46.0,-38.0,-46.0,-47.0,-46.0,-39.0,-47.0,-89.0,-90.0,-87.0,-90.0,42.0,44.0,49.0,44.0,1
3326,3C:55:76:E8:8F:1F,3935100,713634960,91794,228914690,3843306,484720270,43,45196,10096161,44561,9982884,635,113277,18961,46,91906,9954,43,630,286760.0,162500.0,-48.0,-55.0,-47.0,-45.0,-47.0,-55.0,-46.0,-45.0,-89.0,-90.0,-87.0,-90.0,41.0,35.0,40.0,45.0,1
3327,92:69:1D:31:68:E9,3847323,488369835,4017,3649565,3843306,484720270,0,5204,1142607,5042,1105869,162,36738,2189,12,4259,102,0,56,229410.0,130000.0,-52.0,-47.0,-42.0,-48.0,-52.0,-47.0,-43.0,-47.0,-89.0,-90.0,-87.0,-90.0,37.0,43.0,45.0,42.0,1
3328,CC:2F:71:3F:1F:24,4910793,1689220672,1067487,1204500402,3843306,484720270,479,884153,980310655,883351,980213593,802,97062,854735,15,1067308,110936,476,683,86667.0,13000.0,-69.0,-71.0,-66.0,-73.0,-69.0,-70.0,-66.0,-72.0,-89.0,-90.0,-87.0,-90.0,20.0,19.0,21.0,17.0,1
3329,CC:2F:71:3E:C5:1F,3844262,484837178,956,116908,3843306,484720270,0,3991,335378,3294,252602,697,82776,1013,12,1376,26,0,53,130000.0,39000.0,-73.0,-72.0,-70.0,-61.0,-70.0,-69.0,-66.0,-58.0,-89.0,-90.0,-87.0,-90.0,16.0,18.0,17.0,29.0,1
3330,BA:8C:B9:54:50:24,3848204,490910034,4898,6189764,3843306,484720270,0,9442,1730320,9420,1726825,22,3495,2354,17,5384,41,0,67,216660.0,130000.0,-49.0,-35.0,-42.0,-46.0,-46.0,-35.0,-43.0,-47.0,-89.0,-90.0,-87.0,-90.0,40.0,55.0,45.0,44.0,1
3331,62:47:05:9D:EB:15,3845478,487156900,2167,2436166,3843311,484720734,0,4415,3020825,4383,3015706,32,5119,2075,0,2225,56,0,108,229410.0,130000.0,-47.0,-46.0,-38.0,-46.0,-47.0,-46.0,-39.0,-47.0,-89.0,-90.0,-87.0,-90.0,42.0,44.0,49.0,44.0,1
3332,3C:55:76:E8:8F:1F,3935344,714307855,92033,229587121,3843311,484720734,43,45294,10118070,44659,10004793,635,113277,19007,46,92125,9963,43,631,243750.0,146250.0,-46.0,-52.0,-47.0,-40.0,-47.0,-53.0,-47.0,-41.0,-89.0,-90.0,-87.0,-89.0,43.0,38.0,40.0,49.0,1
3333,92:69:1D:31:68:E9,3847328,488370299,4017,3649565,3843311,484720734,0,5205,1142675,5043,1105937,162,36738,2189,12,4259,102,0,56,229410.0,130000.0,-52.0,-49.0,-44.0,-47.0,-52.0,-48.0,-43.0,-47.0,-89.0,-90.0,-87.0,-89.0,37.0,41.0,43.0,42.0,1
3334,CC:2F:71:3F:1F:24,4911046,1689534627,1067735,1204813893,3843311,484720734,479,884385,980613700,883583,980516638,802,97062,854960,15,1067556,110948,476,683,104000.0,26000.0,-69.0,-71.0,-67.0,-74.0,-69.0,-71.0,-67.0,-73.0,-89.0,-90.0,-87.0,-89.0,20.0,19.0,20.0,15.0,1
3335,CC:2F:71:3E:C5:1F,3844267,484837642,956,116908,3843311,484720734,0,3991,335378,3294,252602,697,82776,1013,12,1376,26,0,53,130000.0,39000.0,-73.0,-72.0,-70.0,-61.0,-70.0,-69.0,-66.0,-58.0,-89.0,-90.0,-87.0,-89.0,16.0,18.0,17.0,28.0,1
3336,BA:8C:B9:54:50:24,3848213,490910902,4898,6189764,3843315,484721138,0,9442,1730320,9420,1726825,22,3495,2354,17,5384,41,0,67,216660.0,130000.0,-49.0,-35.0,-42.0,-46.0,-46.0,-35.0,-43.0,-47.0,-89.0,-90.0,-87.0,-89.0,40.0,55.0,45.0,43.0,1
3337,62:47:05:9D:EB:15,3845484,487157506,2167,2436166,3843317,484721340,0,4417,3020961,4385,3015842,32,5119,2075,0,2226,56,0,108,229410.0,130000.0,-48.0,-46.0,-39.0,-46.0,-47.0,-46.0,-39.0,-47.0,-89.0,-90.0,-87.0,-89.0,41.0,44.0,48.0,43.0,1
3338,3C:55:76:E8:8F:1F,3935912,716013170,92595,231291830,3843317,484721340,43,45444,10147000,44809,10033723,635,113277,19079,46,92707,9965,43,631,195000.0,1000.0,-46.0,-53.0,-47.0,-40.0,-47.0,-53.0,-46.0,-41.0,-89.0,-90.0,-87.0,-89.0,43.0,37.0,40.0,49.0,1
3339,92:69:1D:31:68:E9,3847334,488370905,4017,3649565,3843317,484721340,0,5205,1142675,5043,1105937,162,36738,2189,12,4259,102,0,56,229410.0,130000.0,-52.0,-49.0,-44.0,-47.0,-52.0,-48.0,-43.0,-47.0,-89.0,-90.0,-87.0,-89.0,37.0,41.0,43.0,42.0,1
3340,CC:2F:71:3F:1F:24,4911287,1689835167,1067970,1205113827,3843317,484721340,479,884601,980905986,883799,980808924,802,97062,855168,15,1067791,111037,476,684,115556.0,28889.0,-70.0,-72.0,-67.0,-74.0,-69.0,-71.0,-67.0,-73.0,-89.0,-90.0,-87.0,-89.0,19.0,18.0,20.0,15.0,1
3341,CC:2F:71:3E:C5:1F,3844273,484838248,956,116908,3843317,484721340,0,3991,335378,3294,252602,697,82776,1013,12,1376,26,0,53,130000.0,39000.0,-73.0,-72.0,-70.0,-61.0,-70.0,-69.0,-66.0,-58.0,-89.0,-90.0,-87.0,-89.0,16.0,18.0,17.0,28.0,1
3342,BA:8C:B9:54:50:24,3848215,490911104,4898,6189764,3843317,484721340,0,9442,1730320,9420,1726825,22,3495,2354,17,5384,41,0,67,216660.0,130000.0,-49.0,-35.0,-42.0,-46.0,-46.0,-35.0,-43.0,-47.0,-89.0,-90.0,-87.0,-89.0,40.0,55.0,45.0,43.0,1
3343,62:47:05:9D:EB:15,3845489,487157970,2167,2436166,3843322,484721804,0,4417,3020961,4385,3015842,32,5119,2075,0,2226,56,0,108,229410.0,130000.0,-48.0,-46.0,-39.0,-46.0,-47.0,-46.0,-39.0,-47.0,-89.0,-90.0,-87.0,-89.0,41.0,44.0,48.0,43.0,1
3344,3C:55:76:E8:8F:1F,3936073,716439523,92749,231717517,3843324,484722006,43,45512,10160942,44877,10047665,635,113277,19117,46,92861,9965,43,632,146250.0,48750.0,-48.0,-55.0,-47.0,-44.0,-49.0,-54.0,-48.0,-44.0,-89.0,-90.0,-87.0,-89.0,41.0,35.0,40.0,45.0,1
3345,92:69:1D:31:68:E9,3847341,488371571,4017,3649565,3843324,484722006,0,5205,1142675,5043,1105937,162,36738,2189,12,4259,102,0,56,229410.0,130000.0,-52.0,-49.0,-44.0,-47.0,-52.0,-48.0,-43.0,-47.0,-89.0,-90.0,-87.0,-89.0,37.0,41.0,43.0,42.0,1
3346,CC:2F:71:3F:1F:24,4911510,1690109609,1068186,1205387603,3843324,484722006,479,884809,981182870,884007,981085808,802,97062,855362,15,1068007,111078,476,684,115556.0,28889.0,-69.0,-71.0,-67.0,-74.0,-69.0,-71.0,-66.0,-73.0,-89.0,-90.0,-87.0,-89.0,20.0,19.0,20.0,15.0,1
3347,CC:2F:71:3E:C5:1F,3844280,484838914,956,116908,3843324,484722006,0,3991,335378,3294,252602,697,82776,1013,12,1376,26,0,53,130000.0,39000.0,-73.0,-72.0,-70.0,-61.0,-70.0,-69.0,-66.0,-58.0,-89.0,-90.0,-87.0,-89.0,16.0,18.0,17.0,28.0,1
3348,BA:8C:B9:54:50:24,3848222,490911770,4898,6189764,3843324,484722006,0,9443,1730388,9421,1726893,22,3495,2354,17,5384,41,0,67,216660.0,130000.0,-48.0,-35.0,-42.0,-46.0,-46.0,-35.0,-43.0,-47.0,-89.0,-90.0,-87.0,-89.0,41.0,55.0,45.0,43.0,1
3349,62:47:05:9D:EB:15,3845496,487158849,2167,2436166,3843329,484722683,0,4417,3020961,4385,3015842,32,5119,2075,0,2226,56,0,108,229410.0,130000.0,-48.0,-46.0,-39.0,-46.0,-47.0,-46.0,-39.0,-47.0,-89.0,-90.0,-87.0,-89.0,41.0,44.0,48.0,43.0,1
3350,3C:55:76:E8:8F:1F,3936613,718055774,93284,233333091,3843329,484722683,43,45704,10196224,45069,10082947,635,113277,19198,46,93396,9985,43,633,135410.0,1000.0,-47.0,-56.0,-47.0,-44.0,-47.0,-55.0,-47.0,-44.0,-89.0,-90.0,-86.0,-89.0,42.0,34.0,39.0,45.0,1
3351,92:69:1D:31:68:E9,3847346,488372248,4017,3649565,3843329,484722683,0,5205,1142675,5043,1105937,162,36738,2189,12,4259,102,0,56,229410.0,130000.0,-52.0,-49.0,-44.0,-47.0,-52.0,-48.0,-43.0,-47.0,-89.0,-90.0,-86.0,-89.0,37.0,41.0,42.0,42.0,1
3352,CC:2F:71:3F:1F:24,4911754,1690409775,1068425,1205687092,3843329,484722683,479,885028,981470097,884226,981373035,802,97062,855574,15,1068246,111104,476,684,115556.0,28889.0,-69.0,-71.0,-67.0,-73.0,-69.0,-71.0,-67.0,-73.0,-89.0,-90.0,-86.0,-89.0,20.0,19.0,19.0,16.0,1
3353,CC:2F:71:3E:C5:1F,3844285,484839591,956,116908,3843329,484722683,0,3991,335378,3294,252602,697,82776,1013,12,1376,26,0,53,130000.0,39000.0,-73.0,-72.0,-70.0,-61.0,-70.0,-69.0,-66.0,-58.0,-89.0,-90.0,-86.0,-89.0,16.0,18.0,16.0,28.0,1
3354,BA:8C:B9:54:50:24,3848227,490912447,4898,6189764,3843329,484722683,0,9444,1730456,9422,1726961,22,3495,2354,17,5384,41,0,67,216660.0,130000.0,-39.0,-36.0,-46.0,-51.0,-46.0,-35.0,-43.0,-46.0,-89.0,-90.0,-86.0,-89.0,50.0,54.0,40.0,38.0,1
3355,62:47:05:9D:EB:15,3845501,487159313,2167,2436166,3843334,484723147,0,4417,3020961,4385,3015842,32,5119,2075,0,2226,56,0,108,229410.0,130000.0,-48.0,-46.0,-39.0,-46.0,-47.0,-46.0,-39.0,-47.0,-89.0,-90.0,-86.0,-89.0,41.0,44.0,47.0,43.0,1
3356,3C:55:76:E8:8F:1F,3936710,718295778,93376,233572631,3843334,484723147,43,45764,10219759,45129,10106482,635,113277,19227,46,93488,9985,43,634,143380.0,86020.0,-50.0,-55.0,-47.0,-46.0,-50.0,-55.0,-48.0,-45.0,-89.0,-90.0,-86.0,-89.0,39.0,35.0,39.0,43.0,1
3357,92:69:1D:31:68:E9,3847351,488372712,4017,3649565,3843334,484723147,0,5205,1142675,5043,1105937,162,36738,2189,12,4259,102,0,56,229410.0,130000.0,-52.0,-49.0,-44.0,-47.0,-52.0,-48.0,-43.0,-47.0,-89.0,-90.0,-86.0,-89.0,37.0,41.0,42.0,42.0,1
3358,CC:2F:71:3F:1F:24,4911976,1690684433,1068642,1205961286,3843334,484723147,479,885224,981732613,884422,981635551,802,97062,855764,15,1068463,111108,476,684,115556.0,28889.0,-69.0,-71.0,-67.0,-73.0,-69.0,-71.0,-66.0,-73.0,-89.0,-89.0,-86.0,-88.0,20.0,18.0,19.0,15.0,1
3359,CC:2F:71:3E:C5:1F,3844292,484840257,956,116908,3843336,484723349,0,3991,335378,3294,252602,697,82776,1013,12,1376,26,0,53,130000.0,39000.0,-73.0,-72.0,-70.0,-61.0,-70.0,-69.0,-66.0,-58.0,-89.0,-89.0,-86.0,-88.0,16.0,17.0,16.0,27.0,1
3360,BA:8C:B9:54:50:24,3848234,490913113,4898,6189764,3843336,484723349,0,9449,1730796,9427,1727301,22,3495,2354,17,5384,41,0,67,216660.0,130000.0,-48.0,-35.0,-43.0,-45.0,-45.0,-35.0,-43.0,-46.0,-89.0,-89.0,-86.0,-88.0,41.0,54.0,43.0,43.0,1
3361,62:47:05:9D:EB:15,3845505,487159717,2167,2436166,3843338,484723551,0,4417,3020961,4385,3015842,32,5119,2075,0,2226,56,0,108,229410.0,130000.0,-48.0,-46.0,-39.0,-46.0,-47.0,-46.0,-39.0,-47.0,-89.0,-89.0,-86.0,-88.0,41.0,43.0,47.0,42.0,1
3362,3C:55:76:E8:8F:1F,3936879,718736930,93541,234013379,3843338,484723551,43,45836,10245136,45201,10131859,635,113277,19268,46,93591,9988,43,634,108330.0,1000.0,-47.0,-53.0,-50.0,-42.0,-49.0,-54.0,-48.0,-45.0,-89.0,-89.0,-86.0,-88.0,42.0,36.0,36.0,46.0,1
3363,92:69:1D:31:68:E9,3847357,488373318,4017,3649565,3843340,484723753,0,5205,1142675,5043,1105937,162,36738,2189,12,4259,102,0,56,229410.0,130000.0,-52.0,-49.0,-44.0,-47.0,-52.0,-48.0,-43.0,-47.0,-89.0,-89.0,-86.0,-88.0,37.0,40.0,42.0,41.0,1
3364,CC:2F:71:3F:1F:24,4912216,1690981395,1068876,1206257642,3843340,484723753,479,885442,982023407,884640,981926345,802,97062,855975,15,1068697,111129,476,684,115556.0,28889.0,-69.0,-70.0,-67.0,-74.0,-69.0,-70.0,-67.0,-73.0,-89.0,-89.0,-86.0,-88.0,20.0,19.0,19.0,14.0,1
3365,CC:2F:71:3E:C5:1F,3844298,484840863,956,116908,3843342,484723955,0,3991,335378,3294,252602,697,82776,1013,12,1376,26,0,53,130000.0,39000.0,-73.0,-72.0,-70.0,-61.0,-70.0,-69.0,-66.0,-58.0,-89.0,-89.0,-86.0,-88.0,16.0,17.0,16.0,27.0,1
3366,BA:8C:B9:54:50:24,3848240,490913719,4898,6189764,3843342,484723955,0,9449,1730796,9427,1727301,22,3495,2354,17,5384,41,0,67,216660.0,130000.0,-48.0,-35.0,-43.0,-45.0,-45.0,-35.0,-43.0,-46.0,-89.0,-89.0,-86.0,-88.0,41.0,54.0,43.0,43.0,1
3367,62:47:05:9D:EB:15,3845512,487160383,2167,2436166,3843345,484724217,0,4417,3020961,4385,3015842,32,5119,2075,0,2226,56,0,108,229410.0,130000.0,-48.0,-46.0,-39.0,-46.0,-47.0,-46.0,-39.0,-47.0,-89.0,-89.0,-86.0,-88.0,41.0,43.0,47.0,42.0,1
3368,3C:55:76:E8:8F:1F,3936899,718776591,93554,234052374,3843345,484724217,43,45875,10248700,45240,10135423,635,113277,19280,46,93666,9988,43,635,97500.0,1000.0,-45.0,-52.0,-48.0,-38.0,-45.0,-52.0,-47.0,-38.0,-89.0,-89.0,-86.0,-88.0,44.0,37.0,38.0,50.0,1
3369,92:69:1D:31:68:E9,3847362,488373782,4017,3649565,3843345,484724217,0,5205,1142675,5043,1105937,162,36738,2189,12,4259,102,0,56,229410.0,130000.0,-52.0,-49.0,-44.0,-47.0,-52.0,-48.0,-43.0,-47.0,-89.0,-89.0,-86.0,-88.0,37.0,40.0,42.0,41.0,1
3370,CC:2F:71:3F:1F:24,4912431,1691245159,1069086,1206520942,3843345,484724217,479,885643,982286857,884841,982189795,802,97062,856163,15,1068907,111135,476,684,115556.0,28889.0,-69.0,-70.0,-67.0,-73.0,-69.0,-70.0,-66.0,-73.0,-89.0,-89.0,-86.0,-88.0,20.0,19.0,19.0,15.0,1
3371,CC:2F:71:3E:C5:1F,3844301,484841125,956,116908,3843345,484724217,0,3991,335378,3294,252602,697,82776,1013,12,1376,26,0,53,130000.0,39000.0,-73.0,-72.0,-70.0,-61.0,-70.0,-69.0,-66.0,-58.0,-89.0,-89.0,-86.0,-88.0,16.0,17.0,16.0,27.0,1
3372,BA:8C:B9:54:50:24,3848245,490914183,4898,6189764,3843347,484724419,0,9449,1730796,9427,1727301,22,3495,2354,17,5384,41,0,67,216660.0,130000.0,-48.0,-35.0,-43.0,-45.0,-45.0,-35.0,-43.0,-46.0,-89.0,-89.0,-86.0,-88.0,41.0,54.0,43.0,43.0,1
3373,62:47:05:9D:EB:15,3845518,487160989,2167,2436166,3843351,484724823,0,4417,3020961,4385,3015842,32,5119,2075,0,2226,56,0,108,229410.0,130000.0,-48.0,-46.0,-39.0,-46.0,-47.0,-46.0,-39.0,-47.0,-89.0,-90.0,-87.0,-89.0,41.0,44.0,48.0,43.0,1
3374,3C:55:76:E8:8F:1F,3936948,718871816,93597,234146993,3843351,484724823,43,45925,10269796,45290,10156519,635,113277,19302,46,93709,9988,43,635,97500.0,1000.0,-47.0,-53.0,-49.0,-40.0,-47.0,-53.0,-48.0,-40.0,-89.0,-90.0,-87.0,-89.0,42.0,37.0,38.0,49.0,1
3375,92:69:1D:31:68:E9,3847368,488374388,4017,3649565,3843351,484724823,0,5205,1142675,5043,1105937,162,36738,2189,12,4259,102,0,56,229410.0,130000.0,-52.0,-49.0,-44.0,-47.0,-52.0,-48.0,-43.0,-47.0,-89.0,-90.0,-87.0,-89.0,37.0,41.0,43.0,42.0,1
3376,CC:2F:71:3F:1F:24,4912660,1691521470,1069309,1206796647,3843351,484724823,479,885856,982560685,885054,982463623,802,97062,856361,15,1069130,111154,476,684,130000.0,43333.0,-69.0,-70.0,-67.0,-73.0,-69.0,-70.0,-66.0,-73.0,-89.0,-90.0,-87.0,-89.0,20.0,20.0,20.0,16.0,1
3377,CC:2F:71:3E:C5:1F,3844307,484841731,956,116908,3843351,484724823,0,3991,335378,3294,252602,697,82776,1013,12,1376,26,0,53,130000.0,39000.0,-73.0,-72.0,-70.0,-61.0,-70.0,-69.0,-66.0,-58.0,-89.0,-90.0,-87.0,-89.0,16.0,18.0,17.0,28.0,1
3378,BA:8C:B9:54:50:24,3848249,490914587,4898,6189764,3843351,484724823,0,9449,1730796,9427,1727301,22,3495,2354,17,5384,41,0,67,216660.0,130000.0,-48.0,-35.0,-43.0,-45.0,-45.0,-35.0,-43.0,-46.0,-89.0,-90.0,-87.0,-89.0,41.0,55.0,44.0,44.0,1
3379,62:47:05:9D:EB:15,3845520,487161191,2167,2436166,3843353,484725025,0,4417,3020961,4385,3015842,32,5119,2075,0,2226,56,0,108,229410.0,130000.0,-48.0,-46.0,-39.0,-46.0,-47.0,-46.0,-39.0,-47.0,-90.0,-91.0,-87.0,-89.0,42.0,45.0,48.0,43.0,1
3380,3C:55:76:E8:8F:1F,3936953,718872464,93598,234147237,3843355,484725227,43,45929,10270118,45294,10156841,635,113277,19303,46,93710,9988,43,635,97500.0,1000.0,-47.0,-53.0,-49.0,-40.0,-47.0,-53.0,-48.0,-40.0,-90.0,-91.0,-87.0,-89.0,43.0,38.0,38.0,49.0,1
3381,92:69:1D:31:68:E9,3847372,488374792,4017,3649565,3843355,484725227,0,5205,1142675,5043,1105937,162,36738,2189,12,4259,102,0,56,229410.0,130000.0,-52.0,-49.0,-44.0,-47.0,-52.0,-48.0,-43.0,-47.0,-90.0,-91.0,-87.0,-89.0,38.0,42.0,43.0,42.0,1
3382,CC:2F:71:3F:1F:24,4912876,1691788058,1069521,1207062831,3843355,484725227,479,886055,982826703,885253,982729641,802,97062,856547,15,1069342,111178,476,684,130000.0,43333.0,-69.0,-71.0,-66.0,-73.0,-69.0,-70.0,-66.0,-73.0,-90.0,-91.0,-87.0,-89.0,21.0,20.0,21.0,16.0,1
3383,CC:2F:71:3E:C5:1F,3844311,484842135,956,116908,3843355,484725227,0,3991,335378,3294,252602,697,82776,1013,12,1376,26,0,53,130000.0,39000.0,-73.0,-72.0,-70.0,-61.0,-70.0,-69.0,-66.0,-58.0,-90.0,-91.0,-87.0,-89.0,17.0,19.0,17.0,28.0,1
3384,BA:8C:B9:54:50:24,3848254,490915051,4898,6189764,3843356,484725287,0,9449,1730796,9427,1727301,22,3495,2354,17,5384,41,0,67,216660.0,130000.0,-48.0,-35.0,-43.0,-45.0,-45.0,-35.0,-43.0,-46.0,-90.0,-91.0,-87.0,-89.0,42.0,56.0,44.0,44.0,1
3385,62:47:05:9D:EB:15,3845527,487161857,2167,2436166,3843360,484725691,0,4417,3020961,4385,3015842,32,5119,2075,0,2226,56,0,108,229410.0,130000.0,-48.0,-46.0,-39.0,-46.0,-47.0,-46.0,-39.0,-47.0,-90.0,-91.0,-87.0,-89.0,42.0,45.0,48.0,43.0,1
3386,3C:55:76:E8:8F:1F,3936958,718872928,93598,234147237,3843360,484725691,43,45929,10270118,45294,10156841,635,113277,19303,46,93710,9988,43,635,97500.0,1000.0,-47.0,-53.0,-49.0,-40.0,-47.0,-53.0,-48.0,-40.0,-90.0,-91.0,-87.0,-89.0,43.0,38.0,38.0,49.0,1
3387,92:69:1D:31:68:E9,3847377,488375256,4017,3649565,3843360,484725691,0,5205,1142675,5043,1105937,162,36738,2189,12,4259,102,0,56,229410.0,130000.0,-52.0,-49.0,-44.0,-47.0,-52.0,-48.0,-43.0,-47.0,-90.0,-91.0,-87.0,-89.0,38.0,42.0,43.0,42.0,1
3388,CC:2F:71:3F:1F:24,4913089,1692049578,1069729,1207323887,3843360,484725691,479,886247,983083229,885445,982986167,802,97062,856730,15,1069550,111203,476,684,130000.0,43333.0,-69.0,-70.0,-67.0,-74.0,-69.0,-70.0,-66.0,-73.0,-90.0,-91.0,-87.0,-89.0,21.0,21.0,20.0,15.0,1
3389,CC:2F:71:3E:C5:1F,3844316,484842599,956,116908,3843360,484725691,0,3991,335378,3294,252602,697,82776,1013,12,1376,26,0,53,130000.0,39000.0,-73.0,-72.0,-70.0,-61.0,-70.0,-69.0,-66.0,-58.0,-90.0,-91.0,-87.0,-89.0,17.0,19.0,17.0,28.0,1
3390,BA:8C:B9:54:50:24,3848258,490915455,4898,6189764,3843360,484725691,0,9449,1730796,9427,1727301,22,3495,2354,17,5384,41,0,67,216660.0,130000.0,-48.0,-35.0,-43.0,-45.0,-45.0,-35.0,-43.0,-46.0,-90.0,-91.0,-87.0,-89.0,42.0,56.0,44.0,44.0,1
3391,62:47:05:9D:EB:15,3845531,487162261,2167,2436166,3843364,484726095,0,4417,3020961,4385,3015842,32,5119,2075,0,2226,56,0,108,229410.0,130000.0,-48.0,-46.0,-39.0,-46.0,-47.0,-46.0,-39.0,-47.0,-90.0,-91.0,-87.0,-89.0,42.0,45.0,48.0,43.0,1
3392,3C:55:76:E8:8F:1F,3937069,719195677,93705,234469582,3843364,484726095,43,45960,10278102,45325,10164825,635,113277,19318,46,93812,9988,43,635,81250.0,24370.0,-51.0,-56.0,-48.0,-45.0,-48.0,-53.0,-46.0,-43.0,-90.0,-91.0,-87.0,-89.0,39.0,35.0,39.0,44.0,1
3393,92:69:1D:31:68:E9,3847381,488375660,4017,3649565,3843364,484726095,0,5205,1142675,5043,1105937,162,36738,2189,12,4259,102,0,56,229410.0,130000.0,-52.0,-49.0,-44.0,-47.0,-52.0,-48.0,-43.0,-47.0,-90.0,-91.0,-87.0,-89.0,38.0,42.0,43.0,42.0,1
3394,CC:2F:71:3F:1F:24,4913350,1692366381,1069986,1207640286,3843364,484726095,479,886497,983396346,885695,983299284,802,97062,856963,15,1069807,111214,476,684,130000.0,43333.0,-69.0,-71.0,-67.0,-73.0,-68.0,-70.0,-66.0,-73.0,-90.0,-91.0,-87.0,-89.0,21.0,20.0,20.0,16.0,1
3395,CC:2F:71:3E:C5:1F,3844320,484843003,956,116908,3843364,484726095,0,3991,335378,3294,252602,697,82776,1013,12,1376,26,0,53,130000.0,39000.0,-73.0,-72.0,-70.0,-61.0,-70.0,-69.0,-66.0,-58.0,-90.0,-91.0,-87.0,-89.0,17.0,19.0,17.0,28.0,1
3396,BA:8C:B9:54:50:24,3848264,490916061,4898,6189764,3843366,484726297,0,9449,1730796,9427,1727301,22,3495,2354,17,5384,41,0,67,216660.0,130000.0,-48.0,-35.0,-43.0,-45.0,-45.0,-35.0,-43.0,-46.0,-90.0,-91.0,-87.0,-89.0,42.0,56.0,44.0,44.0,1
3397,62:47:05:9D:EB:15,3845538,487162927,2167,2436166,3843371,484726761,0,4417,3020961,4385,3015842,32,5119,2075,0,2226,56,0,108,229410.0,130000.0,-48.0,-46.0,-39.0,-46.0,-47.0,-46.0,-39.0,-47.0,-90.0,-91.0,-87.0,-89.0,42.0,45.0,48.0,43.0,1
3398,3C:55:76:E8:8F:1F,3937368,720002510,93997,235275749,3843371,484726761,43,46100,10327578,45465,10214301,635,113277,19387,46,94108,9988,43,636,97500.0,1000.0,-51.0,-56.0,-48.0,-45.0,-48.0,-54.0,-48.0,-42.0,-90.0,-91.0,-87.0,-89.0,39.0,35.0,39.0,44.0,1
3399,92:69:1D:31:68:E9,3847390,488376528,4017,3649565,3843373,484726963,0,5205,1142675,5043,1105937,162,36738,2189,12,4259,102,0,56,229410.0,130000.0,-52.0,-49.0,-44.0,-47.0,-52.0,-48.0,-43.0,-47.0,-90.0,-91.0,-87.0,-89.0,38.0,42.0,43.0,42.0,1
3400,CC:2F:71:3F:1F:24,4913606,1692687841,1070233,1207960878,3843373,484726963,479,886733,983715054,885931,983617992,802,97062,857187,15,1070054,111228,476,684,130000.0,43333.0,-68.0,-70.0,-66.0,-72.0,-68.0,-70.0,-66.0,-72.0,-90.0,-91.0,-87.0,-89.0,22.0,21.0,21.0,17.0,1
3401,CC:2F:71:3E:C5:1F,3844330,484843931,957,116968,3843373,484726963,0,3993,335518,3296,252742,697,82776,1013,12,1377,26,0,53,130000.0,39000.0,-72.0,-72.0,-69.0,-61.0,-71.0,-70.0,-66.0,-60.0,-90.0,-91.0,-87.0,-89.0,18.0,19.0,18.0,28.0,1
3402,BA:8C:B9:54:50:24,3848272,490916843,4899,6189880,3843373,484726963,0,9453,1731068,9431,1727573,22,3495,2354,17,5385,41,0,67,229410.0,130000.0,-60.0,-36.0,-45.0,-44.0,-48.0,-35.0,-43.0,-45.0,-90.0,-91.0,-87.0,-89.0,30.0,55.0,42.0,45.0,1
3403,62:47:05:9D:EB:15,3845545,487163649,2168,2436282,3843377,484727367,0,4418,3021029,4386,3015910,32,5119,2075,0,2227,56,0,108,229410.0,130000.0,-48.0,-46.0,-39.0,-47.0,-47.0,-46.0,-39.0,-46.0,-90.0,-90.0,-87.0,-89.0,42.0,44.0,48.0,42.0,1
3404,3C:55:76:E8:8F:1F,3937412,720083349,94035,235355982,3843377,484727367,43,46152,10350871,45517,10237594,635,113277,19409,46,94147,9988,43,636,73120.0,1000.0,-47.0,-54.0,-49.0,-40.0,-47.0,-53.0,-48.0,-40.0,-90.0,-90.0,-87.0,-89.0,43.0,36.0,38.0,49.0,1
3405,92:69:1D:31:68:E9,3847395,488377048,4018,3649681,3843377,484727367,0,5207,1142811,5045,1106073,162,36738,2189,12,4260,102,0,56,229410.0,130000.0,-52.0,-47.0,-42.0,-48.0,-52.0,-47.0,-43.0,-47.0,-90.0,-90.0,-87.0,-89.0,38.0,43.0,45.0,41.0,1
3406,CC:2F:71:3F:1F:24,4913829,1692964107,1070452,1208236740,3843377,484727367,479,886934,983983930,886132,983886868,802,97062,857381,15,1070273,111238,476,684,130000.0,43333.0,-69.0,-70.0,-67.0,-73.0,-68.0,-70.0,-66.0,-73.0,-90.0,-90.0,-87.0,-89.0,21.0,20.0,20.0,16.0,1
3407,CC:2F:71:3E:C5:1F,3844334,484844335,957,116968,3843377,484727367,0,3993,335518,3296,252742,697,82776,1013,12,1377,26,0,53,130000.0,39000.0,-72.0,-72.0,-69.0,-61.0,-71.0,-70.0,-66.0,-60.0,-90.0,-90.0,-87.0,-89.0,18.0,18.0,18.0,28.0,1
3408,BA:8C:B9:54:50:24,3848276,490917247,4899,6189880,3843377,484727367,0,9453,1731068,9431,1727573,22,3495,2354,17,5385,41,0,67,229410.0,130000.0,-60.0,-36.0,-45.0,-44.0,-48.0,-35.0,-43.0,-45.0,-90.0,-90.0,-87.0,-89.0,30.0,54.0,42.0,45.0,1
3409,62:47:05:9D:EB:15,3845550,487164113,2168,2436282,3843382,484727831,0,4419,3021097,4387,3015978,32,5119,2075,0,2227,56,0,108,229410.0,130000.0,-43.0,-51.0,-40.0,-46.0,-46.0,-46.0,-38.0,-46.0,-90.0,-90.0,-87.0,-89.0,47.0,39.0,47.0,43.0,1
3410,3C:55:76:E8:8F:1F,3937687,720863562,94305,236135731,3843382,484727831,43,46290,10373854,45655,10260577,635,113277,19488,46,94416,9988,43,636,68820.0,16250.0,-50.0,-55.0,-49.0,-45.0,-49.0,-55.0,-47.0,-44.0,-90.0,-90.0,-87.0,-89.0,40.0,35.0,38.0,44.0,1
3411,92:69:1D:31:68:E9,3847400,488377512,4018,3649681,3843382,484727831,0,5210,1143015,5048,1106277,162,36738,2189,12,4260,102,0,56,229410.0,130000.0,-52.0,-47.0,-42.0,-48.0,-52.0,-47.0,-43.0,-47.0,-90.0,-90.0,-87.0,-89.0,38.0,43.0,45.0,41.0,1
3412,CC:2F:71:3F:1F:24,4914069,1693256176,1070686,1208528072,3843383,484728104,479,887155,984264472,886353,984167410,802,97062,857593,15,1070507,111277,476,684,130000.0,43333.0,-69.0,-70.0,-67.0,-73.0,-69.0,-70.0,-66.0,-73.0,-90.0,-90.0,-87.0,-89.0,21.0,20.0,20.0,16.0,1
3413,CC:2F:71:3E:C5:1F,3844340,484845072,957,116968,3843383,484728104,0,3993,335518,3296,252742,697,82776,1013,12,1377,26,0,53,130000.0,39000.0,-72.0,-72.0,-69.0,-61.0,-71.0,-70.0,-66.0,-60.0,-90.0,-90.0,-87.0,-89.0,18.0,18.0,18.0,28.0,1
3414,BA:8C:B9:54:50:24,3848283,490918046,4899,6189880,3843384,484728166,0,9457,1731340,9435,1727845,22,3495,2354,17,5385,41,0,67,229410.0,130000.0,-48.0,-35.0,-43.0,-45.0,-47.0,-35.0,-43.0,-46.0,-90.0,-90.0,-87.0,-89.0,42.0,55.0,44.0,44.0,1
3415,62:47:05:9D:EB:15,3845557,487164914,2168,2436282,3843389,484728632,0,4419,3021097,4387,3015978,32,5119,2075,0,2227,56,0,108,229410.0,130000.0,-43.0,-51.0,-40.0,-46.0,-46.0,-46.0,-38.0,-46.0,-90.0,-90.0,-87.0,-89.0,47.0,39.0,47.0,43.0,1
3416,3C:55:76:E8:8F:1F,3937735,720956254,94346,236227622,3843389,484728632,43,46345,10396196,45708,10282683,637,113513,19510,46,94458,9988,43,639,68820.0,1000.0,-49.0,-58.0,-46.0,-45.0,-49.0,-57.0,-46.0,-44.0,-90.0,-90.0,-87.0,-89.0,41.0,32.0,41.0,44.0,1
3417,92:69:1D:31:68:E9,3847407,488378313,4018,3649681,3843389,484728632,0,5210,1143015,5048,1106277,162,36738,2189,12,4260,102,0,56,229410.0,130000.0,-52.0,-47.0,-42.0,-48.0,-52.0,-47.0,-43.0,-47.0,-90.0,-90.0,-87.0,-89.0,38.0,43.0,45.0,41.0,1
3418,CC:2F:71:3F:1F:24,4914290,1693523444,1070899,1208794610,3843391,484728834,479,887353,984524622,886551,984427560,802,97062,857782,15,1070720,111293,476,684,130000.0,43333.0,-69.0,-71.0,-67.0,-74.0,-68.0,-70.0,-67.0,-73.0,-90.0,-90.0,-87.0,-89.0,21.0,19.0,20.0,15.0,1
3419,CC:2F:71:3E:C5:1F,3844349,484845864,957,116968,3843392,484728896,0,3994,335636,3296,252742,698,82894,1014,12,1377,26,0,53,130000.0,39000.0,-72.0,-72.0,-69.0,-60.0,-73.0,-73.0,-70.0,-61.0,-90.0,-90.0,-87.0,-89.0,18.0,18.0,18.0,29.0,1
3420,BA:8C:B9:54:50:24,3848291,490918776,4899,6189880,3843392,484728896,0,9463,1731748,9441,1728253,22,3495,2354,17,5385,41,0,67,229410.0,130000.0,-48.0,-35.0,-43.0,-46.0,-48.0,-35.0,-43.0,-45.0,-90.0,-90.0,-87.0,-89.0,42.0,55.0,44.0,43.0,1
3421,62:47:05:9D:EB:15,3845563,487165440,2168,2436282,3843395,484729158,0,4419,3021097,4387,3015978,32,5119,2075,0,2227,56,0,108,229410.0,130000.0,-43.0,-51.0,-40.0,-46.0,-46.0,-46.0,-38.0,-46.0,-90.0,-90.0,-87.0,-89.0,47.0,39.0,47.0,43.0,1
3422,3C:55:76:E8:8F:1F,3937742,720956918,94347,236227760,3843395,484729158,43,46354,10396856,45717,10283343,637,113513,19511,46,94459,9988,43,639,68820.0,1000.0,-49.0,-57.0,-46.0,-44.0,-48.0,-56.0,-44.0,-43.0,-90.0,-90.0,-87.0,-89.0,41.0,33.0,41.0,45.0,1
3423,92:69:1D:31:68:E9,3847413,488378839,4018,3649681,3843395,484729158,0,5210,1143015,5048,1106277,162,36738,2189,12,4260,102,0,56,229410.0,130000.0,-52.0,-47.0,-42.0,-48.0,-52.0,-47.0,-43.0,-47.0,-90.0,-90.0,-87.0,-89.0,38.0,43.0,45.0,41.0,1
3424,CC:2F:71:3F:1F:24,4914502,1693785160,1071107,1209056002,3843395,484729158,479,887551,984786378,886749,984689316,802,97062,857966,15,1070928,111300,476,684,130000.0,43333.0,-69.0,-70.0,-67.0,-74.0,-68.0,-70.0,-66.0,-73.0,-90.0,-90.0,-87.0,-89.0,21.0,20.0,20.0,15.0,1
3425,CC:2F:71:3E:C5:1F,3844352,484846126,957,116968,3843395,484729158,0,3995,335706,3297,252812,698,82894,1014,12,1377,26,0,53,130000.0,39000.0,-73.0,-72.0,-69.0,-61.0,-73.0,-73.0,-70.0,-61.0,-90.0,-90.0,-87.0,-89.0,17.0,18.0,18.0,28.0,1
3426,BA:8C:B9:54:50:24,3848296,490919240,4899,6189880,3843397,484729360,0,9463,1731748,9441,1728253,22,3495,2354,17,5385,41,0,67,229410.0,130000.0,-48.0,-35.0,-43.0,-46.0,-48.0,-35.0,-43.0,-45.0,-90.0,-90.0,-87.0,-89.0,42.0,55.0,44.0,43.0,1
3427,62:47:05:9D:EB:15,3845571,487166248,2168,2436282,3843403,484729966,0,4419,3021097,4387,3015978,32,5119,2075,0,2227,56,0,108,229410.0,130000.0,-43.0,-51.0,-40.0,-46.0,-46.0,-46.0,-38.0,-46.0,-90.0,-90.0,-87.0,-89.0,47.0,39.0,47.0,43.0,1
3428,3C:55:76:E8:8F:1F,3938185,722271057,94782,237541091,3843403,484729966,43,46577,10435055,45940,10321542,637,113513,19597,46,94858,9996,43,639,103230.0,16250.0,-51.0,-55.0,-48.0,-45.0,-50.0,-55.0,-47.0,-44.0,-90.0,-90.0,-87.0,-89.0,39.0,35.0,39.0,44.0,1
3429,92:69:1D:31:68:E9,3847421,488379647,4018,3649681,3843403,484729966,0,5210,1143015,5048,1106277,162,36738,2189,12,4260,102,0,56,229410.0,130000.0,-52.0,-47.0,-42.0,-48.0,-52.0,-47.0,-43.0,-47.0,-90.0,-90.0,-87.0,-89.0,38.0,43.0,45.0,41.0,1
3430,CC:2F:71:3F:1F:24,4914759,1694104477,1071356,1209374511,3843403,484729966,479,887789,985101514,886987,985004452,802,97062,858191,15,1071177,111317,476,684,130000.0,43333.0,-69.0,-71.0,-67.0,-74.0,-69.0,-70.0,-66.0,-73.0,-90.0,-90.0,-87.0,-89.0,21.0,19.0,20.0,15.0,1
3431,CC:2F:71:3E:C5:1F,3844360,484846934,957,116968,3843403,484729966,0,3995,335706,3297,252812,698,82894,1014,12,1377,26,0,53,130000.0,39000.0,-73.0,-72.0,-69.0,-61.0,-73.0,-73.0,-70.0,-61.0,-90.0,-90.0,-87.0,-89.0,17.0,18.0,18.0,28.0,1
3432,BA:8C:B9:54:50:24,3848302,490919846,4899,6189880,3843403,484729966,0,9463,1731748,9441,1728253,22,3495,2354,17,5385,41,0,67,229410.0,130000.0,-48.0,-35.0,-43.0,-46.0,-48.0,-35.0,-43.0,-45.0,-90.0,-90.0,-87.0,-89.0,42.0,55.0,44.0,43.0,1
3433,62:47:05:9D:EB:15,3845576,487166712,2168,2436282,3843408,484730430,0,4420,3021165,4388,3016046,32,5119,2075,0,2227,56,0,108,229410.0,130000.0,-48.0,-46.0,-39.0,-47.0,-46.0,-46.0,-39.0,-46.0,-90.0,-90.0,-87.0,-89.0,42.0,44.0,48.0,42.0,1
3434,3C:55:76:E8:8F:1F,3938646,723632942,95238,238902512,3843408,484730430,43,46729,10460931,46092,10347418,637,113513,19679,46,95318,9996,43,640,137640.0,32500.0,-50.0,-55.0,-49.0,-45.0,-49.0,-55.0,-48.0,-44.0,-90.0,-90.0,-87.0,-89.0,40.0,35.0,38.0,44.0,1
3435,92:69:1D:31:68:E9,3847426,488380111,4018,3649681,3843408,484730430,0,5210,1143015,5048,1106277,162,36738,2189,12,4260,102,0,56,229410.0,130000.0,-52.0,-47.0,-42.0,-48.0,-52.0,-47.0,-43.0,-47.0,-90.0,-90.0,-87.0,-89.0,38.0,43.0,45.0,41.0,1
3436,CC:2F:71:3F:1F:24,4914998,1694403873,1071590,1209673443,3843408,484730430,479,888014,985403318,887212,985306256,802,97062,858404,15,1071411,111371,476,684,117000.0,39000.0,-70.0,-70.0,-66.0,-73.0,-70.0,-70.0,-66.0,-73.0,-90.0,-90.0,-87.0,-89.0,20.0,20.0,21.0,16.0,1
3437,CC:2F:71:3E:C5:1F,3844365,484847398,957,116968,3843408,484730430,0,3995,335706,3297,252812,698,82894,1014,12,1377,26,0,53,130000.0,39000.0,-73.0,-72.0,-69.0,-61.0,-73.0,-73.0,-70.0,-61.0,-90.0,-90.0,-87.0,-89.0,17.0,18.0,18.0,28.0,1
3438,BA:8C:B9:54:50:24,3848309,490920512,4899,6189880,3843410,484730632,0,9463,1731748,9441,1728253,22,3495,2354,17,5385,41,0,67,229410.0,130000.0,-48.0,-35.0,-43.0,-46.0,-48.0,-35.0,-43.0,-45.0,-90.0,-90.0,-87.0,-89.0,42.0,55.0,44.0,43.0,1
3439,62:47:05:9D:EB:15,3845581,487167178,2168,2436282,3843413,484730896,0,4421,3021233,4389,3016114,32,5119,2075,0,2227,56,0,108,229410.0,130000.0,-43.0,-50.0,-40.0,-46.0,-46.0,-47.0,-39.0,-46.0,-90.0,-90.0,-87.0,-89.0,47.0,40.0,47.0,43.0,1
3440,3C:55:76:E8:8F:1F,3938847,724196196,95434,239465300,3843413,484730896,43,46813,10497390,46175,10383759,638,113631,19729,46,95545,9996,43,641,146250.0,48750.0,-48.0,-57.0,-47.0,-44.0,-48.0,-56.0,-47.0,-44.0,-90.0,-90.0,-87.0,-89.0,42.0,33.0,40.0,45.0,1
3441,92:69:1D:31:68:E9,3847431,488380577,4018,3649681,3843413,484730896,0,5210,1143015,5048,1106277,162,36738,2189,12,4260,102,0,56,229410.0,130000.0,-52.0,-47.0,-42.0,-48.0,-52.0,-47.0,-43.0,-47.0,-90.0,-90.0,-87.0,-89.0,38.0,43.0,45.0,41.0,1
3442,CC:2F:71:3F:1F:24,4915220,1694678285,1071807,1209947389,3843413,484730896,479,888211,985664866,887409,985567804,802,97062,858593,15,1071628,111397,476,685,115556.0,26000.0,-69.0,-71.0,-67.0,-75.0,-69.0,-70.0,-66.0,-75.0,-90.0,-90.0,-87.0,-89.0,21.0,19.0,20.0,14.0,1
3443,CC:2F:71:3E:C5:1F,3844370,484847864,957,116968,3843413,484730896,0,3995,335706,3297,252812,698,82894,1014,12,1377,26,0,53,130000.0,39000.0,-73.0,-72.0,-69.0,-61.0,-73.0,-73.0,-70.0,-61.0,-90.0,-90.0,-87.0,-89.0,17.0,18.0,18.0,28.0,1
3444,BA:8C:B9:54:50:24,3848312,490920776,4899,6189880,3843413,484730896,0,9463,1731748,9441,1728253,22,3495,2354,17,5385,41,0,67,229410.0,130000.0,-48.0,-35.0,-43.0,-46.0,-48.0,-35.0,-43.0,-45.0,-90.0,-90.0,-87.0,-89.0,42.0,55.0,44.0,43.0,1
3445,62:47:05:9D:EB:15,3845588,487168669,2169,2437247,3843419,484731422,0,4422,3021301,4390,3016182,32,5119,2075,0,2228,56,0,108,229410.0,130000.0,-48.0,-45.0,-38.0,-46.0,-46.0,-47.0,-39.0,-46.0,-90.0,-90.0,-87.0,-89.0,42.0,45.0,49.0,43.0,1
3446,3C:55:76:E8:8F:1F,3938855,724196924,95434,239465300,3843421,484731624,43,46813,10497390,46175,10383759,638,113631,19729,46,95545,9996,43,641,146250.0,48750.0,-48.0,-57.0,-47.0,-44.0,-48.0,-56.0,-47.0,-44.0,-90.0,-90.0,-87.0,-89.0,42.0,33.0,40.0,45.0,1
3447,92:69:1D:31:68:E9,3847439,488381305,4018,3649681,3843421,484731624,0,5211,1143083,5049,1106345,162,36738,2189,12,4260,102,0,56,229410.0,130000.0,-52.0,-47.0,-42.0,-48.0,-52.0,-47.0,-43.0,-47.0,-90.0,-90.0,-87.0,-89.0,38.0,43.0,45.0,41.0,1
3448,CC:2F:71:3F:1F:24,4915445,1694948849,1072024,1210217225,3843421,484731624,479,888414,985929908,887611,985832728,803,97180,858782,15,1071844,111397,476,685,115556.0,28889.0,-70.0,-71.0,-66.0,-75.0,-69.0,-71.0,-66.0,-75.0,-90.0,-90.0,-87.0,-89.0,20.0,19.0,21.0,14.0,1
3449,CC:2F:71:3E:C5:1F,3844380,484848794,957,116968,3843423,484731826,0,3995,335706,3297,252812,698,82894,1014,12,1377,26,0,53,130000.0,39000.0,-73.0,-72.0,-69.0,-61.0,-73.0,-73.0,-70.0,-61.0,-90.0,-90.0,-87.0,-89.0,17.0,18.0,18.0,28.0,1
3450,BA:8C:B9:54:50:24,3848322,490921706,4899,6189880,3843423,484731826,0,9463,1731748,9441,1728253,22,3495,2354,17,5385,41,0,67,229410.0,130000.0,-48.0,-35.0,-43.0,-46.0,-48.0,-35.0,-43.0,-45.0,-90.0,-90.0,-87.0,-89.0,42.0,55.0,44.0,43.0,1
3451,62:47:05:9D:EB:15,3845592,487169073,2169,2437247,3843423,484731826,0,4423,3021369,4391,3016250,32,5119,2075,0,2228,56,0,108,229410.0,130000.0,-48.0,-45.0,-39.0,-46.0,-46.0,-46.0,-39.0,-46.0,-90.0,-90.0,-87.0,-89.0,42.0,45.0,48.0,43.0,1
3452,3C:55:76:E8:8F:1F,3938857,724197126,95434,239465300,3843423,484731826,43,46813,10497390,46175,10383759,638,113631,19729,46,95545,9996,43,641,146250.0,48750.0,-48.0,-57.0,-47.0,-44.0,-48.0,-56.0,-47.0,-44.0,-90.0,-90.0,-87.0,-89.0,42.0,33.0,40.0,45.0,1
3453,92:69:1D:31:68:E9,3847441,488381507,4018,3649681,3843423,484731826,0,5211,1143083,5049,1106345,162,36738,2189,12,4260,102,0,56,229410.0,130000.0,-52.0,-47.0,-42.0,-48.0,-52.0,-47.0,-43.0,-47.0,-90.0,-90.0,-87.0,-89.0,38.0,43.0,45.0,41.0,1
3454,CC:2F:71:3F:1F:24,4915664,1695215094,1072241,1210483268,3843423,484731826,479,888620,986189484,887817,986092304,803,97180,858978,15,1072062,111438,476,685,104000.0,26000.0,-70.0,-71.0,-67.0,-75.0,-70.0,-71.0,-66.0,-74.0,-90.0,-90.0,-87.0,-89.0,20.0,19.0,20.0,14.0,1
3455,CC:2F:71:3E:C5:1F,3844382,484848996,957,116968,3843425,484732028,0,3995,335706,3297,252812,698,82894,1014,12,1377,26,0,53,130000.0,39000.0,-73.0,-72.0,-69.0,-61.0,-73.0,-73.0,-70.0,-61.0,-90.0,-90.0,-87.0,-89.0,17.0,18.0,18.0,28.0,1
3456,BA:8C:B9:54:50:24,3848326,490922110,4899,6189880,3843427,484732230,0,9463,1731748,9441,1728253,22,3495,2354,17,5385,41,0,67,229410.0,130000.0,-48.0,-35.0,-43.0,-46.0,-48.0,-35.0,-43.0,-45.0,-90.0,-90.0,-87.0,-89.0,42.0,55.0,44.0,43.0,1
3457,62:47:05:9D:EB:15,3845600,487169881,2169,2437247,3843431,484732634,0,4423,3021369,4391,3016250,32,5119,2075,0,2228,56,0,108,229410.0,130000.0,-48.0,-45.0,-39.0,-46.0,-46.0,-46.0,-39.0,-46.0,-90.0,-90.0,-87.0,-89.0,42.0,45.0,48.0,43.0,1
3458,3C:55:76:E8:8F:1F,3938882,724203982,95451,239471348,3843431,484732634,43,46852,10521692,46214,10408061,638,113631,19749,46,95562,9996,43,642,135410.0,48750.0,-52.0,-56.0,-49.0,-46.0,-51.0,-55.0,-49.0,-44.0,-90.0,-90.0,-87.0,-89.0,38.0,34.0,38.0,43.0,1
3459,92:69:1D:31:68:E9,3847449,488382315,4018,3649681,3843431,484732634,0,5211,1143083,5049,1106345,162,36738,2189,12,4260,102,0,56,229410.0,130000.0,-52.0,-47.0,-42.0,-48.0,-52.0,-47.0,-43.0,-47.0,-90.0,-90.0,-87.0,-89.0,38.0,43.0,45.0,41.0,1
3460,CC:2F:71:3F:1F:24,4915887,1695483790,1072455,1210751096,3843432,484732694,479,888820,986452800,888017,986355620,803,97180,859164,15,1072275,111440,476,685,115556.0,28889.0,-70.0,-71.0,-66.0,-75.0,-70.0,-71.0,-66.0,-74.0,-90.0,-90.0,-87.0,-89.0,20.0,19.0,21.0,14.0,1
3461,CC:2F:71:3E:C5:1F,3844389,484849662,957,116968,3843432,484732694,0,3997,335846,3299,252952,698,82894,1014,12,1378,26,0,53,130000.0,39000.0,-73.0,-71.0,-70.0,-60.0,-73.0,-73.0,-70.0,-61.0,-90.0,-90.0,-87.0,-89.0,17.0,19.0,17.0,29.0,1
3462,BA:8C:B9:54:50:24,3848331,490922574,4899,6189880,3843432,484732694,0,9465,1731884,9443,1728389,22,3495,2354,17,5386,41,0,67,229410.0,130000.0,-48.0,-35.0,-42.0,-45.0,-48.0,-35.0,-42.0,-45.0,-90.0,-90.0,-87.0,-89.0,42.0,55.0,45.0,44.0,1
3463,62:47:05:9D:EB:15,3845603,487170143,2169,2437247,3843434,484732896,0,4423,3021369,4391,3016250,32,5119,2075,0,2228,56,0,108,229410.0,130000.0,-48.0,-45.0,-39.0,-46.0,-46.0,-46.0,-39.0,-46.0,-90.0,-90.0,-87.0,-89.0,42.0,45.0,48.0,43.0,1
3464,3C:55:76:E8:8F:1F,3938943,724269390,95509,239536494,3843434,484732896,43,46942,10563411,46304,10449780,638,113631,19807,46,95620,9996,43,644,146250.0,1000.0,-48.0,-53.0,-52.0,-41.0,-48.0,-53.0,-51.0,-41.0,-90.0,-90.0,-87.0,-89.0,42.0,37.0,35.0,48.0,1
3465,92:69:1D:31:68:E9,3847466,488388378,4018,3649681,3843448,484738697,0,5213,1143386,5050,1106413,163,36973,2190,12,4260,102,0,56,229410.0,130000.0,-53.0,-50.0,-46.0,-51.0,-52.0,-47.0,-43.0,-47.0,-90.0,-90.0,-87.0,-89.0,37.0,40.0,41.0,38.0,1
3466,CC:2F:71:3F:1F:24,4916132,1695776651,1072682,1211037438,3843450,484739213,479,889029,986729694,888226,986632514,803,97180,859369,15,1072503,111483,476,685,104000.0,26000.0,-70.0,-72.0,-67.0,-74.0,-70.0,-72.0,-67.0,-74.0,-90.0,-90.0,-87.0,-89.0,20.0,18.0,20.0,15.0,1
3467,CC:2F:71:3E:C5:1F,3844407,484856181,957,116968,3843450,484739213,0,3997,335846,3299,252952,698,82894,1014,12,1378,26,0,53,130000.0,39000.0,-73.0,-71.0,-70.0,-60.0,-73.0,-73.0,-70.0,-61.0,-90.0,-90.0,-87.0,-89.0,17.0,19.0,17.0,29.0,1
3468,BA:8C:B9:54:50:24,3848360,490934517,4899,6189880,3843461,484744637,0,9465,1731884,9443,1728389,22,3495,2354,17,5386,41,0,67,229410.0,130000.0,-48.0,-35.0,-42.0,-45.0,-48.0,-35.0,-42.0,-45.0,-90.0,-90.0,-87.0,-89.0,42.0,55.0,45.0,44.0,1
3469,62:47:05:9D:EB:15,3845634,487182288,2169,2437247,3843465,484745041,0,4423,3021369,4391,3016250,32,5119,2075,0,2228,56,0,108,229410.0,130000.0,-48.0,-45.0,-39.0,-46.0,-46.0,-46.0,-39.0,-46.0,-90.0,-90.0,-87.0,-89.0,42.0,45.0,48.0,43.0,1
3470,3C:55:76:E8:8F:1F,3938989,724292715,95524,239547674,3843465,484745041,43,46980,10576820,46340,10462561,640,114259,19824,46,95635,9996,43,648,135410.0,81250.0,-51.0,-55.0,-48.0,-46.0,-49.0,-53.0,-46.0,-44.0,-90.0,-90.0,-87.0,-89.0,39.0,35.0,39.0,43.0,1
3471,92:69:1D:31:68:E9,3847483,488394722,4018,3649681,3843465,484745041,0,5214,1143454,5051,1106481,163,36973,2190,12,4260,102,0,56,229410.0,130000.0,-51.0,-48.0,-44.0,-47.0,-52.0,-47.0,-43.0,-47.0,-90.0,-90.0,-87.0,-89.0,39.0,42.0,43.0,42.0,1
3472,CC:2F:71:3F:1F:24,4916367,1696052338,1072902,1211307297,3843465,484745041,479,889236,986993202,888433,986896022,803,97180,859563,15,1072723,111508,476,685,115556.0,28889.0,-69.0,-70.0,-66.0,-73.0,-69.0,-70.0,-66.0,-73.0,-90.0,-90.0,-87.0,-89.0,21.0,20.0,21.0,16.0,1
3473,CC:2F:71:3E:C5:1F,3844422,484862009,957,116968,3843465,484745041,0,3997,335846,3299,252952,698,82894,1014,12,1378,26,0,53,130000.0,39000.0,-73.0,-71.0,-70.0,-60.0,-73.0,-73.0,-70.0,-61.0,-90.0,-90.0,-87.0,-89.0,17.0,19.0,17.0,29.0,1
3474,BA:8C:B9:54:50:24,3848365,490934981,4899,6189880,3843466,484745101,0,9465,1731884,9443,1728389,22,3495,2354,17,5386,41,0,67,229410.0,130000.0,-48.0,-35.0,-42.0,-45.0,-48.0,-35.0,-42.0,-45.0,-90.0,-90.0,-87.0,-89.0,42.0,55.0,45.0,44.0,1
3475,62:47:05:9D:EB:15,3845639,487182752,2169,2437247,3843470,484745505,0,4423,3021369,4391,3016250,32,5119,2075,0,2228,56,0,108,229410.0,130000.0,-48.0,-45.0,-39.0,-46.0,-46.0,-46.0,-39.0,-46.0,-90.0,-90.0,-87.0,-89.0,42.0,45.0,48.0,43.0,1
3476,3C:55:76:E8:8F:1F,3939824,726296614,96354,241551109,3843470,484745505,43,47419,10664934,46779,10550675,640,114259,20054,46,96426,10002,43,650,77420.0,1000.0,-47.0,-52.0,-47.0,-41.0,-48.0,-53.0,-48.0,-44.0,-90.0,-90.0,-87.0,-89.0,43.0,38.0,40.0,48.0,1
3477,92:69:1D:31:68:E9,3847489,488395459,4018,3649681,3843471,484745778,0,5214,1143454,5051,1106481,163,36973,2190,12,4260,102,0,56,229410.0,130000.0,-51.0,-48.0,-44.0,-47.0,-52.0,-47.0,-43.0,-47.0,-90.0,-90.0,-87.0,-89.0,39.0,42.0,43.0,42.0,1
3478,CC:2F:71:3F:1F:24,4916606,1696347363,1073135,1211601585,3843471,484745778,479,889454,987279946,888651,987182766,803,97180,859774,15,1072956,111573,476,685,115556.0,28889.0,-69.0,-70.0,-66.0,-73.0,-69.0,-70.0,-66.0,-72.0,-90.0,-90.0,-87.0,-89.0,21.0,20.0,21.0,16.0,1
3479,CC:2F:71:3E:C5:1F,3844432,484863150,957,116968,3843475,484746182,0,3997,335846,3299,252952,698,82894,1014,12,1378,26,0,53,130000.0,39000.0,-73.0,-71.0,-70.0,-60.0,-73.0,-73.0,-70.0,-61.0,-90.0,-90.0,-87.0,-89.0,17.0,19.0,17.0,29.0,1
3480,BA:8C:B9:54:50:24,3848374,490936062,4899,6189880,3843475,484746182,0,9465,1731884,9443,1728389,22,3495,2354,17,5386,41,0,67,229410.0,130000.0,-48.0,-35.0,-42.0,-45.0,-48.0,-35.0,-42.0,-45.0,-90.0,-90.0,-87.0,-89.0,42.0,55.0,45.0,44.0,1
3481,62:47:05:9D:EB:15,3845646,487183631,2169,2437247,3843477,484746384,0,4423,3021369,4391,3016250,32,5119,2075,0,2228,56,0,108,229410.0,130000.0,-48.0,-45.0,-39.0,-46.0,-46.0,-46.0,-39.0,-46.0,-90.0,-90.0,-87.0,-89.0,42.0,45.0,48.0,43.0,1
3482,3C:55:76:E8:8F:1F,3940171,727092658,96694,242346274,3843477,484746384,45,47706,10745153,47066,10630894,640,114259,20250,47,96802,10019,45,653,17200.0,1000.0,-50.0,-55.0,-49.0,-46.0,-49.0,-53.0,-48.0,-44.0,-90.0,-90.0,-87.0,-89.0,40.0,35.0,38.0,43.0,1
3483,92:69:1D:31:68:E9,3847497,488396267,4018,3649681,3843479,484746586,0,5214,1143454,5051,1106481,163,36973,2190,12,4260,102,0,56,229410.0,130000.0,-51.0,-48.0,-44.0,-47.0,-52.0,-47.0,-43.0,-47.0,-90.0,-90.0,-87.0,-89.0,39.0,42.0,43.0,42.0,1
3484,CC:2F:71:3F:1F:24,4916895,1696721879,1073415,1211975233,3843480,484746646,479,889718,987648716,888915,987551536,803,97180,860028,15,1073234,111601,476,685,115556.0,28889.0,-69.0,-70.0,-66.0,-73.0,-68.0,-70.0,-66.0,-72.0,-90.0,-90.0,-87.0,-89.0,21.0,20.0,21.0,16.0,1
3485,CC:2F:71:3E:C5:1F,3844437,484863614,957,116968,3843480,484746646,0,3997,335846,3299,252952,698,82894,1014,12,1378,26,0,53,130000.0,39000.0,-73.0,-71.0,-70.0,-60.0,-73.0,-73.0,-70.0,-61.0,-90.0,-90.0,-87.0,-89.0,17.0,19.0,17.0,29.0,1
3486,BA:8C:B9:54:50:24,3848379,490936526,4899,6189880,3843480,484746646,0,9465,1731884,9443,1728389,22,3495,2354,17,5386,41,0,67,229410.0,130000.0,-48.0,-35.0,-42.0,-45.0,-48.0,-35.0,-42.0,-45.0,-90.0,-90.0,-87.0,-89.0,42.0,55.0,45.0,44.0,1
3487,62:47:05:9D:EB:15,3845655,487184665,2169,2437247,3843486,484747418,0,4423,3021369,4391,3016250,32,5119,2075,0,2228,56,0,108,229410.0,130000.0,-48.0,-45.0,-39.0,-46.0,-46.0,-46.0,-39.0,-46.0,-90.0,-90.0,-87.0,-89.0,42.0,45.0,48.0,43.0,1
3488,3C:55:76:E8:8F:1F,3940287,727289038,96801,242541620,3843486,484747418,47,47844,10765627,47204,10651368,640,114259,20341,63,96918,10084,47,653,5500.0,1000.0,-48.0,-52.0,-47.0,-41.0,-49.0,-53.0,-48.0,-43.0,-90.0,-90.0,-87.0,-89.0,42.0,38.0,40.0,48.0,1
3489,92:69:1D:31:68:E9,3847508,488397503,4018,3649681,3843490,484747822,0,5214,1143454,5051,1106481,163,36973,2190,12,4260,102,0,56,229410.0,130000.0,-51.0,-48.0,-44.0,-47.0,-52.0,-47.0,-43.0,-47.0,-90.0,-90.0,-87.0,-89.0,39.0,42.0,43.0,42.0,1
3490,CC:2F:71:3F:1F:24,4917249,1697187152,1073759,1212439330,3843490,484747822,479,890055,988110907,889252,988013727,803,97180,860354,15,1073570,111629,476,685,115556.0,28889.0,-69.0,-70.0,-66.0,-72.0,-69.0,-70.0,-66.0,-72.0,-90.0,-90.0,-87.0,-89.0,21.0,20.0,21.0,17.0,1
3491,CC:2F:71:3E:C5:1F,3844447,484864790,957,116968,3843490,484747822,0,3997,335846,3299,252952,698,82894,1014,12,1378,26,0,53,130000.0,39000.0,-73.0,-71.0,-70.0,-60.0,-73.0,-73.0,-70.0,-61.0,-90.0,-90.0,-87.0,-89.0,17.0,19.0,17.0,29.0,1
3492,BA:8C:B9:54:50:24,3848393,490938106,4899,6189880,3843494,484748226,0,9472,1732360,9450,1728865,22,3495,2354,17,5386,41,0,67,229410.0,130000.0,-48.0,-35.0,-43.0,-46.0,-45.0,-35.0,-44.0,-48.0,-90.0,-90.0,-87.0,-89.0,42.0,55.0,44.0,43.0,1
3493,62:47:05:9D:EB:15,3845664,487185533,2169,2437247,3843495,484748286,0,4423,3021369,4391,3016250,32,5119,2075,0,2228,56,0,108,229410.0,130000.0,-48.0,-45.0,-39.0,-46.0,-46.0,-46.0,-39.0,-46.0,-90.0,-90.0,-87.0,-89.0,42.0,45.0,48.0,43.0,1
3494,3C:55:76:E8:8F:1F,3940409,727486154,96914,242737868,3843495,484748286,49,47978,10790239,47338,10675980,640,114259,20432,90,97054,10172,49,655,8120.0,1000.0,-48.0,-53.0,-47.0,-41.0,-49.0,-54.0,-48.0,-44.0,-90.0,-90.0,-87.0,-89.0,42.0,37.0,40.0,48.0,1
3495,92:69:1D:31:68:E9,3847513,488397967,4018,3649681,3843495,484748286,0,5214,1143454,5051,1106481,163,36973,2190,12,4260,102,0,56,229410.0,130000.0,-51.0,-48.0,-44.0,-47.0,-52.0,-47.0,-43.0,-47.0,-90.0,-90.0,-87.0,-89.0,39.0,42.0,43.0,42.0,1
3496,CC:2F:71:3F:1F:24,4917528,1697544628,1074033,1212796342,3843495,484748286,479,890325,988482463,889522,988385283,803,97180,860598,15,1073852,111638,476,685,115556.0,28889.0,-70.0,-72.0,-68.0,-74.0,-70.0,-71.0,-67.0,-73.0,-90.0,-90.0,-87.0,-89.0,20.0,18.0,19.0,15.0,1
3497,CC:2F:71:3E:C5:1F,3844456,484865658,957,116968,3843499,484748690,0,3997,335846,3299,252952,698,82894,1014,12,1378,26,0,53,130000.0,39000.0,-73.0,-71.0,-70.0,-60.0,-73.0,-73.0,-70.0,-61.0,-90.0,-90.0,-87.0,-89.0,17.0,19.0,17.0,29.0,1
3498,BA:8C:B9:54:50:24,3848398,490938570,4899,6189880,3843499,484748690,0,9472,1732360,9450,1728865,22,3495,2354,17,5386,41,0,67,229410.0,130000.0,-48.0,-35.0,-43.0,-46.0,-45.0,-35.0,-44.0,-48.0,-90.0,-90.0,-87.0,-89.0,42.0,55.0,44.0,43.0,1
3499,62:47:05:9D:EB:15,3845672,487186341,2169,2437247,3843503,484749094,0,4423,3021369,4391,3016250,32,5119,2075,0,2228,56,0,108,229410.0,130000.0,-48.0,-45.0,-39.0,-46.0,-46.0,-46.0,-39.0,-46.0,-90.0,-90.0,-87.0,-89.0,42.0,45.0,48.0,43.0,1
3500,3C:55:76:E8:8F:1F,3940582,727821993,97079,243072899,3843503,484749094,54,48171,10837288,47531,10723029,640,114259,20575,95,97216,10187,54,656,17200.0,2000.0,-50.0,-56.0,-49.0,-46.0,-50.0,-55.0,-48.0,-45.0,-90.0,-90.0,-87.0,-89.0,40.0,34.0,38.0,43.0,1
3501,92:69:1D:31:68:E9,3847521,488398775,4018,3649681,3843503,484749094,0,5214,1143454,5051,1106481,163,36973,2190,12,4260,102,0,56,229410.0,130000.0,-51.0,-48.0,-44.0,-47.0,-52.0,-47.0,-43.0,-47.0,-90.0,-90.0,-87.0,-89.0,39.0,42.0,43.0,42.0,1
3502,CC:2F:71:3F:1F:24,4917821,1697919417,1074317,1213170263,3843504,484749154,479,890604,988856686,889801,988759506,803,97180,860862,15,1074137,111650,476,685,117000.0,39000.0,-70.0,-71.0,-68.0,-74.0,-69.0,-71.0,-67.0,-73.0,-90.0,-90.0,-87.0,-89.0,20.0,19.0,19.0,15.0,1
3503,CC:2F:71:3E:C5:1F,3844461,484866122,957,116968,3843504,484749154,0,3997,335846,3299,252952,698,82894,1014,12,1378,26,0,53,130000.0,39000.0,-73.0,-71.0,-70.0,-60.0,-73.0,-73.0,-70.0,-61.0,-90.0,-90.0,-87.0,-89.0,17.0,19.0,17.0,29.0,1
3504,BA:8C:B9:54:50:24,3848403,490939034,4899,6189880,3843504,484749154,0,9477,1732700,9455,1729205,22,3495,2354,17,5386,41,0,67,229410.0,130000.0,-40.0,-36.0,-46.0,-52.0,-46.0,-35.0,-43.0,-47.0,-90.0,-90.0,-87.0,-89.0,50.0,54.0,41.0,37.0,1
3505,62:47:05:9D:EB:15,3845681,487187209,2169,2437247,3843512,484749962,0,4423,3021369,4391,3016250,32,5119,2075,0,2228,56,0,108,229410.0,130000.0,-48.0,-45.0,-39.0,-46.0,-46.0,-46.0,-39.0,-46.0,-90.0,-90.0,-87.0,-89.0,42.0,45.0,48.0,43.0,1
3506,3C:55:76:E8:8F:1F,3941185,729202838,97673,244452876,3843512,484749962,54,48625,10957180,47985,10842921,640,114259,20847,95,97777,10187,54,656,51610.0,8120.0,-47.0,-52.0,-47.0,-41.0,-49.0,-55.0,-48.0,-44.0,-90.0,-90.0,-87.0,-89.0,43.0,38.0,40.0,48.0,1
3507,92:69:1D:31:68:E9,3847530,488399643,4018,3649681,3843512,484749962,0,5214,1143454,5051,1106481,163,36973,2190,12,4260,102,0,56,229410.0,130000.0,-51.0,-48.0,-44.0,-47.0,-52.0,-47.0,-43.0,-47.0,-90.0,-90.0,-87.0,-89.0,39.0,42.0,43.0,42.0,1
3508,CC:2F:71:3F:1F:24,4918141,1698337849,1074629,1213587887,3843512,484749962,479,890911,989279200,890108,989182020,803,97180,861151,15,1074450,111685,476,685,115556.0,28889.0,-70.0,-71.0,-67.0,-73.0,-69.0,-70.0,-67.0,-72.0,-90.0,-90.0,-87.0,-89.0,20.0,19.0,20.0,16.0,1
3509,CC:2F:71:3E:C5:1F,3844469,484866930,957,116968,3843512,484749962,0,3997,335846,3299,252952,698,82894,1014,12,1378,26,0,53,130000.0,39000.0,-73.0,-71.0,-70.0,-60.0,-73.0,-73.0,-70.0,-61.0,-90.0,-90.0,-87.0,-89.0,17.0,19.0,17.0,29.0,1
3510,BA:8C:B9:54:50:24,3848411,490939842,4899,6189880,3843512,484749962,0,9477,1732700,9455,1729205,22,3495,2354,17,5386,41,0,67,229410.0,130000.0,-40.0,-36.0,-46.0,-52.0,-46.0,-35.0,-43.0,-47.0,-90.0,-90.0,-87.0,-89.0,50.0,54.0,41.0,37.0,1
3511,62:47:05:9D:EB:15,3845690,487188077,2169,2437247,3843521,484750830,0,4424,3021437,4392,3016318,32,5119,2075,0,2228,56,0,108,229410.0,130000.0,-43.0,-50.0,-40.0,-47.0,-46.0,-47.0,-39.0,-46.0,-90.0,-90.0,-86.0,-89.0,47.0,40.0,46.0,42.0,1
3512,3C:55:76:E8:8F:1F,3941526,730022305,98005,245271475,3843521,484750830,54,48866,11008632,48226,10894373,640,114259,20997,100,98154,10208,54,657,8120.0,1000.0,-50.0,-56.0,-48.0,-47.0,-49.0,-54.0,-47.0,-44.0,-90.0,-90.0,-86.0,-89.0,40.0,34.0,38.0,42.0,1
3513,92:69:1D:31:68:E9,3847539,488400511,4018,3649681,3843521,484750830,0,5215,1143522,5052,1106549,163,36973,2190,12,4260,102,0,56,229410.0,130000.0,-53.0,-47.0,-42.0,-49.0,-52.0,-47.0,-43.0,-48.0,-90.0,-90.0,-86.0,-89.0,37.0,43.0,44.0,40.0,1
3514,CC:2F:71:3F:1F:24,4918463,1698754530,1074942,1214003700,3843521,484750830,479,891206,989683742,890403,989586562,803,97180,861436,15,1074759,111698,476,685,130000.0,39000.0,-70.0,-71.0,-68.0,-74.0,-70.0,-71.0,-67.0,-73.0,-90.0,-90.0,-86.0,-89.0,20.0,19.0,18.0,15.0,1
3515,CC:2F:71:3E:C5:1F,3844479,484867914,958,117084,3843521,484750830,0,3999,335986,3301,253092,698,82894,1014,12,1379,26,0,53,130000.0,39000.0,-73.0,-72.0,-70.0,-60.0,-73.0,-73.0,-70.0,-61.0,-90.0,-90.0,-86.0,-89.0,17.0,18.0,16.0,29.0,1
3516,BA:8C:B9:54:50:24,3848421,490940770,4900,6189940,3843521,484750830,0,9479,1732836,9457,1729341,22,3495,2354,17,5387,41,0,67,229410.0,130000.0,-40.0,-36.0,-46.0,-52.0,-44.0,-35.0,-44.0,-48.0,-90.0,-90.0,-86.0,-89.0,50.0,54.0,40.0,37.0,1
3517,62:47:05:9D:EB:15,3845695,487188597,2170,2437363,3843525,484751234,0,4426,3021573,4394,3016454,32,5119,2075,0,2229,56,0,108,229410.0,130000.0,-43.0,-50.0,-40.0,-47.0,-44.0,-48.0,-39.0,-46.0,-90.0,-90.0,-87.0,-89.0,47.0,40.0,47.0,42.0,1
3518,3C:55:76:E8:8F:1F,3941732,730483618,98205,245732182,3843527,484751436,59,49017,11042033,48377,10927774,640,114259,21103,106,98359,10231,59,658,17200.0,2000.0,-51.0,-56.0,-48.0,-46.0,-50.0,-55.0,-48.0,-45.0,-90.0,-90.0,-87.0,-89.0,39.0,34.0,39.0,43.0,1
3519,92:69:1D:31:68:E9,3847548,488401435,4019,3649797,3843529,484751638,0,5216,1143590,5053,1106617,163,36973,2190,12,4261,102,0,56,229410.0,137640.0,-53.0,-47.0,-42.0,-48.0,-52.0,-47.0,-43.0,-48.0,-90.0,-90.0,-87.0,-89.0,37.0,43.0,45.0,41.0,1
3520,CC:2F:71:3F:1F:24,4918744,1699113302,1075214,1214361604,3843530,484751698,479,891468,990045376,890665,989948196,803,97180,861683,15,1075033,111747,476,685,115556.0,28889.0,-70.0,-71.0,-67.0,-73.0,-69.0,-71.0,-67.0,-73.0,-90.0,-90.0,-87.0,-89.0,20.0,19.0,20.0,16.0,1
3521,CC:2F:71:3E:C5:1F,3844488,484868782,958,117084,3843530,484751698,0,3999,335986,3301,253092,698,82894,1014,12,1379,26,0,53,130000.0,39000.0,-73.0,-72.0,-70.0,-60.0,-73.0,-73.0,-70.0,-61.0,-90.0,-90.0,-87.0,-89.0,17.0,18.0,17.0,29.0,1
3522,BA:8C:B9:54:50:24,3848430,490941638,4900,6189940,3843530,484751698,0,9480,1732904,9458,1729409,22,3495,2354,17,5387,41,0,67,229410.0,130000.0,-48.0,-35.0,-43.0,-46.0,-44.0,-35.0,-44.0,-48.0,-90.0,-90.0,-87.0,-89.0,42.0,55.0,44.0,43.0,1
3523,62:47:05:9D:EB:15,3845702,487189396,2170,2437363,3843532,484752033,0,4426,3021573,4394,3016454,32,5119,2075,0,2229,56,0,108,229410.0,130000.0,-43.0,-50.0,-40.0,-47.0,-44.0,-48.0,-39.0,-46.0,-90.0,-90.0,-87.0,-89.0,47.0,40.0,47.0,42.0,1
3524,3C:55:76:E8:8F:1F,3941998,731075952,98464,246323717,3843534,484752235,60,49197,11084102,48556,10969725,641,114377,21220,109,98619,10242,60,658,16250.0,2000.0,-47.0,-52.0,-47.0,-41.0,-49.0,-54.0,-47.0,-44.0,-90.0,-90.0,-87.0,-89.0,43.0,38.0,40.0,48.0,1
3525,92:69:1D:31:68:E9,3847555,488402234,4019,3649797,3843536,484752437,0,5216,1143590,5053,1106617,163,36973,2190,12,4261,102,0,56,229410.0,137640.0,-53.0,-47.0,-42.0,-48.0,-52.0,-47.0,-43.0,-48.0,-90.0,-90.0,-87.0,-89.0,37.0,43.0,45.0,41.0,1
3526,CC:2F:71:3F:1F:24,4919014,1699455621,1075477,1214703122,3843537,484752499,479,891719,990382864,890915,990285566,804,97298,861924,15,1075297,111751,476,685,115556.0,28889.0,-70.0,-71.0,-67.0,-73.0,-69.0,-70.0,-67.0,-72.0,-90.0,-90.0,-87.0,-89.0,20.0,19.0,20.0,16.0,1
3527,CC:2F:71:3E:C5:1F,3844495,484869583,958,117084,3843537,484752499,0,3999,335986,3301,253092,698,82894,1014,12,1379,26,0,53,130000.0,39000.0,-73.0,-72.0,-70.0,-60.0,-73.0,-73.0,-70.0,-61.0,-90.0,-90.0,-87.0,-89.0,17.0,18.0,17.0,29.0,1
3528,BA:8C:B9:54:50:24,3848440,490942703,4900,6189940,3843540,484752763,0,9480,1732904,9458,1729409,22,3495,2354,17,5387,41,0,67,229410.0,130000.0,-48.0,-35.0,-43.0,-46.0,-44.0,-35.0,-44.0,-48.0,-90.0,-90.0,-86.0,-89.0,42.0,55.0,43.0,43.0,1
3529,62:47:05:9D:EB:15,3845713,487190388,2170,2437363,3843543,484753025,0,4426,3021573,4394,3016454,32,5119,2075,0,2229,56,0,108,229410.0,130000.0,-43.0,-50.0,-40.0,-47.0,-44.0,-48.0,-39.0,-46.0,-90.0,-90.0,-86.0,-89.0,47.0,40.0,46.0,42.0,1
3530,3C:55:76:E8:8F:1F,3942106,731312588,98563,246559563,3843543,484753025,62,49294,11108930,48653,10994553,641,114377,21284,121,98732,10290,62,659,8120.0,1000.0,-48.0,-53.0,-47.0,-41.0,-49.0,-54.0,-48.0,-43.0,-90.0,-90.0,-86.0,-89.0,42.0,37.0,39.0,48.0,1
3531,92:69:1D:31:68:E9,3847562,488402822,4019,3649797,3843543,484753025,0,5216,1143590,5053,1106617,163,36973,2190,12,4261,102,0,56,229410.0,137640.0,-53.0,-47.0,-42.0,-48.0,-52.0,-47.0,-43.0,-48.0,-90.0,-90.0,-86.0,-89.0,37.0,43.0,44.0,41.0,1
3532,CC:2F:71:3F:1F:24,4919294,1699810832,1075751,1215057807,3843543,484753025,479,891980,990733640,891176,990636342,804,97298,862171,15,1075571,111788,476,686,130000.0,43333.0,-69.0,-71.0,-67.0,-73.0,-69.0,-70.0,-67.0,-72.0,-90.0,-90.0,-86.0,-89.0,21.0,19.0,19.0,16.0,1
3533,CC:2F:71:3E:C5:1F,3844503,484870311,958,117084,3843545,484753227,0,4001,336174,3302,253162,699,83012,1015,12,1379,26,0,53,130000.0,39000.0,-73.0,-72.0,-70.0,-60.0,-72.0,-71.0,-69.0,-60.0,-90.0,-90.0,-86.0,-89.0,17.0,18.0,16.0,29.0,1
3534,BA:8C:B9:54:50:24,3848447,490943369,4900,6189940,3843547,484753429,0,9480,1732904,9458,1729409,22,3495,2354,17,5387,41,0,67,229410.0,130000.0,-48.0,-35.0,-43.0,-46.0,-44.0,-35.0,-44.0,-48.0,-90.0,-90.0,-86.0,-89.0,42.0,55.0,43.0,43.0,1
3535,62:47:05:9D:EB:15,3845721,487191196,2170,2437363,3843551,484753833,0,4426,3021573,4394,3016454,32,5119,2075,0,2229,56,0,108,229410.0,130000.0,-43.0,-50.0,-40.0,-47.0,-44.0,-48.0,-39.0,-46.0,-90.0,-90.0,-86.0,-89.0,47.0,40.0,46.0,42.0,1
3536,3C:55:76:E8:8F:1F,3942237,731546834,98683,246792739,3843554,484754095,64,49423,11128227,48782,11013850,641,114377,21365,154,98869,10414,64,666,5500.0,1000.0,-48.0,-53.0,-48.0,-41.0,-49.0,-54.0,-48.0,-43.0,-90.0,-90.0,-86.0,-89.0,42.0,37.0,38.0,48.0,1
3537,92:69:1D:31:68:E9,3847575,488404094,4019,3649797,3843556,484754297,0,5219,1143794,5056,1106821,163,36973,2190,12,4261,102,0,56,229410.0,137640.0,-53.0,-47.0,-42.0,-49.0,-52.0,-47.0,-43.0,-48.0,-90.0,-90.0,-86.0,-89.0,37.0,43.0,44.0,40.0,1
3538,CC:2F:71:3F:1F:24,4919721,1700386788,1076165,1215632491,3843556,484754297,479,892396,991325228,891592,991227930,804,97298,862563,15,1075986,111881,476,688,130000.0,43333.0,-70.0,-71.0,-67.0,-73.0,-69.0,-70.0,-67.0,-73.0,-90.0,-90.0,-86.0,-89.0,20.0,19.0,19.0,16.0,1
3539,CC:2F:71:3E:C5:1F,3844516,484871583,958,117084,3843558,484754499,0,4001,336174,3302,253162,699,83012,1015,12,1379,26,0,53,130000.0,39000.0,-73.0,-72.0,-70.0,-60.0,-72.0,-71.0,-69.0,-60.0,-90.0,-90.0,-86.0,-89.0,17.0,18.0,16.0,29.0,1
3540,BA:8C:B9:54:50:24,3848460,490944641,4900,6189940,3843560,484754701,0,9480,1732904,9458,1729409,22,3495,2354,17,5387,41,0,67,229410.0,130000.0,-48.0,-35.0,-43.0,-46.0,-44.0,-35.0,-44.0,-48.0,-90.0,-90.0,-86.0,-89.0,42.0,55.0,43.0,43.0,1
3541,62:47:05:9D:EB:15,3845735,487192528,2170,2437363,3843565,484755165,0,4426,3021573,4394,3016454,32,5119,2075,0,2229,56,0,108,229410.0,130000.0,-43.0,-50.0,-40.0,-47.0,-44.0,-48.0,-39.0,-46.0,-90.0,-90.0,-86.0,-89.0,47.0,40.0,46.0,42.0,1
3542,3C:55:76:E8:8F:1F,3942327,731672735,98760,246917368,3843567,484755367,67,49546,11144195,48905,11029818,641,114377,21425,189,98956,10588,67,666,8120.0,1000.0,-51.0,-56.0,-49.0,-46.0,-49.0,-54.0,-48.0,-44.0,-90.0,-90.0,-86.0,-89.0,39.0,34.0,37.0,43.0,1
3543,92:69:1D:31:68:E9,3847587,488405224,4019,3649797,3843568,484755427,0,5219,1143794,5056,1106821,163,36973,2190,12,4261,102,0,56,229410.0,137640.0,-53.0,-47.0,-42.0,-49.0,-52.0,-47.0,-43.0,-48.0,-90.0,-90.0,-86.0,-89.0,37.0,43.0,44.0,40.0,1
3544,CC:2F:71:3F:1F:24,4920117,1700909793,1076549,1216154366,3843568,484755427,479,892769,991841689,891965,991744391,804,97298,862925,15,1076370,112022,476,688,117000.0,39000.0,-69.0,-71.0,-67.0,-73.0,-69.0,-71.0,-67.0,-73.0,-90.0,-90.0,-86.0,-89.0,21.0,19.0,19.0,16.0,1
3545,CC:2F:71:3E:C5:1F,3844528,484872713,958,117084,3843570,484755629,0,4001,336174,3302,253162,699,83012,1015,12,1379,26,0,53,130000.0,39000.0,-73.0,-72.0,-70.0,-60.0,-72.0,-71.0,-69.0,-60.0,-90.0,-90.0,-86.0,-89.0,17.0,18.0,16.0,29.0,1
3546,BA:8C:B9:54:50:24,3848470,490945569,4900,6189940,3843570,484755629,0,9480,1732904,9458,1729409,22,3495,2354,17,5387,41,0,67,229410.0,130000.0,-48.0,-35.0,-43.0,-46.0,-44.0,-35.0,-44.0,-48.0,-90.0,-90.0,-86.0,-89.0,42.0,55.0,43.0,43.0,1
3547,62:47:05:9D:EB:15,3845743,487193256,2170,2437363,3843573,484755893,0,4426,3021573,4394,3016454,32,5119,2075,0,2229,56,0,108,229410.0,130000.0,-43.0,-50.0,-40.0,-47.0,-44.0,-48.0,-39.0,-46.0,-90.0,-90.0,-86.0,-89.0,47.0,40.0,46.0,42.0,1
3548,3C:55:76:E8:8F:1F,3942427,731854278,98852,247098183,3843575,484756095,68,49641,11154779,48999,11040284,642,114495,21481,210,99058,10675,68,667,5500.0,1000.0,-48.0,-53.0,-47.0,-42.0,-49.0,-55.0,-48.0,-44.0,-90.0,-90.0,-86.0,-89.0,42.0,37.0,39.0,47.0,1
3549,92:69:1D:31:68:E9,3847596,488406094,4019,3649797,3843577,484756297,0,5219,1143794,5056,1106821,163,36973,2190,12,4261,102,0,56,229410.0,137640.0,-53.0,-47.0,-42.0,-49.0,-52.0,-47.0,-43.0,-48.0,-90.0,-90.0,-86.0,-89.0,37.0,43.0,44.0,40.0,1
3550,CC:2F:71:3F:1F:24,4920467,1701377305,1076888,1216620806,3843579,484756499,479,893118,992334105,892314,992236807,804,97298,863248,15,1076707,112100,476,688,117000.0,39000.0,-69.0,-70.0,-67.0,-72.0,-68.0,-70.0,-66.0,-72.0,-90.0,-90.0,-86.0,-89.0,21.0,20.0,19.0,17.0,1
3551,CC:2F:71:3E:C5:1F,3844537,484873583,958,117084,3843579,484756499,0,4003,336314,3304,253302,699,83012,1015,12,1380,26,0,53,130000.0,39000.0,-74.0,-72.0,-70.0,-60.0,-72.0,-71.0,-69.0,-60.0,-90.0,-90.0,-86.0,-89.0,16.0,18.0,16.0,29.0,1
3552,BA:8C:B9:54:50:24,3848480,490946499,4900,6189940,3843580,484756559,0,9484,1733176,9462,1729681,22,3495,2354,17,5388,41,0,68,229410.0,130000.0,-48.0,-35.0,-43.0,-46.0,-42.0,-36.0,-45.0,-50.0,-90.0,-90.0,-86.0,-89.0,42.0,55.0,43.0,43.0,1
3553,62:47:05:9D:EB:15,3845754,487194326,2170,2437363,3843584,484756963,0,4428,3021709,4396,3016590,32,5119,2075,0,2230,56,0,108,229410.0,130000.0,-47.0,-46.0,-39.0,-46.0,-45.0,-47.0,-39.0,-46.0,-90.0,-90.0,-86.0,-89.0,43.0,44.0,47.0,43.0,1
3554,3C:55:76:E8:8F:1F,3942598,732149484,99012,247392319,3843586,484757165,70,49792,11192764,49150,11078269,642,114495,21571,227,99227,10756,70,671,8120.0,1000.0,-48.0,-52.0,-47.0,-41.0,-49.0,-55.0,-48.0,-45.0,-90.0,-90.0,-86.0,-89.0,42.0,38.0,39.0,48.0,1
3555,92:69:1D:31:68:E9,3847605,488406962,4019,3649797,3843586,484757165,0,5219,1143794,5056,1106821,163,36973,2190,12,4261,102,0,56,229410.0,137640.0,-53.0,-47.0,-42.0,-49.0,-52.0,-47.0,-43.0,-48.0,-90.0,-90.0,-86.0,-89.0,37.0,43.0,44.0,40.0,1
3556,CC:2F:71:3F:1F:24,4920786,1701793398,1077200,1217036233,3843586,484757165,479,893415,992738832,892611,992641534,804,97298,863537,15,1077019,112165,476,688,115556.0,28889.0,-69.0,-70.0,-67.0,-73.0,-69.0,-70.0,-67.0,-73.0,-90.0,-90.0,-86.0,-89.0,21.0,20.0,19.0,16.0,1
3557,CC:2F:71:3E:C5:1F,3844546,484874451,958,117084,3843588,484757367,0,4003,336314,3304,253302,699,83012,1015,12,1380,26,0,53,130000.0,39000.0,-74.0,-72.0,-70.0,-60.0,-72.0,-71.0,-69.0,-60.0,-90.0,-90.0,-86.0,-89.0,16.0,18.0,16.0,29.0,1
3558,BA:8C:B9:54:50:24,3848488,490947307,4900,6189940,3843588,484757367,0,9484,1733176,9462,1729681,22,3495,2354,17,5388,41,0,68,229410.0,130000.0,-48.0,-35.0,-43.0,-46.0,-42.0,-36.0,-45.0,-50.0,-90.0,-90.0,-86.0,-89.0,42.0,55.0,43.0,43.0,1
3559,62:47:05:9D:EB:15,3845759,487194792,2170,2437363,3843589,484757429,0,4428,3021709,4396,3016590,32,5119,2075,0,2230,56,0,108,229410.0,130000.0,-47.0,-46.0,-39.0,-46.0,-45.0,-47.0,-39.0,-46.0,-90.0,-90.0,-86.0,-89.0,43.0,44.0,47.0,43.0,1
3560,3C:55:76:E8:8F:1F,3942857,732616545,99267,247859056,3843590,484757489,70,49985,11241736,49342,11127123,643,114613,21691,231,99475,10774,70,672,24370.0,1000.0,-51.0,-56.0,-49.0,-47.0,-49.0,-55.0,-48.0,-45.0,-90.0,-90.0,-86.0,-89.0,39.0,34.0,37.0,42.0,1
3561,92:69:1D:31:68:E9,3847609,488407286,4019,3649797,3843590,484757489,0,5219,1143794,5056,1106821,163,36973,2190,12,4261,102,0,56,229410.0,137640.0,-53.0,-47.0,-42.0,-49.0,-52.0,-47.0,-43.0,-48.0,-90.0,-90.0,-86.0,-89.0,37.0,43.0,44.0,40.0,1
3562,CC:2F:71:3F:1F:24,4921063,1702152034,1077471,1217394343,3843592,484757691,479,893668,993084960,892864,992987662,804,97298,863783,15,1077290,112178,476,688,115556.0,28889.0,-69.0,-71.0,-67.0,-73.0,-69.0,-71.0,-67.0,-73.0,-90.0,-90.0,-86.0,-89.0,21.0,19.0,19.0,16.0,1
3563,CC:2F:71:3E:C5:1F,3844554,484875179,958,117084,3843596,484758095,0,4003,336314,3304,253302,699,83012,1015,12,1380,26,0,53,130000.0,39000.0,-74.0,-72.0,-70.0,-60.0,-72.0,-71.0,-69.0,-60.0,-89.0,-89.0,-86.0,-88.0,15.0,17.0,16.0,28.0,1
3564,BA:8C:B9:54:50:24,3848496,490948035,4900,6189940,3843596,484758095,0,9484,1733176,9462,1729681,22,3495,2354,17,5388,41,0,68,229410.0,130000.0,-48.0,-35.0,-43.0,-46.0,-42.0,-36.0,-45.0,-50.0,-89.0,-89.0,-86.0,-88.0,41.0,54.0,43.0,42.0,1
3565,62:47:05:9D:EB:15,3845769,487195933,2170,2437363,3843599,484758570,0,4428,3021709,4396,3016590,32,5119,2075,0,2230,56,0,108,229410.0,130000.0,-47.0,-46.0,-39.0,-46.0,-45.0,-47.0,-39.0,-46.0,-89.0,-89.0,-86.0,-88.0,42.0,43.0,47.0,42.0,1
3566,3C:55:76:E8:8F:1F,3943127,733175935,99528,248417365,3843599,484758570,71,50200,11285102,49557,11170489,643,114613,21828,234,99759,10802,71,673,5500.0,1000.0,-48.0,-53.0,-47.0,-41.0,-49.0,-54.0,-47.0,-43.0,-89.0,-89.0,-86.0,-88.0,41.0,36.0,39.0,47.0,1
3567,92:69:1D:31:68:E9,3847618,488408367,4019,3649797,3843599,484758570,0,5219,1143794,5056,1106821,163,36973,2190,12,4261,102,0,56,229410.0,137640.0,-53.0,-47.0,-42.0,-49.0,-52.0,-47.0,-43.0,-48.0,-89.0,-89.0,-86.0,-88.0,36.0,42.0,44.0,39.0,1
3568,CC:2F:71:3F:1F:24,4921389,1702576264,1077790,1217817694,3843599,484758570,479,893970,993498863,893166,993401565,804,97298,864078,15,1077609,112259,476,688,130000.0,43333.0,-70.0,-71.0,-67.0,-73.0,-69.0,-70.0,-67.0,-73.0,-89.0,-89.0,-86.0,-88.0,19.0,18.0,19.0,15.0,1
3569,CC:2F:71:3E:C5:1F,3844564,484876320,958,117084,3843606,484759236,0,4003,336314,3304,253302,699,83012,1015,12,1380,26,0,53,130000.0,39000.0,-74.0,-72.0,-70.0,-60.0,-72.0,-71.0,-69.0,-60.0,-89.0,-89.0,-86.0,-88.0,15.0,17.0,16.0,28.0,1
3570,BA:8C:B9:54:50:24,3848506,490949176,4900,6189940,3843606,484759236,0,9484,1733176,9462,1729681,22,3495,2354,17,5388,41,0,68,229410.0,130000.0,-48.0,-35.0,-43.0,-46.0,-42.0,-36.0,-45.0,-50.0,-89.0,-89.0,-86.0,-88.0,41.0,54.0,43.0,42.0,1
3571,62:47:05:9D:EB:15,3845778,487196801,2170,2437363,3843608,484759438,0,4428,3021709,4396,3016590,32,5119,2075,0,2230,56,0,108,229410.0,130000.0,-47.0,-46.0,-39.0,-46.0,-45.0,-47.0,-39.0,-46.0,-89.0,-89.0,-86.0,-88.0,42.0,43.0,47.0,42.0,1
3572,3C:55:76:E8:8F:1F,3943199,733263153,99591,248503715,3843608,484759438,73,50284,11294844,49641,11180231,643,114613,21869,277,99823,10963,73,674,5500.0,1000.0,-48.0,-52.0,-48.0,-42.0,-49.0,-53.0,-48.0,-44.0,-89.0,-89.0,-86.0,-88.0,41.0,37.0,38.0,46.0,1
3573,92:69:1D:31:68:E9,3847627,488409235,4019,3649797,3843608,484759438,0,5221,1143930,5058,1106957,163,36973,2190,12,4261,102,0,56,229410.0,137640.0,-51.0,-49.0,-44.0,-47.0,-52.0,-47.0,-43.0,-47.0,-89.0,-89.0,-86.0,-88.0,38.0,40.0,42.0,41.0,1
3574,CC:2F:71:3F:1F:24,4921764,1703076990,1078154,1218317350,3843610,484759640,479,894308,993979011,893504,993881713,804,97298,864414,15,1077974,112352,476,689,130000.0,43333.0,-69.0,-71.0,-67.0,-73.0,-69.0,-71.0,-67.0,-73.0,-89.0,-89.0,-86.0,-88.0,20.0,18.0,19.0,15.0,1
3575,CC:2F:71:3E:C5:1F,3844572,484877128,958,117084,3843614,484760044,0,4003,336314,3304,253302,699,83012,1015,12,1380,26,0,53,130000.0,39000.0,-74.0,-72.0,-70.0,-60.0,-72.0,-71.0,-69.0,-60.0,-89.0,-89.0,-86.0,-88.0,15.0,17.0,16.0,28.0,1
3576,BA:8C:B9:54:50:24,3848516,490950186,4900,6189940,3843616,484760246,0,9484,1733176,9462,1729681,22,3495,2354,17,5388,41,0,68,229410.0,130000.0,-48.0,-35.0,-43.0,-46.0,-42.0,-36.0,-45.0,-50.0,-89.0,-89.0,-86.0,-88.0,41.0,54.0,43.0,42.0,1
3577,62:47:05:9D:EB:15,3845787,487197669,2170,2437363,3843617,484760306,0,4428,3021709,4396,3016590,32,5119,2075,0,2230,56,0,108,229410.0,130000.0,-47.0,-46.0,-39.0,-46.0,-45.0,-47.0,-39.0,-46.0,-89.0,-89.0,-86.0,-88.0,42.0,43.0,47.0,42.0,1
3578,3C:55:76:E8:8F:1F,3943320,733482279,99703,248721973,3843617,484760306,73,50407,11330478,49764,11215865,643,114613,21939,307,99946,11067,73,677,8120.0,1000.0,-51.0,-56.0,-49.0,-47.0,-50.0,-55.0,-48.0,-45.0,-89.0,-89.0,-86.0,-88.0,38.0,33.0,37.0,41.0,1
3579,92:69:1D:31:68:E9,3847638,488410305,4019,3649797,3843619,484760508,0,5221,1143930,5058,1106957,163,36973,2190,12,4261,102,0,56,229410.0,137640.0,-51.0,-49.0,-44.0,-47.0,-52.0,-47.0,-43.0,-47.0,-89.0,-89.0,-86.0,-88.0,38.0,40.0,42.0,41.0,1
3580,CC:2F:71:3F:1F:24,4922107,1703526057,1078488,1218765549,3843619,484760508,479,894628,994423364,893824,994326066,804,97298,864724,15,1078309,112421,476,689,104000.0,26000.0,-70.0,-71.0,-68.0,-74.0,-70.0,-71.0,-67.0,-73.0,-89.0,-89.0,-86.0,-88.0,19.0,18.0,18.0,14.0,1
3581,CC:2F:71:3E:C5:1F,3844581,484877996,958,117084,3843623,484760912,0,4003,336314,3304,253302,699,83012,1015,12,1380,26,0,53,130000.0,39000.0,-74.0,-72.0,-70.0,-60.0,-72.0,-71.0,-69.0,-60.0,-89.0,-89.0,-86.0,-88.0,15.0,17.0,16.0,28.0,1
3582,BA:8C:B9:54:50:24,3848523,490950852,4900,6189940,3843623,484760912,0,9484,1733176,9462,1729681,22,3495,2354,17,5388,41,0,68,229410.0,130000.0,-48.0,-35.0,-43.0,-46.0,-42.0,-36.0,-45.0,-50.0,-89.0,-89.0,-86.0,-88.0,41.0,54.0,43.0,42.0,1
3583,62:47:05:9D:EB:15,3845795,487198477,2170,2437363,3843625,484761114,0,4428,3021709,4396,3016590,32,5119,2075,0,2230,56,0,108,229410.0,130000.0,-47.0,-46.0,-39.0,-46.0,-45.0,-47.0,-39.0,-46.0,-89.0,-89.0,-86.0,-88.0,42.0,43.0,47.0,42.0,1
3584,3C:55:76:E8:8F:1F,3943523,733953927,99898,249192813,3843625,484761114,74,50543,11351538,49900,11236925,643,114613,22032,310,100151,11084,74,677,24370.0,2000.0,-48.0,-53.0,-47.0,-41.0,-49.0,-54.0,-48.0,-44.0,-89.0,-89.0,-86.0,-88.0,41.0,36.0,39.0,47.0,1
3585,92:69:1D:31:68:E9,3847644,488410911,4019,3649797,3843625,484761114,0,5222,1143998,5059,1107025,163,36973,2190,12,4261,102,0,56,229410.0,137640.0,-51.0,-49.0,-44.0,-47.0,-52.0,-48.0,-43.0,-47.0,-89.0,-89.0,-86.0,-88.0,38.0,40.0,42.0,41.0,1
3586,CC:2F:71:3F:1F:24,4922377,1703875249,1078751,1219114075,3843626,484761174,479,894886,994777240,894082,994679942,804,97298,864966,15,1078571,112427,476,689,115556.0,28889.0,-68.0,-70.0,-67.0,-73.0,-68.0,-70.0,-66.0,-72.0,-89.0,-89.0,-86.0,-88.0,21.0,19.0,19.0,15.0,1
3587,CC:2F:71:3E:C5:1F,3844584,484878258,958,117084,3843626,484761174,0,4003,336314,3304,253302,699,83012,1015,12,1380,26,0,53,130000.0,39000.0,-74.0,-72.0,-70.0,-60.0,-72.0,-71.0,-69.0,-60.0,-89.0,-89.0,-86.0,-88.0,15.0,17.0,16.0,28.0,1
3588,BA:8C:B9:54:50:24,3848528,490951316,4900,6189940,3843628,484761376,0,9484,1733176,9462,1729681,22,3495,2354,17,5388,41,0,68,229410.0,130000.0,-48.0,-35.0,-43.0,-46.0,-42.0,-36.0,-45.0,-50.0,-89.0,-89.0,-86.0,-88.0,41.0,54.0,43.0,42.0,1
3589,62:47:05:9D:EB:15,3845805,487199471,2170,2437363,3843635,484762108,0,4428,3021709,4396,3016590,32,5119,2075,0,2230,56,0,108,229410.0,130000.0,-47.0,-46.0,-39.0,-46.0,-45.0,-47.0,-39.0,-46.0,-89.0,-89.0,-86.0,-88.0,42.0,43.0,47.0,42.0,1
3590,3C:55:76:E8:8F:1F,3944058,735166444,100423,250404336,3843635,484762108,75,50770,11413124,50127,11298511,643,114613,22184,310,100654,11090,75,679,34410.0,5500.0,-48.0,-53.0,-48.0,-41.0,-49.0,-54.0,-48.0,-43.0,-89.0,-89.0,-86.0,-88.0,41.0,36.0,38.0,47.0,1
3591,92:69:1D:31:68:E9,3847654,488411905,4019,3649797,3843635,484762108,0,5222,1143998,5059,1107025,163,36973,2190,12,4261,102,0,56,229410.0,137640.0,-51.0,-49.0,-44.0,-47.0,-52.0,-48.0,-43.0,-47.0,-89.0,-89.0,-86.0,-88.0,38.0,40.0,42.0,41.0,1
3592,CC:2F:71:3F:1F:24,4922699,1704292041,1079064,1219529933,3843635,484762108,479,895190,995190051,894386,995092753,804,97298,865259,15,1078881,112470,476,693,115556.0,28889.0,-69.0,-70.0,-66.0,-72.0,-68.0,-70.0,-66.0,-72.0,-89.0,-89.0,-86.0,-88.0,20.0,19.0,20.0,16.0,1
3593,CC:2F:71:3E:C5:1F,3844593,484879192,958,117084,3843635,484762108,0,4003,336314,3304,253302,699,83012,1015,12,1380,26,0,53,130000.0,39000.0,-74.0,-72.0,-70.0,-60.0,-72.0,-71.0,-69.0,-60.0,-89.0,-89.0,-86.0,-88.0,15.0,17.0,16.0,28.0,1
3594,BA:8C:B9:54:50:24,3848537,490952250,4900,6189940,3843637,484762310,0,9484,1733176,9462,1729681,22,3495,2354,17,5388,41,0,68,229410.0,130000.0,-48.0,-35.0,-43.0,-46.0,-42.0,-36.0,-45.0,-50.0,-89.0,-89.0,-86.0,-88.0,41.0,54.0,43.0,42.0,1
3595,62:47:05:9D:EB:15,3845814,487200339,2170,2437363,3843644,484762976,0,4431,3021913,4399,3016794,32,5119,2075,0,2230,56,0,108,229410.0,130000.0,-48.0,-46.0,-39.0,-46.0,-44.0,-48.0,-39.0,-46.0,-90.0,-89.0,-86.0,-88.0,42.0,43.0,47.0,42.0,1
3596,3C:55:76:E8:8F:1F,3944570,736431823,100926,251668847,3843644,484762976,75,51020,11487579,50377,11372966,643,114613,22334,311,101167,11104,75,680,32500.0,1000.0,-48.0,-52.0,-47.0,-41.0,-49.0,-54.0,-48.0,-44.0,-90.0,-89.0,-86.0,-88.0,42.0,37.0,39.0,47.0,1
3597,92:69:1D:31:68:E9,3847664,488412833,4020,3649857,3843644,484762976,0,5224,1144134,5061,1107161,163,36973,2190,12,4262,102,0,56,216660.0,130000.0,-52.0,-48.0,-44.0,-47.0,-51.0,-48.0,-43.0,-47.0,-90.0,-89.0,-86.0,-88.0,38.0,41.0,42.0,41.0,1
3598,CC:2F:71:3F:1F:24,4923034,1704732059,1079390,1219969083,3843644,484762976,479,895540,995681171,894736,995583873,804,97298,865565,15,1079209,112496,476,696,115556.0,28889.0,-69.0,-70.0,-66.0,-72.0,-69.0,-70.0,-66.0,-72.0,-90.0,-89.0,-86.0,-88.0,21.0,19.0,20.0,16.0,1
3599,CC:2F:71:3E:C5:1F,3844603,484880176,959,117200,3843644,484762976,0,4005,336454,3306,253442,699,83012,1015,12,1381,26,0,53,130000.0,39000.0,-73.0,-72.0,-70.0,-61.0,-72.0,-71.0,-69.0,-60.0,-90.0,-89.0,-86.0,-88.0,17.0,17.0,16.0,27.0,1
3600,BA:8C:B9:54:50:24,3848545,490953032,4901,6190056,3843644,484762976,0,9486,1733312,9464,1729817,22,3495,2354,17,5389,41,0,68,229410.0,130000.0,-40.0,-37.0,-46.0,-52.0,-42.0,-36.0,-45.0,-50.0,-90.0,-89.0,-86.0,-88.0,50.0,52.0,40.0,36.0,1
3601,62:47:05:9D:EB:15,3845822,487201251,2172,2437669,3843650,484763582,0,4436,3022385,4404,3017266,32,5119,2077,0,2232,56,0,108,229410.0,137640.0,-47.0,-50.0,-41.0,-49.0,-45.0,-48.0,-40.0,-47.0,-90.0,-90.0,-86.0,-88.0,43.0,40.0,45.0,39.0,1
3602,3C:55:76:E8:8F:1F,3944878,737138906,101226,252375122,3843652,484763784,75,51179,11539614,50536,11425001,643,114613,22439,312,101482,11106,75,680,24370.0,1000.0,-48.0,-54.0,-48.0,-41.0,-49.0,-54.0,-48.0,-43.0,-90.0,-90.0,-86.0,-88.0,42.0,36.0,38.0,47.0,1
3603,92:69:1D:31:68:E9,3847673,488413701,4020,3649857,3843653,484763844,0,5224,1144134,5061,1107161,163,36973,2190,12,4262,102,0,56,216660.0,130000.0,-52.0,-48.0,-44.0,-47.0,-51.0,-48.0,-43.0,-47.0,-90.0,-90.0,-86.0,-88.0,38.0,42.0,42.0,41.0,1
3604,CC:2F:71:3F:1F:24,4923314,1705091085,1079661,1220327241,3843653,484763844,479,895813,996048839,895009,995951541,804,97298,865814,15,1079481,112499,476,696,115556.0,28889.0,-69.0,-70.0,-67.0,-72.0,-69.0,-70.0,-66.0,-72.0,-90.0,-90.0,-86.0,-88.0,21.0,20.0,19.0,16.0,1
3605,CC:2F:71:3E:C5:1F,3844612,484881044,959,117200,3843653,484763844,0,4005,336454,3306,253442,699,83012,1015,12,1381,26,0,53,130000.0,39000.0,-73.0,-72.0,-70.0,-61.0,-72.0,-71.0,-69.0,-60.0,-90.0,-90.0,-86.0,-88.0,17.0,18.0,16.0,27.0,1
3606,BA:8C:B9:54:50:24,3848554,490953900,4901,6190056,3843653,484763844,0,9486,1733312,9464,1729817,22,3495,2354,17,5389,41,0,68,229410.0,130000.0,-40.0,-37.0,-46.0,-52.0,-42.0,-36.0,-45.0,-50.0,-90.0,-90.0,-86.0,-88.0,50.0,53.0,40.0,36.0,1
3607,62:47:05:9D:EB:15,3845833,487202454,2172,2437669,3843661,484764785,0,4437,3022453,4405,3017334,32,5119,2077,0,2232,56,0,108,229410.0,137640.0,-46.0,-45.0,-38.0,-46.0,-45.0,-48.0,-39.0,-47.0,-90.0,-90.0,-86.0,-88.0,44.0,45.0,48.0,42.0,1
3608,3C:55:76:E8:8F:1F,3945714,739199431,102052,254434584,3843662,484764847,83,51650,11635390,51007,11520777,643,114613,22665,312,102268,11112,83,683,68820.0,16250.0,-51.0,-55.0,-49.0,-47.0,-50.0,-54.0,-48.0,-46.0,-90.0,-90.0,-86.0,-88.0,39.0,35.0,37.0,41.0,1
3609,92:69:1D:31:68:E9,3847684,488414906,4020,3649857,3843664,484765049,0,5224,1144134,5061,1107161,163,36973,2190,12,4262,102,0,56,216660.0,130000.0,-52.0,-48.0,-44.0,-47.0,-51.0,-48.0,-43.0,-47.0,-90.0,-90.0,-86.0,-88.0,38.0,42.0,42.0,41.0,1
3610,CC:2F:71:3F:1F:24,4923654,1705531839,1079990,1220766790,3843664,484765049,479,896132,996474696,895327,996377280,805,97416,866127,15,1079811,112586,476,697,117000.0,39000.0,-69.0,-70.0,-66.0,-72.0,-69.0,-70.0,-66.0,-72.0,-90.0,-90.0,-86.0,-88.0,21.0,20.0,20.0,16.0,1
3611,CC:2F:71:3E:C5:1F,3844623,484882249,959,117200,3843664,484765049,0,4007,336642,3307,253512,700,83130,1016,12,1381,26,0,53,130000.0,39000.0,-73.0,-72.0,-69.0,-61.0,-72.0,-71.0,-69.0,-60.0,-90.0,-90.0,-86.0,-88.0,17.0,18.0,17.0,27.0,1
3612,BA:8C:B9:54:50:24,3848565,490955105,4901,6190056,3843664,484765049,0,9486,1733312,9464,1729817,22,3495,2354,17,5389,41,0,68,229410.0,130000.0,-40.0,-37.0,-46.0,-52.0,-42.0,-36.0,-45.0,-50.0,-90.0,-90.0,-86.0,-88.0,50.0,53.0,40.0,36.0,1
3613,62:47:05:9D:EB:15,3845841,487203182,2172,2437669,3843669,484765513,0,4437,3022453,4405,3017334,32,5119,2077,0,2232,56,0,108,229410.0,137640.0,-46.0,-45.0,-38.0,-46.0,-45.0,-48.0,-39.0,-47.0,-90.0,-90.0,-86.0,-88.0,44.0,45.0,48.0,42.0,1
3614,3C:55:76:E8:8F:1F,3946368,740750728,102699,255985215,3843669,484765513,84,52024,11706395,51381,11591782,643,114613,22873,315,102930,11135,84,687,81250.0,24370.0,-51.0,-56.0,-49.0,-47.0,-49.0,-54.0,-48.0,-44.0,-90.0,-90.0,-86.0,-88.0,39.0,34.0,37.0,41.0,1
3615,92:69:1D:31:68:E9,3847689,488415370,4020,3649857,3843669,484765513,0,5226,1144270,5063,1107297,163,36973,2190,12,4262,102,0,56,216660.0,130000.0,-52.0,-47.0,-42.0,-48.0,-51.0,-48.0,-43.0,-47.0,-90.0,-90.0,-86.0,-88.0,38.0,43.0,44.0,40.0,1
3616,CC:2F:71:3F:1F:24,4923916,1705866839,1080245,1221101124,3843671,484765715,479,896372,996800966,895567,996703550,805,97416,866361,15,1080064,112682,476,698,130000.0,43333.0,-69.0,-70.0,-66.0,-73.0,-68.0,-70.0,-66.0,-72.0,-90.0,-90.0,-86.0,-88.0,21.0,20.0,20.0,15.0,1
3617,CC:2F:71:3E:C5:1F,3844630,484882915,959,117200,3843671,484765715,0,4007,336642,3307,253512,700,83130,1016,12,1381,26,0,53,130000.0,39000.0,-73.0,-72.0,-69.0,-61.0,-72.0,-71.0,-69.0,-60.0,-90.0,-90.0,-86.0,-88.0,17.0,18.0,17.0,27.0,1
3618,BA:8C:B9:54:50:24,3848576,490956341,4901,6190056,3843675,484766285,0,9486,1733312,9464,1729817,22,3495,2354,17,5389,41,0,68,229410.0,130000.0,-40.0,-37.0,-46.0,-52.0,-42.0,-36.0,-45.0,-50.0,-90.0,-90.0,-86.0,-88.0,50.0,53.0,40.0,36.0,1
3619,62:47:05:9D:EB:15,3845847,487203954,2172,2437669,3843675,484766285,0,4440,3022657,4408,3017538,32,5119,2077,0,2232,56,0,108,229410.0,137640.0,-43.0,-50.0,-40.0,-48.0,-45.0,-48.0,-39.0,-47.0,-90.0,-90.0,-86.0,-88.0,47.0,40.0,46.0,40.0,1
3620,3C:55:76:E8:8F:1F,3947406,743536851,103731,258770566,3843675,484766285,84,52757,11894698,52114,11780085,643,114613,23262,315,103985,11158,84,689,121870.0,73120.0,-50.0,-56.0,-49.0,-47.0,-50.0,-56.0,-49.0,-47.0,-90.0,-90.0,-86.0,-88.0,40.0,34.0,37.0,41.0,1
3621,92:69:1D:31:68:E9,3847695,488416142,4020,3649857,3843675,484766285,0,5226,1144270,5063,1107297,163,36973,2190,12,4262,102,0,56,216660.0,130000.0,-52.0,-47.0,-42.0,-48.0,-51.0,-48.0,-43.0,-47.0,-90.0,-90.0,-86.0,-88.0,38.0,43.0,44.0,40.0,1
3622,CC:2F:71:3F:1F:24,4924215,1706249263,1080535,1221482514,3843680,484766749,479,896647,997175829,895842,997078413,805,97416,866626,15,1080356,112785,476,698,115556.0,28889.0,-69.0,-70.0,-67.0,-73.0,-68.0,-70.0,-66.0,-72.0,-90.0,-90.0,-86.0,-88.0,21.0,20.0,19.0,15.0,1
3623,CC:2F:71:3E:C5:1F,3844639,484883949,959,117200,3843680,484766749,0,4007,336642,3307,253512,700,83130,1016,12,1381,26,0,53,130000.0,39000.0,-73.0,-72.0,-69.0,-61.0,-72.0,-71.0,-69.0,-60.0,-90.0,-90.0,-86.0,-88.0,17.0,18.0,17.0,27.0,1
3624,BA:8C:B9:54:50:24,3848583,490957007,4901,6190056,3843682,484766951,0,9486,1733312,9464,1729817,22,3495,2354,17,5389,41,0,68,229410.0,130000.0,-40.0,-37.0,-46.0,-52.0,-42.0,-36.0,-45.0,-50.0,-90.0,-90.0,-86.0,-88.0,50.0,53.0,40.0,36.0,1
3625,62:47:05:9D:EB:15,3845856,487204822,2172,2437669,3843684,484767153,0,4440,3022657,4408,3017538,32,5119,2077,0,2232,56,0,108,229410.0,137640.0,-43.0,-50.0,-40.0,-48.0,-45.0,-48.0,-39.0,-47.0,-90.0,-90.0,-86.0,-88.0,47.0,40.0,46.0,40.0,1
3626,3C:55:76:E8:8F:1F,3947919,744771275,104235,260004122,3843684,484767153,84,53094,11986159,52451,11871546,643,114613,23474,317,104446,11180,84,689,48750.0,1000.0,-50.0,-55.0,-49.0,-46.0,-49.0,-53.0,-48.0,-44.0,-90.0,-90.0,-86.0,-88.0,40.0,35.0,37.0,42.0,1
3627,92:69:1D:31:68:E9,3847706,488417212,4020,3649857,3843686,484767355,0,5226,1144270,5063,1107297,163,36973,2190,12,4262,102,0,56,216660.0,130000.0,-52.0,-47.0,-42.0,-48.0,-51.0,-48.0,-43.0,-47.0,-90.0,-90.0,-86.0,-88.0,38.0,43.0,44.0,40.0,1
3628,CC:2F:71:3F:1F:24,4924562,1706712445,1080874,1221944888,3843688,484767557,479,896975,997642211,896170,997544795,805,97416,866939,15,1080695,112855,476,698,130000.0,39000.0,-69.0,-70.0,-67.0,-72.0,-69.0,-70.0,-66.0,-72.0,-90.0,-90.0,-86.0,-88.0,21.0,20.0,19.0,16.0,1
3629,CC:2F:71:3E:C5:1F,3844647,484884757,959,117200,3843688,484767557,0,4007,336642,3307,253512,700,83130,1016,12,1381,26,0,53,130000.0,39000.0,-73.0,-72.0,-69.0,-61.0,-72.0,-71.0,-69.0,-60.0,-90.0,-90.0,-86.0,-88.0,17.0,18.0,17.0,27.0,1
3630,BA:8C:B9:54:50:24,3848592,490957877,4901,6190056,3843691,484767821,0,9486,1733312,9464,1729817,22,3495,2354,17,5389,41,0,68,229410.0,130000.0,-40.0,-37.0,-46.0,-52.0,-42.0,-36.0,-45.0,-50.0,-90.0,-90.0,-86.0,-88.0,50.0,53.0,40.0,36.0,1
3631,62:47:05:9D:EB:15,3845869,487206317,2173,2437785,3843696,484768532,0,4443,3022903,4411,3017784,32,5119,2078,0,2233,56,0,108,229410.0,137640.0,-48.0,-46.0,-39.0,-46.0,-46.0,-47.0,-39.0,-47.0,-90.0,-90.0,-86.0,-88.0,42.0,44.0,47.0,42.0,1
3632,3C:55:76:E8:8F:1F,3948307,745655290,104611,260886758,3843696,484768532,84,53492,12118271,52847,12003097,645,115174,23726,319,104858,11187,84,690,32500.0,5500.0,-50.0,-56.0,-49.0,-47.0,-50.0,-55.0,-49.0,-47.0,-90.0,-90.0,-86.0,-88.0,40.0,34.0,37.0,41.0,1
3633,92:69:1D:31:68:E9,3847716,488418389,4020,3649857,3843696,484768532,0,5226,1144270,5063,1107297,163,36973,2190,12,4262,102,0,56,216660.0,130000.0,-52.0,-47.0,-42.0,-48.0,-51.0,-48.0,-43.0,-47.0,-90.0,-90.0,-86.0,-88.0,38.0,43.0,44.0,40.0,1
3634,CC:2F:71:3F:1F:24,4924877,1707116869,1081180,1222348112,3843697,484768757,479,897279,998053582,896474,997956166,805,97416,867223,15,1081000,112928,476,699,115556.0,28889.0,-69.0,-70.0,-67.0,-73.0,-69.0,-70.0,-66.0,-72.0,-90.0,-90.0,-86.0,-88.0,21.0,20.0,19.0,15.0,1
3635,CC:2F:71:3E:C5:1F,3844661,484886585,959,117200,3843702,484769385,0,4007,336642,3307,253512,700,83130,1016,12,1381,26,0,53,130000.0,39000.0,-73.0,-72.0,-69.0,-61.0,-72.0,-71.0,-69.0,-60.0,-90.0,-90.0,-86.0,-88.0,17.0,18.0,17.0,27.0,1
3636,BA:8C:B9:54:50:24,3848605,490959643,4901,6190056,3843704,484769587,0,9486,1733312,9464,1729817,22,3495,2354,17,5389,41,0,68,229410.0,130000.0,-40.0,-37.0,-46.0,-52.0,-42.0,-36.0,-45.0,-50.0,-90.0,-90.0,-86.0,-88.0,50.0,53.0,40.0,36.0,1
3637,62:47:05:9D:EB:15,3845883,487208145,2173,2437785,3843710,484770360,0,4444,3022971,4412,3017852,32,5119,2078,0,2233,56,0,109,229410.0,137640.0,-43.0,-50.0,-40.0,-47.0,-45.0,-47.0,-39.0,-47.0,-90.0,-90.0,-86.0,-88.0,47.0,40.0,46.0,41.0,1
3638,3C:55:76:E8:8F:1F,3948963,747375319,105253,262604959,3843710,484770360,104,53900,12224318,53251,12108185,649,116133,23976,319,105452,11194,104,691,65000.0,16250.0,-48.0,-52.0,-47.0,-42.0,-49.0,-54.0,-48.0,-45.0,-90.0,-90.0,-86.0,-88.0,42.0,38.0,39.0,46.0,1
3639,92:69:1D:31:68:E9,3847730,488420217,4020,3649857,3843710,484770360,0,5228,1144406,5065,1107433,163,36973,2190,12,4263,102,0,56,216660.0,130000.0,-53.0,-47.0,-42.0,-48.0,-51.0,-48.0,-43.0,-47.0,-90.0,-90.0,-86.0,-88.0,37.0,43.0,44.0,40.0,1
3640,CC:2F:71:3F:1F:24,4925253,1707611978,1081539,1222841214,3843714,484770764,479,897628,998543222,896823,998445806,805,97416,867561,15,1081359,112959,476,702,130000.0,39000.0,-69.0,-70.0,-66.0,-73.0,-69.0,-70.0,-66.0,-72.0,-90.0,-90.0,-87.0,-88.0,21.0,20.0,21.0,15.0,1
3641,CC:2F:71:3E:C5:1F,3844673,484887964,959,117200,3843714,484770764,0,4009,336782,3309,253652,700,83130,1016,12,1382,26,0,53,130000.0,39000.0,-73.0,-71.0,-70.0,-60.0,-72.0,-71.0,-69.0,-60.0,-90.0,-90.0,-87.0,-88.0,17.0,19.0,17.0,28.0,1
3642,BA:8C:B9:54:50:24,3848617,490961022,4901,6190056,3843716,484770966,0,9489,1733516,9467,1730021,22,3495,2354,17,5390,41,0,68,229410.0,130000.0,-49.0,-35.0,-43.0,-46.0,-43.0,-36.0,-44.0,-49.0,-90.0,-90.0,-87.0,-88.0,41.0,55.0,44.0,42.0,1
3643,62:47:05:9D:EB:15,3845894,487209464,2173,2437785,3843721,484771679,0,4444,3022971,4412,3017852,32,5119,2078,0,2233,56,0,109,229410.0,137640.0,-43.0,-50.0,-40.0,-47.0,-45.0,-47.0,-39.0,-47.0,-90.0,-90.0,-87.0,-89.0,47.0,40.0,47.0,42.0,1
3644,3C:55:76:E8:8F:1F,3950020,750440062,106299,265668383,3843721,484771679,105,54351,12355660,53700,12238966,651,116694,24247,320,106537,11213,105,693,81250.0,1000.0,-51.0,-56.0,-49.0,-47.0,-51.0,-56.0,-49.0,-47.0,-90.0,-90.0,-87.0,-89.0,39.0,34.0,38.0,42.0,1
3645,92:69:1D:31:68:E9,3847741,488421536,4020,3649857,3843721,484771679,0,5228,1144406,5065,1107433,163,36973,2190,12,4263,102,0,56,216660.0,130000.0,-53.0,-47.0,-42.0,-48.0,-51.0,-48.0,-43.0,-47.0,-90.0,-90.0,-87.0,-89.0,37.0,43.0,45.0,41.0,1
3646,CC:2F:71:3F:1F:24,4925573,1708019751,1081849,1223247810,3843724,484771941,479,897932,998946315,897127,998848899,805,97416,867848,15,1081670,113084,476,703,130000.0,43333.0,-69.0,-70.0,-66.0,-73.0,-69.0,-70.0,-66.0,-72.0,-90.0,-90.0,-87.0,-89.0,21.0,20.0,21.0,16.0,1
3647,CC:2F:71:3E:C5:1F,3844683,484889141,959,117200,3843724,484771941,0,4009,336782,3309,253652,700,83130,1016,12,1382,26,0,53,130000.0,39000.0,-73.0,-71.0,-70.0,-60.0,-72.0,-71.0,-69.0,-60.0,-90.0,-90.0,-87.0,-89.0,17.0,19.0,17.0,29.0,1
3648,BA:8C:B9:54:50:24,3848625,490961997,4901,6190056,3843724,484771941,0,9489,1733516,9467,1730021,22,3495,2354,17,5390,41,0,68,229410.0,130000.0,-49.0,-35.0,-43.0,-46.0,-43.0,-36.0,-44.0,-49.0,-90.0,-90.0,-87.0,-89.0,41.0,55.0,44.0,43.0,1
3649,62:47:05:9D:EB:15,3845901,487210130,2173,2437785,3843728,484772345,0,4444,3022971,4412,3017852,32,5119,2078,0,2233,56,0,109,229410.0,137640.0,-43.0,-50.0,-40.0,-47.0,-45.0,-47.0,-39.0,-47.0,-90.0,-90.0,-87.0,-89.0,47.0,40.0,47.0,42.0,1
3650,3C:55:76:E8:8F:1F,3950064,750467245,106336,265694900,3843728,484772345,105,54415,12385969,53764,12269275,651,116694,24276,320,106577,11213,105,694,73120.0,24370.0,-47.0,-49.0,-47.0,-43.0,-47.0,-51.0,-47.0,-42.0,-90.0,-90.0,-87.0,-89.0,43.0,41.0,40.0,46.0,1
3651,92:69:1D:31:68:E9,3847751,488422677,4020,3649857,3843731,484772820,0,5228,1144406,5065,1107433,163,36973,2190,12,4263,102,0,56,216660.0,130000.0,-53.0,-47.0,-42.0,-48.0,-51.0,-48.0,-43.0,-47.0,-90.0,-90.0,-87.0,-89.0,37.0,43.0,45.0,41.0,1
3652,CC:2F:71:3F:1F:24,4925797,1708293104,1082066,1223520284,3843731,484772820,479,898130,999207519,897325,999110103,805,97416,868040,15,1081887,113130,476,703,115556.0,28889.0,-68.0,-72.0,-66.0,-74.0,-68.0,-72.0,-66.0,-74.0,-90.0,-90.0,-87.0,-89.0,22.0,18.0,21.0,15.0,1
3653,CC:2F:71:3E:C5:1F,3844690,484890020,959,117200,3843731,484772820,0,4009,336782,3309,253652,700,83130,1016,12,1382,26,0,53,130000.0,39000.0,-73.0,-71.0,-70.0,-60.0,-72.0,-71.0,-69.0,-60.0,-90.0,-90.0,-87.0,-89.0,17.0,19.0,17.0,29.0,1
3654,BA:8C:B9:54:50:24,3848632,490962876,4901,6190056,3843731,484772820,0,9490,1733584,9468,1730089,22,3495,2354,17,5390,41,0,68,229410.0,130000.0,-40.0,-37.0,-46.0,-51.0,-43.0,-36.0,-44.0,-49.0,-90.0,-90.0,-87.0,-89.0,50.0,53.0,41.0,38.0,1
3655,62:47:05:9D:EB:15,3845906,487210807,2173,2437785,3843733,484773022,0,4444,3022971,4412,3017852,32,5119,2078,0,2233,56,0,109,229410.0,137640.0,-43.0,-50.0,-40.0,-47.0,-45.0,-47.0,-39.0,-47.0,-90.0,-90.0,-87.0,-89.0,47.0,40.0,47.0,42.0,1
3656,3C:55:76:E8:8F:1F,3950117,750588673,106384,265815651,3843733,484773022,105,54456,12392450,53805,12275756,651,116694,24292,320,106626,11213,105,694,65000.0,16250.0,-49.0,-54.0,-45.0,-43.0,-48.0,-52.0,-44.0,-42.0,-90.0,-90.0,-87.0,-89.0,41.0,36.0,42.0,46.0,1
3657,92:69:1D:31:68:E9,3847755,488423081,4020,3649857,3843735,484773224,0,5228,1144406,5065,1107433,163,36973,2190,12,4263,102,0,56,216660.0,130000.0,-53.0,-47.0,-42.0,-48.0,-51.0,-48.0,-43.0,-47.0,-90.0,-90.0,-87.0,-89.0,37.0,43.0,45.0,41.0,1
3658,CC:2F:71:3F:1F:24,4926010,1708555030,1082275,1223781806,3843735,484773224,479,898324,999465587,897519,999368171,805,97416,868224,15,1082096,113174,476,703,115556.0,28889.0,-68.0,-71.0,-67.0,-71.0,-68.0,-71.0,-67.0,-71.0,-90.0,-90.0,-87.0,-89.0,22.0,19.0,20.0,18.0,1
3659,CC:2F:71:3E:C5:1F,3844694,484890424,959,117200,3843735,484773224,0,4009,336782,3309,253652,700,83130,1016,12,1382,26,0,53,130000.0,39000.0,-73.0,-71.0,-70.0,-60.0,-72.0,-71.0,-69.0,-60.0,-90.0,-90.0,-87.0,-89.0,17.0,19.0,17.0,29.0,1
3660,BA:8C:B9:54:50:24,3848638,490963482,4901,6190056,3843737,484773426,0,9490,1733584,9468,1730089,22,3495,2354,17,5390,41,0,68,229410.0,130000.0,-40.0,-37.0,-46.0,-51.0,-43.0,-36.0,-44.0,-49.0,-90.0,-90.0,-87.0,-89.0,50.0,53.0,41.0,38.0,1
3661,62:47:05:9D:EB:15,3845913,487211473,2173,2437785,3843740,484773688,0,4444,3022971,4412,3017852,32,5119,2078,0,2233,56,0,109,229410.0,137640.0,-43.0,-50.0,-40.0,-47.0,-45.0,-47.0,-39.0,-47.0,-90.0,-90.0,-87.0,-89.0,47.0,40.0,47.0,42.0,1
3662,3C:55:76:E8:8F:1F,3950125,750589550,106385,265815862,3843740,484773688,105,54470,12393575,53819,12276881,651,116694,24294,320,106627,11213,105,695,65000.0,16250.0,-50.0,-54.0,-45.0,-45.0,-49.0,-53.0,-44.0,-44.0,-90.0,-90.0,-87.0,-89.0,40.0,36.0,42.0,44.0,1
3663,92:69:1D:31:68:E9,3847760,488423545,4020,3649857,3843740,484773688,0,5228,1144406,5065,1107433,163,36973,2190,12,4263,102,0,56,216660.0,130000.0,-53.0,-47.0,-42.0,-48.0,-51.0,-48.0,-43.0,-47.0,-90.0,-90.0,-87.0,-89.0,37.0,43.0,45.0,41.0,1
3664,CC:2F:71:3F:1F:24,4926226,1708820236,1082486,1224046548,3843740,484773688,479,898523,999729807,897718,999632391,805,97416,868409,15,1082306,113181,476,703,104000.0,26000.0,-68.0,-72.0,-67.0,-71.0,-68.0,-72.0,-66.0,-71.0,-90.0,-90.0,-87.0,-89.0,22.0,18.0,20.0,18.0,1
3665,CC:2F:71:3E:C5:1F,3844699,484890888,959,117200,3843740,484773688,0,4009,336782,3309,253652,700,83130,1016,12,1382,26,0,53,130000.0,39000.0,-73.0,-71.0,-70.0,-60.0,-72.0,-71.0,-69.0,-60.0,-90.0,-90.0,-87.0,-89.0,17.0,19.0,17.0,29.0,1
3666,BA:8C:B9:54:50:24,3848641,490963744,4901,6190056,3843740,484773688,0,9490,1733584,9468,1730089,22,3495,2354,17,5390,41,0,68,229410.0,130000.0,-40.0,-37.0,-46.0,-51.0,-43.0,-36.0,-44.0,-49.0,-90.0,-90.0,-87.0,-89.0,50.0,53.0,41.0,38.0,1
3667,62:47:05:9D:EB:15,3845917,487211877,2173,2437785,3843744,484774092,0,4444,3022971,4412,3017852,32,5119,2078,0,2233,56,0,109,229410.0,137640.0,-43.0,-50.0,-40.0,-47.0,-45.0,-47.0,-39.0,-47.0,-90.0,-90.0,-87.0,-89.0,47.0,40.0,47.0,42.0,1
3668,3C:55:76:E8:8F:1F,3950130,750590044,106386,265815952,3843744,484774092,105,54482,12394499,53831,12277805,651,116694,24296,320,106628,11213,105,695,65000.0,16250.0,-46.0,-52.0,-52.0,-41.0,-45.0,-51.0,-50.0,-40.0,-90.0,-90.0,-87.0,-89.0,44.0,38.0,35.0,48.0,1
3669,92:69:1D:31:68:E9,3847766,488424151,4020,3649857,3843746,484774294,0,5228,1144406,5065,1107433,163,36973,2190,12,4263,102,0,56,216660.0,130000.0,-53.0,-47.0,-42.0,-48.0,-51.0,-48.0,-43.0,-47.0,-90.0,-90.0,-87.0,-89.0,37.0,43.0,45.0,41.0,1
3670,CC:2F:71:3F:1F:24,4926454,1709089481,1082708,1224315187,3843746,484774294,479,898732,999997422,897927,999900006,805,97416,868604,15,1082529,113187,476,703,115556.0,28889.0,-68.0,-72.0,-67.0,-72.0,-68.0,-72.0,-67.0,-71.0,-90.0,-90.0,-87.0,-89.0,22.0,18.0,20.0,17.0,1
3671,CC:2F:71:3E:C5:1F,3844705,484891494,959,117200,3843746,484774294,0,4009,336782,3309,253652,700,83130,1016,12,1382,26,0,53,130000.0,39000.0,-73.0,-71.0,-70.0,-60.0,-72.0,-71.0,-69.0,-60.0,-90.0,-90.0,-87.0,-89.0,17.0,19.0,17.0,29.0,1
3672,BA:8C:B9:54:50:24,3848647,490964350,4901,6190056,3843746,484774294,0,9490,1733584,9468,1730089,22,3495,2354,17,5390,41,0,68,229410.0,130000.0,-40.0,-37.0,-46.0,-51.0,-43.0,-36.0,-44.0,-49.0,-90.0,-90.0,-87.0,-89.0,50.0,53.0,41.0,38.0,1
3673,62:47:05:9D:EB:15,3845922,487212341,2173,2437785,3843749,484774556,0,4444,3022971,4412,3017852,32,5119,2078,0,2233,56,0,109,229410.0,137640.0,-43.0,-50.0,-40.0,-47.0,-45.0,-47.0,-39.0,-47.0,-90.0,-90.0,-87.0,-89.0,47.0,40.0,47.0,42.0,1
3674,3C:55:76:E8:8F:1F,3950135,750590508,106386,265815952,3843749,484774556,105,54482,12394499,53831,12277805,651,116694,24296,320,106628,11213,105,695,65000.0,16250.0,-46.0,-52.0,-52.0,-41.0,-45.0,-51.0,-50.0,-40.0,-90.0,-90.0,-87.0,-89.0,44.0,38.0,35.0,48.0,1
3675,92:69:1D:31:68:E9,3847769,488424413,4020,3649857,3843749,484774556,0,5228,1144406,5065,1107433,163,36973,2190,12,4263,102,0,56,216660.0,130000.0,-53.0,-47.0,-42.0,-48.0,-51.0,-48.0,-43.0,-47.0,-90.0,-90.0,-87.0,-89.0,37.0,43.0,45.0,41.0,1
3676,CC:2F:71:3F:1F:24,4926697,1709396943,1082948,1224622387,3843749,484774556,479,898966,1000313402,898161,1000215986,805,97416,868821,15,1082767,113187,476,708,115556.0,28889.0,-67.0,-71.0,-66.0,-70.0,-67.0,-70.0,-66.0,-69.0,-90.0,-90.0,-87.0,-89.0,23.0,19.0,21.0,19.0,1
3677,CC:2F:71:3E:C5:1F,3844710,484891958,959,117200,3843751,484774758,0,4009,336782,3309,253652,700,83130,1016,12,1382,26,0,53,130000.0,39000.0,-73.0,-71.0,-70.0,-60.0,-72.0,-71.0,-69.0,-60.0,-90.0,-90.0,-87.0,-89.0,17.0,19.0,17.0,29.0,1
3678,BA:8C:B9:54:50:24,3848652,490964814,4901,6190056,3843751,484774758,0,9490,1733584,9468,1730089,22,3495,2354,17,5390,41,0,68,229410.0,130000.0,-40.0,-37.0,-46.0,-51.0,-43.0,-36.0,-44.0,-49.0,-90.0,-90.0,-87.0,-89.0,50.0,53.0,41.0,38.0,1
3679,62:47:05:9D:EB:15,3845928,487212947,2173,2437785,3843755,484775162,0,4444,3022971,4412,3017852,32,5119,2078,0,2233,56,0,109,229410.0,137640.0,-43.0,-50.0,-40.0,-47.0,-45.0,-47.0,-39.0,-47.0,-90.0,-90.0,-87.0,-89.0,47.0,40.0,47.0,42.0,1
3680,3C:55:76:E8:8F:1F,3950153,750597348,106398,265822186,3843755,484775162,105,54514,12400780,53863,12284086,651,116694,24308,320,106640,11213,105,695,65000.0,1000.0,-46.0,-52.0,-52.0,-41.0,-46.0,-52.0,-51.0,-41.0,-90.0,-90.0,-87.0,-89.0,44.0,38.0,35.0,48.0,1
3681,92:69:1D:31:68:E9,3847777,488425221,4020,3649857,3843757,484775364,0,5228,1144406,5065,1107433,163,36973,2190,12,4263,102,0,56,216660.0,130000.0,-53.0,-47.0,-42.0,-48.0,-51.0,-48.0,-43.0,-47.0,-90.0,-90.0,-87.0,-89.0,37.0,43.0,45.0,41.0,1
3682,CC:2F:71:3F:1F:24,4926918,1709663729,1083161,1224888365,3843757,484775364,479,899158,1000571196,898353,1000473780,805,97416,869006,15,1082982,113231,476,708,104000.0,26000.0,-67.0,-71.0,-66.0,-70.0,-66.0,-70.0,-66.0,-70.0,-90.0,-90.0,-87.0,-89.0,23.0,19.0,21.0,19.0,1
3683,CC:2F:71:3E:C5:1F,3844716,484892564,959,117200,3843757,484775364,0,4009,336782,3309,253652,700,83130,1016,12,1382,26,0,53,130000.0,39000.0,-73.0,-71.0,-70.0,-60.0,-72.0,-71.0,-69.0,-60.0,-90.0,-90.0,-87.0,-89.0,17.0,19.0,17.0,29.0,1
3684,BA:8C:B9:54:50:24,3848658,490965420,4901,6190056,3843757,484775364,0,9490,1733584,9468,1730089,22,3495,2354,17,5390,41,0,68,229410.0,130000.0,-40.0,-37.0,-46.0,-51.0,-43.0,-36.0,-44.0,-49.0,-90.0,-90.0,-87.0,-89.0,50.0,53.0,41.0,38.0,1
3685,62:47:05:9D:EB:15,3845933,487213411,2173,2437785,3843760,484775626,0,4444,3022971,4412,3017852,32,5119,2078,0,2233,56,0,109,229410.0,137640.0,-43.0,-50.0,-40.0,-47.0,-45.0,-47.0,-39.0,-47.0,-90.0,-90.0,-86.0,-88.0,47.0,40.0,46.0,41.0,1
3686,3C:55:76:E8:8F:1F,3950159,750597976,106399,265822350,3843760,484775626,105,54515,12400848,53864,12284154,651,116694,24308,320,106640,11213,105,695,65000.0,1000.0,-43.0,-51.0,-51.0,-38.0,-45.0,-52.0,-51.0,-40.0,-90.0,-90.0,-86.0,-88.0,47.0,39.0,35.0,50.0,1
3687,92:69:1D:31:68:E9,3847780,488425483,4020,3649857,3843760,484775626,0,5228,1144406,5065,1107433,163,36973,2190,12,4263,102,0,56,216660.0,130000.0,-53.0,-47.0,-42.0,-48.0,-51.0,-48.0,-43.0,-47.0,-90.0,-90.0,-86.0,-88.0,37.0,43.0,44.0,40.0,1
3688,CC:2F:71:3F:1F:24,4927137,1709929098,1083377,1225153472,3843760,484775626,479,899365,1000838936,898560,1000741520,805,97416,869198,15,1083198,113232,476,708,115556.0,28889.0,-68.0,-71.0,-66.0,-70.0,-67.0,-71.0,-66.0,-70.0,-90.0,-90.0,-86.0,-88.0,22.0,19.0,20.0,18.0,1
3689,CC:2F:71:3E:C5:1F,3844719,484892826,959,117200,3843760,484775626,0,4009,336782,3309,253652,700,83130,1016,12,1382,26,0,53,130000.0,39000.0,-73.0,-71.0,-70.0,-60.0,-72.0,-71.0,-69.0,-60.0,-90.0,-90.0,-86.0,-88.0,17.0,19.0,16.0,28.0,1
3690,BA:8C:B9:54:50:24,3848661,490965682,4901,6190056,3843760,484775626,0,9490,1733584,9468,1730089,22,3495,2354,17,5390,41,0,68,229410.0,130000.0,-40.0,-37.0,-46.0,-51.0,-43.0,-36.0,-44.0,-49.0,-90.0,-90.0,-86.0,-88.0,50.0,53.0,40.0,37.0,1
3691,62:47:05:9D:EB:15,3845939,487214017,2173,2437785,3843766,484776232,0,4444,3022971,4412,3017852,32,5119,2078,0,2233,56,0,109,229410.0,137640.0,-43.0,-50.0,-40.0,-47.0,-45.0,-47.0,-39.0,-47.0,-89.0,-89.0,-86.0,-88.0,46.0,39.0,46.0,41.0,1
3692,3C:55:76:E8:8F:1F,3950167,750598870,106401,265822638,3843766,484776232,105,54535,12402400,53884,12285706,651,116694,24312,320,106643,11213,105,695,65000.0,16250.0,-46.0,-53.0,-52.0,-40.0,-46.0,-52.0,-50.0,-41.0,-89.0,-89.0,-86.0,-88.0,43.0,36.0,34.0,48.0,1
3693,92:69:1D:31:68:E9,3847786,488426089,4020,3649857,3843766,484776232,0,5228,1144406,5065,1107433,163,36973,2190,12,4263,102,0,56,216660.0,130000.0,-53.0,-47.0,-42.0,-48.0,-51.0,-48.0,-43.0,-47.0,-89.0,-89.0,-86.0,-88.0,36.0,42.0,44.0,40.0,1
3694,CC:2F:71:3F:1F:24,4927351,1710189711,1083585,1225413479,3843766,484776232,479,899557,1001089759,898752,1000992343,805,97416,869384,15,1083406,113239,476,708,115556.0,28889.0,-67.0,-71.0,-66.0,-70.0,-67.0,-71.0,-66.0,-70.0,-89.0,-89.0,-86.0,-88.0,22.0,18.0,20.0,18.0,1
3695,CC:2F:71:3E:C5:1F,3844725,484893432,959,117200,3843766,484776232,0,4009,336782,3309,253652,700,83130,1016,12,1382,26,0,53,130000.0,39000.0,-73.0,-71.0,-70.0,-60.0,-72.0,-71.0,-69.0,-60.0,-89.0,-89.0,-86.0,-88.0,16.0,18.0,16.0,28.0,1
3696,BA:8C:B9:54:50:24,3848667,490966288,4901,6190056,3843766,484776232,0,9490,1733584,9468,1730089,22,3495,2354,17,5390,41,0,68,229410.0,130000.0,-40.0,-37.0,-46.0,-51.0,-43.0,-36.0,-44.0,-49.0,-89.0,-89.0,-86.0,-88.0,49.0,52.0,40.0,37.0,1
3697,62:47:05:9D:EB:15,3845941,487214219,2173,2437785,3843768,484776434,0,4444,3022971,4412,3017852,32,5119,2078,0,2233,56,0,109,229410.0,137640.0,-43.0,-50.0,-40.0,-47.0,-45.0,-47.0,-39.0,-47.0,-89.0,-88.0,-85.0,-87.0,46.0,38.0,45.0,40.0,1
3698,3C:55:76:E8:8F:1F,3950171,750599329,106403,265822895,3843768,484776434,105,54548,12403427,53897,12286733,651,116694,24314,320,106645,11213,105,695,68820.0,16250.0,-46.0,-52.0,-52.0,-41.0,-45.0,-52.0,-52.0,-40.0,-89.0,-88.0,-85.0,-87.0,43.0,36.0,33.0,46.0,1
3699,92:69:1D:31:68:E9,3847788,488426291,4020,3649857,3843768,484776434,0,5228,1144406,5065,1107433,163,36973,2190,12,4263,102,0,56,216660.0,130000.0,-53.0,-47.0,-42.0,-48.0,-51.0,-48.0,-43.0,-47.0,-89.0,-88.0,-85.0,-87.0,36.0,41.0,43.0,39.0,1
3700,CC:2F:71:3F:1F:24,4927563,1710450365,1083795,1225673931,3843768,484776434,479,899756,1001351297,898951,1001253881,805,97416,869570,15,1083616,113244,476,708,115556.0,28889.0,-67.0,-71.0,-66.0,-70.0,-67.0,-71.0,-66.0,-70.0,-89.0,-88.0,-85.0,-87.0,22.0,17.0,19.0,17.0,1
3701,CC:2F:71:3E:C5:1F,3844732,484894098,959,117200,3843773,484776898,0,4009,336782,3309,253652,700,83130,1016,12,1382,26,0,53,130000.0,39000.0,-73.0,-71.0,-70.0,-60.0,-72.0,-71.0,-69.0,-60.0,-89.0,-88.0,-85.0,-87.0,16.0,17.0,15.0,27.0,1
3702,BA:8C:B9:54:50:24,3848674,490966954,4901,6190056,3843773,484776898,0,9490,1733584,9468,1730089,22,3495,2354,17,5390,41,0,68,229410.0,130000.0,-40.0,-37.0,-46.0,-51.0,-43.0,-36.0,-44.0,-49.0,-89.0,-88.0,-85.0,-87.0,49.0,51.0,39.0,36.0,1
3703,62:47:05:9D:EB:15,3845948,487214885,2173,2437785,3843775,484777100,0,4444,3022971,4412,3017852,32,5119,2078,0,2233,56,0,109,229410.0,137640.0,-43.0,-50.0,-40.0,-47.0,-45.0,-47.0,-39.0,-47.0,-88.0,-87.0,-84.0,-86.0,45.0,37.0,44.0,39.0,1
3704,3C:55:76:E8:8F:1F,3950178,750599995,106403,265822895,3843775,484777100,105,54555,12403905,53904,12287211,651,116694,24314,320,106645,11213,105,695,68820.0,16250.0,-46.0,-53.0,-52.0,-41.0,-46.0,-52.0,-52.0,-41.0,-88.0,-87.0,-84.0,-86.0,42.0,34.0,32.0,45.0,1
3705,92:69:1D:31:68:E9,3847796,488427017,4021,3649917,3843775,484777100,0,5230,1144542,5067,1107569,163,36973,2190,12,4264,102,0,56,216660.0,130000.0,-52.0,-47.0,-42.0,-49.0,-52.0,-47.0,-43.0,-47.0,-88.0,-87.0,-84.0,-86.0,36.0,40.0,42.0,37.0,1
3706,CC:2F:71:3F:1F:24,4927803,1710727082,1084028,1225949982,3843775,484777100,479,899965,1001607942,899160,1001510526,805,97416,869776,15,1083848,113253,476,708,115556.0,28889.0,-68.0,-71.0,-66.0,-70.0,-67.0,-71.0,-66.0,-70.0,-88.0,-87.0,-84.0,-86.0,20.0,16.0,18.0,16.0,1
3707,CC:2F:71:3E:C5:1F,3844735,484894416,960,117316,3843775,484777100,0,4011,336922,3311,253792,700,83130,1016,12,1383,26,0,53,130000.0,39000.0,-73.0,-72.0,-69.0,-61.0,-73.0,-71.0,-69.0,-60.0,-88.0,-87.0,-84.0,-86.0,15.0,15.0,15.0,25.0,1
3708,BA:8C:B9:54:50:24,3848677,490967272,4902,6190172,3843775,484777100,0,9492,1733720,9470,1730225,22,3495,2354,17,5391,41,0,68,229410.0,130000.0,-48.0,-35.0,-43.0,-46.0,-43.0,-36.0,-44.0,-49.0,-88.0,-87.0,-84.0,-86.0,40.0,52.0,41.0,40.0,1
3709,62:47:05:9D:EB:15,3845956,487215669,2174,2437901,3843782,484777768,0,4446,3023107,4414,3017988,32,5119,2078,0,2234,56,0,109,216660.0,130000.0,-46.0,-45.0,-38.0,-46.0,-45.0,-48.0,-39.0,-47.0,-88.0,-87.0,-84.0,-86.0,42.0,42.0,46.0,40.0,1
3710,3C:55:76:E8:8F:1F,3950188,750600983,106406,265823215,3843782,484777768,105,54575,12405355,53923,12288543,652,116812,24316,320,106648,11213,105,696,68820.0,16250.0,-46.0,-53.0,-52.0,-41.0,-46.0,-52.0,-51.0,-41.0,-88.0,-87.0,-84.0,-86.0,42.0,34.0,32.0,45.0,1
3711,92:69:1D:31:68:E9,3847803,488427685,4021,3649917,3843782,484777768,0,5230,1144542,5067,1107569,163,36973,2190,12,4264,102,0,56,216660.0,130000.0,-52.0,-47.0,-42.0,-49.0,-52.0,-47.0,-43.0,-47.0,-88.0,-87.0,-84.0,-86.0,36.0,40.0,42.0,37.0,1
3712,CC:2F:71:3F:1F:24,4928373,1711494763,1084591,1226716995,3843782,484777768,479,900297,1001897669,899492,1001800253,805,97416,870095,15,1084412,113332,476,709,104000.0,26000.0,-68.0,-72.0,-67.0,-70.0,-67.0,-71.0,-66.0,-70.0,-88.0,-87.0,-84.0,-86.0,20.0,15.0,17.0,16.0,1
3713,CC:2F:71:3E:C5:1F,3844742,484895084,960,117316,3843782,484777768,0,4011,336922,3311,253792,700,83130,1016,12,1383,26,0,53,130000.0,39000.0,-73.0,-72.0,-69.0,-61.0,-73.0,-71.0,-69.0,-60.0,-88.0,-87.0,-84.0,-86.0,15.0,15.0,15.0,25.0,1
3714,BA:8C:B9:54:50:24,3848684,490967940,4902,6190172,3843782,484777768,0,9492,1733720,9470,1730225,22,3495,2354,17,5391,41,0,68,229410.0,130000.0,-48.0,-35.0,-43.0,-46.0,-43.0,-36.0,-44.0,-49.0,-88.0,-87.0,-84.0,-86.0,40.0,52.0,41.0,40.0,1
3715,62:47:05:9D:EB:15,3845960,487215993,2174,2437901,3843786,484778092,0,4446,3023107,4414,3017988,32,5119,2078,0,2234,56,0,109,216660.0,130000.0,-46.0,-45.0,-38.0,-46.0,-45.0,-48.0,-39.0,-47.0,-88.0,-87.0,-84.0,-86.0,42.0,42.0,46.0,40.0,1
3716,3C:55:76:E8:8F:1F,3950203,750603996,106417,265825904,3843786,484778092,105,54610,12411560,53958,12294748,652,116812,24327,320,106659,11213,105,696,65000.0,16250.0,-46.0,-52.0,-52.0,-40.0,-46.0,-52.0,-50.0,-41.0,-88.0,-87.0,-84.0,-86.0,42.0,35.0,32.0,46.0,1
3717,92:69:1D:31:68:E9,3847807,488428009,4021,3649917,3843786,484778092,0,5230,1144542,5067,1107569,163,36973,2190,12,4264,102,0,56,216660.0,130000.0,-52.0,-47.0,-42.0,-49.0,-52.0,-47.0,-43.0,-47.0,-88.0,-87.0,-84.0,-86.0,36.0,40.0,42.0,37.0,1
3718,CC:2F:71:3F:1F:24,4928885,1712071257,1085097,1227292963,3843788,484778294,479,900647,1002176343,899842,1002078927,805,97416,870441,15,1084918,113367,476,709,115556.0,28889.0,-68.0,-71.0,-66.0,-70.0,-68.0,-71.0,-66.0,-70.0,-87.0,-87.0,-83.0,-85.0,19.0,16.0,17.0,15.0,1
3719,CC:2F:71:3E:C5:1F,3844748,484895610,960,117316,3843788,484778294,0,4013,337110,3312,253862,701,83248,1017,12,1383,26,0,53,130000.0,39000.0,-80.0,-80.0,-73.0,-71.0,-73.0,-72.0,-69.0,-61.0,-87.0,-87.0,-83.0,-85.0,7.0,7.0,10.0,14.0,1
3720,BA:8C:B9:54:50:24,3848690,490968466,4902,6190172,3843788,484778294,0,9492,1733720,9470,1730225,22,3495,2354,17,5391,41,0,68,229410.0,130000.0,-48.0,-35.0,-43.0,-46.0,-43.0,-36.0,-44.0,-49.0,-87.0,-87.0,-83.0,-85.0,39.0,52.0,40.0,39.0,1
3721,62:47:05:9D:EB:15,3845968,487216934,2174,2437901,3843794,484779033,0,4446,3023107,4414,3017988,32,5119,2078,0,2234,56,0,109,216660.0,130000.0,-46.0,-45.0,-38.0,-46.0,-45.0,-48.0,-39.0,-47.0,-87.0,-87.0,-83.0,-85.0,41.0,42.0,45.0,39.0,1
3722,3C:55:76:E8:8F:1F,3950211,750604937,106417,265825904,3843794,484779033,105,54620,12412292,53967,12295362,653,116930,24328,320,106659,11213,105,697,65000.0,16250.0,-46.0,-53.0,-52.0,-41.0,-46.0,-52.0,-51.0,-41.0,-87.0,-87.0,-83.0,-85.0,41.0,34.0,31.0,44.0,1
3723,92:69:1D:31:68:E9,3847817,488429152,4021,3649917,3843796,484779235,0,5230,1144542,5067,1107569,163,36973,2190,12,4264,102,0,56,216660.0,130000.0,-52.0,-47.0,-42.0,-49.0,-52.0,-47.0,-43.0,-47.0,-87.0,-87.0,-83.0,-85.0,35.0,40.0,41.0,36.0,1
3724,CC:2F:71:3F:1F:24,4929101,1712332390,1085305,1227553155,3843796,484779235,479,900834,1002423701,900029,1002326285,805,97416,870625,15,1085126,113368,476,709,115556.0,28889.0,-68.0,-71.0,-66.0,-70.0,-67.0,-71.0,-66.0,-70.0,-87.0,-87.0,-83.0,-85.0,19.0,16.0,17.0,15.0,1
3725,CC:2F:71:3E:C5:1F,3844756,484896551,960,117316,3843796,484779235,0,4013,337110,3312,253862,701,83248,1017,12,1383,26,0,53,130000.0,39000.0,-80.0,-80.0,-73.0,-71.0,-73.0,-72.0,-69.0,-61.0,-87.0,-87.0,-83.0,-85.0,7.0,7.0,10.0,14.0,1
3726,BA:8C:B9:54:50:24,3848698,490969407,4902,6190172,3843796,484779235,0,9492,1733720,9470,1730225,22,3495,2354,17,5391,41,0,68,229410.0,130000.0,-48.0,-35.0,-43.0,-46.0,-43.0,-36.0,-44.0,-49.0,-87.0,-87.0,-83.0,-85.0,39.0,52.0,40.0,39.0,1
3727,62:47:05:9D:EB:15,3845973,487217398,2174,2437901,3843799,484779497,0,4446,3023107,4414,3017988,32,5119,2078,0,2234,56,0,109,216660.0,130000.0,-46.0,-45.0,-38.0,-46.0,-45.0,-48.0,-39.0,-47.0,-87.0,-86.0,-83.0,-85.0,41.0,41.0,45.0,39.0,1
3728,3C:55:76:E8:8F:1F,3950216,750605401,106417,265825904,3843799,484779497,105,54620,12412292,53967,12295362,653,116930,24328,320,106659,11213,105,697,65000.0,16250.0,-46.0,-53.0,-52.0,-41.0,-46.0,-52.0,-51.0,-41.0,-87.0,-86.0,-83.0,-85.0,41.0,33.0,31.0,44.0,1
3729,92:69:1D:31:68:E9,3847820,488429414,4021,3649917,3843799,484779497,0,5230,1144542,5067,1107569,163,36973,2190,12,4264,102,0,56,216660.0,130000.0,-52.0,-47.0,-42.0,-49.0,-52.0,-47.0,-43.0,-47.0,-87.0,-86.0,-83.0,-85.0,35.0,39.0,41.0,36.0,1
3730,CC:2F:71:3F:1F:24,4929505,1712838588,1085706,1228059091,3843799,484779497,479,901123,1002682728,900318,1002585312,805,97416,870900,15,1085527,113406,476,710,115556.0,28889.0,-68.0,-71.0,-67.0,-70.0,-67.0,-71.0,-66.0,-70.0,-87.0,-86.0,-83.0,-85.0,19.0,15.0,16.0,15.0,1
3731,CC:2F:71:3E:C5:1F,3844759,484896813,960,117316,3843799,484779497,0,4013,337110,3312,253862,701,83248,1017,12,1383,26,0,53,130000.0,39000.0,-80.0,-80.0,-73.0,-71.0,-73.0,-72.0,-69.0,-61.0,-87.0,-86.0,-83.0,-85.0,7.0,6.0,10.0,14.0,1
3732,BA:8C:B9:54:50:24,3848702,490969731,4902,6190172,3843800,484779559,0,9492,1733720,9470,1730225,22,3495,2354,17,5391,41,0,68,229410.0,130000.0,-48.0,-35.0,-43.0,-46.0,-43.0,-36.0,-44.0,-49.0,-87.0,-86.0,-83.0,-85.0,39.0,51.0,40.0,39.0,1
3733,62:47:05:9D:EB:15,3845980,487218066,2174,2437901,3843806,484780165,0,4446,3023107,4414,3017988,32,5119,2078,0,2234,56,0,109,216660.0,130000.0,-46.0,-45.0,-38.0,-46.0,-45.0,-48.0,-39.0,-47.0,-87.0,-86.0,-83.0,-85.0,41.0,41.0,45.0,39.0,1
3734,3C:55:76:E8:8F:1F,3950223,750606069,106417,265825904,3843806,484780165,105,54637,12413500,53983,12296452,654,117048,24329,320,106659,11213,105,697,65000.0,16250.0,-46.0,-53.0,-53.0,-41.0,-46.0,-52.0,-52.0,-41.0,-87.0,-86.0,-83.0,-85.0,41.0,33.0,30.0,44.0,1
3735,92:69:1D:31:68:E9,3847827,488430082,4021,3649917,3843806,484780165,0,5230,1144542,5067,1107569,163,36973,2190,12,4264,102,0,56,216660.0,130000.0,-52.0,-47.0,-42.0,-49.0,-52.0,-47.0,-43.0,-47.0,-87.0,-86.0,-83.0,-85.0,35.0,39.0,41.0,36.0,1
3736,CC:2F:71:3F:1F:24,4929721,1713102426,1085915,1228322261,3843806,484780165,479,901312,1002932998,900507,1002835582,805,97416,871086,15,1085736,113406,476,710,115556.0,28889.0,-67.0,-71.0,-66.0,-71.0,-67.0,-71.0,-66.0,-70.0,-87.0,-86.0,-83.0,-85.0,20.0,15.0,17.0,14.0,1
3737,CC:2F:71:3E:C5:1F,3844767,484897543,960,117316,3843807,484780227,0,4013,337110,3312,253862,701,83248,1017,12,1383,26,0,53,130000.0,39000.0,-80.0,-80.0,-73.0,-71.0,-73.0,-72.0,-69.0,-61.0,-87.0,-86.0,-83.0,-85.0,7.0,6.0,10.0,14.0,1
3738,BA:8C:B9:54:50:24,3848709,490970399,4902,6190172,3843807,484780227,0,9492,1733720,9470,1730225,22,3495,2354,17,5391,41,0,68,229410.0,130000.0,-48.0,-35.0,-43.0,-46.0,-43.0,-36.0,-44.0,-49.0,-87.0,-86.0,-83.0,-85.0,39.0,51.0,40.0,39.0,1
3739,62:47:05:9D:EB:15,3845983,487218330,2174,2437901,3843809,484780429,0,4446,3023107,4414,3017988,32,5119,2078,0,2234,56,0,109,216660.0,130000.0,-46.0,-45.0,-38.0,-46.0,-45.0,-48.0,-39.0,-47.0,-87.0,-86.0,-82.0,-84.0,41.0,41.0,44.0,38.0,1
3740,3C:55:76:E8:8F:1F,3950226,750606333,106417,265825904,3843809,484780429,105,54645,12414140,53991,12297092,654,117048,24330,320,106659,11213,105,698,65000.0,16250.0,-46.0,-52.0,-42.0,-41.0,-45.0,-52.0,-49.0,-40.0,-87.0,-86.0,-82.0,-84.0,41.0,34.0,40.0,43.0,1
3741,92:69:1D:31:68:E9,3847830,488430346,4021,3649917,3843809,484780429,0,5230,1144542,5067,1107569,163,36973,2190,12,4264,102,0,56,216660.0,130000.0,-52.0,-47.0,-42.0,-49.0,-52.0,-47.0,-43.0,-47.0,-87.0,-86.0,-82.0,-84.0,35.0,39.0,40.0,35.0,1
3742,CC:2F:71:3F:1F:24,4929934,1713365430,1086125,1228585001,3843809,484780429,479,901508,1003191362,900702,1003093828,806,97534,871273,15,1085946,113430,476,710,130000.0,39000.0,-67.0,-71.0,-67.0,-70.0,-67.0,-71.0,-66.0,-70.0,-87.0,-86.0,-82.0,-84.0,20.0,15.0,15.0,14.0,1
3743,CC:2F:71:3E:C5:1F,3844772,484898007,960,117316,3843812,484780691,0,4013,337110,3312,253862,701,83248,1017,12,1383,26,0,53,130000.0,39000.0,-80.0,-80.0,-73.0,-71.0,-73.0,-72.0,-69.0,-61.0,-87.0,-86.0,-82.0,-84.0,7.0,6.0,9.0,13.0,1
3744,BA:8C:B9:54:50:24,3848714,490970863,4902,6190172,3843812,484780691,0,9492,1733720,9470,1730225,22,3495,2354,17,5391,41,0,68,229410.0,130000.0,-48.0,-35.0,-43.0,-46.0,-43.0,-36.0,-44.0,-49.0,-87.0,-86.0,-82.0,-84.0,39.0,51.0,39.0,38.0,1
3745,62:47:05:9D:EB:15,3846015,487221316,2174,2437901,3843841,484783415,0,4451,3023447,4419,3018328,32,5119,2078,0,2234,56,0,109,216660.0,130000.0,-42.0,-49.0,-41.0,-48.0,-43.0,-48.0,-40.0,-47.0,-87.0,-86.0,-82.0,-84.0,45.0,37.0,41.0,36.0,1
3746,3C:55:76:E8:8F:1F,3950382,750745610,106514,265950768,3843868,484794842,140,54901,12510644,54244,12393278,657,117366,24417,320,106713,11217,140,702,68820.0,16250.0,-51.0,-55.0,-49.0,-46.0,-49.0,-53.0,-48.0,-43.0,-87.0,-86.0,-82.0,-84.0,36.0,31.0,33.0,38.0,1
3747,92:69:1D:31:68:E9,3847894,488445223,4021,3649917,3843873,484795306,0,5236,1145117,5072,1107909,164,37208,2191,12,4264,102,0,56,216660.0,130000.0,-51.0,-47.0,-42.0,-49.0,-51.0,-48.0,-43.0,-49.0,-86.0,-85.0,-82.0,-83.0,35.0,38.0,40.0,34.0,1
3748,CC:2F:71:3F:1F:24,4931698,1715866803,1087789,1231067455,3843909,484799348,658,903828,1006655084,903022,1006557550,806,97534,873481,15,1087458,115160,655,713,104000.0,26000.0,-68.0,-71.0,-65.0,-73.0,-68.0,-70.0,-65.0,-72.0,-86.0,-85.0,-82.0,-83.0,18.0,14.0,17.0,10.0,1
3749,CC:2F:71:3E:C5:1F,3844984,484927408,961,117432,3844023,484809976,0,4094,342888,3393,259640,701,83248,1020,12,1384,26,0,53,130000.0,39000.0,-71.0,-70.0,-70.0,-60.0,-70.0,-69.0,-68.0,-59.0,-85.0,-84.0,-81.0,-83.0,14.0,14.0,11.0,23.0,1
3750,BA:8C:B9:54:50:24,3848933,491001576,4908,6191398,3844025,484810178,6,9568,1738926,9546,1735431,22,3495,2355,17,5392,41,6,68,229410.0,130000.0,-40.0,-37.0,-46.0,-52.0,-45.0,-35.0,-44.0,-47.0,-85.0,-84.0,-81.0,-83.0,45.0,47.0,35.0,31.0,1
3751,62:47:05:9D:EB:15,3846205,487248603,2175,2437961,3844030,484810642,1,4473,3024943,4441,3019824,32,5119,2078,0,2235,56,1,109,216660.0,130000.0,-47.0,-47.0,-39.0,-46.0,-46.0,-48.0,-39.0,-46.0,-85.0,-84.0,-81.0,-83.0,38.0,37.0,42.0,37.0,1
3752,92:69:1D:31:68:E9,3848052,488460675,4022,3650033,3844030,484810642,1,5267,1147225,5103,1110017,164,37208,2191,12,4265,102,1,57,216660.0,130000.0,-51.0,-48.0,-46.0,-49.0,-51.0,-47.0,-44.0,-48.0,-85.0,-84.0,-81.0,-83.0,34.0,36.0,35.0,34.0,1
3753,CC:2F:71:3F:1F:24,4934400,1719804711,1090370,1234994069,3844030,484810642,1344,907042,1011532270,906231,1011434206,811,98064,876546,15,1089369,115613,1341,714,115556.0,28889.0,-70.0,-71.0,-65.0,-73.0,-70.0,-71.0,-65.0,-72.0,-85.0,-84.0,-81.0,-83.0,15.0,13.0,16.0,10.0,1
3754,CC:2F:71:3E:C5:1F,3844991,484928074,961,117432,3844030,484810642,1,4096,343028,3395,259780,701,83248,1020,12,1385,26,1,53,130000.0,39000.0,-71.0,-70.0,-70.0,-61.0,-70.0,-69.0,-68.0,-59.0,-85.0,-84.0,-81.0,-83.0,14.0,14.0,11.0,22.0,1
3755,BA:8C:B9:54:50:24,3848938,491002040,4908,6191398,3844030,484810642,6,9570,1739062,9548,1735567,22,3495,2355,17,5393,41,6,68,229410.0,130000.0,-48.0,-35.0,-43.0,-45.0,-46.0,-35.0,-43.0,-46.0,-85.0,-84.0,-81.0,-83.0,37.0,49.0,38.0,38.0,1
3756,62:47:05:9D:EB:15,3846209,487249007,2175,2437961,3844034,484811046,1,4473,3024943,4441,3019824,32,5119,2078,0,2235,56,1,109,216660.0,130000.0,-47.0,-47.0,-39.0,-46.0,-46.0,-48.0,-39.0,-46.0,-85.0,-84.0,-81.0,-83.0,38.0,37.0,42.0,37.0,1
3757,92:69:1D:31:68:E9,3848056,488461079,4022,3650033,3844034,484811046,1,5267,1147225,5103,1110017,164,37208,2191,12,4265,102,1,57,216660.0,130000.0,-51.0,-48.0,-46.0,-49.0,-51.0,-47.0,-44.0,-48.0,-85.0,-84.0,-81.0,-83.0,34.0,36.0,35.0,34.0,1
3758,CC:2F:71:3F:1F:24,4934639,1720107945,1090601,1235296495,3844038,484811450,1344,907258,1011826838,906447,1011728774,811,98064,876754,15,1089600,115615,1341,714,117000.0,39000.0,-69.0,-70.0,-65.0,-72.0,-69.0,-70.0,-65.0,-72.0,-85.0,-84.0,-81.0,-83.0,16.0,14.0,16.0,11.0,1
3759,CC:2F:71:3E:C5:1F,3845001,484929004,961,117432,3844040,484811572,1,4096,343028,3395,259780,701,83248,1020,12,1385,26,1,53,130000.0,39000.0,-71.0,-70.0,-70.0,-61.0,-70.0,-69.0,-68.0,-59.0,-85.0,-84.0,-81.0,-83.0,14.0,14.0,11.0,22.0,1
3760,BA:8C:B9:54:50:24,3848950,491003172,4908,6191398,3844042,484811774,6,9570,1739062,9548,1735567,22,3495,2355,17,5393,41,6,68,229410.0,130000.0,-48.0,-35.0,-43.0,-45.0,-46.0,-35.0,-43.0,-46.0,-85.0,-84.0,-81.0,-83.0,37.0,49.0,38.0,38.0,1
3761,62:47:05:9D:EB:15,3846223,487250341,2175,2437961,3844048,484812380,1,4473,3024943,4441,3019824,32,5119,2078,0,2235,56,1,109,216660.0,130000.0,-47.0,-47.0,-39.0,-46.0,-46.0,-48.0,-39.0,-46.0,-85.0,-84.0,-81.0,-83.0,38.0,37.0,42.0,37.0,1
3762,92:69:1D:31:68:E9,3848070,488462413,4022,3650033,3844048,484812380,1,5267,1147225,5103,1110017,164,37208,2191,12,4265,102,1,57,216660.0,130000.0,-51.0,-48.0,-46.0,-49.0,-51.0,-47.0,-44.0,-48.0,-85.0,-84.0,-81.0,-83.0,34.0,36.0,35.0,34.0,1
3763,CC:2F:71:3F:1F:24,4935187,1720881458,1091136,1236068816,3844051,484812642,1344,907821,1012636995,907009,1012538813,812,98182,877282,15,1090122,115676,1341,715,117000.0,39000.0,-70.0,-71.0,-65.0,-72.0,-69.0,-70.0,-66.0,-69.0,-85.0,-84.0,-81.0,-83.0,15.0,13.0,16.0,11.0,1
3764,CC:2F:71:3E:C5:1F,3845019,484930806,961,117432,3844058,484813374,1,4096,343028,3395,259780,701,83248,1020,12,1385,26,1,53,130000.0,39000.0,-71.0,-70.0,-70.0,-61.0,-70.0,-69.0,-68.0,-59.0,-85.0,-84.0,-81.0,-83.0,14.0,14.0,11.0,22.0,1
3765,BA:8C:B9:54:50:24,3848970,491005258,4910,6191682,3844060,484813576,6,9583,1740078,9561,1736583,22,3495,2357,17,5395,41,6,68,229410.0,130000.0,-48.0,-36.0,-43.0,-45.0,-44.0,-37.0,-44.0,-48.0,-85.0,-84.0,-81.0,-83.0,37.0,48.0,38.0,38.0,1
3766,62:47:05:9D:EB:15,3846313,487259359,2176,2438077,3844137,484821282,1,4480,3025419,4448,3020300,32,5119,2078,0,2235,56,1,109,216660.0,130000.0,-50.0,-47.0,-39.0,-48.0,-48.0,-48.0,-39.0,-48.0,-85.0,-84.0,-81.0,-83.0,35.0,37.0,42.0,35.0,1
3767,92:69:1D:31:68:E9,3848257,488481432,4023,3650149,3844234,484831283,1,5296,1149197,5132,1111989,164,37208,2191,12,4266,102,1,60,216660.0,130000.0,-52.0,-46.0,-43.0,-50.0,-51.0,-47.0,-43.0,-49.0,-85.0,-83.0,-80.0,-82.0,33.0,37.0,37.0,32.0,1
3768,CC:2F:71:3F:1F:24,4938113,1725054857,1093879,1240223574,3844234,484831283,1730,910685,1016950941,909872,1016852641,813,98300,880004,15,1092503,116498,1727,719,130000.0,43333.0,-70.0,-71.0,-65.0,-72.0,-69.0,-71.0,-65.0,-72.0,-85.0,-83.0,-80.0,-82.0,15.0,12.0,15.0,10.0,1
3769,CC:2F:71:3E:C5:1F,3845196,484948831,962,117548,3844234,484831283,2,4181,348978,3480,265730,701,83248,1020,12,1386,26,2,53,130000.0,39000.0,-72.0,-69.0,-71.0,-61.0,-71.0,-69.0,-69.0,-60.0,-85.0,-83.0,-80.0,-82.0,13.0,14.0,9.0,21.0,1
3770,BA:8C:B9:54:50:24,3849147,491023283,4911,6191798,3844236,484831485,7,9625,1743014,9603,1739519,22,3495,2358,17,5396,41,7,69,229410.0,130000.0,-49.0,-36.0,-43.0,-46.0,-44.0,-36.0,-44.0,-49.0,-85.0,-83.0,-80.0,-82.0,36.0,47.0,37.0,36.0,1
3771,62:47:05:9D:EB:15,3846417,487270026,2176,2438077,3844241,484831949,1,4491,3026167,4459,3021048,32,5119,2078,0,2236,56,1,109,216660.0,130000.0,-48.0,-46.0,-39.0,-46.0,-47.0,-48.0,-39.0,-49.0,-85.0,-83.0,-80.0,-82.0,37.0,37.0,41.0,36.0,1
3772,92:69:1D:31:68:E9,3848264,488482098,4023,3650149,3844241,484831949,1,5296,1149197,5132,1111989,164,37208,2191,12,4266,102,1,60,216660.0,130000.0,-52.0,-46.0,-43.0,-50.0,-51.0,-47.0,-43.0,-49.0,-85.0,-83.0,-80.0,-82.0,33.0,37.0,37.0,32.0,1
3773,CC:2F:71:3F:1F:24,4938410,1725446421,1094167,1240614270,3844243,484832151,1730,910957,1017331999,910144,1017233699,813,98300,880264,15,1092790,116603,1727,719,115556.0,28889.0,-69.0,-69.0,-68.0,-72.0,-69.0,-68.0,-67.0,-71.0,-85.0,-83.0,-80.0,-82.0,16.0,14.0,12.0,10.0,1
3774,CC:2F:71:3E:C5:1F,3845205,484949699,962,117548,3844243,484832151,2,4182,349048,3481,265800,701,83248,1020,12,1386,26,2,53,130000.0,39000.0,-71.0,-70.0,-70.0,-60.0,-71.0,-69.0,-69.0,-60.0,-85.0,-83.0,-80.0,-82.0,14.0,13.0,10.0,22.0,1
3775,BA:8C:B9:54:50:24,3849154,491023949,4911,6191798,3844243,484832151,7,9629,1743286,9607,1739791,22,3495,2358,17,5396,41,7,69,229410.0,130000.0,-48.0,-36.0,-43.0,-46.0,-44.0,-36.0,-44.0,-48.0,-85.0,-83.0,-80.0,-82.0,37.0,47.0,37.0,36.0,1
3776,62:47:05:9D:EB:15,3846428,487271096,2176,2438077,3844252,484833019,1,4491,3026167,4459,3021048,32,5119,2078,0,2236,56,1,109,216660.0,130000.0,-48.0,-46.0,-39.0,-46.0,-47.0,-48.0,-39.0,-49.0,-85.0,-83.0,-80.0,-82.0,37.0,37.0,41.0,36.0,1
3777,92:69:1D:31:68:E9,3848275,488483168,4023,3650149,3844252,484833019,1,5296,1149197,5132,1111989,164,37208,2191,12,4266,102,1,60,216660.0,130000.0,-52.0,-46.0,-43.0,-50.0,-51.0,-47.0,-43.0,-49.0,-85.0,-83.0,-80.0,-82.0,33.0,37.0,37.0,32.0,1
3778,CC:2F:71:3F:1F:24,4938819,1726005844,1094567,1241172825,3844252,484833019,1730,911355,1017889111,910542,1017790811,813,98300,880649,15,1093192,116625,1727,719,130000.0,39000.0,-69.0,-69.0,-67.0,-71.0,-68.0,-69.0,-66.0,-71.0,-85.0,-83.0,-80.0,-82.0,16.0,14.0,13.0,11.0,1
3779,CC:2F:71:3E:C5:1F,3845214,484950567,962,117548,3844252,484833019,2,4182,349048,3481,265800,701,83248,1020,12,1386,26,2,53,130000.0,39000.0,-71.0,-70.0,-70.0,-60.0,-71.0,-69.0,-69.0,-60.0,-85.0,-83.0,-80.0,-82.0,14.0,13.0,10.0,22.0,1
3780,BA:8C:B9:54:50:24,3849165,491025019,4911,6191798,3844254,484833221,7,9629,1743286,9607,1739791,22,3495,2358,17,5396,41,7,69,229410.0,130000.0,-48.0,-36.0,-43.0,-46.0,-44.0,-36.0,-44.0,-48.0,-85.0,-83.0,-80.0,-82.0,37.0,47.0,37.0,36.0,1
3781,62:47:05:9D:EB:15,3846432,487271500,2176,2438077,3844256,484833423,1,4491,3026167,4459,3021048,32,5119,2078,0,2236,56,1,109,216660.0,130000.0,-48.0,-46.0,-39.0,-46.0,-47.0,-48.0,-39.0,-49.0,-85.0,-83.0,-80.0,-82.0,37.0,37.0,41.0,36.0,1
3782,92:69:1D:31:68:E9,3848281,488483774,4023,3650149,3844258,484833625,1,5296,1149197,5132,1111989,164,37208,2191,12,4266,102,1,60,216660.0,130000.0,-52.0,-46.0,-43.0,-50.0,-51.0,-47.0,-43.0,-49.0,-85.0,-83.0,-80.0,-82.0,33.0,37.0,37.0,32.0,1
3783,CC:2F:71:3F:1F:24,4939018,1726252078,1094760,1241418453,3844258,484833625,1730,911540,1018138831,910727,1018040531,813,98300,880821,15,1093385,116641,1727,719,130000.0,43333.0,-69.0,-69.0,-68.0,-71.0,-69.0,-69.0,-67.0,-71.0,-85.0,-83.0,-80.0,-82.0,16.0,14.0,12.0,11.0,1
3784,CC:2F:71:3E:C5:1F,3845220,484951173,962,117548,3844258,484833625,2,4182,349048,3481,265800,701,83248,1020,12,1386,26,2,53,130000.0,39000.0,-71.0,-70.0,-70.0,-60.0,-71.0,-69.0,-69.0,-60.0,-85.0,-83.0,-80.0,-82.0,14.0,13.0,10.0,22.0,1
3785,BA:8C:B9:54:50:24,3849169,491025423,4911,6191798,3844258,484833625,7,9629,1743286,9607,1739791,22,3495,2358,17,5396,41,7,69,229410.0,130000.0,-48.0,-36.0,-43.0,-46.0,-44.0,-36.0,-44.0,-48.0,-85.0,-83.0,-80.0,-82.0,37.0,47.0,37.0,36.0,1
3786,62:47:05:9D:EB:15,3846436,487271904,2176,2438077,3844260,484833827,1,4491,3026167,4459,3021048,32,5119,2078,0,2236,56,1,109,216660.0,130000.0,-48.0,-46.0,-39.0,-46.0,-47.0,-48.0,-39.0,-49.0,-85.0,-83.0,-80.0,-82.0,37.0,37.0,41.0,36.0,1
3787,92:69:1D:31:68:E9,3848283,488483976,4023,3650149,3844260,484833827,1,5296,1149197,5132,1111989,164,37208,2191,12,4266,102,1,60,216660.0,130000.0,-52.0,-46.0,-43.0,-50.0,-51.0,-47.0,-43.0,-49.0,-85.0,-83.0,-80.0,-82.0,33.0,37.0,37.0,32.0,1
3788,CC:2F:71:3F:1F:24,4939213,1726495072,1094951,1241661043,3844262,484834029,1730,911712,1018368345,910899,1018270045,813,98300,880990,15,1093575,116661,1727,719,130000.0,43333.0,-69.0,-69.0,-68.0,-71.0,-69.0,-69.0,-67.0,-71.0,-85.0,-83.0,-80.0,-82.0,16.0,14.0,12.0,11.0,1
3789,CC:2F:71:3E:C5:1F,3845224,484951577,962,117548,3844262,484834029,2,4182,349048,3481,265800,701,83248,1020,12,1386,26,2,53,130000.0,39000.0,-71.0,-70.0,-70.0,-60.0,-71.0,-69.0,-69.0,-60.0,-85.0,-83.0,-80.0,-82.0,14.0,13.0,10.0,22.0,1
3790,BA:8C:B9:54:50:24,3849173,491025827,4911,6191798,3844262,484834029,7,9629,1743286,9607,1739791,22,3495,2358,17,5396,41,7,69,229410.0,130000.0,-48.0,-36.0,-43.0,-46.0,-44.0,-36.0,-44.0,-48.0,-85.0,-83.0,-80.0,-82.0,37.0,47.0,37.0,36.0,1
3791,62:47:05:9D:EB:15,3846443,487272570,2176,2438077,3844267,484834493,1,4491,3026167,4459,3021048,32,5119,2078,0,2236,56,1,109,216660.0,130000.0,-48.0,-46.0,-39.0,-46.0,-47.0,-48.0,-39.0,-49.0,-85.0,-83.0,-80.0,-82.0,37.0,37.0,41.0,36.0,1
3792,92:69:1D:31:68:E9,3848290,488484642,4023,3650149,3844267,484834493,1,5296,1149197,5132,1111989,164,37208,2191,12,4266,102,1,60,216660.0,130000.0,-52.0,-46.0,-43.0,-50.0,-51.0,-47.0,-43.0,-49.0,-85.0,-83.0,-80.0,-82.0,33.0,37.0,37.0,32.0,1
3793,CC:2F:71:3F:1F:24,4939412,1726739884,1095145,1241905391,3844267,484834493,1730,911892,1018609003,911079,1018510703,813,98300,881163,15,1093770,116683,1727,719,115556.0,28889.0,-70.0,-69.0,-66.0,-71.0,-69.0,-69.0,-66.0,-71.0,-85.0,-83.0,-80.0,-82.0,15.0,14.0,14.0,11.0,1
3794,CC:2F:71:3E:C5:1F,3845229,484952041,962,117548,3844267,484834493,2,4182,349048,3481,265800,701,83248,1020,12,1386,26,2,53,130000.0,39000.0,-71.0,-70.0,-70.0,-60.0,-71.0,-69.0,-69.0,-60.0,-85.0,-83.0,-80.0,-82.0,14.0,13.0,10.0,22.0,1
3795,BA:8C:B9:54:50:24,3849178,491026291,4911,6191798,3844267,484834493,7,9629,1743286,9607,1739791,22,3495,2358,17,5396,41,7,69,229410.0,130000.0,-48.0,-36.0,-43.0,-46.0,-44.0,-36.0,-44.0,-48.0,-85.0,-83.0,-80.0,-82.0,37.0,47.0,37.0,36.0,1
3796,62:47:05:9D:EB:15,3846445,487272772,2176,2438077,3844269,484834695,1,4491,3026167,4459,3021048,32,5119,2078,0,2236,56,1,109,216660.0,130000.0,-48.0,-46.0,-39.0,-46.0,-47.0,-48.0,-39.0,-49.0,-85.0,-83.0,-80.0,-82.0,37.0,37.0,41.0,36.0,1
3797,92:69:1D:31:68:E9,3848294,488485046,4023,3650149,3844271,484834897,1,5296,1149197,5132,1111989,164,37208,2191,12,4266,102,1,60,216660.0,130000.0,-52.0,-46.0,-43.0,-50.0,-51.0,-47.0,-43.0,-49.0,-85.0,-83.0,-80.0,-82.0,33.0,37.0,37.0,32.0,1
3798,CC:2F:71:3F:1F:24,4939630,1727011449,1095359,1242176552,3844271,484834897,1730,912093,1018872712,911280,1018774412,813,98300,881356,15,1093984,116690,1727,719,115556.0,28889.0,-69.0,-69.0,-65.0,-70.0,-69.0,-69.0,-65.0,-70.0,-85.0,-83.0,-80.0,-82.0,16.0,14.0,15.0,12.0,1
3799,CC:2F:71:3E:C5:1F,3845233,484952445,962,117548,3844271,484834897,2,4182,349048,3481,265800,701,83248,1020,12,1386,26,2,53,130000.0,39000.0,-71.0,-70.0,-70.0,-60.0,-71.0,-69.0,-69.0,-60.0,-85.0,-83.0,-80.0,-82.0,14.0,13.0,10.0,22.0,1
3800,BA:8C:B9:54:50:24,3849182,491026695,4911,6191798,3844271,484834897,7,9629,1743286,9607,1739791,22,3495,2358,17,5396,41,7,69,229410.0,130000.0,-48.0,-36.0,-43.0,-46.0,-44.0,-36.0,-44.0,-48.0,-85.0,-83.0,-80.0,-82.0,37.0,47.0,37.0,36.0,1
3801,62:47:05:9D:EB:15,3846452,487273438,2176,2438077,3844276,484835361,1,4491,3026167,4459,3021048,32,5119,2078,0,2236,56,1,109,216660.0,130000.0,-48.0,-46.0,-39.0,-46.0,-47.0,-48.0,-39.0,-49.0,-85.0,-83.0,-80.0,-82.0,37.0,37.0,41.0,36.0,1
3802,92:69:1D:31:68:E9,3848299,488485510,4023,3650149,3844276,484835361,1,5296,1149197,5132,1111989,164,37208,2191,12,4266,102,1,60,216660.0,130000.0,-52.0,-46.0,-43.0,-50.0,-51.0,-47.0,-43.0,-49.0,-85.0,-83.0,-80.0,-82.0,33.0,37.0,37.0,32.0,1
3803,CC:2F:71:3F:1F:24,4939829,1727254874,1095551,1242419311,3844278,484835563,1730,912278,1019121157,911465,1019022857,813,98300,881528,15,1094176,116694,1727,719,115556.0,28889.0,-69.0,-69.0,-65.0,-70.0,-69.0,-69.0,-65.0,-70.0,-85.0,-83.0,-80.0,-82.0,16.0,14.0,15.0,12.0,1
3804,CC:2F:71:3E:C5:1F,3845240,484953111,962,117548,3844278,484835563,2,4182,349048,3481,265800,701,83248,1020,12,1386,26,2,53,130000.0,39000.0,-71.0,-70.0,-70.0,-60.0,-71.0,-69.0,-69.0,-60.0,-85.0,-83.0,-80.0,-82.0,14.0,13.0,10.0,22.0,1
3805,BA:8C:B9:54:50:24,3849189,491027361,4911,6191798,3844278,484835563,7,9629,1743286,9607,1739791,22,3495,2358,17,5396,41,7,69,229410.0,130000.0,-48.0,-36.0,-43.0,-46.0,-44.0,-36.0,-44.0,-48.0,-85.0,-83.0,-80.0,-82.0,37.0,47.0,37.0,36.0,1
3806,62:47:05:9D:EB:15,3846457,487273904,2176,2438077,3844281,484835827,1,4491,3026167,4459,3021048,32,5119,2078,0,2236,56,1,109,216660.0,130000.0,-48.0,-46.0,-39.0,-46.0,-47.0,-48.0,-39.0,-49.0,-85.0,-83.0,-80.0,-82.0,37.0,37.0,41.0,36.0,1
3807,92:69:1D:31:68:E9,3848305,488486092,4024,3650265,3844281,484835827,1,5298,1149333,5134,1112125,164,37208,2191,12,4267,102,1,60,216660.0,130000.0,-51.0,-47.0,-42.0,-48.0,-51.0,-47.0,-43.0,-49.0,-85.0,-83.0,-80.0,-82.0,34.0,36.0,38.0,34.0,1
3808,CC:2F:71:3F:1F:24,4940026,1727499752,1095745,1242663925,3844281,484835827,1730,912465,1019371215,911651,1019272797,814,98418,881701,15,1094370,116694,1727,720,115556.0,28889.0,-69.0,-69.0,-65.0,-70.0,-69.0,-69.0,-65.0,-70.0,-85.0,-83.0,-80.0,-82.0,16.0,14.0,15.0,12.0,1
3809,CC:2F:71:3E:C5:1F,3845244,484953491,963,117664,3844281,484835827,2,4184,349188,3483,265940,701,83248,1020,12,1387,26,2,53,130000.0,39000.0,-71.0,-71.0,-71.0,-60.0,-71.0,-70.0,-69.0,-60.0,-85.0,-83.0,-80.0,-82.0,14.0,12.0,9.0,22.0,1
3810,BA:8C:B9:54:50:24,3849195,491027943,4912,6191914,3844283,484836029,7,9631,1743422,9609,1739927,22,3495,2358,17,5397,41,7,69,229410.0,130000.0,-49.0,-35.0,-43.0,-46.0,-44.0,-36.0,-44.0,-49.0,-85.0,-83.0,-80.0,-82.0,36.0,48.0,37.0,36.0,1
3811,62:47:05:9D:EB:15,3846462,487274424,2177,2438193,3844285,484836231,1,4493,3026303,4461,3021184,32,5119,2078,0,2237,56,1,109,216660.0,130000.0,-48.0,-46.0,-39.0,-48.0,-47.0,-47.0,-39.0,-48.0,-85.0,-83.0,-80.0,-82.0,37.0,37.0,41.0,34.0,1
3812,92:69:1D:31:68:E9,3848309,488486496,4024,3650265,3844285,484836231,1,5298,1149333,5134,1112125,164,37208,2191,12,4267,102,1,60,216660.0,130000.0,-51.0,-47.0,-42.0,-48.0,-51.0,-47.0,-43.0,-49.0,-85.0,-83.0,-80.0,-82.0,34.0,36.0,38.0,34.0,1
3813,CC:2F:71:3F:1F:24,4940224,1727744278,1095937,1242907845,3844287,484836433,1730,912646,1019611797,911832,1019513379,814,98418,881875,15,1094562,116723,1727,720,115556.0,28889.0,-70.0,-72.0,-66.0,-74.0,-69.0,-72.0,-65.0,-74.0,-85.0,-83.0,-80.0,-82.0,15.0,11.0,14.0,8.0,1
3814,CC:2F:71:3E:C5:1F,3845251,484954157,963,117664,3844288,484836493,2,4184,349188,3483,265940,701,83248,1020,12,1387,26,2,53,130000.0,39000.0,-71.0,-71.0,-71.0,-60.0,-71.0,-70.0,-69.0,-60.0,-85.0,-83.0,-80.0,-82.0,14.0,12.0,9.0,22.0,1
3815,BA:8C:B9:54:50:24,3849200,491028407,4912,6191914,3844288,484836493,7,9631,1743422,9609,1739927,22,3495,2358,17,5397,41,7,69,229410.0,130000.0,-49.0,-35.0,-43.0,-46.0,-44.0,-36.0,-44.0,-49.0,-85.0,-83.0,-80.0,-82.0,36.0,48.0,37.0,36.0,1
3816,62:47:05:9D:EB:15,3846467,487274888,2177,2438193,3844290,484836695,1,4493,3026303,4461,3021184,32,5119,2078,0,2237,56,1,109,216660.0,130000.0,-48.0,-46.0,-39.0,-48.0,-47.0,-47.0,-39.0,-48.0,-85.0,-84.0,-80.0,-82.0,37.0,38.0,41.0,34.0,1
3817,92:69:1D:31:68:E9,3848314,488486960,4024,3650265,3844290,484836695,1,5298,1149333,5134,1112125,164,37208,2191,12,4267,102,1,60,216660.0,130000.0,-51.0,-47.0,-42.0,-48.0,-51.0,-47.0,-43.0,-49.0,-85.0,-84.0,-80.0,-82.0,34.0,37.0,38.0,34.0,1
3818,CC:2F:71:3F:1F:24,4940436,1727993699,1096144,1243156802,3844292,484836897,1730,912848,1019859144,912034,1019760726,814,98418,882063,15,1094769,116742,1727,720,115556.0,28889.0,-70.0,-72.0,-67.0,-75.0,-69.0,-72.0,-66.0,-74.0,-85.0,-84.0,-80.0,-82.0,15.0,12.0,13.0,7.0,1
3819,CC:2F:71:3E:C5:1F,3845256,484954834,963,117664,3844293,484837170,2,4184,349188,3483,265940,701,83248,1020,12,1387,26,2,53,130000.0,39000.0,-71.0,-71.0,-71.0,-60.0,-71.0,-70.0,-69.0,-60.0,-85.0,-84.0,-80.0,-82.0,14.0,13.0,9.0,22.0,1
3820,BA:8C:B9:54:50:24,3849205,491029084,4912,6191914,3844293,484837170,7,9631,1743422,9609,1739927,22,3495,2358,17,5397,41,7,69,229410.0,130000.0,-49.0,-35.0,-43.0,-46.0,-44.0,-36.0,-44.0,-49.0,-85.0,-84.0,-80.0,-82.0,36.0,49.0,37.0,36.0,1
3821,62:47:05:9D:EB:15,3846474,487275767,2177,2438193,3844297,484837574,1,4493,3026303,4461,3021184,32,5119,2078,0,2237,56,1,109,216660.0,130000.0,-48.0,-46.0,-39.0,-48.0,-47.0,-47.0,-39.0,-48.0,-85.0,-84.0,-80.0,-82.0,37.0,38.0,41.0,34.0,1
3822,92:69:1D:31:68:E9,3848321,488487839,4024,3650265,3844297,484837574,1,5298,1149333,5134,1112125,164,37208,2191,12,4267,102,1,60,216660.0,130000.0,-51.0,-47.0,-42.0,-48.0,-51.0,-47.0,-43.0,-49.0,-85.0,-84.0,-80.0,-82.0,34.0,37.0,38.0,34.0,1
3823,CC:2F:71:3F:1F:24,4940634,1728240298,1096337,1243402724,3844297,484837574,1730,913037,1020109424,912223,1020011006,814,98418,882238,15,1094962,116742,1727,720,115556.0,28889.0,-70.0,-71.0,-67.0,-74.0,-69.0,-71.0,-66.0,-73.0,-85.0,-84.0,-80.0,-82.0,15.0,13.0,13.0,8.0,1
3824,CC:2F:71:3E:C5:1F,3845260,484955238,963,117664,3844297,484837574,2,4184,349188,3483,265940,701,83248,1020,12,1387,26,2,53,130000.0,39000.0,-71.0,-71.0,-71.0,-60.0,-71.0,-70.0,-69.0,-60.0,-85.0,-84.0,-80.0,-82.0,14.0,13.0,9.0,22.0,1
3825,BA:8C:B9:54:50:24,3849209,491029488,4912,6191914,3844297,484837574,7,9631,1743422,9609,1739927,22,3495,2358,17,5397,41,7,69,229410.0,130000.0,-49.0,-35.0,-43.0,-46.0,-44.0,-36.0,-44.0,-49.0,-85.0,-84.0,-80.0,-82.0,36.0,49.0,37.0,36.0,1
3826,62:47:05:9D:EB:15,3846479,487276231,2177,2438193,3844302,484838038,1,4493,3026303,4461,3021184,32,5119,2078,0,2237,56,1,109,216660.0,130000.0,-48.0,-46.0,-39.0,-48.0,-47.0,-47.0,-39.0,-48.0,-85.0,-84.0,-80.0,-82.0,37.0,38.0,41.0,34.0,1
3827,92:69:1D:31:68:E9,3848326,488488303,4024,3650265,3844302,484838038,1,5298,1149333,5134,1112125,164,37208,2191,12,4267,102,1,60,216660.0,130000.0,-51.0,-47.0,-42.0,-48.0,-51.0,-47.0,-43.0,-49.0,-85.0,-84.0,-80.0,-82.0,34.0,37.0,38.0,34.0,1
3828,CC:2F:71:3F:1F:24,4940836,1728485556,1096534,1243647518,3844302,484838038,1730,913214,1020339602,912400,1020241184,814,98418,882415,15,1095159,116751,1727,720,115556.0,28889.0,-69.0,-70.0,-67.0,-74.0,-69.0,-70.0,-67.0,-74.0,-85.0,-84.0,-80.0,-82.0,16.0,14.0,13.0,8.0,1
3829,CC:2F:71:3E:C5:1F,3845265,484955702,963,117664,3844302,484838038,2,4184,349188,3483,265940,701,83248,1020,12,1387,26,2,53,130000.0,39000.0,-71.0,-71.0,-71.0,-60.0,-71.0,-70.0,-69.0,-60.0,-85.0,-84.0,-80.0,-82.0,14.0,13.0,9.0,22.0,1
3830,BA:8C:B9:54:50:24,3849214,491029952,4912,6191914,3844302,484838038,7,9631,1743422,9609,1739927,22,3495,2358,17,5397,41,7,69,229410.0,130000.0,-49.0,-35.0,-43.0,-46.0,-44.0,-36.0,-44.0,-49.0,-85.0,-84.0,-80.0,-82.0,36.0,49.0,37.0,36.0,1
3831,62:47:05:9D:EB:15,3846483,487276635,2177,2438193,3844306,484838442,1,4493,3026303,4461,3021184,32,5119,2078,0,2237,56,1,109,216660.0,130000.0,-48.0,-46.0,-39.0,-48.0,-47.0,-47.0,-39.0,-48.0,-85.0,-84.0,-81.0,-82.0,37.0,38.0,42.0,34.0,1
3832,92:69:1D:31:68:E9,3848330,488488707,4024,3650265,3844306,484838442,1,5298,1149333,5134,1112125,164,37208,2191,12,4267,102,1,60,216660.0,130000.0,-51.0,-47.0,-42.0,-48.0,-51.0,-47.0,-43.0,-49.0,-85.0,-84.0,-81.0,-82.0,34.0,37.0,39.0,34.0,1
3833,CC:2F:71:3F:1F:24,4941036,1728731464,1096730,1243893022,3844306,484838442,1730,913398,1020579837,912584,1020481419,814,98418,882591,15,1095355,116751,1727,720,115556.0,28889.0,-69.0,-72.0,-66.0,-74.0,-69.0,-72.0,-66.0,-73.0,-85.0,-84.0,-81.0,-82.0,16.0,12.0,15.0,8.0,1
3834,CC:2F:71:3E:C5:1F,3845269,484956106,963,117664,3844306,484838442,2,4184,349188,3483,265940,701,83248,1020,12,1387,26,2,53,130000.0,39000.0,-71.0,-71.0,-71.0,-60.0,-71.0,-70.0,-69.0,-60.0,-85.0,-84.0,-81.0,-82.0,14.0,13.0,10.0,22.0,1
3835,BA:8C:B9:54:50:24,3849218,491030356,4912,6191914,3844306,484838442,7,9631,1743422,9609,1739927,22,3495,2358,17,5397,41,7,69,229410.0,130000.0,-49.0,-35.0,-43.0,-46.0,-44.0,-36.0,-44.0,-49.0,-85.0,-84.0,-81.0,-82.0,36.0,49.0,38.0,36.0,1
3836,62:47:05:9D:EB:15,3846487,487277039,2177,2438193,3844310,484838846,1,4496,3026507,4464,3021388,32,5119,2078,0,2237,56,1,109,216660.0,130000.0,-47.0,-46.0,-40.0,-46.0,-47.0,-46.0,-39.0,-46.0,-85.0,-84.0,-81.0,-82.0,38.0,38.0,41.0,36.0,1
3837,92:69:1D:31:68:E9,3848334,488489111,4024,3650265,3844310,484838846,1,5298,1149333,5134,1112125,164,37208,2191,12,4267,102,1,60,216660.0,130000.0,-51.0,-47.0,-42.0,-48.0,-51.0,-47.0,-43.0,-49.0,-85.0,-84.0,-81.0,-82.0,34.0,37.0,39.0,34.0,1
3838,CC:2F:71:3F:1F:24,4941237,1728978217,1096927,1244139371,3844310,484838846,1730,913577,1020815983,912763,1020717565,814,98418,882765,15,1095552,116765,1727,720,130000.0,43333.0,-69.0,-72.0,-67.0,-74.0,-69.0,-71.0,-66.0,-73.0,-85.0,-84.0,-81.0,-82.0,16.0,12.0,14.0,8.0,1
3839,CC:2F:71:3E:C5:1F,3845274,484956570,963,117664,3844311,484838906,2,4184,349188,3483,265940,701,83248,1020,12,1387,26,2,53,130000.0,39000.0,-71.0,-71.0,-71.0,-60.0,-71.0,-70.0,-69.0,-60.0,-85.0,-84.0,-81.0,-82.0,14.0,13.0,10.0,22.0,1
3840,BA:8C:B9:54:50:24,3849223,491030820,4912,6191914,3844311,484838906,7,9631,1743422,9609,1739927,22,3495,2358,17,5397,41,7,69,229410.0,130000.0,-49.0,-35.0,-43.0,-46.0,-44.0,-36.0,-44.0,-49.0,-85.0,-84.0,-81.0,-82.0,36.0,49.0,38.0,36.0,1
3841,62:47:05:9D:EB:15,3846492,487277503,2177,2438193,3844315,484839310,1,4496,3026507,4464,3021388,32,5119,2078,0,2237,56,1,109,216660.0,130000.0,-47.0,-46.0,-40.0,-46.0,-47.0,-46.0,-39.0,-46.0,-86.0,-85.0,-82.0,-83.0,39.0,39.0,42.0,37.0,1
3842,92:69:1D:31:68:E9,3848339,488489575,4024,3650265,3844315,484839310,1,5298,1149333,5134,1112125,164,37208,2191,12,4267,102,1,60,216660.0,130000.0,-51.0,-47.0,-42.0,-48.0,-51.0,-47.0,-43.0,-49.0,-86.0,-85.0,-82.0,-83.0,35.0,38.0,40.0,35.0,1
3843,CC:2F:71:3F:1F:24,4941443,1729237163,1097128,1244397853,3844315,484839310,1730,913763,1021067209,912949,1020968791,814,98418,882946,15,1095753,116785,1727,721,130000.0,43333.0,-69.0,-71.0,-67.0,-74.0,-69.0,-71.0,-66.0,-74.0,-86.0,-85.0,-82.0,-83.0,17.0,14.0,15.0,9.0,1
3844,CC:2F:71:3E:C5:1F,3845278,484956974,963,117664,3844315,484839310,2,4184,349188,3483,265940,701,83248,1020,12,1387,26,2,53,130000.0,39000.0,-71.0,-71.0,-71.0,-60.0,-71.0,-70.0,-69.0,-60.0,-86.0,-85.0,-82.0,-83.0,15.0,14.0,11.0,23.0,1
3845,BA:8C:B9:54:50:24,3849227,491031224,4912,6191914,3844315,484839310,7,9631,1743422,9609,1739927,22,3495,2358,17,5397,41,7,69,229410.0,130000.0,-49.0,-35.0,-43.0,-46.0,-44.0,-36.0,-44.0,-49.0,-86.0,-85.0,-82.0,-83.0,37.0,50.0,39.0,37.0,1
3846,62:47:05:9D:EB:15,3846500,487278528,2180,2438752,3844320,484839776,1,4501,3027096,4469,3021977,32,5119,2082,0,2240,56,1,109,216660.0,130000.0,-48.0,-50.0,-41.0,-48.0,-47.0,-48.0,-40.0,-46.0,-86.0,-85.0,-82.0,-83.0,38.0,35.0,41.0,35.0,1
3847,92:69:1D:31:68:E9,3848344,488490041,4024,3650265,3844320,484839776,1,5298,1149333,5134,1112125,164,37208,2191,12,4267,102,1,60,216660.0,130000.0,-51.0,-47.0,-42.0,-48.0,-51.0,-47.0,-43.0,-49.0,-86.0,-85.0,-82.0,-83.0,35.0,38.0,40.0,35.0,1
3848,CC:2F:71:3F:1F:24,4941640,1729480085,1097320,1244640309,3844320,484839776,1730,913942,1021307683,913128,1021209265,814,98418,883116,15,1095945,116826,1727,721,115556.0,28889.0,-70.0,-71.0,-66.0,-74.0,-69.0,-71.0,-66.0,-74.0,-86.0,-86.0,-82.0,-84.0,16.0,15.0,16.0,10.0,1
3849,CC:2F:71:3E:C5:1F,3845283,484957440,963,117664,3844320,484839776,2,4186,349376,3484,266010,702,83366,1021,12,1387,26,2,53,130000.0,39000.0,-71.0,-70.0,-70.0,-61.0,-71.0,-70.0,-70.0,-60.0,-86.0,-86.0,-82.0,-84.0,15.0,16.0,12.0,23.0,1
3850,BA:8C:B9:54:50:24,3849232,491031690,4912,6191914,3844320,484839776,7,9631,1743422,9609,1739927,22,3495,2358,17,5397,41,7,69,229410.0,130000.0,-49.0,-35.0,-43.0,-46.0,-44.0,-36.0,-44.0,-49.0,-86.0,-86.0,-82.0,-84.0,37.0,51.0,39.0,38.0,1
3851,62:47:05:9D:EB:15,3846505,487278992,2180,2438752,3844325,484840240,1,4502,3027164,4470,3022045,32,5119,2082,0,2240,56,1,109,216660.0,130000.0,-45.0,-44.0,-38.0,-45.0,-47.0,-47.0,-40.0,-46.0,-86.0,-86.0,-82.0,-84.0,41.0,42.0,44.0,39.0,1
3852,92:69:1D:31:68:E9,3848349,488490505,4024,3650265,3844325,484840240,1,5299,1149401,5135,1112193,164,37208,2191,12,4267,102,1,60,216660.0,130000.0,-49.0,-49.0,-48.0,-47.0,-51.0,-47.0,-43.0,-48.0,-86.0,-86.0,-82.0,-84.0,37.0,37.0,34.0,37.0,1
3853,CC:2F:71:3F:1F:24,4941845,1729728520,1097520,1244888280,3844325,484840240,1730,914131,1021545596,913317,1021447178,814,98418,883298,15,1096145,116828,1727,721,115556.0,28889.0,-69.0,-71.0,-67.0,-75.0,-69.0,-71.0,-67.0,-74.0,-86.0,-86.0,-82.0,-84.0,17.0,15.0,15.0,9.0,1
3854,CC:2F:71:3E:C5:1F,3845288,484957904,963,117664,3844325,484840240,2,4186,349376,3484,266010,702,83366,1021,12,1387,26,2,53,130000.0,39000.0,-71.0,-70.0,-70.0,-61.0,-71.0,-70.0,-70.0,-60.0,-86.0,-86.0,-82.0,-84.0,15.0,16.0,12.0,23.0,1
3855,BA:8C:B9:54:50:24,3849237,491032154,4912,6191914,3844325,484840240,7,9631,1743422,9609,1739927,22,3495,2358,17,5397,41,7,69,229410.0,130000.0,-49.0,-35.0,-43.0,-46.0,-44.0,-36.0,-44.0,-49.0,-86.0,-86.0,-82.0,-84.0,37.0,51.0,39.0,38.0,1
3856,62:47:05:9D:EB:15,3846509,487279396,2180,2438752,3844329,484840644,1,4502,3027164,4470,3022045,32,5119,2082,0,2240,56,1,109,216660.0,130000.0,-45.0,-44.0,-38.0,-45.0,-47.0,-47.0,-40.0,-46.0,-87.0,-86.0,-83.0,-84.0,42.0,42.0,45.0,39.0,1
3857,92:69:1D:31:68:E9,3848353,488490909,4024,3650265,3844329,484840644,1,5299,1149401,5135,1112193,164,37208,2191,12,4267,102,1,60,216660.0,130000.0,-49.0,-49.0,-48.0,-47.0,-51.0,-47.0,-43.0,-48.0,-87.0,-86.0,-83.0,-84.0,38.0,37.0,35.0,37.0,1
3858,CC:2F:71:3F:1F:24,4942041,1729973068,1097712,1245132424,3844329,484840644,1730,914313,1021789260,913499,1021690842,814,98418,883471,15,1096337,116860,1727,722,115556.0,28889.0,-68.0,-72.0,-69.0,-72.0,-68.0,-72.0,-69.0,-72.0,-87.0,-86.0,-83.0,-84.0,19.0,14.0,14.0,12.0,1
3859,CC:2F:71:3E:C5:1F,3845292,484958308,963,117664,3844329,484840644,2,4186,349376,3484,266010,702,83366,1021,12,1387,26,2,53,130000.0,39000.0,-71.0,-70.0,-70.0,-61.0,-71.0,-70.0,-70.0,-60.0,-87.0,-86.0,-83.0,-84.0,16.0,16.0,13.0,23.0,1
3860,BA:8C:B9:54:50:24,3849243,491032760,4912,6191914,3844331,484840846,7,9631,1743422,9609,1739927,22,3495,2358,17,5397,41,7,69,229410.0,130000.0,-49.0,-35.0,-43.0,-46.0,-44.0,-36.0,-44.0,-49.0,-87.0,-86.0,-83.0,-84.0,38.0,51.0,40.0,38.0,1
3861,62:47:05:9D:EB:15,3846513,487279800,2180,2438752,3844333,484841048,1,4502,3027164,4470,3022045,32,5119,2082,0,2240,56,1,109,216660.0,130000.0,-45.0,-44.0,-38.0,-45.0,-47.0,-47.0,-40.0,-46.0,-87.0,-87.0,-83.0,-85.0,42.0,43.0,45.0,40.0,1
3862,92:69:1D:31:68:E9,3848358,488491373,4024,3650265,3844334,484841108,1,5299,1149401,5135,1112193,164,37208,2191,12,4267,102,1,60,216660.0,130000.0,-49.0,-49.0,-48.0,-47.0,-51.0,-47.0,-43.0,-48.0,-87.0,-87.0,-83.0,-85.0,38.0,38.0,35.0,38.0,1
3863,CC:2F:71:3F:1F:24,4942239,1730218030,1097905,1245376922,3844334,484841108,1730,914490,1022027968,913676,1021929550,814,98418,883642,15,1096530,116861,1727,722,115556.0,28889.0,-71.0,-75.0,-71.0,-64.0,-70.0,-74.0,-71.0,-65.0,-87.0,-87.0,-83.0,-85.0,16.0,12.0,12.0,21.0,1
3864,CC:2F:71:3E:C5:1F,3845297,484958772,963,117664,3844334,484841108,2,4186,349376,3484,266010,702,83366,1021,12,1387,26,2,53,130000.0,39000.0,-71.0,-70.0,-70.0,-61.0,-71.0,-70.0,-70.0,-60.0,-87.0,-87.0,-83.0,-85.0,16.0,17.0,13.0,24.0,1
3865,BA:8C:B9:54:50:24,3849246,491033022,4912,6191914,3844334,484841108,7,9633,1743558,9611,1740063,22,3495,2358,17,5398,41,7,69,229410.0,130000.0,-51.0,-35.0,-44.0,-45.0,-45.0,-36.0,-44.0,-48.0,-87.0,-87.0,-83.0,-85.0,36.0,52.0,39.0,40.0,1
3866,62:47:05:9D:EB:15,3846522,487281462,2181,2439717,3844341,484841745,1,4506,3027593,4472,3022181,34,5412,2084,0,2241,56,1,109,216660.0,130000.0,-44.0,-37.0,-44.0,-51.0,-44.0,-46.0,-43.0,-47.0,-87.0,-87.0,-83.0,-85.0,43.0,50.0,39.0,34.0,1
3867,92:69:1D:31:68:E9,3848365,488492010,4024,3650265,3844341,484841745,1,5299,1149401,5135,1112193,164,37208,2191,12,4267,102,1,60,216660.0,130000.0,-49.0,-49.0,-48.0,-47.0,-51.0,-47.0,-43.0,-48.0,-87.0,-87.0,-83.0,-85.0,38.0,38.0,35.0,38.0,1
3868,CC:2F:71:3F:1F:24,4942463,1730482734,1098107,1245635126,3844356,484847608,1730,914683,1022287210,913869,1022188792,814,98418,883822,15,1096732,116867,1727,722,117000.0,39000.0,-70.0,-66.0,-70.0,-70.0,-69.0,-66.0,-69.0,-70.0,-87.0,-87.0,-83.0,-85.0,17.0,21.0,13.0,15.0,1
3869,CC:2F:71:3E:C5:1F,3845319,484965272,963,117664,3844356,484847608,2,4186,349376,3484,266010,702,83366,1021,12,1387,26,2,53,130000.0,39000.0,-71.0,-70.0,-70.0,-61.0,-71.0,-70.0,-70.0,-60.0,-87.0,-87.0,-83.0,-85.0,16.0,17.0,13.0,24.0,1
3870,BA:8C:B9:54:50:24,3849270,491039724,4912,6191914,3844358,484847810,7,9633,1743558,9611,1740063,22,3495,2358,17,5398,41,7,69,229410.0,130000.0,-51.0,-35.0,-44.0,-45.0,-45.0,-36.0,-44.0,-48.0,-87.0,-87.0,-83.0,-85.0,36.0,52.0,39.0,40.0,1
3871,62:47:05:9D:EB:15,3846553,487293184,2181,2439717,3844372,484853467,1,4517,3028552,4480,3022725,37,5827,2087,0,2241,56,1,111,216660.0,130000.0,-69.0,-69.0,-56.0,-66.0,-68.0,-68.0,-57.0,-64.0,-87.0,-87.0,-83.0,-85.0,18.0,18.0,27.0,19.0,1
3872,92:69:1D:31:68:E9,3848397,488503794,4024,3650265,3844373,484853529,1,5302,1149772,5137,1112329,165,37443,2192,12,4267,102,1,60,216660.0,130000.0,-53.0,-48.0,-43.0,-48.0,-51.0,-47.0,-44.0,-48.0,-87.0,-87.0,-83.0,-85.0,34.0,39.0,40.0,37.0,1
3873,CC:2F:71:3F:1F:24,4942699,1730761469,1098322,1245907565,3844377,484853904,1730,914889,1022557197,914075,1022458779,814,98418,884019,15,1096947,116882,1727,723,115556.0,28889.0,-68.0,-67.0,-68.0,-69.0,-68.0,-67.0,-68.0,-69.0,-87.0,-87.0,-83.0,-85.0,19.0,20.0,15.0,16.0,1
3874,CC:2F:71:3E:C5:1F,3845340,484971568,963,117664,3844377,484853904,2,4186,349376,3484,266010,702,83366,1021,12,1387,26,2,53,130000.0,39000.0,-71.0,-70.0,-70.0,-61.0,-71.0,-70.0,-70.0,-60.0,-87.0,-87.0,-83.0,-85.0,16.0,17.0,13.0,24.0,1
3875,BA:8C:B9:54:50:24,3849289,491045818,4912,6191914,3844377,484853904,7,9633,1743558,9611,1740063,22,3495,2358,17,5398,41,7,69,229410.0,130000.0,-51.0,-35.0,-44.0,-45.0,-45.0,-36.0,-44.0,-48.0,-87.0,-87.0,-83.0,-85.0,36.0,52.0,39.0,40.0,1
3876,62:47:05:9D:EB:15,3846610,487312219,2227,2457789,3844383,484854430,1,4609,3054281,4568,3047917,41,6364,2149,0,2287,56,1,118,229410.0,137640.0,-61.0,-65.0,-56.0,-61.0,-61.0,-65.0,-56.0,-61.0,-87.0,-87.0,-83.0,-85.0,26.0,22.0,27.0,24.0,1
3877,92:69:1D:31:68:E9,3848410,488504957,4024,3650265,3844386,484854692,1,5302,1149772,5137,1112329,165,37443,2192,12,4267,102,1,60,216660.0,130000.0,-53.0,-48.0,-43.0,-48.0,-51.0,-47.0,-44.0,-48.0,-87.0,-87.0,-83.0,-85.0,34.0,39.0,40.0,37.0,1
3878,CC:2F:71:3F:1F:24,4942903,1731008455,1098517,1246153763,3844386,484854692,1730,915072,1022802515,914258,1022704097,814,98418,884191,15,1097142,116882,1727,723,115556.0,28889.0,-68.0,-67.0,-68.0,-70.0,-67.0,-66.0,-67.0,-69.0,-87.0,-87.0,-83.0,-85.0,19.0,20.0,15.0,15.0,1
3879,CC:2F:71:3E:C5:1F,3845349,484972356,963,117664,3844386,484854692,2,4186,349376,3484,266010,702,83366,1021,12,1387,26,2,53,130000.0,39000.0,-71.0,-70.0,-70.0,-61.0,-71.0,-70.0,-70.0,-60.0,-87.0,-87.0,-84.0,-85.0,16.0,17.0,14.0,24.0,1
3880,BA:8C:B9:54:50:24,3849298,491046606,4912,6191914,3844386,484854692,7,9633,1743558,9611,1740063,22,3495,2358,17,5398,41,7,69,229410.0,130000.0,-51.0,-35.0,-44.0,-45.0,-45.0,-36.0,-44.0,-48.0,-87.0,-87.0,-84.0,-85.0,36.0,52.0,40.0,40.0,1
3881,62:47:05:9D:EB:15,3846674,487337681,2284,2482403,3844390,484855278,1,4705,3078815,4663,3072280,42,6535,2210,0,2344,56,1,118,229410.0,137640.0,-49.0,-52.0,-39.0,-52.0,-49.0,-52.0,-39.0,-51.0,-87.0,-87.0,-84.0,-85.0,38.0,35.0,45.0,33.0,1
3882,92:69:1D:31:68:E9,3848414,488505543,4024,3650265,3844390,484855278,1,5302,1149772,5137,1112329,165,37443,2192,12,4267,102,1,60,216660.0,130000.0,-53.0,-48.0,-43.0,-48.0,-51.0,-47.0,-44.0,-48.0,-87.0,-87.0,-84.0,-85.0,34.0,39.0,41.0,37.0,1
3883,CC:2F:71:3F:1F:24,4943100,1731252939,1098710,1246397661,3844390,484855278,1730,915255,1023047815,914441,1022949397,814,98418,884362,15,1097335,116901,1727,723,130000.0,43333.0,-68.0,-67.0,-68.0,-69.0,-68.0,-67.0,-67.0,-69.0,-87.0,-87.0,-84.0,-85.0,19.0,20.0,16.0,16.0,1
3884,CC:2F:71:3E:C5:1F,3845355,484973144,963,117664,3844392,484855480,2,4186,349376,3484,266010,702,83366,1021,12,1387,26,2,53,130000.0,39000.0,-71.0,-70.0,-70.0,-61.0,-71.0,-70.0,-70.0,-60.0,-87.0,-87.0,-84.0,-85.0,16.0,17.0,14.0,24.0,1
3885,BA:8C:B9:54:50:24,3849304,491047394,4912,6191914,3844392,484855480,7,9633,1743558,9611,1740063,22,3495,2358,17,5398,41,7,69,229410.0,130000.0,-51.0,-35.0,-44.0,-45.0,-45.0,-36.0,-44.0,-48.0,-87.0,-87.0,-84.0,-85.0,36.0,52.0,40.0,40.0,1
3886,62:47:05:9D:EB:15,3846747,487382510,2349,2526455,3844398,484856055,1,4814,3121803,4771,3115097,43,6706,2277,0,2409,56,1,118,229410.0,137640.0,-50.0,-54.0,-40.0,-51.0,-49.0,-53.0,-40.0,-51.0,-88.0,-88.0,-85.0,-86.0,38.0,34.0,45.0,35.0,1
3887,92:69:1D:31:68:E9,3848422,488506320,4024,3650265,3844398,484856055,1,5302,1149772,5137,1112329,165,37443,2192,12,4267,102,1,60,216660.0,130000.0,-53.0,-48.0,-43.0,-48.0,-51.0,-47.0,-44.0,-48.0,-88.0,-88.0,-85.0,-86.0,35.0,40.0,42.0,38.0,1
3888,CC:2F:71:3F:1F:24,4943301,1731498230,1098903,1246642175,3844398,484856055,1730,915426,1023275871,914612,1023177453,814,98418,884531,15,1097528,116905,1727,723,130000.0,43333.0,-68.0,-67.0,-68.0,-70.0,-68.0,-67.0,-67.0,-69.0,-88.0,-88.0,-85.0,-86.0,20.0,21.0,17.0,16.0,1
3889,CC:2F:71:3E:C5:1F,3845361,484973719,963,117664,3844398,484856055,2,4186,349376,3484,266010,702,83366,1021,12,1387,26,2,53,130000.0,39000.0,-71.0,-70.0,-70.0,-61.0,-71.0,-70.0,-70.0,-60.0,-88.0,-88.0,-85.0,-86.0,17.0,18.0,15.0,25.0,1
3890,BA:8C:B9:54:50:24,3849310,491047969,4912,6191914,3844398,484856055,7,9633,1743558,9611,1740063,22,3495,2358,17,5398,41,7,69,229410.0,130000.0,-51.0,-35.0,-44.0,-45.0,-45.0,-36.0,-44.0,-48.0,-88.0,-88.0,-85.0,-86.0,37.0,53.0,41.0,41.0,1
3891,62:47:05:9D:EB:15,3846805,487424837,2405,2568580,3844400,484856257,1,4908,3170381,4865,3163675,43,6706,2336,0,2465,56,1,119,229410.0,137640.0,-51.0,-54.0,-41.0,-51.0,-51.0,-54.0,-41.0,-51.0,-88.0,-89.0,-85.0,-87.0,37.0,35.0,44.0,36.0,1
3892,92:69:1D:31:68:E9,3848426,488506890,4024,3650265,3844402,484856625,1,5302,1149772,5137,1112329,165,37443,2192,12,4267,102,1,60,216660.0,130000.0,-53.0,-48.0,-43.0,-48.0,-51.0,-47.0,-44.0,-48.0,-88.0,-89.0,-85.0,-87.0,35.0,41.0,42.0,39.0,1
3893,CC:2F:71:3F:1F:24,4943504,1731743587,1099101,1246886828,3844403,484856759,1730,915612,1023516196,914798,1023417778,814,98418,884710,15,1097726,116909,1727,723,130000.0,43333.0,-68.0,-67.0,-68.0,-69.0,-68.0,-67.0,-68.0,-69.0,-88.0,-89.0,-85.0,-87.0,20.0,22.0,17.0,18.0,1
3894,CC:2F:71:3E:C5:1F,3845366,484974423,963,117664,3844403,484856759,2,4186,349376,3484,266010,702,83366,1021,12,1387,26,2,53,130000.0,39000.0,-71.0,-70.0,-70.0,-61.0,-71.0,-70.0,-70.0,-60.0,-88.0,-89.0,-85.0,-87.0,17.0,19.0,15.0,26.0,1
3895,BA:8C:B9:54:50:24,3849316,491048741,4912,6191914,3844404,484856827,7,9633,1743558,9611,1740063,22,3495,2358,17,5398,41,7,69,229410.0,130000.0,-51.0,-35.0,-44.0,-45.0,-45.0,-36.0,-44.0,-48.0,-88.0,-89.0,-85.0,-87.0,37.0,54.0,41.0,42.0,1
3896,62:47:05:9D:EB:15,3846880,487443704,2471,2586413,3844409,484857291,1,5043,3285727,5000,3279021,43,6706,2408,0,2531,56,1,119,229410.0,137640.0,-52.0,-55.0,-41.0,-50.0,-50.0,-54.0,-40.0,-49.0,-89.0,-90.0,-86.0,-87.0,37.0,35.0,45.0,37.0,1
3897,92:69:1D:31:68:E9,3848433,488507556,4024,3650265,3844409,484857291,1,5302,1149772,5137,1112329,165,37443,2192,12,4267,102,1,60,216660.0,130000.0,-53.0,-48.0,-43.0,-48.0,-51.0,-47.0,-44.0,-48.0,-89.0,-90.0,-86.0,-87.0,36.0,42.0,43.0,39.0,1
3898,CC:2F:71:3F:1F:24,4943702,1731988503,1099293,1247131212,3844409,484857291,1730,915792,1023756756,914978,1023658338,814,98418,884882,15,1097918,116909,1727,723,130000.0,43333.0,-68.0,-67.0,-68.0,-70.0,-68.0,-67.0,-67.0,-69.0,-89.0,-90.0,-86.0,-87.0,21.0,23.0,18.0,17.0,1
3899,CC:2F:71:3E:C5:1F,3845372,484974955,963,117664,3844409,484857291,2,4186,349376,3484,266010,702,83366,1021,12,1387,26,2,53,130000.0,39000.0,-71.0,-70.0,-70.0,-61.0,-71.0,-70.0,-70.0,-60.0,-89.0,-90.0,-86.0,-87.0,18.0,20.0,16.0,26.0,1
3900,BA:8C:B9:54:50:24,3849321,491049205,4912,6191914,3844409,484857291,7,9633,1743558,9611,1740063,22,3495,2358,17,5398,41,7,69,229410.0,130000.0,-51.0,-35.0,-44.0,-45.0,-45.0,-36.0,-44.0,-48.0,-89.0,-90.0,-86.0,-87.0,38.0,55.0,42.0,42.0,1
3901,62:47:05:9D:EB:15,3847063,487692532,2650,2834919,3844413,484857613,1,5187,3335336,5144,3328630,43,6706,2515,0,2710,56,1,119,229410.0,137640.0,-47.0,-50.0,-36.0,-47.0,-47.0,-50.0,-36.0,-47.0,-89.0,-90.0,-86.0,-87.0,42.0,40.0,50.0,40.0,1
3902,92:69:1D:31:68:E9,3848437,488507878,4024,3650265,3844413,484857613,1,5302,1149772,5137,1112329,165,37443,2192,12,4267,102,1,60,216660.0,130000.0,-53.0,-48.0,-43.0,-48.0,-51.0,-47.0,-44.0,-48.0,-89.0,-90.0,-86.0,-87.0,36.0,42.0,43.0,39.0,1
3903,CC:2F:71:3F:1F:24,4943896,1732230089,1099482,1247372342,3844414,484857747,1730,915971,1023998572,915157,1023900154,814,98418,885051,15,1098107,116910,1727,723,130000.0,43333.0,-71.0,-70.0,-71.0,-73.0,-70.0,-69.0,-70.0,-71.0,-89.0,-90.0,-86.0,-87.0,18.0,20.0,15.0,14.0,1
3904,CC:2F:71:3E:C5:1F,3845377,484975411,963,117664,3844414,484857747,2,4186,349376,3484,266010,702,83366,1021,12,1387,26,2,53,130000.0,39000.0,-71.0,-70.0,-70.0,-61.0,-71.0,-70.0,-70.0,-60.0,-89.0,-90.0,-86.0,-88.0,18.0,20.0,16.0,27.0,1
3905,BA:8C:B9:54:50:24,3849327,491049729,4912,6191914,3844415,484857815,7,9633,1743558,9611,1740063,22,3495,2358,17,5398,41,7,69,229410.0,130000.0,-51.0,-35.0,-44.0,-45.0,-45.0,-36.0,-44.0,-48.0,-89.0,-90.0,-86.0,-88.0,38.0,55.0,42.0,43.0,1
3906,62:47:05:9D:EB:15,3847110,487759236,2691,2901017,3844419,484858219,1,5228,3356567,5185,3349861,43,6706,2538,0,2750,56,1,119,229410.0,137640.0,-47.0,-53.0,-40.0,-49.0,-51.0,-57.0,-44.0,-52.0,-89.0,-90.0,-86.0,-88.0,42.0,37.0,46.0,39.0,1
3907,92:69:1D:31:68:E9,3848443,488508484,4024,3650265,3844419,484858219,1,5302,1149772,5137,1112329,165,37443,2192,12,4267,102,1,60,216660.0,130000.0,-53.0,-48.0,-43.0,-48.0,-51.0,-47.0,-44.0,-48.0,-89.0,-90.0,-86.0,-88.0,36.0,42.0,43.0,40.0,1
3908,CC:2F:71:3F:1F:24,4944101,1732478252,1099681,1247619973,3844420,484858279,1730,916159,1024244813,915345,1024146395,814,98418,885229,15,1098306,116914,1727,723,130000.0,43333.0,-72.0,-70.0,-72.0,-74.0,-70.0,-69.0,-70.0,-72.0,-89.0,-90.0,-86.0,-88.0,17.0,20.0,14.0,14.0,1
3909,CC:2F:71:3E:C5:1F,3845383,484975943,963,117664,3844420,484858279,2,4186,349376,3484,266010,702,83366,1021,12,1387,26,2,53,130000.0,39000.0,-71.0,-70.0,-70.0,-61.0,-71.0,-70.0,-70.0,-60.0,-89.0,-90.0,-86.0,-88.0,18.0,20.0,16.0,27.0,1
3910,BA:8C:B9:54:50:24,3849332,491050193,4912,6191914,3844420,484858279,7,9633,1743558,9611,1740063,22,3495,2358,17,5398,41,7,69,229410.0,130000.0,-51.0,-35.0,-44.0,-45.0,-45.0,-36.0,-44.0,-48.0,-89.0,-90.0,-86.0,-88.0,38.0,55.0,42.0,43.0,1
3911,62:47:05:9D:EB:15,3847214,487978770,2791,3120229,3844423,484858541,1,5274,3369708,5231,3363002,43,6706,2564,0,2851,56,1,119,229410.0,137640.0,-52.0,-57.0,-43.0,-53.0,-52.0,-56.0,-43.0,-52.0,-89.0,-90.0,-86.0,-88.0,37.0,33.0,43.0,35.0,1
3912,92:69:1D:31:68:E9,3848447,488508806,4024,3650265,3844423,484858541,1,5302,1149772,5137,1112329,165,37443,2192,12,4267,102,1,60,216660.0,130000.0,-53.0,-48.0,-43.0,-48.0,-51.0,-47.0,-44.0,-48.0,-89.0,-90.0,-86.0,-88.0,36.0,42.0,43.0,40.0,1
3913,CC:2F:71:3F:1F:24,4944298,1732723102,1099873,1247864359,3844425,484858743,1730,916341,1024484535,915527,1024386117,814,98418,885401,15,1098498,116914,1727,723,130000.0,43333.0,-68.0,-67.0,-68.0,-70.0,-68.0,-67.0,-67.0,-70.0,-89.0,-90.0,-86.0,-88.0,21.0,23.0,18.0,18.0,1
3914,CC:2F:71:3E:C5:1F,3845388,484976407,963,117664,3844425,484858743,2,4186,349376,3484,266010,702,83366,1021,12,1387,26,2,53,130000.0,39000.0,-71.0,-70.0,-70.0,-61.0,-71.0,-70.0,-70.0,-60.0,-89.0,-90.0,-86.0,-88.0,18.0,20.0,16.0,27.0,1
3915,BA:8C:B9:54:50:24,3849337,491050657,4912,6191914,3844425,484858743,7,9633,1743558,9611,1740063,22,3495,2358,17,5398,41,7,69,229410.0,130000.0,-51.0,-35.0,-44.0,-45.0,-45.0,-36.0,-44.0,-48.0,-89.0,-90.0,-86.0,-88.0,38.0,55.0,42.0,43.0,1
3916,62:47:05:9D:EB:15,3847221,487979506,2792,3120359,3844429,484859147,1,5279,3370803,5236,3364097,43,6706,2565,0,2852,56,1,119,229410.0,137640.0,-51.0,-57.0,-44.0,-53.0,-51.0,-56.0,-42.0,-52.0,-88.0,-89.0,-86.0,-87.0,37.0,32.0,42.0,34.0,1
3917,92:69:1D:31:68:E9,3848453,488509412,4024,3650265,3844429,484859147,1,5302,1149772,5137,1112329,165,37443,2192,12,4267,102,1,60,216660.0,130000.0,-53.0,-48.0,-43.0,-48.0,-51.0,-47.0,-44.0,-48.0,-88.0,-89.0,-86.0,-87.0,35.0,41.0,43.0,39.0,1
3918,CC:2F:71:3F:1F:24,4944493,1732966128,1100064,1248106981,3844429,484859147,1730,916517,1024720449,915703,1024622031,814,98418,885570,15,1098688,116918,1727,723,130000.0,43333.0,-68.0,-67.0,-68.0,-70.0,-68.0,-67.0,-67.0,-69.0,-88.0,-89.0,-86.0,-87.0,20.0,22.0,18.0,17.0,1
3919,CC:2F:71:3E:C5:1F,3845392,484976811,963,117664,3844429,484859147,2,4186,349376,3484,266010,702,83366,1021,12,1387,26,2,53,130000.0,39000.0,-71.0,-70.0,-70.0,-61.0,-71.0,-70.0,-70.0,-60.0,-88.0,-89.0,-86.0,-87.0,17.0,19.0,16.0,26.0,1
3920,BA:8C:B9:54:50:24,3849341,491051061,4912,6191914,3844429,484859147,7,9633,1743558,9611,1740063,22,3495,2358,17,5398,41,7,69,229410.0,130000.0,-51.0,-35.0,-44.0,-45.0,-45.0,-36.0,-44.0,-48.0,-88.0,-89.0,-86.0,-87.0,37.0,54.0,42.0,42.0,1
3921,62:47:05:9D:EB:15,3847229,487981144,2798,3121795,3844431,484859349,1,5285,3371639,5242,3364933,43,6706,2569,0,2858,56,1,119,229410.0,137640.0,-49.0,-60.0,-51.0,-55.0,-50.0,-56.0,-43.0,-52.0,-88.0,-89.0,-85.0,-87.0,39.0,29.0,34.0,32.0,1
3922,92:69:1D:31:68:E9,3848457,488509816,4024,3650265,3844433,484859551,1,5302,1149772,5137,1112329,165,37443,2192,12,4267,102,1,60,216660.0,130000.0,-53.0,-48.0,-43.0,-48.0,-51.0,-47.0,-44.0,-48.0,-88.0,-89.0,-85.0,-87.0,35.0,41.0,42.0,39.0,1
3923,CC:2F:71:3F:1F:24,4944689,1733209492,1100256,1248349941,3844433,484859551,1730,916697,1024963791,915883,1024865373,814,98418,885741,15,1098880,116918,1727,723,130000.0,43333.0,-68.0,-67.0,-68.0,-71.0,-68.0,-67.0,-68.0,-70.0,-88.0,-89.0,-85.0,-87.0,20.0,22.0,17.0,16.0,1
3924,CC:2F:71:3E:C5:1F,3845396,484977215,963,117664,3844433,484859551,2,4186,349376,3484,266010,702,83366,1021,12,1387,26,2,53,130000.0,39000.0,-71.0,-70.0,-70.0,-61.0,-71.0,-70.0,-70.0,-60.0,-88.0,-89.0,-85.0,-87.0,17.0,19.0,15.0,26.0,1
3925,BA:8C:B9:54:50:24,3849346,491051525,4912,6191914,3844434,484859611,7,9633,1743558,9611,1740063,22,3495,2358,17,5398,41,7,69,229410.0,130000.0,-51.0,-35.0,-44.0,-45.0,-45.0,-36.0,-44.0,-48.0,-88.0,-89.0,-85.0,-87.0,37.0,54.0,41.0,42.0,1
3926,62:47:05:9D:EB:15,3847246,487991890,2807,3131815,3844439,484860075,1,5307,3377066,5264,3370360,43,6706,2575,0,2867,56,1,119,229410.0,137640.0,-53.0,-54.0,-39.0,-49.0,-52.0,-55.0,-41.0,-51.0,-88.0,-89.0,-85.0,-87.0,35.0,35.0,46.0,38.0,1
3927,92:69:1D:31:68:E9,3848463,488510340,4024,3650265,3844439,484860075,1,5302,1149772,5137,1112329,165,37443,2192,12,4267,102,1,60,216660.0,130000.0,-53.0,-48.0,-43.0,-48.0,-51.0,-47.0,-44.0,-48.0,-88.0,-89.0,-85.0,-87.0,35.0,41.0,42.0,39.0,1
3928,CC:2F:71:3F:1F:24,4944900,1733461557,1100461,1248601482,3844439,484860075,1730,916891,1025213658,916077,1025115240,814,98418,885924,15,1099086,116922,1727,724,130000.0,39000.0,-68.0,-67.0,-68.0,-69.0,-67.0,-66.0,-67.0,-69.0,-88.0,-89.0,-85.0,-87.0,20.0,22.0,17.0,18.0,1
3929,CC:2F:71:3E:C5:1F,3845403,484977855,964,117780,3844439,484860075,2,4187,349446,3485,266080,702,83366,1021,12,1388,26,2,53,130000.0,39000.0,-71.0,-70.0,-69.0,-61.0,-71.0,-70.0,-69.0,-60.0,-88.0,-89.0,-85.0,-87.0,17.0,19.0,16.0,26.0,1
3930,BA:8C:B9:54:50:24,3849352,491052105,4913,6192030,3844439,484860075,7,9635,1743694,9613,1740199,22,3495,2358,17,5399,41,7,69,229410.0,130000.0,-49.0,-35.0,-43.0,-46.0,-47.0,-35.0,-43.0,-46.0,-88.0,-89.0,-85.0,-87.0,39.0,54.0,42.0,41.0,1
3931,62:47:05:9D:EB:15,3847266,488002940,2822,3142401,3844444,484860539,1,5354,3407664,5311,3400958,43,6706,2602,0,2882,56,1,119,229410.0,137640.0,-53.0,-58.0,-44.0,-53.0,-52.0,-58.0,-44.0,-52.0,-88.0,-89.0,-85.0,-87.0,35.0,31.0,41.0,34.0,1
3932,92:69:1D:31:68:E9,3848469,488510920,4025,3650381,3844444,484860539,1,5304,1149908,5139,1112465,165,37443,2192,12,4268,102,1,60,216660.0,130000.0,-52.0,-46.0,-42.0,-48.0,-51.0,-47.0,-44.0,-47.0,-88.0,-89.0,-85.0,-87.0,36.0,43.0,43.0,39.0,1
3933,CC:2F:71:3F:1F:24,4945097,1733703389,1100653,1248842850,3844444,484860539,1730,917068,1025448398,916254,1025349980,814,98418,886093,15,1099278,116926,1727,724,130000.0,43333.0,-68.0,-67.0,-68.0,-70.0,-68.0,-67.0,-68.0,-70.0,-88.0,-89.0,-85.0,-87.0,20.0,22.0,17.0,17.0,1
3934,CC:2F:71:3E:C5:1F,3845408,484978319,964,117780,3844444,484860539,2,4188,349516,3486,266150,702,83366,1021,12,1388,26,2,53,130000.0,39000.0,-71.0,-71.0,-69.0,-61.0,-71.0,-70.0,-69.0,-60.0,-88.0,-89.0,-85.0,-87.0,17.0,18.0,16.0,26.0,1
3935,BA:8C:B9:54:50:24,3849357,491052569,4913,6192030,3844444,484860539,7,9635,1743694,9613,1740199,22,3495,2358,17,5399,41,7,69,229410.0,130000.0,-49.0,-35.0,-43.0,-46.0,-47.0,-35.0,-43.0,-46.0,-88.0,-89.0,-85.0,-87.0,39.0,54.0,42.0,41.0,1
3936,62:47:05:9D:EB:15,3848991,492417586,4540,7556461,3844451,484861125,1,5466,3434297,5423,3427591,43,6706,2686,0,4570,56,1,119,229410.0,137640.0,-55.0,-59.0,-44.0,-53.0,-55.0,-59.0,-44.0,-52.0,-88.0,-89.0,-85.0,-87.0,33.0,30.0,41.0,34.0,1
3937,92:69:1D:31:68:E9,3848476,488511506,4025,3650381,3844451,484861125,1,5304,1149908,5139,1112465,165,37443,2192,12,4268,102,1,60,216660.0,130000.0,-52.0,-46.0,-42.0,-48.0,-51.0,-47.0,-44.0,-47.0,-88.0,-89.0,-85.0,-87.0,36.0,43.0,43.0,39.0,1
3938,CC:2F:71:3F:1F:24,4945298,1733950043,1100847,1249088918,3844451,484861125,1730,917252,1025690938,916437,1025592402,815,98536,886265,15,1099471,116926,1727,724,130000.0,43333.0,-68.0,-68.0,-68.0,-70.0,-68.0,-68.0,-68.0,-70.0,-88.0,-89.0,-85.0,-87.0,20.0,21.0,17.0,17.0,1
3939,CC:2F:71:3E:C5:1F,3845417,484979107,964,117780,3844453,484861327,2,4188,349516,3486,266150,702,83366,1021,12,1388,26,2,53,130000.0,39000.0,-71.0,-71.0,-69.0,-61.0,-71.0,-70.0,-69.0,-60.0,-88.0,-89.0,-85.0,-87.0,17.0,18.0,16.0,26.0,1
3940,BA:8C:B9:54:50:24,3849366,491053357,4913,6192030,3844453,484861327,7,9636,1743762,9614,1740267,22,3495,2358,17,5399,41,7,69,229410.0,130000.0,-49.0,-35.0,-43.0,-46.0,-47.0,-35.0,-43.0,-46.0,-88.0,-89.0,-85.0,-87.0,39.0,54.0,42.0,41.0,1
3941,62:47:05:9D:EB:15,3849596,493882034,5140,9020232,3844456,484861802,1,5566,3465078,5523,3458372,43,6706,2752,0,5200,56,1,119,229410.0,137640.0,-50.0,-56.0,-40.0,-49.0,-50.0,-55.0,-40.0,-49.0,-88.0,-89.0,-85.0,-87.0,38.0,33.0,45.0,38.0,1
3942,92:69:1D:31:68:E9,3848481,488512183,4025,3650381,3844456,484861802,1,5304,1149908,5139,1112465,165,37443,2192,12,4268,102,1,60,216660.0,130000.0,-52.0,-46.0,-42.0,-48.0,-51.0,-47.0,-44.0,-47.0,-88.0,-89.0,-85.0,-87.0,36.0,43.0,43.0,39.0,1
3943,CC:2F:71:3F:1F:24,4945493,1734190318,1101037,1249328516,3844456,484861802,1730,917442,1025939784,916627,1025841248,815,98536,886435,15,1099662,116930,1727,724,130000.0,43333.0,-68.0,-68.0,-69.0,-70.0,-68.0,-67.0,-68.0,-70.0,-88.0,-89.0,-85.0,-87.0,20.0,21.0,16.0,17.0,1
3944,CC:2F:71:3E:C5:1F,3845420,484979582,964,117780,3844456,484861802,2,4188,349516,3486,266150,702,83366,1021,12,1388,26,2,53,130000.0,39000.0,-71.0,-71.0,-69.0,-61.0,-71.0,-70.0,-69.0,-60.0,-88.0,-89.0,-85.0,-87.0,17.0,18.0,16.0,26.0,1
3945,BA:8C:B9:54:50:24,3849369,491053832,4913,6192030,3844456,484861802,7,9636,1743762,9614,1740267,22,3495,2358,17,5399,41,7,69,229410.0,130000.0,-49.0,-35.0,-43.0,-46.0,-47.0,-35.0,-43.0,-46.0,-88.0,-89.0,-85.0,-87.0,39.0,54.0,42.0,41.0,1
3946,62:47:05:9D:EB:15,3849603,493883408,5143,9021202,3844460,484862206,1,5574,3466611,5531,3459905,43,6706,2756,0,5203,56,1,119,229410.0,137640.0,-55.0,-59.0,-50.0,-52.0,-52.0,-57.0,-42.0,-50.0,-88.0,-89.0,-85.0,-87.0,33.0,30.0,35.0,35.0,1
3947,92:69:1D:31:68:E9,3848485,488512587,4025,3650381,3844460,484862206,1,5304,1149908,5139,1112465,165,37443,2192,12,4268,102,1,60,216660.0,130000.0,-52.0,-46.0,-42.0,-48.0,-51.0,-47.0,-44.0,-47.0,-88.0,-89.0,-85.0,-87.0,36.0,43.0,43.0,39.0,1
3948,CC:2F:71:3F:1F:24,4945696,1734437079,1101234,1249574671,3844462,484862408,1730,917631,1026184955,916816,1026086419,815,98536,886610,15,1099859,116930,1727,724,130000.0,43333.0,-69.0,-68.0,-69.0,-70.0,-68.0,-67.0,-68.0,-70.0,-88.0,-89.0,-85.0,-87.0,19.0,21.0,16.0,17.0,1
3949,CC:2F:71:3E:C5:1F,3845426,484980188,964,117780,3844462,484862408,2,4188,349516,3486,266150,702,83366,1021,12,1388,26,2,53,130000.0,39000.0,-71.0,-71.0,-69.0,-61.0,-71.0,-70.0,-69.0,-60.0,-88.0,-89.0,-85.0,-87.0,17.0,18.0,16.0,26.0,1
3950,BA:8C:B9:54:50:24,3849375,491054438,4913,6192030,3844462,484862408,7,9636,1743762,9614,1740267,22,3495,2358,17,5399,41,7,69,229410.0,130000.0,-49.0,-35.0,-43.0,-46.0,-47.0,-35.0,-43.0,-46.0,-88.0,-89.0,-85.0,-87.0,39.0,54.0,42.0,41.0,1
3951,62:47:05:9D:EB:15,3849619,493894746,5153,9032016,3844466,484862730,1,5595,3474409,5552,3467703,43,6706,2768,0,5213,56,1,119,229410.0,137640.0,-51.0,-55.0,-40.0,-50.0,-52.0,-56.0,-42.0,-51.0,-88.0,-89.0,-85.0,-87.0,37.0,34.0,45.0,37.0,1
3952,92:69:1D:31:68:E9,3848491,488513111,4025,3650381,3844466,484862730,1,5304,1149908,5139,1112465,165,37443,2192,12,4268,102,1,60,216660.0,130000.0,-52.0,-46.0,-42.0,-48.0,-51.0,-47.0,-44.0,-47.0,-88.0,-89.0,-85.0,-87.0,36.0,43.0,43.0,39.0,1
3953,CC:2F:71:3F:1F:24,4945889,1734677107,1101423,1249814377,3844466,484862730,1730,917812,1026428535,916997,1026329999,815,98536,886779,15,1100048,116930,1727,724,130000.0,43333.0,-68.0,-68.0,-68.0,-71.0,-68.0,-68.0,-68.0,-70.0,-88.0,-89.0,-85.0,-87.0,20.0,21.0,17.0,16.0,1
3954,CC:2F:71:3E:C5:1F,3845432,484980712,964,117780,3844468,484862932,2,4188,349516,3486,266150,702,83366,1021,12,1388,26,2,53,130000.0,39000.0,-71.0,-71.0,-69.0,-61.0,-71.0,-70.0,-69.0,-60.0,-88.0,-89.0,-85.0,-87.0,17.0,18.0,16.0,26.0,1
3955,BA:8C:B9:54:50:24,3849383,491055164,4913,6192030,3844470,484863134,7,9636,1743762,9614,1740267,22,3495,2358,17,5399,41,7,69,229410.0,130000.0,-49.0,-35.0,-43.0,-46.0,-47.0,-35.0,-43.0,-46.0,-88.0,-89.0,-85.0,-87.0,39.0,54.0,42.0,41.0,1
3956,62:47:05:9D:EB:15,3849626,493895412,5153,9032016,3844473,484863396,1,5609,3475361,5566,3468655,43,6706,2768,0,5213,56,1,119,229410.0,137640.0,-51.0,-58.0,-51.0,-54.0,-50.0,-54.0,-41.0,-50.0,-88.0,-89.0,-85.0,-87.0,37.0,31.0,34.0,33.0,1
3957,92:69:1D:31:68:E9,3848498,488513777,4025,3650381,3844473,484863396,1,5304,1149908,5139,1112465,165,37443,2192,12,4268,102,1,60,216660.0,130000.0,-52.0,-46.0,-42.0,-48.0,-51.0,-47.0,-44.0,-47.0,-88.0,-89.0,-85.0,-87.0,36.0,43.0,43.0,39.0,1
3958,CC:2F:71:3F:1F:24,4946088,1734921917,1101615,1250058521,3844473,484863396,1730,917995,1026672555,917180,1026574019,815,98536,886950,15,1100240,116938,1727,724,130000.0,43333.0,-69.0,-68.0,-69.0,-70.0,-68.0,-67.0,-68.0,-70.0,-88.0,-89.0,-85.0,-87.0,19.0,21.0,16.0,17.0,1
3959,CC:2F:71:3E:C5:1F,3845437,484981176,964,117780,3844473,484863396,2,4188,349516,3486,266150,702,83366,1021,12,1388,26,2,53,130000.0,39000.0,-71.0,-71.0,-69.0,-61.0,-71.0,-70.0,-69.0,-60.0,-88.0,-89.0,-85.0,-87.0,17.0,18.0,16.0,26.0,1
3960,BA:8C:B9:54:50:24,3849386,491055426,4913,6192030,3844473,484863396,7,9636,1743762,9614,1740267,22,3495,2358,17,5399,41,7,69,229410.0,130000.0,-49.0,-35.0,-43.0,-46.0,-47.0,-35.0,-43.0,-46.0,-88.0,-89.0,-85.0,-87.0,39.0,54.0,42.0,41.0,1
3961,62:47:05:9D:EB:15,3849629,493895674,5153,9032016,3844476,484863658,1,5609,3475361,5566,3468655,43,6706,2768,0,5213,56,1,119,229410.0,137640.0,-51.0,-58.0,-51.0,-54.0,-50.0,-54.0,-41.0,-50.0,-88.0,-89.0,-85.0,-87.0,37.0,31.0,34.0,33.0,1
3962,92:69:1D:31:68:E9,3848501,488514039,4025,3650381,3844476,484863658,1,5304,1149908,5139,1112465,165,37443,2192,12,4268,102,1,60,216660.0,130000.0,-52.0,-46.0,-42.0,-48.0,-51.0,-47.0,-44.0,-47.0,-88.0,-89.0,-85.0,-87.0,36.0,43.0,43.0,39.0,1
3963,CC:2F:71:3F:1F:24,4946281,1735161957,1101803,1250298097,3844478,484863860,1730,918167,1026904959,917352,1026806423,815,98536,887116,15,1100428,116938,1727,724,130000.0,43333.0,-68.0,-67.0,-68.0,-70.0,-68.0,-67.0,-67.0,-70.0,-88.0,-89.0,-85.0,-87.0,20.0,22.0,17.0,17.0,1
3964,CC:2F:71:3E:C5:1F,3845442,484981640,964,117780,3844478,484863860,2,4188,349516,3486,266150,702,83366,1021,12,1388,26,2,53,130000.0,39000.0,-71.0,-71.0,-69.0,-61.0,-71.0,-70.0,-69.0,-60.0,-88.0,-89.0,-85.0,-87.0,17.0,18.0,16.0,26.0,1
3965,BA:8C:B9:54:50:24,3849394,491056152,4913,6192030,3844481,484864122,7,9636,1743762,9614,1740267,22,3495,2358,17,5399,41,7,69,229410.0,130000.0,-49.0,-35.0,-43.0,-46.0,-47.0,-35.0,-43.0,-46.0,-88.0,-89.0,-85.0,-87.0,39.0,54.0,42.0,41.0,1
3966,62:47:05:9D:EB:15,3849636,493896340,5153,9032016,3844483,484864324,1,5609,3475361,5566,3468655,43,6706,2768,0,5213,56,1,119,229410.0,137640.0,-51.0,-58.0,-51.0,-54.0,-50.0,-54.0,-41.0,-50.0,-88.0,-89.0,-85.0,-87.0,37.0,31.0,34.0,33.0,1
3967,92:69:1D:31:68:E9,3848508,488514705,4025,3650381,3844483,484864324,1,5304,1149908,5139,1112465,165,37443,2192,12,4268,102,1,60,216660.0,130000.0,-52.0,-46.0,-42.0,-48.0,-51.0,-47.0,-44.0,-47.0,-88.0,-89.0,-85.0,-87.0,36.0,43.0,43.0,39.0,1
3968,CC:2F:71:3F:1F:24,4946486,1735408728,1102003,1250544404,3844483,484864324,1730,918355,1027148382,917540,1027049846,815,98536,887295,15,1100627,116946,1727,724,130000.0,43333.0,-68.0,-67.0,-67.0,-70.0,-68.0,-67.0,-67.0,-70.0,-88.0,-89.0,-85.0,-87.0,20.0,22.0,18.0,17.0,1
3969,CC:2F:71:3E:C5:1F,3845447,484982104,964,117780,3844483,484864324,2,4188,349516,3486,266150,702,83366,1021,12,1388,26,2,53,130000.0,39000.0,-71.0,-71.0,-69.0,-61.0,-71.0,-70.0,-69.0,-60.0,-88.0,-89.0,-85.0,-87.0,17.0,18.0,16.0,26.0,1
3970,BA:8C:B9:54:50:24,3849396,491056354,4913,6192030,3844483,484864324,7,9636,1743762,9614,1740267,22,3495,2358,17,5399,41,7,69,229410.0,130000.0,-49.0,-35.0,-43.0,-46.0,-47.0,-35.0,-43.0,-46.0,-88.0,-89.0,-85.0,-87.0,39.0,54.0,42.0,41.0,1
3971,62:47:05:9D:EB:15,3849641,493897292,5156,9032766,3844485,484864526,1,5637,3479909,5594,3473203,43,6706,2773,0,5216,56,1,120,229410.0,137640.0,-52.0,-55.0,-38.0,-50.0,-48.0,-54.0,-39.0,-50.0,-88.0,-89.0,-86.0,-87.0,36.0,34.0,48.0,37.0,1
3972,92:69:1D:31:68:E9,3848510,488514907,4025,3650381,3844485,484864526,1,5304,1149908,5139,1112465,165,37443,2192,12,4268,102,1,60,216660.0,130000.0,-52.0,-46.0,-42.0,-48.0,-51.0,-47.0,-44.0,-47.0,-88.0,-89.0,-86.0,-87.0,36.0,43.0,44.0,39.0,1
3973,CC:2F:71:3F:1F:24,4946682,1735649170,1102193,1250784240,3844489,484864930,1730,918531,1027382782,917716,1027284246,815,98536,887463,15,1100817,116946,1727,724,130000.0,43333.0,-68.0,-67.0,-67.0,-70.0,-68.0,-67.0,-67.0,-70.0,-88.0,-89.0,-86.0,-87.0,20.0,22.0,19.0,17.0,1
3974,CC:2F:71:3E:C5:1F,3845453,484982710,964,117780,3844489,484864930,2,4188,349516,3486,266150,702,83366,1021,12,1388,26,2,53,130000.0,39000.0,-71.0,-71.0,-69.0,-61.0,-71.0,-70.0,-69.0,-60.0,-88.0,-89.0,-86.0,-87.0,17.0,18.0,17.0,26.0,1
3975,BA:8C:B9:54:50:24,3849403,491057020,4913,6192030,3844490,484864990,7,9636,1743762,9614,1740267,22,3495,2358,17,5399,41,7,69,229410.0,130000.0,-49.0,-35.0,-43.0,-46.0,-47.0,-35.0,-43.0,-46.0,-88.0,-89.0,-86.0,-87.0,39.0,54.0,43.0,41.0,1
3976,62:47:05:9D:EB:15,3849649,493898020,5156,9032766,3844493,484865254,1,5637,3479909,5594,3473203,43,6706,2773,0,5216,56,1,120,229410.0,137640.0,-52.0,-55.0,-38.0,-50.0,-48.0,-54.0,-39.0,-50.0,-88.0,-89.0,-86.0,-87.0,36.0,34.0,48.0,37.0,1
3977,92:69:1D:31:68:E9,3848518,488515635,4025,3650381,3844493,484865254,1,5304,1149908,5139,1112465,165,37443,2192,12,4268,102,1,60,216660.0,130000.0,-52.0,-46.0,-42.0,-48.0,-51.0,-47.0,-44.0,-47.0,-88.0,-89.0,-86.0,-87.0,36.0,43.0,44.0,39.0,1
3978,CC:2F:71:3F:1F:24,4946880,1735894122,1102387,1251028868,3844493,484865254,1730,918718,1027631454,917903,1027532918,815,98536,887636,15,1101012,116946,1727,724,130000.0,43333.0,-71.0,-71.0,-71.0,-74.0,-71.0,-69.0,-70.0,-73.0,-88.0,-89.0,-86.0,-87.0,17.0,18.0,15.0,13.0,1
3979,CC:2F:71:3E:C5:1F,3845457,484983034,964,117780,3844493,484865254,2,4190,349704,3487,266220,703,83484,1022,12,1388,26,2,53,130000.0,39000.0,-70.0,-70.0,-69.0,-61.0,-71.0,-70.0,-69.0,-60.0,-88.0,-89.0,-86.0,-87.0,18.0,19.0,17.0,26.0,1
3980,BA:8C:B9:54:50:24,3849406,491057284,4913,6192030,3844493,484865254,7,9636,1743762,9614,1740267,22,3495,2358,17,5399,41,7,69,229410.0,130000.0,-49.0,-35.0,-43.0,-46.0,-47.0,-35.0,-43.0,-46.0,-88.0,-89.0,-86.0,-87.0,39.0,54.0,43.0,41.0,1
3981,62:47:05:9D:EB:15,3849654,493898486,5156,9032766,3844498,484865720,1,5640,3480167,5596,3473339,44,6828,2774,0,5216,56,1,120,229410.0,137640.0,-48.0,-60.0,-52.0,-55.0,-49.0,-55.0,-41.0,-50.0,-88.0,-89.0,-86.0,-87.0,40.0,29.0,34.0,32.0,1
3982,92:69:1D:31:68:E9,3848525,488516303,4025,3650381,3844500,484865922,1,5304,1149908,5139,1112465,165,37443,2192,12,4268,102,1,60,216660.0,130000.0,-52.0,-46.0,-42.0,-48.0,-51.0,-47.0,-44.0,-47.0,-88.0,-89.0,-86.0,-87.0,36.0,43.0,44.0,39.0,1
3983,CC:2F:71:3F:1F:24,4947081,1736140618,1102581,1251274696,3844500,484865922,1730,918901,1027878020,918086,1027779484,815,98536,887808,15,1101206,116950,1727,724,130000.0,43333.0,-71.0,-70.0,-71.0,-73.0,-71.0,-70.0,-71.0,-73.0,-88.0,-89.0,-86.0,-87.0,17.0,19.0,15.0,14.0,1
3984,CC:2F:71:3E:C5:1F,3845464,484983702,964,117780,3844500,484865922,2,4190,349704,3487,266220,703,83484,1022,12,1388,26,2,53,130000.0,39000.0,-70.0,-70.0,-69.0,-61.0,-71.0,-70.0,-69.0,-60.0,-88.0,-89.0,-86.0,-87.0,18.0,19.0,17.0,26.0,1
3985,BA:8C:B9:54:50:24,3849413,491057952,4913,6192030,3844500,484865922,7,9636,1743762,9614,1740267,22,3495,2358,17,5399,41,7,69,229410.0,130000.0,-49.0,-35.0,-43.0,-46.0,-47.0,-35.0,-43.0,-46.0,-88.0,-89.0,-86.0,-87.0,39.0,54.0,43.0,41.0,1
3986,62:47:05:9D:EB:15,3849659,493898950,5156,9032766,3844503,484866184,1,5641,3480235,5597,3473407,44,6828,2774,0,5216,56,1,120,229410.0,137640.0,-48.0,-61.0,-52.0,-55.0,-49.0,-56.0,-42.0,-51.0,-88.0,-89.0,-86.0,-87.0,40.0,28.0,34.0,32.0,1
3987,92:69:1D:31:68:E9,3848528,488516565,4025,3650381,3844503,484866184,1,5306,1150044,5141,1112601,165,37443,2192,12,4269,102,1,60,216660.0,130000.0,-53.0,-50.0,-44.0,-49.0,-51.0,-48.0,-45.0,-48.0,-88.0,-89.0,-86.0,-87.0,35.0,39.0,42.0,38.0,1
3988,CC:2F:71:3F:1F:24,4947283,1736385933,1102780,1251519749,3844503,484866184,1730,919093,1028124999,918278,1028026463,815,98536,887985,15,1101405,116951,1727,725,130000.0,43333.0,-71.0,-71.0,-71.0,-74.0,-70.0,-70.0,-70.0,-72.0,-88.0,-89.0,-86.0,-87.0,17.0,18.0,15.0,13.0,1
3989,CC:2F:71:3E:C5:1F,3845467,484983964,964,117780,3844503,484866184,2,4190,349704,3487,266220,703,83484,1022,12,1388,26,2,53,130000.0,39000.0,-70.0,-70.0,-69.0,-61.0,-71.0,-70.0,-69.0,-60.0,-88.0,-89.0,-86.0,-87.0,18.0,19.0,17.0,26.0,1
3990,BA:8C:B9:54:50:24,3849416,491058214,4913,6192030,3844503,484866184,7,9638,1743898,9616,1740403,22,3495,2358,17,5400,41,7,69,229410.0,130000.0,-40.0,-37.0,-46.0,-52.0,-48.0,-35.0,-43.0,-46.0,-88.0,-89.0,-86.0,-87.0,48.0,52.0,40.0,35.0,1
3991,62:47:05:9D:EB:15,3849665,493899556,5156,9032766,3844509,484866790,1,5643,3480371,5599,3473543,44,6828,2774,0,5216,56,1,120,229410.0,137640.0,-50.0,-56.0,-38.0,-49.0,-49.0,-57.0,-44.0,-51.0,-88.0,-89.0,-86.0,-87.0,38.0,33.0,48.0,38.0,1
3992,92:69:1D:31:68:E9,3848534,488517171,4025,3650381,3844509,484866790,1,5306,1150044,5141,1112601,165,37443,2192,12,4269,102,1,60,216660.0,130000.0,-53.0,-50.0,-44.0,-49.0,-51.0,-48.0,-45.0,-48.0,-88.0,-89.0,-86.0,-87.0,35.0,39.0,42.0,38.0,1
3993,CC:2F:71:3F:1F:24,4947479,1736627575,1102970,1251760785,3844509,484866790,1730,919276,1028370197,918461,1028271661,815,98536,888155,15,1101595,116958,1727,725,130000.0,43333.0,-72.0,-71.0,-71.0,-74.0,-71.0,-70.0,-70.0,-72.0,-88.0,-89.0,-86.0,-87.0,16.0,18.0,15.0,13.0,1
3994,CC:2F:71:3E:C5:1F,3845473,484984570,964,117780,3844509,484866790,2,4190,349704,3487,266220,703,83484,1022,12,1388,26,2,53,130000.0,39000.0,-70.0,-70.0,-69.0,-61.0,-71.0,-70.0,-69.0,-60.0,-88.0,-89.0,-86.0,-87.0,18.0,19.0,17.0,26.0,1
3995,BA:8C:B9:54:50:24,3849422,491058820,4913,6192030,3844509,484866790,7,9638,1743898,9616,1740403,22,3495,2358,17,5400,41,7,69,229410.0,130000.0,-40.0,-37.0,-46.0,-52.0,-48.0,-35.0,-43.0,-46.0,-88.0,-89.0,-86.0,-87.0,48.0,52.0,40.0,35.0,1
3996,62:47:05:9D:EB:15,3849679,493910186,5167,9043134,3844512,484867052,1,5679,3500685,5635,3493857,44,6828,2793,0,5227,56,1,120,216660.0,130000.0,-52.0,-57.0,-39.0,-50.0,-52.0,-58.0,-43.0,-51.0,-88.0,-89.0,-86.0,-87.0,36.0,32.0,47.0,37.0,1
3997,92:69:1D:31:68:E9,3848537,488517433,4025,3650381,3844512,484867052,1,5306,1150044,5141,1112601,165,37443,2192,12,4269,102,1,60,216660.0,130000.0,-53.0,-50.0,-44.0,-49.0,-51.0,-48.0,-45.0,-48.0,-88.0,-89.0,-86.0,-87.0,35.0,39.0,42.0,38.0,1
3998,CC:2F:71:3F:1F:24,4947680,1736877755,1103168,1252010703,3844512,484867052,1730,919460,1028614035,918645,1028515499,815,98536,888331,15,1101793,116960,1727,725,130000.0,43333.0,-68.0,-67.0,-68.0,-70.0,-67.0,-67.0,-67.0,-69.0,-88.0,-89.0,-86.0,-87.0,20.0,22.0,18.0,17.0,1
3999,CC:2F:71:3E:C5:1F,3845476,484984832,964,117780,3844512,484867052,2,4190,349704,3487,266220,703,83484,1022,12,1388,26,2,53,130000.0,39000.0,-70.0,-70.0,-69.0,-61.0,-71.0,-70.0,-69.0,-60.0,-88.0,-89.0,-86.0,-87.0,18.0,19.0,17.0,26.0,1
4000,BA:8C:B9:54:50:24,3849426,491059142,4913,6192030,3844513,484867112,7,9638,1743898,9616,1740403,22,3495,2358,17,5400,41,7,69,229410.0,130000.0,-40.0,-37.0,-46.0,-52.0,-48.0,-35.0,-43.0,-46.0,-88.0,-89.0,-86.0,-87.0,48.0,52.0,40.0,35.0,1
4001,62:47:05:9D:EB:15,3849690,493911735,5171,9044017,3844519,484867718,1,5710,3510545,5666,3503717,44,6828,2801,0,5231,56,1,120,216660.0,130000.0,-52.0,-59.0,-44.0,-52.0,-50.0,-57.0,-41.0,-49.0,-88.0,-89.0,-86.0,-87.0,36.0,30.0,42.0,35.0,1
4002,92:69:1D:31:68:E9,3848544,488518099,4025,3650381,3844519,484867718,1,5306,1150044,5141,1112601,165,37443,2192,12,4269,102,1,60,216660.0,130000.0,-53.0,-50.0,-44.0,-49.0,-51.0,-48.0,-45.0,-48.0,-88.0,-89.0,-86.0,-87.0,35.0,39.0,42.0,38.0,1
4003,CC:2F:71:3F:1F:24,4947877,1737119697,1103358,1252251979,3844519,484867718,1730,919634,1028845399,918819,1028746863,815,98536,888499,15,1101983,116960,1727,726,130000.0,43333.0,-68.0,-67.0,-68.0,-70.0,-68.0,-67.0,-68.0,-70.0,-88.0,-89.0,-86.0,-87.0,20.0,22.0,18.0,17.0,1
4004,CC:2F:71:3E:C5:1F,3845483,484985498,964,117780,3844519,484867718,2,4190,349704,3487,266220,703,83484,1022,12,1388,26,2,53,130000.0,39000.0,-70.0,-70.0,-69.0,-61.0,-71.0,-70.0,-69.0,-60.0,-88.0,-89.0,-86.0,-87.0,18.0,19.0,17.0,26.0,1
4005,BA:8C:B9:54:50:24,3849432,491059748,4913,6192030,3844519,484867718,7,9638,1743898,9616,1740403,22,3495,2358,17,5400,41,7,69,229410.0,130000.0,-40.0,-37.0,-46.0,-52.0,-48.0,-35.0,-43.0,-46.0,-88.0,-89.0,-86.0,-87.0,48.0,52.0,40.0,35.0,1
4006,62:47:05:9D:EB:15,3849706,493923436,5183,9055183,3844523,484868253,1,5745,3526404,5701,3519576,44,6828,2815,0,5243,56,1,120,229410.0,130000.0,-55.0,-61.0,-45.0,-53.0,-54.0,-60.0,-43.0,-52.0,-88.0,-89.0,-86.0,-87.0,33.0,28.0,41.0,34.0,1
4007,92:69:1D:31:68:E9,3848548,488518634,4025,3650381,3844523,484868253,1,5306,1150044,5141,1112601,165,37443,2192,12,4269,102,1,60,216660.0,130000.0,-53.0,-50.0,-44.0,-49.0,-51.0,-48.0,-45.0,-48.0,-88.0,-89.0,-86.0,-87.0,35.0,39.0,42.0,38.0,1
4008,CC:2F:71:3F:1F:24,4948078,1737364755,1103555,1252496502,3844523,484868253,1730,919826,1029095171,919011,1028996635,815,98536,888676,15,1102180,116965,1727,726,130000.0,43333.0,-71.0,-70.0,-72.0,-73.0,-70.0,-69.0,-71.0,-73.0,-88.0,-89.0,-86.0,-87.0,17.0,19.0,14.0,14.0,1
4009,CC:2F:71:3E:C5:1F,3845487,484986033,964,117780,3844523,484868253,2,4190,349704,3487,266220,703,83484,1022,12,1388,26,2,53,130000.0,39000.0,-70.0,-70.0,-69.0,-61.0,-71.0,-70.0,-69.0,-60.0,-88.0,-89.0,-86.0,-87.0,18.0,19.0,17.0,26.0,1
4010,BA:8C:B9:54:50:24,3849436,491060283,4913,6192030,3844523,484868253,7,9638,1743898,9616,1740403,22,3495,2358,17,5400,41,7,69,229410.0,130000.0,-40.0,-37.0,-46.0,-52.0,-48.0,-35.0,-43.0,-46.0,-88.0,-89.0,-86.0,-87.0,48.0,52.0,40.0,35.0,1
4011,62:47:05:9D:EB:15,3849715,493924273,5183,9055183,3844532,484869090,1,5770,3528207,5725,3521208,45,6999,2816,0,5243,56,1,120,229410.0,130000.0,-51.0,-59.0,-38.0,-47.0,-54.0,-59.0,-43.0,-51.0,-88.0,-89.0,-86.0,-87.0,37.0,30.0,48.0,40.0,1
4012,92:69:1D:31:68:E9,3848557,488519471,4025,3650381,3844532,484869090,1,5306,1150044,5141,1112601,165,37443,2192,12,4269,102,1,60,216660.0,130000.0,-53.0,-50.0,-44.0,-49.0,-51.0,-48.0,-45.0,-48.0,-88.0,-89.0,-86.0,-87.0,35.0,39.0,42.0,38.0,1
4013,CC:2F:71:3F:1F:24,4948277,1737608164,1103745,1252739074,3844532,484869090,1730,920012,1029342237,919197,1029243701,815,98536,888847,15,1102369,116970,1727,726,117000.0,39000.0,-68.0,-66.0,-69.0,-71.0,-67.0,-66.0,-69.0,-71.0,-88.0,-89.0,-86.0,-87.0,20.0,23.0,17.0,16.0,1
4014,CC:2F:71:3E:C5:1F,3845496,484986870,964,117780,3844532,484869090,2,4190,349704,3487,266220,703,83484,1022,12,1388,26,2,53,130000.0,39000.0,-70.0,-70.0,-69.0,-61.0,-71.0,-70.0,-69.0,-60.0,-88.0,-89.0,-86.0,-87.0,18.0,19.0,17.0,26.0,1
4015,BA:8C:B9:54:50:24,3849447,491061322,4913,6192030,3844534,484869292,7,9638,1743898,9616,1740403,22,3495,2358,17,5400,41,7,69,229410.0,130000.0,-40.0,-37.0,-46.0,-52.0,-48.0,-35.0,-43.0,-46.0,-88.0,-89.0,-86.0,-87.0,48.0,52.0,40.0,35.0,1
4016,62:47:05:9D:EB:15,3849728,493928782,5192,9059280,3844536,484869502,1,5801,3540559,5756,3533560,45,6999,2830,0,5252,56,1,120,229410.0,137640.0,-48.0,-63.0,-45.0,-55.0,-53.0,-56.0,-44.0,-53.0,-88.0,-89.0,-86.0,-87.0,40.0,26.0,41.0,32.0,1
4017,92:69:1D:31:68:E9,3848561,488519883,4025,3650381,3844536,484869502,1,5306,1150044,5141,1112601,165,37443,2192,12,4269,102,1,60,216660.0,130000.0,-53.0,-50.0,-44.0,-49.0,-51.0,-48.0,-45.0,-48.0,-88.0,-89.0,-86.0,-87.0,35.0,39.0,42.0,38.0,1
4018,CC:2F:71:3F:1F:24,4948469,1737848040,1103933,1252978538,3844536,484869502,1730,920186,1029570745,919371,1029472209,815,98536,889015,15,1102558,116973,1727,726,130000.0,43333.0,-70.0,-66.0,-68.0,-69.0,-69.0,-66.0,-68.0,-69.0,-88.0,-89.0,-86.0,-87.0,18.0,23.0,18.0,18.0,1
4019,CC:2F:71:3E:C5:1F,3845500,484987282,964,117780,3844536,484869502,2,4190,349704,3487,266220,703,83484,1022,12,1388,26,2,53,130000.0,39000.0,-70.0,-70.0,-69.0,-61.0,-71.0,-70.0,-69.0,-60.0,-88.0,-89.0,-86.0,-87.0,18.0,19.0,17.0,26.0,1
4020,BA:8C:B9:54:50:24,3849449,491061532,4913,6192030,3844536,484869502,7,9638,1743898,9616,1740403,22,3495,2358,17,5400,41,7,69,229410.0,130000.0,-40.0,-37.0,-46.0,-52.0,-48.0,-35.0,-43.0,-46.0,-88.0,-89.0,-86.0,-87.0,48.0,52.0,40.0,35.0,1
4021,62:47:05:9D:EB:15,3850031,494650217,5489,9780109,3844542,484870108,1,5886,3588538,5841,3581539,45,6999,2876,0,5549,56,1,120,229410.0,137640.0,-51.0,-51.0,-46.0,-54.0,-46.0,-47.0,-42.0,-50.0,-88.0,-89.0,-86.0,-87.0,37.0,38.0,40.0,33.0,1
4022,92:69:1D:31:68:E9,3848567,488520489,4025,3650381,3844542,484870108,1,5306,1150044,5141,1112601,165,37443,2192,12,4269,102,1,60,216660.0,130000.0,-53.0,-50.0,-44.0,-49.0,-51.0,-48.0,-45.0,-48.0,-88.0,-89.0,-86.0,-87.0,35.0,39.0,42.0,38.0,1
4023,CC:2F:71:3F:1F:24,4948673,1738094723,1104131,1253224615,3844542,484870108,1730,920374,1029808596,919559,1029710060,815,98536,889195,15,1102756,116977,1727,726,130000.0,43333.0,-68.0,-66.0,-68.0,-70.0,-68.0,-66.0,-68.0,-70.0,-88.0,-89.0,-86.0,-87.0,20.0,23.0,18.0,17.0,1
4024,CC:2F:71:3E:C5:1F,3845508,484988090,964,117780,3844544,484870310,2,4190,349704,3487,266220,703,83484,1022,12,1388,26,2,53,130000.0,39000.0,-70.0,-70.0,-69.0,-61.0,-71.0,-70.0,-69.0,-60.0,-88.0,-89.0,-86.0,-87.0,18.0,19.0,17.0,26.0,1
4025,BA:8C:B9:54:50:24,3849458,491062400,4913,6192030,3844545,484870370,7,9638,1743898,9616,1740403,22,3495,2358,17,5400,41,7,69,229410.0,130000.0,-40.0,-37.0,-46.0,-52.0,-48.0,-35.0,-43.0,-46.0,-88.0,-89.0,-86.0,-87.0,48.0,52.0,40.0,35.0,1
4026,62:47:05:9D:EB:15,3850041,494657851,5496,9787481,3844545,484870370,1,5903,3589888,5858,3582889,45,6999,2879,0,5556,56,1,120,229410.0,137640.0,-51.0,-46.0,-43.0,-55.0,-51.0,-50.0,-46.0,-54.0,-88.0,-89.0,-86.0,-87.0,37.0,43.0,43.0,32.0,1
4027,92:69:1D:31:68:E9,3848570,488520751,4025,3650381,3844545,484870370,1,5306,1150044,5141,1112601,165,37443,2192,12,4269,102,1,60,216660.0,130000.0,-53.0,-50.0,-44.0,-49.0,-51.0,-48.0,-45.0,-48.0,-88.0,-89.0,-86.0,-87.0,35.0,39.0,42.0,38.0,1
4028,CC:2F:71:3F:1F:24,4948867,1738339223,1104322,1253468853,3844545,484870370,1730,920556,1030056484,919741,1029957948,815,98536,889365,15,1102947,116977,1727,726,130000.0,43333.0,-70.0,-67.0,-69.0,-71.0,-69.0,-67.0,-69.0,-70.0,-88.0,-89.0,-86.0,-87.0,18.0,22.0,17.0,16.0,1
4029,CC:2F:71:3E:C5:1F,3845509,484988150,964,117780,3844545,484870370,2,4190,349704,3487,266220,703,83484,1022,12,1388,26,2,53,130000.0,39000.0,-70.0,-70.0,-69.0,-61.0,-71.0,-70.0,-69.0,-60.0,-88.0,-89.0,-86.0,-87.0,18.0,19.0,17.0,26.0,1
4030,BA:8C:B9:54:50:24,3849458,491062400,4913,6192030,3844545,484870370,7,9638,1743898,9616,1740403,22,3495,2358,17,5400,41,7,69,229410.0,130000.0,-40.0,-37.0,-46.0,-52.0,-48.0,-35.0,-43.0,-46.0,-88.0,-89.0,-86.0,-87.0,48.0,52.0,40.0,35.0,1
4031,62:47:05:9D:EB:15,3850138,494870263,5587,9999287,3844551,484870976,1,5922,3593109,5877,3586110,45,6999,2894,0,5647,56,1,120,229410.0,137640.0,-48.0,-58.0,-47.0,-52.0,-51.0,-52.0,-46.0,-55.0,-88.0,-89.0,-86.0,-87.0,40.0,31.0,39.0,35.0,1
4032,92:69:1D:31:68:E9,3848578,488521559,4025,3650381,3844553,484871178,1,5306,1150044,5141,1112601,165,37443,2192,12,4269,102,1,60,216660.0,130000.0,-53.0,-50.0,-44.0,-49.0,-51.0,-48.0,-45.0,-48.0,-88.0,-89.0,-86.0,-87.0,35.0,39.0,42.0,38.0,1
4033,CC:2F:71:3F:1F:24,4949066,1738581407,1104513,1253710229,3844553,484871178,1730,920738,1030298858,919923,1030200322,815,98536,889535,15,1103138,116977,1727,726,130000.0,43333.0,-73.0,-70.0,-72.0,-73.0,-72.0,-69.0,-71.0,-72.0,-88.0,-89.0,-86.0,-87.0,15.0,19.0,14.0,14.0,1
4034,CC:2F:71:3E:C5:1F,3845517,484988958,964,117780,3844553,484871178,2,4190,349704,3487,266220,703,83484,1022,12,1388,26,2,53,130000.0,39000.0,-70.0,-70.0,-69.0,-61.0,-71.0,-70.0,-69.0,-60.0,-88.0,-89.0,-86.0,-87.0,18.0,19.0,17.0,26.0,1
4035,BA:8C:B9:54:50:24,3849466,491063208,4913,6192030,3844553,484871178,7,9638,1743898,9616,1740403,22,3495,2358,17,5400,41,7,69,229410.0,130000.0,-40.0,-37.0,-46.0,-52.0,-48.0,-35.0,-43.0,-46.0,-88.0,-89.0,-86.0,-87.0,48.0,52.0,40.0,35.0,1
4036,62:47:05:9D:EB:15,3850163,494886103,5609,10014865,3844554,484871238,1,6000,3625132,5955,3618133,45,6999,2928,0,5669,56,1,120,229410.0,137640.0,-51.0,-51.0,-47.0,-56.0,-50.0,-51.0,-47.0,-55.0,-89.0,-89.0,-86.0,-87.0,38.0,38.0,39.0,31.0,1
4037,92:69:1D:31:68:E9,3848579,488521619,4025,3650381,3844554,484871238,1,5307,1150112,5142,1112669,165,37443,2192,12,4269,102,1,60,216660.0,130000.0,-51.0,-49.0,-44.0,-49.0,-51.0,-48.0,-44.0,-48.0,-89.0,-89.0,-86.0,-87.0,38.0,40.0,42.0,38.0,1
4038,CC:2F:71:3F:1F:24,4949257,1738822519,1104703,1253951281,3844554,484871238,1730,920927,1030546366,920112,1030447830,815,98536,889708,15,1103328,116990,1727,726,130000.0,43333.0,-73.0,-70.0,-72.0,-74.0,-72.0,-69.0,-71.0,-73.0,-89.0,-89.0,-86.0,-87.0,16.0,19.0,14.0,13.0,1
4039,CC:2F:71:3E:C5:1F,3845518,484989018,964,117780,3844554,484871238,2,4190,349704,3487,266220,703,83484,1022,12,1388,26,2,53,130000.0,39000.0,-70.0,-70.0,-69.0,-61.0,-71.0,-70.0,-69.0,-60.0,-89.0,-89.0,-86.0,-87.0,19.0,19.0,17.0,26.0,1
4040,BA:8C:B9:54:50:24,3849467,491063268,4913,6192030,3844554,484871238,7,9638,1743898,9616,1740403,22,3495,2358,17,5400,41,7,69,229410.0,130000.0,-40.0,-37.0,-46.0,-52.0,-48.0,-35.0,-43.0,-46.0,-89.0,-89.0,-86.0,-87.0,49.0,52.0,40.0,35.0,1
4041,62:47:05:9D:EB:15,3850332,495225278,5769,10353106,3844563,484872172,1,6051,3638026,6006,3631027,45,6999,2972,0,5829,56,1,120,229410.0,137640.0,-51.0,-51.0,-47.0,-55.0,-51.0,-51.0,-47.0,-55.0,-89.0,-89.0,-86.0,-87.0,38.0,38.0,39.0,32.0,1
4042,92:69:1D:31:68:E9,3848588,488522553,4025,3650381,3844563,484872172,1,5307,1150112,5142,1112669,165,37443,2192,12,4269,102,1,60,216660.0,130000.0,-51.0,-49.0,-44.0,-49.0,-51.0,-48.0,-44.0,-48.0,-89.0,-89.0,-86.0,-87.0,38.0,40.0,42.0,38.0,1
4043,CC:2F:71:3F:1F:24,4949465,1739071324,1104902,1254199152,3844563,484872172,1730,921112,1030788028,920297,1030689492,815,98536,889886,15,1103527,116990,1727,726,130000.0,43333.0,-73.0,-70.0,-72.0,-73.0,-72.0,-69.0,-71.0,-73.0,-89.0,-89.0,-86.0,-87.0,16.0,19.0,14.0,14.0,1
4044,CC:2F:71:3E:C5:1F,3845527,484989952,964,117780,3844563,484872172,2,4190,349704,3487,266220,703,83484,1022,12,1388,26,2,53,130000.0,39000.0,-70.0,-70.0,-69.0,-61.0,-71.0,-70.0,-69.0,-60.0,-89.0,-89.0,-86.0,-87.0,19.0,19.0,17.0,26.0,1
4045,BA:8C:B9:54:50:24,3849476,491064202,4913,6192030,3844563,484872172,7,9638,1743898,9616,1740403,22,3495,2358,17,5400,41,7,69,229410.0,130000.0,-40.0,-37.0,-46.0,-52.0,-48.0,-35.0,-43.0,-46.0,-89.0,-89.0,-86.0,-87.0,49.0,52.0,40.0,35.0,1
4046,62:47:05:9D:EB:15,3850601,495826700,6038,10954528,3844563,484872172,1,6137,3657447,6092,3650448,45,6999,3029,0,6098,56,1,121,229410.0,137640.0,-52.0,-52.0,-47.0,-55.0,-50.0,-50.0,-46.0,-54.0,-89.0,-89.0,-86.0,-87.0,37.0,37.0,39.0,32.0,1
4047,92:69:1D:31:68:E9,3848588,488522553,4025,3650381,3844563,484872172,1,5307,1150112,5142,1112669,165,37443,2192,12,4269,102,1,60,216660.0,130000.0,-51.0,-49.0,-44.0,-49.0,-51.0,-48.0,-44.0,-48.0,-89.0,-89.0,-86.0,-87.0,38.0,40.0,42.0,38.0,1
4048,CC:2F:71:3F:1F:24,4949662,1739320408,1105099,1254448236,3844563,484872172,1730,921300,1031042560,920485,1030944024,815,98536,890059,15,1103724,117006,1727,729,130000.0,43333.0,-73.0,-70.0,-72.0,-74.0,-73.0,-69.0,-71.0,-72.0,-89.0,-89.0,-86.0,-87.0,16.0,19.0,14.0,13.0,1
4049,CC:2F:71:3E:C5:1F,3845527,484989952,964,117780,3844563,484872172,2,4190,349704,3487,266220,703,83484,1022,12,1388,26,2,53,130000.0,39000.0,-70.0,-70.0,-69.0,-61.0,-71.0,-70.0,-69.0,-60.0,-89.0,-89.0,-86.0,-87.0,19.0,19.0,17.0,26.0,1
4050,BA:8C:B9:54:50:24,3849479,491064464,4913,6192030,3844566,484872434,7,9638,1743898,9616,1740403,22,3495,2358,17,5400,41,7,69,229410.0,130000.0,-40.0,-37.0,-46.0,-52.0,-48.0,-35.0,-43.0,-46.0,-89.0,-89.0,-86.0,-87.0,49.0,52.0,40.0,35.0,1
4051,62:47:05:9D:EB:15,3850610,495827568,6038,10954528,3844572,484873040,1,6138,3657515,6093,3650516,45,6999,3029,0,6098,56,1,121,229410.0,137640.0,-50.0,-45.0,-43.0,-54.0,-51.0,-50.0,-46.0,-54.0,-89.0,-89.0,-86.0,-87.0,39.0,44.0,43.0,33.0,1
4052,92:69:1D:31:68:E9,3848597,488523421,4025,3650381,3844572,484873040,1,5307,1150112,5142,1112669,165,37443,2192,12,4269,102,1,60,216660.0,130000.0,-51.0,-49.0,-44.0,-49.0,-51.0,-48.0,-44.0,-48.0,-89.0,-89.0,-86.0,-87.0,38.0,40.0,42.0,38.0,1
4053,CC:2F:71:3F:1F:24,4949867,1739571806,1105295,1254698766,3844572,484873040,1730,921486,1031293922,920671,1031195386,815,98536,890234,15,1103920,117008,1727,729,130000.0,39000.0,-70.0,-67.0,-69.0,-70.0,-70.0,-66.0,-68.0,-70.0,-89.0,-89.0,-86.0,-87.0,19.0,22.0,17.0,17.0,1
4054,CC:2F:71:3E:C5:1F,3845537,484990936,965,117896,3844572,484873040,2,4193,349914,3490,266430,703,83484,1022,12,1389,26,2,53,130000.0,39000.0,-72.0,-71.0,-69.0,-60.0,-70.0,-69.0,-68.0,-60.0,-89.0,-89.0,-86.0,-87.0,17.0,18.0,17.0,27.0,1
4055,BA:8C:B9:54:50:24,3849486,491065186,4914,6192146,3844572,484873040,7,9641,1744102,9619,1740607,22,3495,2358,17,5401,41,7,70,229410.0,130000.0,-41.0,-34.0,-42.0,-47.0,-44.0,-35.0,-43.0,-47.0,-89.0,-89.0,-86.0,-87.0,48.0,55.0,44.0,40.0,1
4056,62:47:05:9D:EB:15,3850611,495827684,6039,10954644,3844572,484873040,1,6140,3657651,6095,3650652,45,6999,3029,0,6099,56,1,121,229410.0,137640.0,-46.0,-44.0,-42.0,-51.0,-49.0,-48.0,-45.0,-53.0,-89.0,-89.0,-86.0,-87.0,43.0,45.0,44.0,36.0,1
4057,92:69:1D:31:68:E9,3848598,488523537,4026,3650497,3844572,484873040,1,5309,1150248,5144,1112805,165,37443,2192,12,4270,102,1,60,216660.0,130000.0,-52.0,-49.0,-43.0,-48.0,-52.0,-48.0,-43.0,-48.0,-89.0,-89.0,-86.0,-87.0,37.0,40.0,43.0,39.0,1
4058,CC:2F:71:3F:1F:24,4950060,1739817560,1105488,1254944520,3844572,484873040,1730,921666,1031531668,920851,1031433132,815,98536,890407,15,1104113,117012,1727,729,130000.0,43333.0,-73.0,-70.0,-72.0,-73.0,-72.0,-68.0,-71.0,-72.0,-89.0,-89.0,-86.0,-87.0,16.0,19.0,14.0,14.0,1
4059,CC:2F:71:3E:C5:1F,3845539,484991138,965,117896,3844574,484873242,2,4193,349914,3490,266430,703,83484,1022,12,1389,26,2,53,130000.0,39000.0,-72.0,-71.0,-69.0,-60.0,-70.0,-69.0,-68.0,-60.0,-89.0,-89.0,-86.0,-87.0,17.0,18.0,17.0,27.0,1
4060,BA:8C:B9:54:50:24,3849488,491065388,4914,6192146,3844574,484873242,7,9642,1744170,9620,1740675,22,3495,2358,17,5401,41,7,70,229410.0,130000.0,-48.0,-35.0,-43.0,-45.0,-44.0,-35.0,-43.0,-47.0,-89.0,-89.0,-86.0,-87.0,41.0,54.0,43.0,42.0,1
4061,62:47:05:9D:EB:15,3850621,495828614,6039,10954644,3844582,484873970,1,6163,3659269,6117,3652148,46,7121,3030,0,6099,56,1,121,229410.0,137640.0,-46.0,-42.0,-41.0,-51.0,-46.0,-47.0,-45.0,-52.0,-89.0,-90.0,-86.0,-87.0,43.0,48.0,45.0,36.0,1
4062,92:69:1D:31:68:E9,3848608,488524467,4026,3650497,3844582,484873970,1,5309,1150248,5144,1112805,165,37443,2192,12,4270,102,1,60,216660.0,130000.0,-52.0,-49.0,-43.0,-48.0,-52.0,-48.0,-43.0,-48.0,-89.0,-90.0,-86.0,-87.0,37.0,41.0,43.0,39.0,1
4063,CC:2F:71:3F:1F:24,4950269,1740066331,1105687,1255192361,3844582,484873970,1730,921856,1031779708,921041,1031681172,815,98536,890585,15,1104312,117012,1727,730,130000.0,43333.0,-71.0,-67.0,-69.0,-70.0,-71.0,-67.0,-68.0,-70.0,-89.0,-90.0,-86.0,-87.0,18.0,23.0,17.0,17.0,1
4064,CC:2F:71:3E:C5:1F,3845547,484991866,965,117896,3844582,484873970,2,4193,349914,3490,266430,703,83484,1022,12,1389,26,2,53,130000.0,39000.0,-72.0,-71.0,-69.0,-60.0,-70.0,-69.0,-68.0,-60.0,-89.0,-90.0,-86.0,-87.0,17.0,19.0,17.0,27.0,1
4065,BA:8C:B9:54:50:24,3849496,491066116,4914,6192146,3844582,484873970,7,9642,1744170,9620,1740675,22,3495,2358,17,5401,41,7,70,229410.0,130000.0,-48.0,-35.0,-43.0,-45.0,-44.0,-35.0,-43.0,-47.0,-89.0,-90.0,-86.0,-87.0,41.0,55.0,43.0,42.0,1
4066,62:47:05:9D:EB:15,3850624,495829316,6041,10955073,3844583,484874243,1,6169,3659975,6123,3652854,46,7121,3033,0,6101,56,1,121,229410.0,137640.0,-43.0,-46.0,-38.0,-47.0,-48.0,-49.0,-42.0,-50.0,-89.0,-90.0,-86.0,-87.0,46.0,44.0,48.0,40.0,1
4067,92:69:1D:31:68:E9,3848609,488524740,4026,3650497,3844583,484874243,1,5309,1150248,5144,1112805,165,37443,2192,12,4270,102,1,60,216660.0,130000.0,-52.0,-49.0,-43.0,-48.0,-52.0,-48.0,-43.0,-48.0,-89.0,-90.0,-86.0,-87.0,37.0,41.0,43.0,39.0,1
4068,CC:2F:71:3F:1F:24,4950463,1740307972,1105878,1255433527,3844585,484874445,1730,922037,1032024742,921222,1031926206,815,98536,890753,15,1104503,117016,1727,730,130000.0,43333.0,-74.0,-69.0,-72.0,-74.0,-73.0,-68.0,-70.0,-73.0,-89.0,-90.0,-86.0,-87.0,15.0,21.0,14.0,13.0,1
4069,CC:2F:71:3E:C5:1F,3845550,484992341,965,117896,3844585,484874445,2,4193,349914,3490,266430,703,83484,1022,12,1389,26,2,53,130000.0,39000.0,-72.0,-71.0,-69.0,-60.0,-70.0,-69.0,-68.0,-60.0,-89.0,-90.0,-86.0,-87.0,17.0,19.0,17.0,27.0,1
4070,BA:8C:B9:54:50:24,3849501,491066793,4914,6192146,3844587,484874647,7,9642,1744170,9620,1740675,22,3495,2358,17,5401,41,7,70,229410.0,130000.0,-48.0,-35.0,-43.0,-45.0,-44.0,-35.0,-43.0,-47.0,-89.0,-90.0,-86.0,-87.0,41.0,55.0,43.0,42.0,1
4071,62:47:05:9D:EB:15,3850636,495830725,6045,10955674,3844591,484875051,1,6177,3663235,6131,3656114,46,7121,3037,0,6105,56,1,121,229410.0,137640.0,-44.0,-46.0,-38.0,-47.0,-46.0,-49.0,-41.0,-48.0,-89.0,-90.0,-86.0,-87.0,45.0,44.0,48.0,40.0,1
4072,92:69:1D:31:68:E9,3848617,488525548,4026,3650497,3844591,484875051,1,5309,1150248,5144,1112805,165,37443,2192,12,4270,102,1,60,216660.0,130000.0,-52.0,-49.0,-43.0,-48.0,-52.0,-48.0,-43.0,-48.0,-89.0,-90.0,-86.0,-87.0,37.0,41.0,43.0,39.0,1
4073,CC:2F:71:3F:1F:24,4950660,1740551976,1106069,1255676925,3844591,484875051,1730,922220,1032272822,921405,1032174286,815,98536,890922,15,1104694,117084,1727,730,104000.0,26000.0,-74.0,-70.0,-71.0,-76.0,-73.0,-70.0,-70.0,-75.0,-89.0,-90.0,-86.0,-87.0,15.0,20.0,15.0,11.0,1
4074,CC:2F:71:3E:C5:1F,3845557,484993007,965,117896,3844592,484875111,2,4193,349914,3490,266430,703,83484,1022,12,1389,26,2,53,130000.0,39000.0,-72.0,-71.0,-69.0,-60.0,-70.0,-69.0,-68.0,-60.0,-89.0,-90.0,-86.0,-87.0,17.0,19.0,17.0,27.0,1
4075,BA:8C:B9:54:50:24,3849506,491067257,4914,6192146,3844592,484875111,7,9642,1744170,9620,1740675,22,3495,2358,17,5401,41,7,70,229410.0,130000.0,-48.0,-35.0,-43.0,-45.0,-44.0,-35.0,-43.0,-47.0,-89.0,-90.0,-86.0,-87.0,41.0,55.0,43.0,42.0,1
4076,62:47:05:9D:EB:15,3850683,495894432,6089,11019119,3844594,484875313,1,6208,3673082,6162,3665961,46,7121,3061,0,6149,56,1,121,229410.0,137640.0,-51.0,-52.0,-42.0,-51.0,-50.0,-51.0,-42.0,-51.0,-89.0,-90.0,-86.0,-87.0,38.0,38.0,44.0,36.0,1
4077,92:69:1D:31:68:E9,3848620,488525810,4026,3650497,3844594,484875313,1,5309,1150248,5144,1112805,165,37443,2192,12,4270,102,1,60,216660.0,130000.0,-52.0,-49.0,-43.0,-48.0,-52.0,-48.0,-43.0,-48.0,-89.0,-90.0,-86.0,-87.0,37.0,41.0,43.0,39.0,1
4078,CC:2F:71:3F:1F:24,4950855,1740796510,1106261,1255921197,3844594,484875313,1730,922408,1032527352,921593,1032428816,815,98536,891093,15,1104886,117084,1727,730,115556.0,28889.0,-71.0,-67.0,-68.0,-73.0,-72.0,-68.0,-69.0,-73.0,-89.0,-90.0,-86.0,-87.0,18.0,23.0,18.0,14.0,1
4079,CC:2F:71:3E:C5:1F,3845563,484993613,965,117896,3844598,484875717,2,4193,349914,3490,266430,703,83484,1022,12,1389,26,2,53,130000.0,39000.0,-72.0,-71.0,-69.0,-60.0,-70.0,-69.0,-68.0,-60.0,-89.0,-90.0,-86.0,-87.0,17.0,19.0,17.0,27.0,1
4080,BA:8C:B9:54:50:24,3849512,491067863,4914,6192146,3844598,484875717,7,9642,1744170,9620,1740675,22,3495,2358,17,5401,41,7,70,229410.0,130000.0,-48.0,-35.0,-43.0,-45.0,-44.0,-35.0,-43.0,-47.0,-89.0,-90.0,-86.0,-87.0,41.0,55.0,43.0,42.0,1
4081,62:47:05:9D:EB:15,3850691,495895406,6089,11019119,3844602,484876287,1,6227,3674374,6181,3667253,46,7121,3061,0,6149,56,1,121,229410.0,137640.0,-48.0,-46.0,-38.0,-48.0,-47.0,-47.0,-38.0,-47.0,-89.0,-90.0,-86.0,-87.0,41.0,44.0,48.0,39.0,1
4082,92:69:1D:31:68:E9,3848628,488526784,4026,3650497,3844602,484876287,1,5309,1150248,5144,1112805,165,37443,2192,12,4270,102,1,60,216660.0,130000.0,-52.0,-49.0,-43.0,-48.0,-52.0,-48.0,-43.0,-48.0,-89.0,-90.0,-86.0,-87.0,37.0,41.0,43.0,39.0,1
4083,CC:2F:71:3F:1F:24,4951073,1741058275,1106471,1256181988,3844602,484876287,1730,922606,1032781931,921791,1032683395,815,98536,891283,15,1105095,117087,1727,730,115556.0,28889.0,-70.0,-66.0,-68.0,-72.0,-70.0,-66.0,-67.0,-71.0,-89.0,-90.0,-86.0,-87.0,19.0,24.0,18.0,15.0,1
4084,CC:2F:71:3E:C5:1F,3845567,484994183,965,117896,3844602,484876287,2,4193,349914,3490,266430,703,83484,1022,12,1389,26,2,53,130000.0,39000.0,-72.0,-71.0,-69.0,-60.0,-70.0,-69.0,-68.0,-60.0,-89.0,-90.0,-86.0,-87.0,17.0,19.0,17.0,27.0,1
4085,BA:8C:B9:54:50:24,3849516,491068433,4914,6192146,3844602,484876287,7,9642,1744170,9620,1740675,22,3495,2358,17,5401,41,7,70,229410.0,130000.0,-48.0,-35.0,-43.0,-45.0,-44.0,-35.0,-43.0,-47.0,-89.0,-90.0,-86.0,-87.0,41.0,55.0,43.0,42.0,1
4086,62:47:05:9D:EB:15,3850696,495896083,6091,11019534,3844605,484876549,1,6232,3675228,6186,3668107,46,7121,3065,0,6151,56,1,121,229410.0,137640.0,-50.0,-52.0,-43.0,-51.0,-48.0,-49.0,-40.0,-49.0,-89.0,-90.0,-86.0,-87.0,39.0,38.0,43.0,36.0,1
4087,92:69:1D:31:68:E9,3848635,488527450,4026,3650497,3844609,484876953,1,5309,1150248,5144,1112805,165,37443,2192,12,4270,102,1,60,216660.0,130000.0,-52.0,-49.0,-43.0,-48.0,-52.0,-48.0,-43.0,-48.0,-89.0,-90.0,-86.0,-87.0,37.0,41.0,43.0,39.0,1
4088,CC:2F:71:3F:1F:24,4951273,1741303007,1106664,1256426054,3844609,484876953,1730,922781,1033016065,921966,1032917529,815,98536,891455,15,1105289,117097,1727,730,115556.0,28889.0,-70.0,-66.0,-68.0,-71.0,-70.0,-66.0,-67.0,-71.0,-89.0,-90.0,-86.0,-87.0,19.0,24.0,18.0,16.0,1
4089,CC:2F:71:3E:C5:1F,3845576,484995051,965,117896,3844611,484877155,2,4193,349914,3490,266430,703,83484,1022,12,1389,26,2,53,130000.0,39000.0,-72.0,-71.0,-69.0,-60.0,-70.0,-69.0,-68.0,-60.0,-89.0,-90.0,-86.0,-87.0,17.0,19.0,17.0,27.0,1
4090,BA:8C:B9:54:50:24,3849525,491069301,4914,6192146,3844611,484877155,7,9642,1744170,9620,1740675,22,3495,2358,17,5401,41,7,70,229410.0,130000.0,-48.0,-35.0,-43.0,-45.0,-44.0,-35.0,-43.0,-47.0,-89.0,-90.0,-86.0,-87.0,41.0,55.0,43.0,42.0,1
4091,62:47:05:9D:EB:15,3850702,495896689,6091,11019534,3844611,484877155,1,6233,3675296,6187,3668175,46,7121,3065,0,6151,56,1,121,229410.0,137640.0,-47.0,-46.0,-38.0,-48.0,-48.0,-49.0,-40.0,-49.0,-89.0,-90.0,-86.0,-87.0,42.0,44.0,48.0,39.0,1
4092,92:69:1D:31:68:E9,3848637,488527652,4026,3650497,3844611,484877155,1,5309,1150248,5144,1112805,165,37443,2192,12,4270,102,1,60,216660.0,130000.0,-52.0,-49.0,-43.0,-48.0,-52.0,-48.0,-43.0,-48.0,-89.0,-90.0,-86.0,-87.0,37.0,41.0,43.0,39.0,1
4093,CC:2F:71:3F:1F:24,4951465,1741544469,1106854,1256667314,3844611,484877155,1730,922965,1033257251,922150,1033158715,815,98536,891626,15,1105479,117098,1727,730,115556.0,28889.0,-70.0,-66.0,-68.0,-71.0,-70.0,-66.0,-68.0,-71.0,-89.0,-90.0,-86.0,-87.0,19.0,24.0,18.0,16.0,1
4094,CC:2F:71:3E:C5:1F,3845576,484995051,965,117896,3844611,484877155,2,4193,349914,3490,266430,703,83484,1022,12,1389,26,2,53,130000.0,39000.0,-72.0,-71.0,-69.0,-60.0,-70.0,-69.0,-68.0,-60.0,-89.0,-90.0,-86.0,-87.0,17.0,19.0,17.0,27.0,1
4095,BA:8C:B9:54:50:24,3849526,491069363,4914,6192146,3844612,484877217,7,9642,1744170,9620,1740675,22,3495,2358,17,5401,41,7,70,229410.0,130000.0,-48.0,-35.0,-43.0,-45.0,-44.0,-35.0,-43.0,-47.0,-89.0,-90.0,-86.0,-87.0,41.0,55.0,43.0,42.0,1
4096,62:47:05:9D:EB:15,3850757,495970971,6139,11093148,3844618,484877823,1,6286,3686026,6240,3678905,46,7121,3086,0,6199,56,1,122,229410.0,137640.0,-50.0,-52.0,-43.0,-50.0,-50.0,-52.0,-43.0,-50.0,-89.0,-90.0,-86.0,-87.0,39.0,38.0,43.0,37.0,1
4097,92:69:1D:31:68:E9,3848646,488528522,4026,3650497,3844620,484878025,1,5309,1150248,5144,1112805,165,37443,2192,12,4270,102,1,60,216660.0,130000.0,-52.0,-49.0,-43.0,-48.0,-52.0,-48.0,-43.0,-48.0,-89.0,-90.0,-86.0,-87.0,37.0,41.0,43.0,39.0,1
4098,CC:2F:71:3F:1F:24,4951675,1741791740,1107054,1256913655,3844621,484878085,1730,923153,1033499208,922337,1033400554,816,98654,891806,15,1105679,117104,1727,731,115556.0,28889.0,-70.0,-66.0,-68.0,-71.0,-70.0,-66.0,-67.0,-71.0,-89.0,-90.0,-86.0,-87.0,19.0,24.0,18.0,16.0,1
4099,CC:2F:71:3E:C5:1F,3845586,484995981,965,117896,3844621,484878085,2,4193,349914,3490,266430,703,83484,1022,12,1389,26,2,53,130000.0,39000.0,-72.0,-71.0,-69.0,-60.0,-70.0,-69.0,-68.0,-60.0,-89.0,-90.0,-86.0,-87.0,17.0,19.0,17.0,27.0,1
4100,BA:8C:B9:54:50:24,3849535,491070231,4914,6192146,3844621,484878085,7,9642,1744170,9620,1740675,22,3495,2358,17,5401,41,7,70,229410.0,130000.0,-48.0,-35.0,-43.0,-45.0,-44.0,-35.0,-43.0,-47.0,-89.0,-90.0,-86.0,-87.0,41.0,55.0,43.0,42.0,1
4101,62:47:05:9D:EB:15,3850771,495986909,6150,11108824,3844621,484878085,1,6297,3688223,6251,3681102,46,7121,3095,0,6210,56,1,122,229410.0,137640.0,-50.0,-52.0,-43.0,-50.0,-49.0,-51.0,-43.0,-50.0,-89.0,-90.0,-86.0,-87.0,39.0,38.0,43.0,37.0,1
4102,92:69:1D:31:68:E9,3848647,488528582,4026,3650497,3844621,484878085,1,5309,1150248,5144,1112805,165,37443,2192,12,4270,102,1,60,216660.0,130000.0,-52.0,-49.0,-43.0,-48.0,-52.0,-48.0,-43.0,-48.0,-89.0,-89.0,-86.0,-87.0,37.0,40.0,43.0,39.0,1
4103,CC:2F:71:3F:1F:24,4951864,1742031462,1107243,1257153377,3844621,484878085,1730,923327,1033730592,922511,1033631938,816,98654,891972,15,1105868,117104,1727,731,115556.0,28889.0,-70.0,-66.0,-68.0,-71.0,-70.0,-66.0,-67.0,-71.0,-89.0,-89.0,-86.0,-87.0,19.0,23.0,18.0,16.0,1
4104,CC:2F:71:3E:C5:1F,3845586,484995981,965,117896,3844621,484878085,2,4193,349914,3490,266430,703,83484,1022,12,1389,26,2,53,130000.0,39000.0,-72.0,-71.0,-69.0,-60.0,-70.0,-69.0,-68.0,-60.0,-89.0,-89.0,-86.0,-87.0,17.0,18.0,17.0,27.0,1
4105,BA:8C:B9:54:50:24,3849535,491070231,4914,6192146,3844621,484878085,7,9642,1744170,9620,1740675,22,3495,2358,17,5401,41,7,70,229410.0,130000.0,-48.0,-35.0,-43.0,-45.0,-44.0,-35.0,-43.0,-47.0,-89.0,-89.0,-86.0,-87.0,41.0,54.0,43.0,42.0,1
4106,62:47:05:9D:EB:15,3850799,496014433,6170,11135540,3844629,484878893,1,6322,3691547,6276,3684426,46,7121,3105,0,6230,56,1,123,229410.0,137640.0,-46.0,-46.0,-39.0,-50.0,-46.0,-46.0,-39.0,-49.0,-89.0,-89.0,-86.0,-87.0,43.0,43.0,47.0,37.0,1
4107,92:69:1D:31:68:E9,3848655,488529390,4026,3650497,3844629,484878893,1,5309,1150248,5144,1112805,165,37443,2192,12,4270,102,1,60,216660.0,130000.0,-52.0,-49.0,-43.0,-48.0,-52.0,-48.0,-43.0,-48.0,-89.0,-89.0,-86.0,-87.0,37.0,40.0,43.0,39.0,1
4108,CC:2F:71:3F:1F:24,4952069,1742280068,1107439,1257401113,3844630,484878955,1730,923514,1033979108,922698,1033880454,816,98654,892147,15,1106063,117105,1727,731,115556.0,28889.0,-70.0,-66.0,-68.0,-71.0,-70.0,-66.0,-68.0,-71.0,-89.0,-89.0,-86.0,-87.0,19.0,23.0,18.0,16.0,1
4109,CC:2F:71:3E:C5:1F,3845595,484996851,965,117896,3844630,484878955,2,4195,350102,3491,266500,704,83602,1023,12,1389,26,2,53,130000.0,39000.0,-72.0,-71.0,-69.0,-60.0,-70.0,-69.0,-67.0,-60.0,-89.0,-89.0,-86.0,-87.0,17.0,18.0,17.0,27.0,1
4110,BA:8C:B9:54:50:24,3849544,491071101,4914,6192146,3844630,484878955,7,9642,1744170,9620,1740675,22,3495,2358,17,5401,41,7,70,229410.0,130000.0,-48.0,-35.0,-43.0,-45.0,-44.0,-35.0,-43.0,-47.0,-89.0,-89.0,-86.0,-87.0,41.0,54.0,43.0,42.0,1
4111,62:47:05:9D:EB:15,3850806,496021683,6175,11142668,3844631,484879015,1,6336,3693010,6290,3685889,46,7121,3108,0,6235,56,1,123,229410.0,137640.0,-46.0,-46.0,-39.0,-49.0,-47.0,-48.0,-40.0,-50.0,-89.0,-89.0,-86.0,-87.0,43.0,43.0,47.0,38.0,1
4112,92:69:1D:31:68:E9,3848658,488529572,4026,3650497,3844632,484879075,1,5311,1150384,5146,1112941,165,37443,2192,12,4271,102,1,60,216660.0,130000.0,-51.0,-47.0,-42.0,-48.0,-51.0,-48.0,-43.0,-48.0,-89.0,-89.0,-86.0,-87.0,38.0,42.0,44.0,39.0,1
4113,CC:2F:71:3F:1F:24,4952264,1742526806,1107632,1257647731,3844632,484879075,1730,923699,1034224710,922883,1034126056,816,98654,892321,15,1106257,117171,1727,731,117000.0,39000.0,-70.0,-66.0,-68.0,-71.0,-70.0,-66.0,-68.0,-71.0,-89.0,-89.0,-86.0,-87.0,19.0,23.0,18.0,16.0,1
4114,CC:2F:71:3E:C5:1F,3845597,484996971,965,117896,3844632,484879075,2,4195,350102,3491,266500,704,83602,1023,12,1389,26,2,53,130000.0,39000.0,-72.0,-71.0,-69.0,-60.0,-70.0,-69.0,-67.0,-60.0,-89.0,-89.0,-86.0,-87.0,17.0,18.0,17.0,27.0,1
4115,BA:8C:B9:54:50:24,3849546,491071221,4914,6192146,3844632,484879075,7,9644,1744306,9622,1740811,22,3495,2358,17,5402,41,7,70,229410.0,130000.0,-39.0,-37.0,-45.0,-52.0,-43.0,-35.0,-43.0,-48.0,-89.0,-89.0,-86.0,-87.0,50.0,52.0,41.0,35.0,1
4116,62:47:05:9D:EB:15,3850825,496034709,6185,11154826,3844640,484879883,1,6346,3694699,6300,3687578,46,7121,3114,0,6245,56,1,123,229410.0,137640.0,-46.0,-47.0,-39.0,-49.0,-49.0,-52.0,-43.0,-50.0,-89.0,-89.0,-86.0,-87.0,43.0,42.0,47.0,38.0,1
4117,92:69:1D:31:68:E9,3848666,488530380,4026,3650497,3844640,484879883,1,5311,1150384,5146,1112941,165,37443,2192,12,4271,102,1,60,216660.0,130000.0,-51.0,-47.0,-42.0,-48.0,-51.0,-48.0,-43.0,-48.0,-89.0,-89.0,-86.0,-87.0,38.0,42.0,44.0,39.0,1
4118,CC:2F:71:3F:1F:24,4952472,1742775247,1107832,1257895364,3844640,484879883,1730,923885,1034465072,923069,1034366418,816,98654,892498,15,1106457,117252,1727,731,130000.0,43333.0,-70.0,-66.0,-68.0,-71.0,-70.0,-66.0,-67.0,-71.0,-89.0,-89.0,-86.0,-87.0,19.0,23.0,18.0,16.0,1
4119,CC:2F:71:3E:C5:1F,3845605,484997779,965,117896,3844640,484879883,2,4195,350102,3491,266500,704,83602,1023,12,1389,26,2,53,130000.0,39000.0,-72.0,-71.0,-69.0,-60.0,-70.0,-69.0,-67.0,-60.0,-89.0,-89.0,-86.0,-87.0,17.0,18.0,17.0,27.0,1
4120,BA:8C:B9:54:50:24,3849555,491072089,4914,6192146,3844641,484879943,7,9644,1744306,9622,1740811,22,3495,2358,17,5402,41,7,70,229410.0,130000.0,-39.0,-37.0,-45.0,-52.0,-43.0,-35.0,-43.0,-48.0,-89.0,-89.0,-86.0,-87.0,50.0,52.0,41.0,35.0,1
4121,62:47:05:9D:EB:15,3850830,496040375,6189,11160432,3844641,484879943,1,6377,3697207,6331,3690086,46,7121,3116,0,6249,56,1,123,216660.0,130000.0,-50.0,-58.0,-46.0,-52.0,-45.0,-49.0,-39.0,-46.0,-89.0,-89.0,-86.0,-87.0,39.0,31.0,40.0,35.0,1
4122,92:69:1D:31:68:E9,3848668,488530500,4026,3650497,3844642,484880003,1,5311,1150384,5146,1112941,165,37443,2192,12,4271,102,1,60,216660.0,130000.0,-51.0,-47.0,-42.0,-48.0,-51.0,-48.0,-43.0,-48.0,-89.0,-89.0,-86.0,-87.0,38.0,42.0,44.0,39.0,1
4123,CC:2F:71:3F:1F:24,4952670,1743027375,1108028,1258147372,3844642,484880003,1730,924074,1034713924,923258,1034615270,816,98654,892678,15,1106653,117322,1727,731,130000.0,43333.0,-70.0,-66.0,-68.0,-71.0,-70.0,-66.0,-67.0,-71.0,-89.0,-89.0,-86.0,-87.0,19.0,23.0,18.0,16.0,1
4124,CC:2F:71:3E:C5:1F,3845607,484997899,965,117896,3844642,484880003,2,4195,350102,3491,266500,704,83602,1023,12,1389,26,2,53,130000.0,39000.0,-72.0,-71.0,-69.0,-60.0,-70.0,-69.0,-67.0,-60.0,-89.0,-89.0,-86.0,-87.0,17.0,18.0,17.0,27.0,1
4125,BA:8C:B9:54:50:24,3849556,491072149,4914,6192146,3844642,484880003,7,9644,1744306,9622,1740811,22,3495,2358,17,5402,41,7,70,229410.0,130000.0,-39.0,-37.0,-45.0,-52.0,-43.0,-35.0,-43.0,-48.0,-89.0,-89.0,-86.0,-87.0,50.0,52.0,41.0,35.0,1
4126,62:47:05:9D:EB:15,3851057,496574613,6406,11693742,3844651,484880871,1,6421,3704547,6375,3697426,46,7121,3131,0,6466,56,1,123,229410.0,130000.0,-47.0,-48.0,-39.0,-50.0,-49.0,-52.0,-43.0,-51.0,-89.0,-89.0,-86.0,-87.0,42.0,41.0,47.0,37.0,1
4127,92:69:1D:31:68:E9,3848677,488531368,4026,3650497,3844651,484880871,1,5311,1150384,5146,1112941,165,37443,2192,12,4271,102,1,60,216660.0,130000.0,-51.0,-47.0,-42.0,-48.0,-51.0,-48.0,-43.0,-48.0,-89.0,-89.0,-86.0,-87.0,38.0,42.0,44.0,39.0,1
4128,CC:2F:71:3F:1F:24,4952873,1743274158,1108221,1258393014,3844652,484881144,1730,924258,1034964892,923442,1034866238,816,98654,892850,15,1106845,117392,1727,731,130000.0,39000.0,-70.0,-66.0,-68.0,-71.0,-70.0,-66.0,-67.0,-71.0,-89.0,-89.0,-86.0,-87.0,19.0,23.0,18.0,16.0,1
4129,CC:2F:71:3E:C5:1F,3845617,484999040,965,117896,3844652,484881144,2,4195,350102,3491,266500,704,83602,1023,12,1389,26,2,53,130000.0,39000.0,-72.0,-71.0,-69.0,-60.0,-70.0,-69.0,-67.0,-60.0,-89.0,-89.0,-86.0,-87.0,17.0,18.0,17.0,27.0,1
4130,BA:8C:B9:54:50:24,3849566,491073290,4914,6192146,3844652,484881144,7,9645,1744374,9623,1740879,22,3495,2358,17,5402,41,7,70,229410.0,130000.0,-39.0,-36.0,-45.0,-52.0,-42.0,-35.0,-44.0,-48.0,-89.0,-89.0,-86.0,-87.0,50.0,53.0,41.0,35.0,1
4131,62:47:05:9D:EB:15,3851157,496814370,6505,11933226,3844652,484881144,1,6462,3709461,6416,3702340,46,7121,3140,0,6565,56,1,123,229410.0,137640.0,-47.0,-47.0,-39.0,-50.0,-47.0,-48.0,-39.0,-48.0,-89.0,-89.0,-86.0,-87.0,42.0,42.0,47.0,37.0,1
4132,92:69:1D:31:68:E9,3848678,488531641,4026,3650497,3844652,484881144,1,5311,1150384,5146,1112941,165,37443,2192,12,4271,102,1,60,216660.0,130000.0,-51.0,-47.0,-42.0,-48.0,-51.0,-48.0,-43.0,-48.0,-89.0,-89.0,-86.0,-87.0,38.0,42.0,44.0,39.0,1
4133,CC:2F:71:3F:1F:24,4953064,1743518228,1108412,1258637084,3844652,484881144,1730,924432,1035197472,923616,1035098818,816,98654,893022,15,1107037,117450,1727,731,130000.0,43333.0,-70.0,-66.0,-68.0,-71.0,-70.0,-66.0,-67.0,-71.0,-89.0,-89.0,-86.0,-87.0,19.0,23.0,18.0,16.0,1
4134,CC:2F:71:3E:C5:1F,3845617,484999040,965,117896,3844652,484881144,2,4195,350102,3491,266500,704,83602,1023,12,1389,26,2,53,130000.0,39000.0,-72.0,-71.0,-69.0,-60.0,-70.0,-69.0,-67.0,-60.0,-89.0,-89.0,-86.0,-87.0,17.0,18.0,17.0,27.0,1
4135,BA:8C:B9:54:50:24,3849569,491073603,4914,6192146,3844655,484881457,7,9645,1744374,9623,1740879,22,3495,2358,17,5402,41,7,70,229410.0,130000.0,-39.0,-36.0,-45.0,-52.0,-42.0,-35.0,-44.0,-48.0,-89.0,-89.0,-86.0,-87.0,50.0,53.0,41.0,35.0,1
4136,62:47:05:9D:EB:15,3851167,496815349,6505,11933226,3844662,484882123,1,6490,3711584,6443,3704292,47,7292,3142,0,6565,56,1,123,229410.0,137640.0,-51.0,-53.0,-44.0,-52.0,-50.0,-51.0,-43.0,-51.0,-89.0,-89.0,-86.0,-87.0,38.0,36.0,42.0,35.0,1
4137,92:69:1D:31:68:E9,3848688,488532620,4026,3650497,3844662,484882123,1,5311,1150384,5146,1112941,165,37443,2192,12,4271,102,1,60,216660.0,130000.0,-51.0,-47.0,-42.0,-48.0,-51.0,-48.0,-43.0,-48.0,-89.0,-89.0,-86.0,-87.0,38.0,42.0,44.0,39.0,1
4138,CC:2F:71:3F:1F:24,4953273,1743766838,1108611,1258884715,3844662,484882123,1730,924615,1035433101,923799,1035334447,816,98654,893200,15,1107236,117524,1727,731,130000.0,43333.0,-70.0,-66.0,-68.0,-71.0,-70.0,-66.0,-67.0,-71.0,-89.0,-89.0,-86.0,-87.0,19.0,23.0,18.0,16.0,1
4139,CC:2F:71:3E:C5:1F,3845627,485000019,965,117896,3844662,484882123,2,4195,350102,3491,266500,704,83602,1023,12,1389,26,2,53,130000.0,39000.0,-72.0,-71.0,-69.0,-60.0,-70.0,-69.0,-67.0,-60.0,-89.0,-89.0,-86.0,-87.0,17.0,18.0,17.0,27.0,1
4140,BA:8C:B9:54:50:24,3849576,491074269,4914,6192146,3844662,484882123,7,9645,1744374,9623,1740879,22,3495,2358,17,5402,41,7,70,229410.0,130000.0,-39.0,-36.0,-45.0,-52.0,-42.0,-35.0,-44.0,-48.0,-89.0,-89.0,-86.0,-87.0,50.0,53.0,41.0,35.0,1
4141,62:47:05:9D:EB:15,3851167,496815349,6505,11933226,3844662,484882123,1,6491,3711652,6444,3704360,47,7292,3142,0,6565,56,1,123,229410.0,137640.0,-48.0,-47.0,-39.0,-50.0,-49.0,-50.0,-42.0,-51.0,-89.0,-90.0,-86.0,-88.0,41.0,43.0,47.0,38.0,1
4142,92:69:1D:31:68:E9,3848688,488532620,4026,3650497,3844662,484882123,1,5311,1150384,5146,1112941,165,37443,2192,12,4271,102,1,60,216660.0,130000.0,-51.0,-47.0,-42.0,-48.0,-51.0,-48.0,-43.0,-48.0,-89.0,-90.0,-86.0,-88.0,38.0,43.0,44.0,40.0,1
4143,CC:2F:71:3F:1F:24,4953466,1744011336,1108804,1259129213,3844662,484882123,1730,924794,1035676341,923978,1035577687,816,98654,893369,15,1107428,117576,1727,731,130000.0,43333.0,-70.0,-67.0,-69.0,-72.0,-70.0,-66.0,-68.0,-72.0,-89.0,-90.0,-86.0,-88.0,19.0,23.0,17.0,16.0,1
4144,CC:2F:71:3E:C5:1F,3845629,485000221,965,117896,3844664,484882325,2,4195,350102,3491,266500,704,83602,1023,12,1389,26,2,53,130000.0,39000.0,-72.0,-71.0,-69.0,-60.0,-70.0,-69.0,-67.0,-60.0,-89.0,-90.0,-86.0,-88.0,17.0,19.0,17.0,28.0,1
4145,BA:8C:B9:54:50:24,3849578,491074471,4914,6192146,3844664,484882325,7,9645,1744374,9623,1740879,22,3495,2358,17,5402,41,7,70,229410.0,130000.0,-39.0,-36.0,-45.0,-52.0,-42.0,-35.0,-44.0,-48.0,-89.0,-90.0,-86.0,-88.0,50.0,54.0,41.0,36.0,1
4146,62:47:05:9D:EB:15,3851176,496816217,6505,11933226,3844671,484882991,1,6491,3711652,6444,3704360,47,7292,3142,0,6565,56,1,123,229410.0,137640.0,-48.0,-47.0,-39.0,-50.0,-49.0,-50.0,-42.0,-51.0,-89.0,-90.0,-86.0,-88.0,41.0,43.0,47.0,38.0,1
4147,92:69:1D:31:68:E9,3848697,488533488,4026,3650497,3844671,484882991,1,5311,1150384,5146,1112941,165,37443,2192,12,4271,102,1,60,216660.0,130000.0,-51.0,-47.0,-42.0,-48.0,-51.0,-48.0,-43.0,-48.0,-89.0,-90.0,-86.0,-88.0,38.0,43.0,44.0,40.0,1
4148,CC:2F:71:3F:1F:24,4953667,1744256348,1108996,1259373357,3844671,484882991,1730,924980,1035923407,924164,1035824753,816,98654,893544,15,1107621,117644,1727,731,130000.0,43333.0,-73.0,-70.0,-71.0,-74.0,-72.0,-69.0,-70.0,-74.0,-89.0,-90.0,-86.0,-88.0,16.0,20.0,15.0,14.0,1
4149,CC:2F:71:3E:C5:1F,3845636,485000887,965,117896,3844671,484882991,2,4195,350102,3491,266500,704,83602,1023,12,1389,26,2,53,130000.0,39000.0,-72.0,-71.0,-69.0,-60.0,-70.0,-69.0,-67.0,-60.0,-89.0,-90.0,-86.0,-88.0,17.0,19.0,17.0,28.0,1
4150,BA:8C:B9:54:50:24,3849585,491075137,4914,6192146,3844671,484882991,7,9645,1744374,9623,1740879,22,3495,2358,17,5402,41,7,70,229410.0,130000.0,-39.0,-36.0,-45.0,-52.0,-42.0,-35.0,-44.0,-48.0,-89.0,-90.0,-86.0,-88.0,50.0,54.0,41.0,36.0,1
4151,62:47:05:9D:EB:15,3851181,496818011,6510,11935020,3844671,484882991,1,6501,3714530,6454,3707238,47,7292,3148,0,6570,56,1,123,229410.0,137640.0,-51.0,-53.0,-45.0,-52.0,-49.0,-50.0,-42.0,-51.0,-89.0,-90.0,-86.0,-88.0,38.0,37.0,41.0,36.0,1
4152,92:69:1D:31:68:E9,3848699,488533690,4026,3650497,3844673,484883193,1,5311,1150384,5146,1112941,165,37443,2192,12,4271,102,1,60,216660.0,130000.0,-51.0,-47.0,-42.0,-48.0,-51.0,-48.0,-43.0,-48.0,-89.0,-90.0,-86.0,-88.0,38.0,43.0,44.0,40.0,1
4153,CC:2F:71:3F:1F:24,4953869,1744504199,1109196,1259621006,3844673,484883193,1730,925182,1036181828,924366,1036083174,816,98654,893723,15,1107821,117715,1727,731,117000.0,39000.0,-73.0,-70.0,-71.0,-74.0,-73.0,-69.0,-71.0,-74.0,-89.0,-90.0,-86.0,-88.0,16.0,20.0,15.0,14.0,1
4154,CC:2F:71:3E:C5:1F,3845642,485001493,965,117896,3844677,484883597,2,4195,350102,3491,266500,704,83602,1023,12,1389,26,2,53,130000.0,39000.0,-72.0,-71.0,-69.0,-60.0,-70.0,-69.0,-67.0,-60.0,-89.0,-90.0,-86.0,-88.0,17.0,19.0,17.0,28.0,1
4155,BA:8C:B9:54:50:24,3849593,491075945,4914,6192146,3844679,484883799,7,9645,1744374,9623,1740879,22,3495,2358,17,5402,41,7,70,229410.0,130000.0,-39.0,-36.0,-45.0,-52.0,-42.0,-35.0,-44.0,-48.0,-89.0,-90.0,-86.0,-88.0,50.0,54.0,41.0,36.0,1
4156,62:47:05:9D:EB:15,3851198,496830709,6519,11946910,3844679,484883799,1,6514,3716024,6467,3708732,47,7292,3152,0,6579,56,1,123,229410.0,137640.0,-47.0,-47.0,-39.0,-48.0,-46.0,-48.0,-39.0,-47.0,-89.0,-90.0,-86.0,-88.0,42.0,43.0,47.0,40.0,1
4157,92:69:1D:31:68:E9,3848705,488534296,4026,3650497,3844679,484883799,1,5311,1150384,5146,1112941,165,37443,2192,12,4271,102,1,60,216660.0,130000.0,-51.0,-47.0,-42.0,-48.0,-51.0,-48.0,-43.0,-48.0,-89.0,-90.0,-86.0,-88.0,38.0,43.0,44.0,40.0,1
4158,CC:2F:71:3F:1F:24,4954069,1744751945,1109390,1259868146,3844679,484883799,1730,925369,1036436020,924553,1036337366,816,98654,893896,15,1108015,117769,1727,731,130000.0,43333.0,-73.0,-69.0,-71.0,-74.0,-73.0,-69.0,-71.0,-74.0,-89.0,-90.0,-86.0,-88.0,16.0,21.0,15.0,14.0,1
4159,CC:2F:71:3E:C5:1F,3845644,485001695,965,117896,3844679,484883799,2,4195,350102,3491,266500,704,83602,1023,12,1389,26,2,53,130000.0,39000.0,-72.0,-71.0,-69.0,-60.0,-70.0,-69.0,-67.0,-60.0,-89.0,-90.0,-86.0,-88.0,17.0,19.0,17.0,28.0,1
4160,BA:8C:B9:54:50:24,3849593,491075945,4914,6192146,3844679,484883799,7,9645,1744374,9623,1740879,22,3495,2358,17,5402,41,7,70,229410.0,130000.0,-39.0,-36.0,-45.0,-52.0,-42.0,-35.0,-44.0,-48.0,-89.0,-90.0,-86.0,-88.0,50.0,54.0,41.0,36.0,1
4161,62:47:05:9D:EB:15,3851267,496981745,6585,12097684,3844682,484884061,1,6555,3723138,6508,3715846,47,7292,3162,0,6645,56,1,124,229410.0,137640.0,-50.0,-46.0,-38.0,-49.0,-47.0,-47.0,-38.0,-48.0,-89.0,-90.0,-86.0,-88.0,39.0,44.0,48.0,39.0,1
4162,92:69:1D:31:68:E9,3848712,488534962,4026,3650497,3844686,484884465,1,5311,1150384,5146,1112941,165,37443,2192,12,4271,102,1,60,216660.0,130000.0,-51.0,-47.0,-42.0,-48.0,-51.0,-48.0,-43.0,-48.0,-89.0,-90.0,-86.0,-88.0,38.0,43.0,44.0,40.0,1
4163,CC:2F:71:3F:1F:24,4954276,1745003545,1109588,1260118878,3844688,484884667,1730,925553,1036682912,924737,1036584258,816,98654,894070,15,1108213,117838,1727,731,117000.0,39000.0,-70.0,-66.0,-68.0,-72.0,-70.0,-66.0,-68.0,-71.0,-89.0,-90.0,-86.0,-88.0,19.0,24.0,18.0,16.0,1
4164,CC:2F:71:3E:C5:1F,3845653,485002563,965,117896,3844688,484884667,2,4195,350102,3491,266500,704,83602,1023,12,1389,26,2,53,130000.0,39000.0,-72.0,-71.0,-69.0,-60.0,-70.0,-69.0,-67.0,-60.0,-89.0,-90.0,-86.0,-88.0,17.0,19.0,17.0,28.0,1
4165,BA:8C:B9:54:50:24,3849602,491076813,4914,6192146,3844688,484884667,7,9648,1744578,9626,1741083,22,3495,2358,17,5402,41,7,70,229410.0,130000.0,-39.0,-36.0,-46.0,-52.0,-43.0,-35.0,-44.0,-48.0,-89.0,-90.0,-86.0,-88.0,50.0,54.0,40.0,36.0,1
4166,62:47:05:9D:EB:15,3851277,496985449,6589,12100782,3844688,484884667,1,6563,3725383,6516,3718091,47,7292,3166,0,6649,56,1,124,229410.0,137640.0,-50.0,-47.0,-39.0,-49.0,-49.0,-49.0,-40.0,-49.0,-89.0,-90.0,-86.0,-88.0,39.0,43.0,47.0,39.0,1
4167,92:69:1D:31:68:E9,3848714,488535164,4026,3650497,3844688,484884667,1,5311,1150384,5146,1112941,165,37443,2192,12,4271,102,1,60,216660.0,130000.0,-51.0,-47.0,-42.0,-48.0,-51.0,-48.0,-43.0,-48.0,-89.0,-90.0,-86.0,-88.0,38.0,43.0,44.0,40.0,1
4168,CC:2F:71:3F:1F:24,4954467,1745246247,1109779,1260361580,3844688,484884667,1730,925733,1036925078,924917,1036826424,816,98654,894239,15,1108404,117883,1727,731,130000.0,43333.0,-73.0,-69.0,-71.0,-74.0,-72.0,-68.0,-70.0,-74.0,-89.0,-90.0,-86.0,-88.0,16.0,21.0,15.0,14.0,1
4169,CC:2F:71:3E:C5:1F,3845653,485002563,965,117896,3844688,484884667,2,4195,350102,3491,266500,704,83602,1023,12,1389,26,2,53,130000.0,39000.0,-72.0,-71.0,-69.0,-60.0,-70.0,-69.0,-67.0,-60.0,-89.0,-90.0,-86.0,-88.0,17.0,19.0,17.0,28.0,1
4170,BA:8C:B9:54:50:24,3849602,491076813,4914,6192146,3844688,484884667,7,9648,1744578,9626,1741083,22,3495,2358,17,5402,41,7,70,229410.0,130000.0,-39.0,-36.0,-46.0,-52.0,-43.0,-35.0,-44.0,-48.0,-89.0,-90.0,-86.0,-88.0,50.0,54.0,40.0,36.0,1
4171,62:47:05:9D:EB:15,3851284,496986115,6589,12100782,3844695,484885333,1,6563,3725383,6516,3718091,47,7292,3166,0,6649,56,1,124,229410.0,137640.0,-50.0,-47.0,-39.0,-49.0,-49.0,-49.0,-40.0,-49.0,-89.0,-90.0,-86.0,-88.0,39.0,43.0,47.0,39.0,1
4172,92:69:1D:31:68:E9,3848723,488536032,4026,3650497,3844697,484885535,1,5311,1150384,5146,1112941,165,37443,2192,12,4271,102,1,60,216660.0,130000.0,-51.0,-47.0,-42.0,-48.0,-51.0,-48.0,-43.0,-48.0,-89.0,-90.0,-86.0,-88.0,38.0,43.0,44.0,40.0,1
4173,CC:2F:71:3F:1F:24,4954679,1745499426,1109982,1260613891,3844697,484885535,1730,925930,1037179498,925114,1037080844,816,98654,894422,15,1108607,117938,1727,731,117000.0,39000.0,-73.0,-70.0,-71.0,-75.0,-71.0,-67.0,-69.0,-72.0,-89.0,-90.0,-86.0,-88.0,16.0,20.0,15.0,13.0,1
4174,CC:2F:71:3E:C5:1F,3845662,485003431,965,117896,3844697,484885535,2,4195,350102,3491,266500,704,83602,1023,12,1389,26,2,53,130000.0,39000.0,-72.0,-71.0,-69.0,-60.0,-70.0,-69.0,-67.0,-60.0,-89.0,-90.0,-86.0,-88.0,17.0,19.0,17.0,28.0,1
4175,BA:8C:B9:54:50:24,3849611,491077681,4914,6192146,3844697,484885535,7,9648,1744578,9626,1741083,22,3495,2358,17,5402,41,7,70,229410.0,130000.0,-39.0,-36.0,-46.0,-52.0,-43.0,-35.0,-44.0,-48.0,-89.0,-90.0,-86.0,-88.0,50.0,54.0,40.0,36.0,1
4176,62:47:05:9D:EB:15,3851312,497017173,6615,12131638,3844697,484885535,1,6597,3733998,6550,3726706,47,7292,3183,0,6675,56,1,124,229410.0,137640.0,-51.0,-53.0,-43.0,-53.0,-51.0,-53.0,-43.0,-52.0,-89.0,-90.0,-86.0,-88.0,38.0,37.0,43.0,35.0,1
4177,92:69:1D:31:68:E9,3848724,488536148,4027,3650613,3844697,484885535,1,5313,1150520,5148,1113077,165,37443,2192,12,4272,102,1,60,216660.0,130000.0,-51.0,-47.0,-42.0,-47.0,-51.0,-48.0,-43.0,-48.0,-89.0,-90.0,-86.0,-88.0,38.0,43.0,44.0,41.0,1
4178,CC:2F:71:3F:1F:24,4954875,1745744229,1110178,1260858694,3844697,484885535,1730,926117,1037423775,925301,1037325121,816,98654,894599,15,1108803,117977,1727,731,130000.0,43333.0,-70.0,-66.0,-67.0,-71.0,-70.0,-66.0,-67.0,-71.0,-89.0,-90.0,-86.0,-88.0,19.0,24.0,19.0,17.0,1
4179,CC:2F:71:3E:C5:1F,3845663,485003547,966,118012,3844697,484885535,2,4197,350242,3493,266640,704,83602,1023,12,1390,26,2,53,130000.0,39000.0,-72.0,-71.0,-69.0,-61.0,-70.0,-70.0,-67.0,-60.0,-89.0,-90.0,-86.0,-88.0,17.0,19.0,17.0,27.0,1
4180,BA:8C:B9:54:50:24,3849612,491077797,4915,6192262,3844697,484885535,7,9650,1744714,9628,1741219,22,3495,2358,17,5403,41,7,70,229410.0,130000.0,-39.0,-36.0,-45.0,-52.0,-41.0,-35.0,-44.0,-50.0,-89.0,-90.0,-86.0,-88.0,50.0,54.0,41.0,36.0,1
4181,62:47:05:9D:EB:15,3851325,497026645,6620,12140302,3844705,484886343,1,6619,3735603,6572,3728311,47,7292,3184,0,6680,56,1,124,229410.0,137640.0,-50.0,-47.0,-39.0,-51.0,-48.0,-50.0,-40.0,-50.0,-89.0,-90.0,-86.0,-88.0,39.0,43.0,47.0,37.0,1
4182,92:69:1D:31:68:E9,3848732,488536956,4027,3650613,3844705,484886343,1,5313,1150520,5148,1113077,165,37443,2192,12,4272,102,1,60,216660.0,130000.0,-51.0,-47.0,-42.0,-47.0,-51.0,-48.0,-43.0,-48.0,-89.0,-90.0,-86.0,-88.0,38.0,43.0,44.0,41.0,1
4183,CC:2F:71:3F:1F:24,4955075,1745987869,1110370,1261101526,3844705,484886343,1730,926297,1037667131,925481,1037568477,816,98654,894769,15,1108995,118018,1727,731,117000.0,39000.0,-70.0,-66.0,-68.0,-70.0,-69.0,-65.0,-67.0,-70.0,-89.0,-90.0,-86.0,-88.0,19.0,24.0,18.0,18.0,1
4184,CC:2F:71:3E:C5:1F,3845671,485004355,966,118012,3844705,484886343,2,4197,350242,3493,266640,704,83602,1023,12,1390,26,2,53,130000.0,39000.0,-72.0,-71.0,-69.0,-61.0,-70.0,-70.0,-67.0,-60.0,-89.0,-90.0,-86.0,-88.0,17.0,19.0,17.0,27.0,1
4185,BA:8C:B9:54:50:24,3849620,491078605,4915,6192262,3844705,484886343,7,9650,1744714,9628,1741219,22,3495,2358,17,5403,41,7,70,229410.0,130000.0,-39.0,-36.0,-45.0,-52.0,-41.0,-35.0,-44.0,-50.0,-89.0,-90.0,-86.0,-88.0,50.0,54.0,41.0,36.0,1
4186,62:47:05:9D:EB:15,3851332,497033521,6626,12147118,3844706,484886403,1,6648,3738136,6601,3730844,47,7292,3188,0,6686,56,1,124,229410.0,137640.0,-50.0,-52.0,-43.0,-51.0,-47.0,-49.0,-39.0,-48.0,-89.0,-90.0,-86.0,-88.0,39.0,38.0,43.0,37.0,1
4187,92:69:1D:31:68:E9,3848733,488537016,4027,3650613,3844706,484886403,1,5313,1150520,5148,1113077,165,37443,2192,12,4272,102,1,60,216660.0,130000.0,-51.0,-47.0,-42.0,-47.0,-51.0,-48.0,-43.0,-48.0,-89.0,-90.0,-86.0,-88.0,38.0,43.0,44.0,41.0,1
4188,CC:2F:71:3F:1F:24,4955268,1746230329,1110562,1261343926,3844706,484886403,1730,926471,1037898287,925655,1037799633,816,98654,894941,15,1109187,118059,1727,731,130000.0,43333.0,-69.0,-66.0,-67.0,-70.0,-69.0,-65.0,-67.0,-70.0,-89.0,-90.0,-86.0,-88.0,20.0,24.0,19.0,18.0,1
4189,CC:2F:71:3E:C5:1F,3845672,485004415,966,118012,3844706,484886403,2,4197,350242,3493,266640,704,83602,1023,12,1390,26,2,53,130000.0,39000.0,-72.0,-71.0,-69.0,-61.0,-70.0,-70.0,-67.0,-60.0,-89.0,-90.0,-86.0,-88.0,17.0,19.0,17.0,27.0,1
4190,BA:8C:B9:54:50:24,3849621,491078665,4915,6192262,3844706,484886403,7,9650,1744714,9628,1741219,22,3495,2358,17,5403,41,7,70,229410.0,130000.0,-39.0,-36.0,-45.0,-52.0,-41.0,-35.0,-44.0,-50.0,-89.0,-90.0,-86.0,-88.0,50.0,54.0,41.0,36.0,1
4191,62:47:05:9D:EB:15,3851342,497034664,6626,12147118,3844716,484887546,1,6664,3739278,6616,3731864,48,7414,3189,0,6686,56,1,124,229410.0,137640.0,-49.0,-48.0,-38.0,-49.0,-47.0,-49.0,-39.0,-48.0,-89.0,-90.0,-86.0,-88.0,40.0,42.0,48.0,39.0,1
4192,92:69:1D:31:68:E9,3848743,488538159,4027,3650613,3844716,484887546,1,5313,1150520,5148,1113077,165,37443,2192,12,4272,102,1,60,216660.0,130000.0,-51.0,-47.0,-42.0,-47.0,-51.0,-48.0,-43.0,-48.0,-89.0,-90.0,-86.0,-88.0,38.0,43.0,44.0,41.0,1
4193,CC:2F:71:3F:1F:24,4955487,1746482335,1110771,1261594789,3844716,484887546,1730,926674,1038142783,925858,1038044129,816,98654,895131,15,1109396,118092,1727,731,130000.0,43333.0,-70.0,-66.0,-67.0,-71.0,-70.0,-66.0,-67.0,-71.0,-89.0,-90.0,-86.0,-88.0,19.0,24.0,19.0,17.0,1
4194,CC:2F:71:3E:C5:1F,3845682,485005558,966,118012,3844716,484887546,2,4197,350242,3493,266640,704,83602,1023,12,1390,26,2,53,130000.0,39000.0,-72.0,-71.0,-69.0,-61.0,-70.0,-70.0,-67.0,-60.0,-89.0,-90.0,-86.0,-88.0,17.0,19.0,17.0,27.0,1
4195,BA:8C:B9:54:50:24,3849631,491079808,4915,6192262,3844716,484887546,7,9650,1744714,9628,1741219,22,3495,2358,17,5403,41,7,70,229410.0,130000.0,-39.0,-36.0,-45.0,-52.0,-41.0,-35.0,-44.0,-50.0,-89.0,-90.0,-86.0,-88.0,50.0,54.0,41.0,36.0,1
4196,62:47:05:9D:EB:15,3851343,497034724,6626,12147118,3844717,484887606,1,6664,3739278,6616,3731864,48,7414,3189,0,6686,56,1,124,229410.0,137640.0,-49.0,-48.0,-38.0,-49.0,-47.0,-49.0,-39.0,-48.0,-89.0,-90.0,-86.0,-88.0,40.0,42.0,48.0,39.0,1
4197,92:69:1D:31:68:E9,3848744,488538219,4027,3650613,3844717,484887606,1,5313,1150520,5148,1113077,165,37443,2192,12,4272,102,1,60,216660.0,130000.0,-51.0,-47.0,-42.0,-47.0,-51.0,-48.0,-43.0,-48.0,-89.0,-90.0,-86.0,-88.0,38.0,43.0,44.0,41.0,1
4198,CC:2F:71:3F:1F:24,4955680,1746726539,1110963,1261838933,3844717,484887606,1730,926847,1038373885,926031,1038275231,816,98654,895301,15,1109588,118143,1727,731,130000.0,43333.0,-70.0,-66.0,-67.0,-71.0,-70.0,-66.0,-67.0,-71.0,-89.0,-90.0,-86.0,-88.0,19.0,24.0,19.0,17.0,1
4199,CC:2F:71:3E:C5:1F,3845683,485005618,966,118012,3844717,484887606,2,4197,350242,3493,266640,704,83602,1023,12,1390,26,2,53,130000.0,39000.0,-72.0,-71.0,-69.0,-61.0,-70.0,-70.0,-67.0,-60.0,-89.0,-90.0,-86.0,-88.0,17.0,19.0,17.0,27.0,1
4200,BA:8C:B9:54:50:24,3849632,491079868,4915,6192262,3844717,484887606,7,9650,1744714,9628,1741219,22,3495,2358,17,5403,41,7,70,229410.0,130000.0,-39.0,-36.0,-45.0,-52.0,-41.0,-35.0,-44.0,-50.0,-89.0,-90.0,-86.0,-88.0,50.0,54.0,41.0,36.0,1
4201,62:47:05:9D:EB:15,3851354,497036922,6629,12148508,3844725,484888414,1,6686,3742380,6638,3734966,48,7414,3192,0,6689,56,1,125,229410.0,137640.0,-51.0,-48.0,-39.0,-52.0,-49.0,-50.0,-41.0,-51.0,-89.0,-90.0,-86.0,-88.0,38.0,42.0,47.0,36.0,1
4202,92:69:1D:31:68:E9,3848752,488539027,4027,3650613,3844725,484888414,1,5313,1150520,5148,1113077,165,37443,2192,12,4272,102,1,60,216660.0,130000.0,-51.0,-47.0,-42.0,-47.0,-51.0,-48.0,-43.0,-48.0,-89.0,-90.0,-86.0,-88.0,38.0,43.0,44.0,41.0,1
4203,CC:2F:71:3F:1F:24,4955881,1746971621,1111156,1262083207,3844725,484888414,1730,927026,1038610031,926210,1038511377,816,98654,895475,15,1109781,118201,1727,731,130000.0,43333.0,-70.0,-66.0,-68.0,-71.0,-69.0,-65.0,-67.0,-71.0,-89.0,-90.0,-86.0,-88.0,19.0,24.0,18.0,17.0,1
4204,CC:2F:71:3E:C5:1F,3845691,485006426,966,118012,3844725,484888414,2,4197,350242,3493,266640,704,83602,1023,12,1390,26,2,53,130000.0,39000.0,-72.0,-71.0,-69.0,-61.0,-70.0,-70.0,-67.0,-60.0,-89.0,-90.0,-86.0,-88.0,17.0,19.0,17.0,27.0,1
4205,BA:8C:B9:54:50:24,3849640,491080676,4915,6192262,3844725,484888414,7,9650,1744714,9628,1741219,22,3495,2358,17,5403,41,7,70,229410.0,130000.0,-39.0,-36.0,-45.0,-52.0,-41.0,-35.0,-44.0,-50.0,-89.0,-90.0,-86.0,-88.0,50.0,54.0,41.0,36.0,1
4206,62:47:05:9D:EB:15,3851354,497036922,6629,12148508,3844725,484888414,1,6686,3742380,6638,3734966,48,7414,3192,0,6689,56,1,125,229410.0,137640.0,-51.0,-48.0,-39.0,-52.0,-49.0,-50.0,-41.0,-51.0,-89.0,-90.0,-86.0,-88.0,38.0,42.0,47.0,36.0,1
4207,92:69:1D:31:68:E9,3848752,488539027,4027,3650613,3844725,484888414,1,5313,1150520,5148,1113077,165,37443,2192,12,4272,102,1,60,216660.0,130000.0,-51.0,-47.0,-42.0,-47.0,-51.0,-48.0,-43.0,-48.0,-89.0,-90.0,-86.0,-88.0,38.0,43.0,44.0,41.0,1
4208,CC:2F:71:3F:1F:24,4956072,1747212899,1111347,1262324485,3844725,484888414,1730,927204,1038846217,926388,1038747563,816,98654,895646,15,1109972,118246,1727,731,117000.0,39000.0,-70.0,-65.0,-68.0,-71.0,-70.0,-65.0,-67.0,-71.0,-89.0,-90.0,-86.0,-88.0,19.0,25.0,18.0,17.0,1
4209,CC:2F:71:3E:C5:1F,3845691,485006426,966,118012,3844725,484888414,2,4197,350242,3493,266640,704,83602,1023,12,1390,26,2,53,130000.0,39000.0,-72.0,-71.0,-69.0,-61.0,-70.0,-70.0,-67.0,-60.0,-89.0,-90.0,-86.0,-88.0,17.0,19.0,17.0,27.0,1
4210,BA:8C:B9:54:50:24,3849640,491080676,4915,6192262,3844725,484888414,7,9650,1744714,9628,1741219,22,3495,2358,17,5403,41,7,70,229410.0,130000.0,-39.0,-36.0,-45.0,-52.0,-41.0,-35.0,-44.0,-50.0,-89.0,-90.0,-86.0,-88.0,50.0,54.0,41.0,36.0,1
4211,62:47:05:9D:EB:15,3851363,497037790,6629,12148508,3844734,484889282,1,6686,3742380,6638,3734966,48,7414,3192,0,6689,56,1,125,229410.0,137640.0,-51.0,-48.0,-39.0,-52.0,-49.0,-50.0,-41.0,-51.0,-89.0,-90.0,-86.0,-88.0,38.0,42.0,47.0,36.0,1
4212,92:69:1D:31:68:E9,3848761,488539895,4027,3650613,3844734,484889282,1,5313,1150520,5148,1113077,165,37443,2192,12,4272,102,1,60,216660.0,130000.0,-51.0,-47.0,-42.0,-47.0,-51.0,-48.0,-43.0,-48.0,-89.0,-90.0,-86.0,-88.0,38.0,43.0,44.0,41.0,1
4213,CC:2F:71:3F:1F:24,4956279,1747461364,1111545,1262572082,3844734,484889282,1730,927391,1039086576,926575,1038987922,816,98654,895825,15,1110170,118272,1727,731,130000.0,43333.0,-70.0,-66.0,-68.0,-71.0,-69.0,-65.0,-67.0,-71.0,-89.0,-90.0,-86.0,-88.0,19.0,24.0,18.0,17.0,1
4214,CC:2F:71:3E:C5:1F,3845700,485007294,966,118012,3844734,484889282,2,4197,350242,3493,266640,704,83602,1023,12,1390,26,2,53,130000.0,39000.0,-72.0,-71.0,-69.0,-61.0,-70.0,-70.0,-67.0,-60.0,-89.0,-90.0,-86.0,-88.0,17.0,19.0,17.0,27.0,1
4215,BA:8C:B9:54:50:24,3849649,491081544,4915,6192262,3844734,484889282,7,9650,1744714,9628,1741219,22,3495,2358,17,5403,41,7,70,229410.0,130000.0,-39.0,-36.0,-45.0,-52.0,-41.0,-35.0,-44.0,-50.0,-89.0,-90.0,-86.0,-88.0,50.0,54.0,41.0,36.0,1
4216,62:47:05:9D:EB:15,3851368,497038552,6633,12149208,3844735,484889344,1,6693,3743678,6645,3736264,48,7414,3196,0,6693,56,1,125,229410.0,137640.0,-46.0,-51.0,-43.0,-49.0,-46.0,-49.0,-41.0,-49.0,-89.0,-90.0,-86.0,-88.0,43.0,39.0,43.0,39.0,1
4217,92:69:1D:31:68:E9,3848763,488540019,4027,3650613,3844736,484889406,1,5313,1150520,5148,1113077,165,37443,2192,12,4272,102,1,60,216660.0,130000.0,-51.0,-47.0,-42.0,-47.0,-51.0,-48.0,-43.0,-48.0,-89.0,-90.0,-86.0,-88.0,38.0,43.0,44.0,41.0,1
4218,CC:2F:71:3F:1F:24,4956473,1747705872,1111737,1262816466,3844736,484889406,1730,927577,1039335356,926760,1039236584,817,98772,895997,15,1110362,118278,1727,731,130000.0,43333.0,-74.0,-69.0,-71.0,-73.0,-72.0,-67.0,-69.0,-71.0,-89.0,-90.0,-86.0,-88.0,15.0,21.0,15.0,15.0,1
4219,CC:2F:71:3E:C5:1F,3845702,485007418,966,118012,3844736,484889406,2,4197,350242,3493,266640,704,83602,1023,12,1390,26,2,53,130000.0,39000.0,-72.0,-71.0,-69.0,-61.0,-70.0,-70.0,-67.0,-60.0,-89.0,-90.0,-86.0,-88.0,17.0,19.0,17.0,27.0,1
4220,BA:8C:B9:54:50:24,3849653,491081870,4915,6192262,3844738,484889608,7,9650,1744714,9628,1741219,22,3495,2358,17,5403,41,7,70,229410.0,130000.0,-39.0,-36.0,-45.0,-52.0,-41.0,-35.0,-44.0,-50.0,-89.0,-90.0,-86.0,-88.0,50.0,54.0,41.0,36.0,1
4221,62:47:05:9D:EB:15,3851390,497042019,6644,12151683,3844746,484890336,1,6709,3746263,6659,3738605,50,7658,3209,0,6704,56,1,125,229410.0,137640.0,-43.0,-48.0,-45.0,-47.0,-42.0,-44.0,-39.0,-42.0,-89.0,-90.0,-86.0,-88.0,46.0,42.0,41.0,41.0,1
4222,92:69:1D:31:68:E9,3848773,488540949,4027,3650613,3844746,484890336,1,5314,1150588,5149,1113145,165,37443,2192,12,4272,102,1,60,216660.0,130000.0,-51.0,-50.0,-46.0,-50.0,-51.0,-48.0,-43.0,-48.0,-89.0,-90.0,-86.0,-88.0,38.0,40.0,40.0,38.0,1
4223,CC:2F:71:3F:1F:24,4956677,1747951278,1111931,1263060942,3844746,484890336,1730,927764,1039586934,926947,1039488162,817,98772,896167,15,1110556,118278,1727,731,144444.0,43333.0,-68.0,-70.0,-71.0,-70.0,-68.0,-70.0,-71.0,-69.0,-89.0,-90.0,-86.0,-88.0,21.0,20.0,15.0,18.0,1
4224,CC:2F:71:3E:C5:1F,3845712,485008348,966,118012,3844746,484890336,2,4197,350242,3493,266640,704,83602,1023,12,1390,26,2,53,130000.0,39000.0,-72.0,-71.0,-69.0,-61.0,-70.0,-70.0,-67.0,-60.0,-89.0,-90.0,-86.0,-88.0,17.0,19.0,17.0,27.0,1
4225,BA:8C:B9:54:50:24,3849661,491082598,4915,6192262,3844746,484890336,7,9650,1744714,9628,1741219,22,3495,2358,17,5403,41,7,70,229410.0,130000.0,-39.0,-36.0,-45.0,-52.0,-41.0,-35.0,-44.0,-50.0,-89.0,-90.0,-86.0,-88.0,50.0,54.0,41.0,36.0,1
4226,62:47:05:9D:EB:15,3851391,497042081,6644,12151683,3844747,484890398,1,6710,3746331,6660,3738673,50,7658,3209,0,6704,56,1,125,229410.0,137640.0,-45.0,-53.0,-48.0,-47.0,-42.0,-45.0,-41.0,-43.0,-89.0,-90.0,-86.0,-88.0,44.0,37.0,38.0,41.0,1
4227,92:69:1D:31:68:E9,3848774,488541011,4027,3650613,3844747,484890398,1,5314,1150588,5149,1113145,165,37443,2192,12,4272,102,1,60,216660.0,130000.0,-51.0,-50.0,-46.0,-50.0,-51.0,-48.0,-43.0,-48.0,-89.0,-90.0,-86.0,-88.0,38.0,40.0,40.0,38.0,1
4228,CC:2F:71:3F:1F:24,4956882,1748202691,1112133,1263312091,3844749,484890600,1730,927962,1039844528,927145,1039745756,817,98772,896349,15,1110758,118289,1727,731,130000.0,43333.0,-72.0,-69.0,-67.0,-71.0,-72.0,-69.0,-66.0,-71.0,-89.0,-90.0,-86.0,-88.0,17.0,21.0,19.0,17.0,1
4229,CC:2F:71:3E:C5:1F,3845715,485008612,966,118012,3844749,484890600,2,4199,350430,3494,266710,705,83720,1024,12,1390,26,2,53,130000.0,39000.0,-71.0,-71.0,-69.0,-61.0,-70.0,-70.0,-67.0,-60.0,-89.0,-90.0,-86.0,-88.0,18.0,19.0,17.0,27.0,1
4230,BA:8C:B9:54:50:24,3849666,491083064,4915,6192262,3844751,484890802,7,9650,1744714,9628,1741219,22,3495,2358,17,5403,41,7,70,229410.0,130000.0,-39.0,-36.0,-45.0,-52.0,-41.0,-35.0,-44.0,-50.0,-89.0,-90.0,-86.0,-88.0,50.0,54.0,41.0,36.0,1
4231,62:47:05:9D:EB:15,3851399,497042889,6644,12151683,3844755,484891206,1,6710,3746331,6660,3738673,50,7658,3209,0,6704,56,1,125,229410.0,137640.0,-45.0,-53.0,-48.0,-47.0,-42.0,-45.0,-41.0,-43.0,-89.0,-90.0,-86.0,-88.0,44.0,37.0,38.0,41.0,1
4232,92:69:1D:31:68:E9,3848782,488541819,4027,3650613,3844755,484891206,1,5314,1150588,5149,1113145,165,37443,2192,12,4272,102,1,60,216660.0,130000.0,-51.0,-50.0,-46.0,-50.0,-51.0,-48.0,-43.0,-48.0,-89.0,-90.0,-86.0,-88.0,38.0,40.0,40.0,38.0,1
4233,CC:2F:71:3F:1F:24,4957080,1748447665,1112325,1263556459,3844755,484891206,1730,928138,1040078998,927321,1039980226,817,98772,896520,15,1110950,118289,1727,731,130000.0,43333.0,-71.0,-68.0,-66.0,-72.0,-71.0,-68.0,-66.0,-72.0,-89.0,-90.0,-86.0,-88.0,18.0,22.0,20.0,16.0,1
4234,CC:2F:71:3E:C5:1F,3845721,485009218,966,118012,3844755,484891206,2,4199,350430,3494,266710,705,83720,1024,12,1390,26,2,53,130000.0,39000.0,-71.0,-71.0,-69.0,-61.0,-70.0,-70.0,-67.0,-60.0,-89.0,-90.0,-86.0,-88.0,18.0,19.0,17.0,27.0,1
4235,BA:8C:B9:54:50:24,3849670,491083468,4915,6192262,3844755,484891206,7,9652,1744850,9630,1741355,22,3495,2358,17,5404,41,7,70,229410.0,130000.0,-48.0,-35.0,-43.0,-45.0,-41.0,-35.0,-45.0,-50.0,-89.0,-90.0,-86.0,-88.0,41.0,55.0,43.0,43.0,1
4236,62:47:05:9D:EB:15,3851402,497043151,6644,12151683,3844758,484891468,1,6710,3746331,6660,3738673,50,7658,3209,0,6704,56,1,125,229410.0,137640.0,-45.0,-53.0,-48.0,-47.0,-42.0,-45.0,-41.0,-43.0,-89.0,-90.0,-86.0,-88.0,44.0,37.0,38.0,41.0,1
4237,92:69:1D:31:68:E9,3848785,488542081,4027,3650613,3844758,484891468,1,5314,1150588,5149,1113145,165,37443,2192,12,4272,102,1,60,216660.0,130000.0,-51.0,-50.0,-46.0,-50.0,-51.0,-48.0,-43.0,-48.0,-89.0,-90.0,-86.0,-88.0,38.0,40.0,40.0,38.0,1
4238,CC:2F:71:3F:1F:24,4957276,1748690943,1112516,1263799273,3844760,484891670,1730,928316,1040313632,927499,1040214860,817,98772,896691,15,1111141,118289,1727,731,130000.0,43333.0,-70.0,-68.0,-66.0,-74.0,-70.0,-68.0,-66.0,-73.0,-89.0,-90.0,-86.0,-88.0,19.0,22.0,20.0,14.0,1
4239,CC:2F:71:3E:C5:1F,3845726,485009682,966,118012,3844760,484891670,2,4199,350430,3494,266710,705,83720,1024,12,1390,26,2,53,130000.0,39000.0,-71.0,-71.0,-69.0,-61.0,-70.0,-70.0,-67.0,-60.0,-89.0,-90.0,-86.0,-88.0,18.0,19.0,17.0,27.0,1
4240,BA:8C:B9:54:50:24,3849677,491084134,4915,6192262,3844762,484891872,7,9652,1744850,9630,1741355,22,3495,2358,17,5404,41,7,70,229410.0,130000.0,-48.0,-35.0,-43.0,-45.0,-41.0,-35.0,-45.0,-50.0,-89.0,-90.0,-86.0,-88.0,41.0,55.0,43.0,43.0,1
4241,62:47:05:9D:EB:15,3851431,497054780,6644,12151683,3844787,484903097,1,6710,3746331,6660,3738673,50,7658,3209,0,6704,56,1,125,229410.0,137640.0,-45.0,-53.0,-48.0,-47.0,-42.0,-45.0,-41.0,-43.0,-89.0,-90.0,-86.0,-88.0,44.0,37.0,38.0,41.0,1
4242,92:69:1D:31:68:E9,3848814,488553710,4027,3650613,3844787,484903097,1,5317,1150959,5151,1113281,166,37678,2193,12,4272,102,1,60,216660.0,130000.0,-51.0,-51.0,-46.0,-49.0,-51.0,-49.0,-44.0,-49.0,-89.0,-90.0,-86.0,-88.0,38.0,39.0,40.0,39.0,1
4243,CC:2F:71:3F:1F:24,4957496,1748948252,1112709,1264045155,3844787,484903097,1730,928493,1040550872,927676,1040452100,817,98772,896864,15,1111334,118289,1727,731,144444.0,43333.0,-70.0,-68.0,-69.0,-73.0,-70.0,-68.0,-69.0,-73.0,-89.0,-90.0,-86.0,-88.0,19.0,22.0,17.0,15.0,1
4244,CC:2F:71:3E:C5:1F,3845753,485021109,966,118012,3844787,484903097,2,4199,350430,3494,266710,705,83720,1024,12,1390,26,2,53,130000.0,39000.0,-71.0,-71.0,-69.0,-61.0,-70.0,-70.0,-67.0,-60.0,-89.0,-90.0,-86.0,-88.0,18.0,19.0,17.0,27.0,1
4245,BA:8C:B9:54:50:24,3849702,491095359,4915,6192262,3844787,484903097,7,9652,1744850,9630,1741355,22,3495,2358,17,5404,41,7,70,229410.0,130000.0,-48.0,-35.0,-43.0,-45.0,-41.0,-35.0,-45.0,-50.0,-89.0,-90.0,-86.0,-88.0,41.0,55.0,43.0,43.0,1
4246,62:47:05:9D:EB:15,3851436,497055244,6644,12151683,3844792,484903561,1,6713,3746535,6663,3738877,50,7658,3209,0,6704,56,1,125,229410.0,137640.0,-43.0,-46.0,-35.0,-47.0,-42.0,-46.0,-41.0,-44.0,-89.0,-90.0,-86.0,-88.0,46.0,44.0,51.0,41.0,1
4247,92:69:1D:31:68:E9,3848819,488554174,4027,3650613,3844792,484903561,1,5317,1150959,5151,1113281,166,37678,2193,12,4272,102,1,60,216660.0,130000.0,-51.0,-51.0,-46.0,-49.0,-51.0,-49.0,-44.0,-49.0,-89.0,-90.0,-86.0,-88.0,38.0,39.0,40.0,39.0,1
4248,CC:2F:71:3F:1F:24,4957703,1749196873,1112909,1264293110,3844794,484903763,1730,928681,1040790105,927864,1040691333,817,98772,897044,15,1111534,118290,1727,731,144444.0,43333.0,-71.0,-69.0,-69.0,-74.0,-71.0,-68.0,-69.0,-74.0,-89.0,-90.0,-86.0,-88.0,18.0,21.0,17.0,14.0,1
4249,CC:2F:71:3E:C5:1F,3845760,485021775,966,118012,3844794,484903763,2,4199,350430,3494,266710,705,83720,1024,12,1390,26,2,53,130000.0,39000.0,-71.0,-71.0,-69.0,-61.0,-70.0,-70.0,-67.0,-60.0,-89.0,-90.0,-86.0,-88.0,18.0,19.0,17.0,27.0,1
4250,BA:8C:B9:54:50:24,3849711,491096227,4915,6192262,3844796,484903965,7,9652,1744850,9630,1741355,22,3495,2358,17,5404,41,7,70,229410.0,130000.0,-48.0,-35.0,-43.0,-45.0,-41.0,-35.0,-45.0,-50.0,-89.0,-90.0,-86.0,-88.0,41.0,55.0,43.0,43.0,1
4251,62:47:05:9D:EB:15,3851441,497055921,6644,12151683,3844797,484904238,1,6713,3746535,6663,3738877,50,7658,3209,0,6704,56,1,125,229410.0,137640.0,-43.0,-46.0,-35.0,-47.0,-42.0,-46.0,-41.0,-44.0,-89.0,-90.0,-86.0,-88.0,46.0,44.0,51.0,41.0,1
4252,92:69:1D:31:68:E9,3848824,488554851,4027,3650613,3844797,484904238,1,5317,1150959,5151,1113281,166,37678,2193,12,4272,102,1,60,216660.0,130000.0,-51.0,-51.0,-46.0,-49.0,-51.0,-49.0,-44.0,-49.0,-89.0,-90.0,-86.0,-88.0,38.0,39.0,40.0,39.0,1
4253,CC:2F:71:3F:1F:24,4957905,1749454018,1113108,1264549780,3844797,484904238,1730,928868,1041042943,928051,1040944171,817,98772,897222,15,1111733,118292,1727,731,144444.0,43333.0,-70.0,-68.0,-68.0,-75.0,-70.0,-68.0,-68.0,-74.0,-89.0,-90.0,-86.0,-88.0,19.0,22.0,18.0,13.0,1
4254,CC:2F:71:3E:C5:1F,3845763,485022250,966,118012,3844797,484904238,2,4199,350430,3494,266710,705,83720,1024,12,1390,26,2,53,130000.0,39000.0,-71.0,-71.0,-69.0,-61.0,-70.0,-70.0,-67.0,-60.0,-89.0,-90.0,-86.0,-88.0,18.0,19.0,17.0,27.0,1
4255,BA:8C:B9:54:50:24,3849712,491096500,4915,6192262,3844797,484904238,7,9652,1744850,9630,1741355,22,3495,2358,17,5404,41,7,70,229410.0,130000.0,-48.0,-35.0,-43.0,-45.0,-41.0,-35.0,-45.0,-50.0,-89.0,-90.0,-86.0,-88.0,41.0,55.0,43.0,43.0,1
4256,62:47:05:9D:EB:15,3851473,497066843,6670,12161999,3844803,484904844,1,6777,3779494,6727,3771836,50,7658,3252,0,6730,56,1,125,229410.0,130000.0,-47.0,-48.0,-40.0,-47.0,-47.0,-48.0,-40.0,-47.0,-89.0,-90.0,-86.0,-88.0,42.0,42.0,46.0,41.0,1
4257,92:69:1D:31:68:E9,3848830,488555457,4027,3650613,3844803,484904844,1,5317,1150959,5151,1113281,166,37678,2193,12,4272,102,1,60,216660.0,130000.0,-51.0,-51.0,-46.0,-49.0,-51.0,-49.0,-44.0,-49.0,-89.0,-90.0,-86.0,-88.0,38.0,39.0,40.0,39.0,1
4258,CC:2F:71:3F:1F:24,4958103,1749697526,1113298,1264792480,3844805,484905046,1730,929042,1041272675,928225,1041173903,817,98772,897394,15,1111922,118292,1727,731,144444.0,43333.0,-70.0,-69.0,-68.0,-75.0,-70.0,-68.0,-68.0,-74.0,-89.0,-90.0,-86.0,-88.0,19.0,21.0,18.0,13.0,1
4259,CC:2F:71:3E:C5:1F,3845772,485023118,966,118012,3844806,484905106,2,4199,350430,3494,266710,705,83720,1024,12,1390,26,2,53,130000.0,39000.0,-71.0,-71.0,-69.0,-61.0,-70.0,-70.0,-67.0,-60.0,-89.0,-90.0,-86.0,-88.0,18.0,19.0,17.0,27.0,1
4260,BA:8C:B9:54:50:24,3849721,491097368,4915,6192262,3844806,484905106,7,9652,1744850,9630,1741355,22,3495,2358,17,5404,41,7,70,229410.0,130000.0,-48.0,-35.0,-43.0,-45.0,-41.0,-35.0,-45.0,-50.0,-89.0,-90.0,-86.0,-88.0,41.0,55.0,43.0,43.0,1
4261,62:47:05:9D:EB:15,3851476,497067105,6670,12161999,3844806,484905106,1,6778,3779562,6728,3771904,50,7658,3252,0,6730,56,1,125,229410.0,130000.0,-43.0,-45.0,-35.0,-47.0,-46.0,-47.0,-39.0,-47.0,-89.0,-90.0,-86.0,-88.0,46.0,45.0,51.0,41.0,1
4262,92:69:1D:31:68:E9,3848833,488555719,4027,3650613,3844806,484905106,1,5317,1150959,5151,1113281,166,37678,2193,12,4272,102,1,60,216660.0,130000.0,-51.0,-51.0,-46.0,-49.0,-51.0,-49.0,-44.0,-49.0,-89.0,-90.0,-86.0,-88.0,38.0,39.0,40.0,39.0,1
4263,CC:2F:71:3F:1F:24,4958299,1749946616,1113493,1265041510,3844806,484905106,1730,929216,1041508131,928399,1041409359,817,98772,897568,15,1112118,118292,1727,731,144444.0,43333.0,-70.0,-69.0,-68.0,-74.0,-70.0,-68.0,-68.0,-74.0,-89.0,-90.0,-86.0,-88.0,19.0,21.0,18.0,14.0,1
4264,CC:2F:71:3E:C5:1F,3845772,485023118,966,118012,3844806,484905106,2,4199,350430,3494,266710,705,83720,1024,12,1390,26,2,53,130000.0,39000.0,-71.0,-71.0,-69.0,-61.0,-70.0,-70.0,-67.0,-60.0,-89.0,-90.0,-86.0,-88.0,18.0,19.0,17.0,27.0,1
4265,BA:8C:B9:54:50:24,3849721,491097368,4915,6192262,3844806,484905106,7,9652,1744850,9630,1741355,22,3495,2358,17,5404,41,7,70,229410.0,130000.0,-48.0,-35.0,-43.0,-45.0,-41.0,-35.0,-45.0,-50.0,-89.0,-90.0,-86.0,-88.0,41.0,55.0,43.0,43.0,1
4266,62:47:05:9D:EB:15,3851486,497068281,6670,12161999,3844816,484906282,1,6778,3779562,6728,3771904,50,7658,3252,0,6730,56,1,125,229410.0,130000.0,-43.0,-45.0,-35.0,-47.0,-46.0,-47.0,-39.0,-47.0,-89.0,-90.0,-86.0,-88.0,46.0,45.0,51.0,41.0,1
4267,92:69:1D:31:68:E9,3848843,488556895,4027,3650613,3844816,484906282,1,5317,1150959,5151,1113281,166,37678,2193,12,4272,102,1,60,216660.0,130000.0,-51.0,-51.0,-46.0,-49.0,-51.0,-49.0,-44.0,-49.0,-89.0,-90.0,-86.0,-88.0,38.0,39.0,40.0,39.0,1
4268,CC:2F:71:3F:1F:24,4958509,1750195761,1113693,1265289479,3844816,484906282,1730,929396,1041739022,928579,1041640250,817,98772,897748,15,1112318,118293,1727,731,144444.0,43333.0,-70.0,-69.0,-69.0,-73.0,-69.0,-69.0,-69.0,-73.0,-89.0,-90.0,-86.0,-88.0,19.0,21.0,17.0,15.0,1
4269,CC:2F:71:3E:C5:1F,3845782,485024294,966,118012,3844816,484906282,2,4199,350430,3494,266710,705,83720,1024,12,1390,26,2,53,130000.0,39000.0,-71.0,-71.0,-69.0,-61.0,-70.0,-70.0,-67.0,-60.0,-89.0,-90.0,-86.0,-88.0,18.0,19.0,17.0,27.0,1
4270,BA:8C:B9:54:50:24,3849731,491098544,4915,6192262,3844816,484906282,7,9652,1744850,9630,1741355,22,3495,2358,17,5404,41,7,70,229410.0,130000.0,-48.0,-35.0,-43.0,-45.0,-41.0,-35.0,-45.0,-50.0,-89.0,-90.0,-86.0,-88.0,41.0,55.0,43.0,43.0,1
4271,62:47:05:9D:EB:15,3851487,497068341,6670,12161999,3844817,484906342,1,6778,3779562,6728,3771904,50,7658,3252,0,6730,56,1,125,229410.0,130000.0,-43.0,-45.0,-35.0,-47.0,-46.0,-47.0,-39.0,-47.0,-89.0,-90.0,-86.0,-88.0,46.0,45.0,51.0,41.0,1
4272,92:69:1D:31:68:E9,3848844,488556955,4027,3650613,3844817,484906342,1,5317,1150959,5151,1113281,166,37678,2193,12,4272,102,1,60,216660.0,130000.0,-51.0,-51.0,-46.0,-49.0,-51.0,-49.0,-44.0,-49.0,-89.0,-90.0,-86.0,-88.0,38.0,39.0,40.0,39.0,1
4273,CC:2F:71:3F:1F:24,4958702,1750438751,1113885,1265532409,3844817,484906342,1730,929571,1041970394,928754,1041871622,817,98772,897920,15,1112510,118294,1727,731,144444.0,43333.0,-70.0,-68.0,-68.0,-74.0,-70.0,-68.0,-67.0,-74.0,-89.0,-90.0,-86.0,-88.0,19.0,22.0,18.0,14.0,1
4274,CC:2F:71:3E:C5:1F,3845783,485024354,966,118012,3844817,484906342,2,4199,350430,3494,266710,705,83720,1024,12,1390,26,2,53,130000.0,39000.0,-71.0,-71.0,-69.0,-61.0,-70.0,-70.0,-67.0,-60.0,-89.0,-90.0,-86.0,-88.0,18.0,19.0,17.0,27.0,1
4275,BA:8C:B9:54:50:24,3849732,491098604,4915,6192262,3844817,484906342,7,9652,1744850,9630,1741355,22,3495,2358,17,5404,41,7,70,229410.0,130000.0,-48.0,-35.0,-43.0,-45.0,-41.0,-35.0,-45.0,-50.0,-89.0,-90.0,-86.0,-88.0,41.0,55.0,43.0,43.0,1
4276,62:47:05:9D:EB:15,3851495,497069149,6670,12161999,3844825,484907150,1,6778,3779562,6728,3771904,50,7658,3252,0,6730,56,1,125,229410.0,130000.0,-43.0,-45.0,-35.0,-47.0,-46.0,-47.0,-39.0,-47.0,-89.0,-90.0,-86.0,-88.0,46.0,45.0,51.0,41.0,1
4277,92:69:1D:31:68:E9,3848852,488557763,4027,3650613,3844825,484907150,1,5317,1150959,5151,1113281,166,37678,2193,12,4272,102,1,60,216660.0,130000.0,-51.0,-51.0,-46.0,-49.0,-51.0,-49.0,-44.0,-49.0,-89.0,-90.0,-86.0,-88.0,38.0,39.0,40.0,39.0,1
4278,CC:2F:71:3F:1F:24,4958900,1750682243,1114075,1265775093,3844825,484907150,1730,929744,1042201544,928927,1042102772,817,98772,898090,15,1112699,118295,1727,731,144444.0,43333.0,-70.0,-68.0,-67.0,-74.0,-69.0,-68.0,-67.0,-73.0,-89.0,-90.0,-86.0,-88.0,19.0,22.0,19.0,14.0,1
4279,CC:2F:71:3E:C5:1F,3845791,485025162,966,118012,3844825,484907150,2,4199,350430,3494,266710,705,83720,1024,12,1390,26,2,53,130000.0,39000.0,-71.0,-71.0,-69.0,-61.0,-70.0,-70.0,-67.0,-60.0,-89.0,-90.0,-86.0,-88.0,18.0,19.0,17.0,27.0,1
4280,BA:8C:B9:54:50:24,3849740,491099412,4915,6192262,3844825,484907150,7,9652,1744850,9630,1741355,22,3495,2358,17,5404,41,7,70,229410.0,130000.0,-48.0,-35.0,-43.0,-45.0,-41.0,-35.0,-45.0,-50.0,-89.0,-90.0,-86.0,-88.0,41.0,55.0,43.0,43.0,1
4281,62:47:05:9D:EB:15,3851495,497069149,6670,12161999,3844825,484907150,1,6778,3779562,6728,3771904,50,7658,3252,0,6730,56,1,125,229410.0,130000.0,-43.0,-45.0,-35.0,-47.0,-46.0,-47.0,-39.0,-47.0,-89.0,-90.0,-86.0,-88.0,46.0,45.0,51.0,41.0,1
4282,92:69:1D:31:68:E9,3848852,488557763,4027,3650613,3844825,484907150,1,5317,1150959,5151,1113281,166,37678,2193,12,4272,102,1,60,216660.0,130000.0,-51.0,-51.0,-46.0,-49.0,-51.0,-49.0,-44.0,-49.0,-89.0,-90.0,-86.0,-88.0,38.0,39.0,40.0,39.0,1
4283,CC:2F:71:3F:1F:24,4959096,1750931403,1114271,1266024253,3844825,484907150,1730,929920,1042440066,929103,1042341294,817,98772,898263,15,1112896,118296,1727,731,144444.0,43333.0,-71.0,-69.0,-68.0,-74.0,-71.0,-69.0,-67.0,-74.0,-89.0,-90.0,-86.0,-88.0,18.0,21.0,18.0,14.0,1
4284,CC:2F:71:3E:C5:1F,3845792,485025222,966,118012,3844826,484907210,2,4199,350430,3494,266710,705,83720,1024,12,1390,26,2,53,130000.0,39000.0,-71.0,-71.0,-69.0,-61.0,-70.0,-70.0,-67.0,-60.0,-89.0,-90.0,-86.0,-88.0,18.0,19.0,17.0,27.0,1
4285,BA:8C:B9:54:50:24,3849743,491099674,4915,6192262,3844828,484907412,7,9652,1744850,9630,1741355,22,3495,2358,17,5404,41,7,70,229410.0,130000.0,-48.0,-35.0,-43.0,-45.0,-41.0,-35.0,-45.0,-50.0,-89.0,-90.0,-86.0,-88.0,41.0,55.0,43.0,43.0,1
4286,62:47:05:9D:EB:15,3851504,497070017,6670,12161999,3844834,484908018,1,6778,3779562,6728,3771904,50,7658,3252,0,6730,56,1,125,229410.0,130000.0,-43.0,-45.0,-35.0,-47.0,-46.0,-47.0,-39.0,-47.0,-89.0,-90.0,-86.0,-88.0,46.0,45.0,51.0,41.0,1
4287,92:69:1D:31:68:E9,3848861,488558631,4027,3650613,3844834,484908018,1,5317,1150959,5151,1113281,166,37678,2193,12,4272,102,1,60,216660.0,130000.0,-51.0,-51.0,-46.0,-49.0,-51.0,-49.0,-44.0,-49.0,-89.0,-90.0,-86.0,-88.0,38.0,39.0,40.0,39.0,1
4288,CC:2F:71:3F:1F:24,4959314,1751191506,1114480,1266283488,3844834,484908018,1730,930109,1042683546,929292,1042584774,817,98772,898451,15,1113105,118313,1727,732,144444.0,43333.0,-74.0,-71.0,-69.0,-75.0,-72.0,-69.0,-67.0,-73.0,-89.0,-90.0,-86.0,-88.0,15.0,19.0,17.0,13.0,1
4289,CC:2F:71:3E:C5:1F,3845800,485026030,966,118012,3844834,484908018,2,4199,350430,3494,266710,705,83720,1024,12,1390,26,2,53,130000.0,39000.0,-71.0,-71.0,-69.0,-61.0,-70.0,-70.0,-67.0,-60.0,-89.0,-90.0,-86.0,-88.0,18.0,19.0,17.0,27.0,1
4290,BA:8C:B9:54:50:24,3849749,491100280,4915,6192262,3844834,484908018,7,9652,1744850,9630,1741355,22,3495,2358,17,5404,41,7,70,229410.0,130000.0,-48.0,-35.0,-43.0,-45.0,-41.0,-35.0,-45.0,-50.0,-89.0,-90.0,-86.0,-88.0,41.0,55.0,43.0,43.0,1
4291,62:47:05:9D:EB:15,3851504,497070017,6670,12161999,3844834,484908018,1,6779,3779630,6729,3771972,50,7658,3252,0,6730,56,1,125,229410.0,130000.0,-43.0,-44.0,-36.0,-46.0,-46.0,-47.0,-38.0,-46.0,-89.0,-90.0,-86.0,-88.0,46.0,46.0,50.0,42.0,1
4292,92:69:1D:31:68:E9,3848861,488558631,4027,3650613,3844834,484908018,1,5317,1150959,5151,1113281,166,37678,2193,12,4272,102,1,60,216660.0,130000.0,-51.0,-51.0,-46.0,-49.0,-51.0,-49.0,-44.0,-49.0,-89.0,-90.0,-86.0,-88.0,38.0,39.0,40.0,39.0,1
4293,CC:2F:71:3F:1F:24,4959507,1751433114,1114671,1266524894,3844836,484908220,1730,930282,1042914614,929465,1042815842,817,98772,898620,15,1113296,118315,1727,732,144444.0,43333.0,-75.0,-70.0,-69.0,-75.0,-74.0,-70.0,-68.0,-74.0,-89.0,-90.0,-86.0,-88.0,14.0,20.0,17.0,13.0,1
4294,CC:2F:71:3E:C5:1F,3845802,485026232,966,118012,3844836,484908220,2,4199,350430,3494,266710,705,83720,1024,12,1390,26,2,53,130000.0,39000.0,-71.0,-71.0,-69.0,-61.0,-70.0,-70.0,-67.0,-60.0,-89.0,-90.0,-86.0,-88.0,18.0,19.0,17.0,27.0,1
4295,BA:8C:B9:54:50:24,3849751,491100482,4915,6192262,3844836,484908220,7,9652,1744850,9630,1741355,22,3495,2358,17,5404,41,7,70,229410.0,130000.0,-48.0,-35.0,-43.0,-45.0,-41.0,-35.0,-45.0,-50.0,-89.0,-90.0,-86.0,-88.0,41.0,55.0,43.0,43.0,1
4296,62:47:05:9D:EB:15,3851513,497070885,6670,12161999,3844843,484908886,1,6779,3779630,6729,3771972,50,7658,3252,0,6730,56,1,125,229410.0,130000.0,-43.0,-44.0,-36.0,-46.0,-46.0,-47.0,-38.0,-46.0,-89.0,-90.0,-86.0,-88.0,46.0,46.0,50.0,42.0,1
4297,92:69:1D:31:68:E9,3848870,488559499,4027,3650613,3844843,484908886,1,5317,1150959,5151,1113281,166,37678,2193,12,4272,102,1,60,216660.0,130000.0,-51.0,-51.0,-46.0,-49.0,-51.0,-49.0,-44.0,-49.0,-89.0,-90.0,-86.0,-88.0,38.0,39.0,40.0,39.0,1
4298,CC:2F:71:3F:1F:24,4959708,1751678424,1114865,1266769538,3844843,484908886,1730,930470,1043166496,929653,1043067724,817,98772,898791,15,1113490,118316,1727,732,144444.0,43333.0,-72.0,-67.0,-66.0,-72.0,-75.0,-69.0,-68.0,-74.0,-89.0,-90.0,-86.0,-88.0,17.0,23.0,20.0,16.0,1
4299,CC:2F:71:3E:C5:1F,3845809,485026898,966,118012,3844843,484908886,2,4199,350430,3494,266710,705,83720,1024,12,1390,26,2,53,130000.0,39000.0,-71.0,-71.0,-69.0,-61.0,-70.0,-70.0,-67.0,-60.0,-89.0,-90.0,-86.0,-88.0,18.0,19.0,17.0,27.0,1
4300,BA:8C:B9:54:50:24,3849759,491101208,4915,6192262,3844844,484908946,7,9652,1744850,9630,1741355,22,3495,2358,17,5404,41,7,70,229410.0,130000.0,-48.0,-35.0,-43.0,-45.0,-41.0,-35.0,-45.0,-50.0,-89.0,-90.0,-86.0,-88.0,41.0,55.0,43.0,43.0,1
4301,62:47:05:9D:EB:15,3851516,497071147,6670,12161999,3844846,484909148,1,6780,3779698,6730,3772040,50,7658,3252,0,6730,56,1,125,229410.0,130000.0,-43.0,-44.0,-36.0,-46.0,-45.0,-46.0,-38.0,-46.0,-89.0,-90.0,-86.0,-88.0,46.0,46.0,50.0,42.0,1
4302,92:69:1D:31:68:E9,3848874,488559877,4028,3650729,3844846,484909148,1,5319,1151095,5153,1113417,166,37678,2193,12,4273,102,1,60,216660.0,130000.0,-53.0,-51.0,-44.0,-49.0,-51.0,-50.0,-45.0,-49.0,-89.0,-90.0,-86.0,-88.0,36.0,39.0,42.0,39.0,1
4303,CC:2F:71:3F:1F:24,4959914,1751927033,1115068,1267017885,3844846,484909148,1730,930652,1043400679,929835,1043301907,817,98772,898970,15,1113693,118324,1727,733,144444.0,43333.0,-76.0,-71.0,-69.0,-76.0,-75.0,-70.0,-68.0,-75.0,-89.0,-90.0,-86.0,-88.0,13.0,19.0,17.0,12.0,1
4304,CC:2F:71:3E:C5:1F,3845813,485027276,967,118128,3844846,484909148,2,4201,350570,3496,266850,705,83720,1024,12,1391,26,2,53,130000.0,39000.0,-73.0,-72.0,-69.0,-61.0,-71.0,-71.0,-68.0,-60.0,-89.0,-90.0,-86.0,-88.0,16.0,18.0,17.0,27.0,1
4305,BA:8C:B9:54:50:24,3849764,491101728,4916,6192378,3844848,484909350,7,9654,1744986,9632,1741491,22,3495,2358,17,5405,41,7,70,229410.0,137640.0,-48.0,-36.0,-43.0,-45.0,-41.0,-35.0,-45.0,-50.0,-89.0,-90.0,-86.0,-88.0,41.0,54.0,43.0,43.0,1
4306,62:47:05:9D:EB:15,3851524,497071929,6671,12162115,3844853,484909814,1,6781,3779766,6731,3772108,50,7658,3252,0,6731,56,1,125,229410.0,130000.0,-45.0,-48.0,-44.0,-44.0,-45.0,-46.0,-38.0,-46.0,-89.0,-91.0,-87.0,-88.0,44.0,43.0,43.0,44.0,1
4307,92:69:1D:31:68:E9,3848881,488560543,4028,3650729,3844853,484909814,1,5319,1151095,5153,1113417,166,37678,2193,12,4273,102,1,60,216660.0,130000.0,-53.0,-51.0,-44.0,-49.0,-51.0,-50.0,-45.0,-49.0,-89.0,-91.0,-87.0,-88.0,36.0,40.0,43.0,39.0,1
4308,CC:2F:71:3F:1F:24,4960116,1752173797,1115262,1267263923,3844854,484909874,1730,930823,1043630025,930006,1043531253,817,98772,899141,15,1113886,118328,1727,733,144444.0,43333.0,-76.0,-70.0,-70.0,-76.0,-76.0,-70.0,-69.0,-76.0,-89.0,-91.0,-87.0,-88.0,13.0,21.0,17.0,12.0,1
4309,CC:2F:71:3E:C5:1F,3845821,485028002,967,118128,3844854,484909874,2,4201,350570,3496,266850,705,83720,1024,12,1391,26,2,53,130000.0,39000.0,-73.0,-72.0,-69.0,-61.0,-71.0,-71.0,-68.0,-60.0,-89.0,-91.0,-87.0,-88.0,16.0,19.0,18.0,27.0,1
4310,BA:8C:B9:54:50:24,3849770,491102252,4916,6192378,3844854,484909874,7,9654,1744986,9632,1741491,22,3495,2358,17,5405,41,7,70,229410.0,137640.0,-48.0,-36.0,-43.0,-45.0,-41.0,-35.0,-45.0,-50.0,-89.0,-91.0,-87.0,-88.0,41.0,55.0,44.0,43.0,1
4311,62:47:05:9D:EB:15,3851528,497072251,6671,12162115,3844857,484910136,1,6781,3779766,6731,3772108,50,7658,3252,0,6731,56,1,125,229410.0,130000.0,-45.0,-48.0,-44.0,-44.0,-45.0,-46.0,-38.0,-46.0,-89.0,-91.0,-87.0,-88.0,44.0,43.0,43.0,44.0,1
4312,92:69:1D:31:68:E9,3848886,488561138,4028,3650729,3844858,484910409,1,5319,1151095,5153,1113417,166,37678,2193,12,4273,102,1,60,216660.0,130000.0,-53.0,-51.0,-44.0,-49.0,-51.0,-50.0,-45.0,-49.0,-89.0,-91.0,-87.0,-88.0,36.0,40.0,43.0,39.0,1
4313,CC:2F:71:3F:1F:24,4960329,1752445006,1115471,1267534597,3844858,484910409,1730,931015,1043891931,930198,1043793159,817,98772,899330,15,1114096,118340,1727,733,144444.0,43333.0,-72.0,-67.0,-68.0,-71.0,-75.0,-69.0,-69.0,-74.0,-89.0,-91.0,-87.0,-88.0,17.0,24.0,19.0,17.0,1
4314,CC:2F:71:3E:C5:1F,3845827,485028739,967,118128,3844860,484910611,2,4201,350570,3496,266850,705,83720,1024,12,1391,26,2,53,130000.0,39000.0,-73.0,-72.0,-69.0,-61.0,-71.0,-71.0,-68.0,-60.0,-89.0,-91.0,-87.0,-88.0,16.0,19.0,18.0,27.0,1
4315,BA:8C:B9:54:50:24,3849778,491103191,4916,6192378,3844862,484910813,7,9655,1745054,9633,1741559,22,3495,2358,17,5405,41,7,70,229410.0,137640.0,-40.0,-37.0,-45.0,-52.0,-41.0,-36.0,-45.0,-50.0,-89.0,-91.0,-87.0,-88.0,49.0,54.0,42.0,36.0,1
4316,62:47:05:9D:EB:15,3851538,497073728,6674,12162713,3844864,484911015,1,6787,3780469,6737,3772811,50,7658,3254,0,6734,56,1,125,229410.0,130000.0,-44.0,-45.0,-36.0,-47.0,-44.0,-46.0,-37.0,-46.0,-89.0,-91.0,-87.0,-88.0,45.0,46.0,51.0,41.0,1
4317,92:69:1D:31:68:E9,3848892,488561744,4028,3650729,3844864,484911015,1,5319,1151095,5153,1113417,166,37678,2193,12,4273,102,1,60,216660.0,130000.0,-53.0,-51.0,-44.0,-49.0,-51.0,-50.0,-45.0,-49.0,-89.0,-91.0,-87.0,-88.0,36.0,40.0,43.0,39.0,1
4318,CC:2F:71:3F:1F:24,4960526,1752688426,1115662,1267777411,3844864,484911015,1730,931194,1044132323,930377,1044033551,817,98772,899501,15,1114287,118351,1727,733,144444.0,43333.0,-75.0,-72.0,-70.0,-74.0,-74.0,-70.0,-69.0,-73.0,-89.0,-91.0,-87.0,-88.0,14.0,19.0,17.0,14.0,1
4319,CC:2F:71:3E:C5:1F,3845831,485029143,967,118128,3844864,484911015,2,4201,350570,3496,266850,705,83720,1024,12,1391,26,2,53,130000.0,39000.0,-73.0,-72.0,-69.0,-61.0,-71.0,-71.0,-68.0,-60.0,-89.0,-91.0,-87.0,-89.0,16.0,19.0,18.0,28.0,1
4320,BA:8C:B9:54:50:24,3849780,491103393,4916,6192378,3844864,484911015,7,9655,1745054,9633,1741559,22,3495,2358,17,5405,41,7,70,229410.0,137640.0,-40.0,-37.0,-45.0,-52.0,-41.0,-36.0,-45.0,-50.0,-89.0,-91.0,-87.0,-89.0,49.0,54.0,42.0,37.0,1
4321,62:47:05:9D:EB:15,3851541,497073990,6674,12162713,3844867,484911277,1,6787,3780469,6737,3772811,50,7658,3254,0,6734,56,1,125,229410.0,130000.0,-44.0,-45.0,-36.0,-47.0,-44.0,-46.0,-37.0,-46.0,-89.0,-91.0,-87.0,-89.0,45.0,46.0,51.0,42.0,1
4322,92:69:1D:31:68:E9,3848895,488562006,4028,3650729,3844867,484911277,1,5319,1151095,5153,1113417,166,37678,2193,12,4273,102,1,60,216660.0,130000.0,-53.0,-51.0,-44.0,-49.0,-51.0,-50.0,-45.0,-49.0,-89.0,-91.0,-87.0,-89.0,36.0,40.0,43.0,40.0,1
4323,CC:2F:71:3F:1F:24,4960733,1752938429,1115862,1268026748,3844871,484911681,1730,931390,1044385278,930573,1044286506,817,98772,899681,15,1114487,118406,1727,733,130000.0,43333.0,-75.0,-72.0,-70.0,-75.0,-74.0,-71.0,-69.0,-75.0,-89.0,-91.0,-87.0,-89.0,14.0,19.0,17.0,14.0,1
4324,CC:2F:71:3E:C5:1F,3845838,485029809,967,118128,3844871,484911681,2,4201,350570,3496,266850,705,83720,1024,12,1391,26,2,53,130000.0,39000.0,-73.0,-72.0,-69.0,-61.0,-71.0,-71.0,-68.0,-60.0,-89.0,-91.0,-87.0,-89.0,16.0,19.0,18.0,28.0,1
4325,BA:8C:B9:54:50:24,3849787,491104059,4916,6192378,3844871,484911681,7,9655,1745054,9633,1741559,22,3495,2358,17,5405,41,7,70,229410.0,137640.0,-40.0,-37.0,-45.0,-52.0,-41.0,-36.0,-45.0,-50.0,-89.0,-91.0,-87.0,-89.0,49.0,54.0,42.0,37.0,1
4326,62:47:05:9D:EB:15,3851548,497074765,6675,12162882,3844873,484911883,1,6791,3780884,6741,3773226,50,7658,3256,0,6735,56,1,125,229410.0,130000.0,-43.0,-45.0,-36.0,-48.0,-44.0,-47.0,-39.0,-47.0,-89.0,-91.0,-87.0,-89.0,46.0,46.0,51.0,41.0,1
4327,92:69:1D:31:68:E9,3848901,488562612,4028,3650729,3844873,484911883,1,5319,1151095,5153,1113417,166,37678,2193,12,4273,102,1,60,216660.0,130000.0,-53.0,-51.0,-44.0,-49.0,-51.0,-50.0,-45.0,-49.0,-89.0,-91.0,-87.0,-89.0,36.0,40.0,43.0,40.0,1
4328,CC:2F:71:3F:1F:24,4960928,1753183129,1116055,1268271246,3844873,484911883,1730,931570,1044627210,930753,1044528438,817,98772,899853,15,1114680,118406,1727,733,130000.0,43333.0,-75.0,-72.0,-71.0,-77.0,-75.0,-72.0,-70.0,-76.0,-89.0,-91.0,-87.0,-89.0,14.0,19.0,16.0,12.0,1
4329,CC:2F:71:3E:C5:1F,3845840,485030011,967,118128,3844873,484911883,2,4201,350570,3496,266850,705,83720,1024,12,1391,26,2,53,130000.0,39000.0,-73.0,-72.0,-69.0,-61.0,-71.0,-71.0,-68.0,-60.0,-89.0,-91.0,-87.0,-89.0,16.0,19.0,18.0,28.0,1
4330,BA:8C:B9:54:50:24,3849789,491104261,4916,6192378,3844873,484911883,7,9655,1745054,9633,1741559,22,3495,2358,17,5405,41,7,70,229410.0,137640.0,-40.0,-37.0,-45.0,-52.0,-41.0,-36.0,-45.0,-50.0,-89.0,-91.0,-87.0,-89.0,49.0,54.0,42.0,37.0,1
4331,62:47:05:9D:EB:15,3851553,497075229,6675,12162882,3844878,484912347,1,6795,3781272,6745,3773614,50,7658,3257,0,6735,56,1,125,229410.0,130000.0,-46.0,-49.0,-44.0,-45.0,-44.0,-47.0,-39.0,-47.0,-89.0,-91.0,-87.0,-89.0,43.0,42.0,43.0,44.0,1
4332,92:69:1D:31:68:E9,3848906,488563076,4028,3650729,3844878,484912347,1,5319,1151095,5153,1113417,166,37678,2193,12,4273,102,1,60,216660.0,130000.0,-53.0,-51.0,-44.0,-49.0,-51.0,-50.0,-45.0,-49.0,-89.0,-91.0,-87.0,-89.0,36.0,40.0,43.0,40.0,1
4333,CC:2F:71:3F:1F:24,4961128,1753428125,1116248,1268515576,3844880,484912549,1730,931748,1044866194,930931,1044767422,817,98772,900024,15,1114872,118406,1727,733,144444.0,43333.0,-75.0,-72.0,-70.0,-76.0,-75.0,-72.0,-70.0,-76.0,-89.0,-91.0,-87.0,-89.0,14.0,19.0,17.0,13.0,1
4334,CC:2F:71:3E:C5:1F,3845847,485030677,967,118128,3844880,484912549,2,4201,350570,3496,266850,705,83720,1024,12,1391,26,2,53,130000.0,39000.0,-73.0,-72.0,-69.0,-61.0,-71.0,-71.0,-68.0,-60.0,-89.0,-91.0,-87.0,-89.0,16.0,19.0,18.0,28.0,1
4335,BA:8C:B9:54:50:24,3849796,491104927,4916,6192378,3844880,484912549,7,9655,1745054,9633,1741559,22,3495,2358,17,5405,41,7,70,229410.0,137640.0,-40.0,-37.0,-45.0,-52.0,-41.0,-36.0,-45.0,-50.0,-89.0,-91.0,-87.0,-89.0,49.0,54.0,42.0,37.0,1
4336,62:47:05:9D:EB:15,3851560,497075955,6677,12163142,3844883,484912813,1,6799,3781989,6749,3774331,50,7658,3259,0,6737,56,1,125,229410.0,137640.0,-43.0,-45.0,-36.0,-48.0,-44.0,-46.0,-38.0,-47.0,-90.0,-91.0,-88.0,-89.0,47.0,46.0,52.0,41.0,1
4337,92:69:1D:31:68:E9,3848911,488563542,4028,3650729,3844883,484912813,1,5319,1151095,5153,1113417,166,37678,2193,12,4273,102,1,60,216660.0,130000.0,-53.0,-51.0,-44.0,-49.0,-51.0,-50.0,-45.0,-49.0,-90.0,-91.0,-88.0,-89.0,37.0,40.0,44.0,40.0,1
4338,CC:2F:71:3F:1F:24,4961323,1753672757,1116440,1268759944,3844883,484912813,1730,931924,1045104758,931107,1045005986,817,98772,900194,15,1115065,118407,1727,733,144444.0,43333.0,-76.0,-72.0,-70.0,-76.0,-75.0,-72.0,-70.0,-76.0,-90.0,-91.0,-88.0,-89.0,14.0,19.0,18.0,13.0,1
4339,CC:2F:71:3E:C5:1F,3845850,485030941,967,118128,3844883,484912813,2,4203,350758,3497,266920,706,83838,1025,12,1391,26,2,53,130000.0,39000.0,-72.0,-71.0,-69.0,-61.0,-71.0,-71.0,-68.0,-60.0,-90.0,-91.0,-88.0,-89.0,18.0,20.0,19.0,28.0,1
4340,BA:8C:B9:54:50:24,3849799,491105191,4916,6192378,3844883,484912813,7,9655,1745054,9633,1741559,22,3495,2358,17,5405,41,7,70,229410.0,137640.0,-40.0,-37.0,-45.0,-52.0,-41.0,-36.0,-45.0,-50.0,-90.0,-91.0,-88.0,-89.0,50.0,54.0,43.0,37.0,1
4341,62:47:05:9D:EB:15,3851566,497076561,6677,12163142,3844889,484913419,1,6799,3781989,6749,3774331,50,7658,3259,0,6737,56,1,125,229410.0,137640.0,-43.0,-45.0,-36.0,-48.0,-44.0,-46.0,-38.0,-47.0,-90.0,-91.0,-88.0,-89.0,47.0,46.0,52.0,41.0,1
4342,92:69:1D:31:68:E9,3848917,488564148,4028,3650729,3844889,484913419,1,5319,1151095,5153,1113417,166,37678,2193,12,4273,102,1,60,216660.0,130000.0,-53.0,-51.0,-44.0,-49.0,-51.0,-50.0,-45.0,-49.0,-90.0,-91.0,-88.0,-89.0,37.0,40.0,44.0,40.0,1
4343,CC:2F:71:3F:1F:24,4961527,1753919580,1116637,1269006099,3844890,484913481,1730,932115,1045348617,931297,1045249727,818,98890,900374,15,1115262,118409,1727,733,144444.0,43333.0,-76.0,-72.0,-70.0,-76.0,-76.0,-72.0,-70.0,-76.0,-90.0,-91.0,-88.0,-90.0,14.0,19.0,18.0,14.0,1
4344,CC:2F:71:3E:C5:1F,3845857,485031609,967,118128,3844890,484913481,2,4203,350758,3497,266920,706,83838,1025,12,1391,26,2,53,130000.0,39000.0,-72.0,-71.0,-69.0,-61.0,-71.0,-71.0,-68.0,-60.0,-90.0,-91.0,-88.0,-90.0,18.0,20.0,19.0,29.0,1
4345,BA:8C:B9:54:50:24,3849806,491105859,4916,6192378,3844890,484913481,7,9655,1745054,9633,1741559,22,3495,2358,17,5405,41,7,70,229410.0,137640.0,-40.0,-37.0,-45.0,-52.0,-41.0,-36.0,-45.0,-50.0,-90.0,-91.0,-88.0,-90.0,50.0,54.0,43.0,38.0,1
4346,62:47:05:9D:EB:15,3851570,497076885,6677,12163142,3844893,484913743,1,6799,3781989,6749,3774331,50,7658,3259,0,6737,56,1,125,229410.0,137640.0,-43.0,-45.0,-36.0,-48.0,-44.0,-46.0,-38.0,-47.0,-90.0,-91.0,-88.0,-90.0,47.0,46.0,52.0,42.0,1
4347,92:69:1D:31:68:E9,3848921,488564472,4028,3650729,3844893,484913743,1,5319,1151095,5153,1113417,166,37678,2193,12,4273,102,1,60,216660.0,130000.0,-53.0,-51.0,-44.0,-49.0,-51.0,-50.0,-45.0,-49.0,-90.0,-91.0,-88.0,-90.0,37.0,40.0,44.0,41.0,1
4348,CC:2F:71:3F:1F:24,4961722,1754162786,1116829,1269249043,3844893,484913743,1730,932290,1045581479,931472,1045482589,818,98890,900544,15,1115454,118416,1727,733,144444.0,43333.0,-76.0,-72.0,-70.0,-76.0,-75.0,-72.0,-70.0,-76.0,-90.0,-91.0,-88.0,-90.0,14.0,19.0,18.0,14.0,1
4349,CC:2F:71:3E:C5:1F,3845862,485032073,967,118128,3844895,484913945,2,4203,350758,3497,266920,706,83838,1025,12,1391,26,2,53,130000.0,39000.0,-72.0,-71.0,-69.0,-61.0,-71.0,-71.0,-68.0,-60.0,-90.0,-91.0,-88.0,-90.0,18.0,20.0,19.0,29.0,1
4350,BA:8C:B9:54:50:24,3849811,491106323,4916,6192378,3844895,484913945,7,9655,1745054,9633,1741559,22,3495,2358,17,5405,41,7,70,229410.0,137640.0,-40.0,-37.0,-45.0,-52.0,-41.0,-36.0,-45.0,-50.0,-90.0,-91.0,-88.0,-90.0,50.0,54.0,43.0,38.0,1
4351,62:47:05:9D:EB:15,3851576,497077491,6677,12163142,3844899,484914349,1,6799,3781989,6749,3774331,50,7658,3259,0,6737,56,1,125,229410.0,137640.0,-43.0,-45.0,-36.0,-48.0,-44.0,-46.0,-38.0,-47.0,-90.0,-91.0,-88.0,-90.0,47.0,46.0,52.0,42.0,1
4352,92:69:1D:31:68:E9,3848927,488565078,4028,3650729,3844899,484914349,1,5319,1151095,5153,1113417,166,37678,2193,12,4273,102,1,60,216660.0,130000.0,-53.0,-51.0,-44.0,-49.0,-51.0,-50.0,-45.0,-49.0,-90.0,-91.0,-88.0,-90.0,37.0,40.0,44.0,41.0,1
4353,CC:2F:71:3F:1F:24,4961928,1754416048,1117029,1269501699,3844899,484914349,1730,932475,1045831123,931657,1045732233,818,98890,900721,15,1115654,118419,1727,733,144444.0,43333.0,-75.0,-72.0,-69.0,-76.0,-74.0,-71.0,-69.0,-75.0,-90.0,-91.0,-88.0,-90.0,15.0,19.0,19.0,14.0,1
4354,CC:2F:71:3E:C5:1F,3845866,485032477,967,118128,3844899,484914349,2,4203,350758,3497,266920,706,83838,1025,12,1391,26,2,53,130000.0,39000.0,-72.0,-71.0,-69.0,-61.0,-71.0,-71.0,-68.0,-60.0,-90.0,-91.0,-88.0,-90.0,18.0,20.0,19.0,29.0,1
4355,BA:8C:B9:54:50:24,3849815,491106727,4916,6192378,3844899,484914349,7,9655,1745054,9633,1741559,22,3495,2358,17,5405,41,7,70,229410.0,137640.0,-40.0,-37.0,-45.0,-52.0,-41.0,-36.0,-45.0,-50.0,-90.0,-91.0,-88.0,-90.0,50.0,54.0,43.0,38.0,1
4356,62:47:05:9D:EB:15,3851579,497077753,6677,12163142,3844902,484914611,1,6799,3781989,6749,3774331,50,7658,3259,0,6737,56,1,125,229410.0,137640.0,-43.0,-45.0,-36.0,-48.0,-44.0,-46.0,-38.0,-47.0,-90.0,-92.0,-88.0,-90.0,47.0,47.0,52.0,42.0,1
4357,92:69:1D:31:68:E9,3848932,488565542,4028,3650729,3844904,484914813,1,5321,1151231,5155,1113553,166,37678,2193,12,4274,102,1,60,216660.0,130000.0,-51.0,-48.0,-44.0,-46.0,-51.0,-50.0,-45.0,-48.0,-90.0,-92.0,-88.0,-90.0,39.0,44.0,44.0,44.0,1
4358,CC:2F:71:3F:1F:24,4962125,1754659456,1117221,1269744643,3844904,484914813,1730,932655,1046074573,931837,1045975683,818,98890,900890,15,1115846,118422,1727,733,144444.0,43333.0,-72.0,-69.0,-67.0,-73.0,-74.0,-71.0,-69.0,-75.0,-90.0,-92.0,-88.0,-90.0,18.0,23.0,21.0,17.0,1
4359,CC:2F:71:3E:C5:1F,3845871,485032941,967,118128,3844904,484914813,2,4203,350758,3497,266920,706,83838,1025,12,1391,26,2,53,130000.0,39000.0,-72.0,-71.0,-69.0,-61.0,-71.0,-71.0,-68.0,-60.0,-90.0,-92.0,-88.0,-90.0,18.0,21.0,19.0,29.0,1
4360,BA:8C:B9:54:50:24,3849820,491107191,4916,6192378,3844904,484914813,7,9657,1745190,9635,1741695,22,3495,2358,17,5406,41,7,70,229410.0,137640.0,-48.0,-35.0,-43.0,-46.0,-42.0,-36.0,-44.0,-49.0,-90.0,-92.0,-88.0,-90.0,42.0,57.0,45.0,44.0,1
4361,62:47:05:9D:EB:15,3851585,497078359,6677,12163142,3844908,484915217,1,6799,3781989,6749,3774331,50,7658,3259,0,6737,56,1,125,229410.0,137640.0,-43.0,-45.0,-36.0,-48.0,-44.0,-46.0,-38.0,-47.0,-90.0,-92.0,-88.0,-90.0,47.0,47.0,52.0,42.0,1
4362,92:69:1D:31:68:E9,3848936,488565946,4028,3650729,3844908,484915217,1,5321,1151231,5155,1113553,166,37678,2193,12,4274,102,1,60,216660.0,130000.0,-51.0,-48.0,-44.0,-46.0,-51.0,-50.0,-45.0,-48.0,-90.0,-92.0,-88.0,-90.0,39.0,44.0,44.0,44.0,1
4363,CC:2F:71:3F:1F:24,4962334,1754908541,1117426,1269993324,3844908,484915217,1730,932842,1046312088,932024,1046213198,818,98890,901072,15,1116051,118424,1727,733,144444.0,43333.0,-73.0,-69.0,-67.0,-73.0,-75.0,-71.0,-69.0,-75.0,-90.0,-92.0,-88.0,-90.0,17.0,23.0,21.0,17.0,1
4364,CC:2F:71:3E:C5:1F,3845875,485033345,967,118128,3844908,484915217,2,4203,350758,3497,266920,706,83838,1025,12,1391,26,2,53,130000.0,39000.0,-72.0,-71.0,-69.0,-61.0,-71.0,-71.0,-68.0,-60.0,-90.0,-92.0,-88.0,-90.0,18.0,21.0,19.0,29.0,1
4365,BA:8C:B9:54:50:24,3849826,491108719,4916,6192378,3844910,484916341,7,9657,1745190,9635,1741695,22,3495,2358,17,5406,41,7,70,229410.0,137640.0,-48.0,-35.0,-43.0,-46.0,-42.0,-36.0,-44.0,-49.0,-90.0,-92.0,-88.0,-90.0,42.0,57.0,45.0,44.0,1
4366,62:47:05:9D:EB:15,3851591,497079887,6677,12163142,3844914,484916745,1,6799,3781989,6749,3774331,50,7658,3259,0,6737,56,1,125,229410.0,137640.0,-43.0,-45.0,-36.0,-48.0,-44.0,-46.0,-38.0,-47.0,-90.0,-92.0,-88.0,-90.0,47.0,47.0,52.0,42.0,1
4367,92:69:1D:31:68:E9,3848942,488567474,4028,3650729,3844914,484916745,1,5321,1151231,5155,1113553,166,37678,2193,12,4274,102,1,60,216660.0,130000.0,-51.0,-48.0,-44.0,-46.0,-51.0,-50.0,-45.0,-48.0,-90.0,-92.0,-88.0,-90.0,39.0,44.0,44.0,44.0,1
4368,CC:2F:71:3F:1F:24,4962534,1755154697,1117620,1270237952,3844914,484916745,1730,933022,1046551102,932204,1046452212,818,98890,901247,15,1116245,118424,1727,733,144444.0,43333.0,-75.0,-72.0,-71.0,-76.0,-74.0,-71.0,-69.0,-74.0,-90.0,-92.0,-88.0,-91.0,15.0,20.0,17.0,15.0,1
4369,CC:2F:71:3E:C5:1F,3845881,485034873,967,118128,3844914,484916745,2,4203,350758,3497,266920,706,83838,1025,12,1391,26,2,53,130000.0,39000.0,-72.0,-71.0,-69.0,-61.0,-71.0,-71.0,-68.0,-60.0,-90.0,-92.0,-88.0,-91.0,18.0,21.0,19.0,30.0,1
4370,BA:8C:B9:54:50:24,3849830,491109123,4916,6192378,3844914,484916745,7,9657,1745190,9635,1741695,22,3495,2358,17,5406,41,7,70,229410.0,137640.0,-48.0,-35.0,-43.0,-46.0,-42.0,-36.0,-44.0,-49.0,-90.0,-92.0,-88.0,-91.0,42.0,57.0,45.0,45.0,1
4371,62:47:05:9D:EB:15,3851596,497080351,6677,12163142,3844919,484917209,1,6799,3781989,6749,3774331,50,7658,3259,0,6737,56,1,125,229410.0,137640.0,-43.0,-45.0,-36.0,-48.0,-44.0,-46.0,-38.0,-47.0,-90.0,-92.0,-88.0,-91.0,47.0,47.0,52.0,43.0,1
4372,92:69:1D:31:68:E9,3848947,488567938,4028,3650729,3844919,484917209,1,5321,1151231,5155,1113553,166,37678,2193,12,4274,102,1,60,216660.0,130000.0,-51.0,-48.0,-44.0,-46.0,-51.0,-50.0,-45.0,-48.0,-90.0,-92.0,-88.0,-91.0,39.0,44.0,44.0,45.0,1
4373,CC:2F:71:3F:1F:24,4962741,1755410237,1117820,1270491904,3844921,484918333,1730,933213,1046810092,932395,1046711202,818,98890,901423,15,1116444,118432,1727,733,144444.0,43333.0,-76.0,-72.0,-70.0,-75.0,-74.0,-70.0,-68.0,-74.0,-90.0,-92.0,-88.0,-91.0,14.0,20.0,18.0,16.0,1
4374,CC:2F:71:3E:C5:1F,3845888,485036461,967,118128,3844921,484918333,2,4203,350758,3497,266920,706,83838,1025,12,1391,26,2,53,130000.0,39000.0,-72.0,-71.0,-69.0,-61.0,-71.0,-71.0,-68.0,-60.0,-90.0,-92.0,-88.0,-91.0,18.0,21.0,19.0,30.0,1
4375,BA:8C:B9:54:50:24,3849839,491110913,4916,6192378,3844923,484918535,7,9657,1745190,9635,1741695,22,3495,2358,17,5406,41,7,70,229410.0,137640.0,-48.0,-35.0,-43.0,-46.0,-42.0,-36.0,-44.0,-49.0,-90.0,-92.0,-88.0,-91.0,42.0,57.0,45.0,45.0,1
4376,62:47:05:9D:EB:15,3851603,497082152,6677,12163142,3844926,484919010,1,6802,3782245,6752,3774587,50,7658,3260,0,6737,56,1,125,229410.0,137640.0,-45.0,-51.0,-44.0,-44.0,-45.0,-47.0,-39.0,-47.0,-90.0,-92.0,-89.0,-91.0,45.0,41.0,45.0,47.0,1
4377,92:69:1D:31:68:E9,3848954,488569739,4028,3650729,3844926,484919010,1,5321,1151231,5155,1113553,166,37678,2193,12,4274,102,1,60,216660.0,130000.0,-51.0,-48.0,-44.0,-46.0,-51.0,-50.0,-45.0,-48.0,-90.0,-92.0,-89.0,-91.0,39.0,44.0,45.0,45.0,1
4378,CC:2F:71:3F:1F:24,4962945,1755657329,1118019,1270738319,3844926,484919010,1730,933398,1047046092,932580,1046947202,818,98890,901600,15,1116644,118444,1727,733,144444.0,43333.0,-73.0,-69.0,-68.0,-72.0,-72.0,-69.0,-68.0,-72.0,-90.0,-92.0,-89.0,-91.0,17.0,23.0,21.0,19.0,1
4379,CC:2F:71:3E:C5:1F,3845893,485037138,967,118128,3844926,484919010,2,4203,350758,3497,266920,706,83838,1025,12,1391,26,2,53,130000.0,39000.0,-72.0,-71.0,-69.0,-61.0,-71.0,-71.0,-68.0,-60.0,-90.0,-92.0,-89.0,-91.0,18.0,21.0,20.0,30.0,1
4380,BA:8C:B9:54:50:24,3849842,491111388,4916,6192378,3844926,484919010,7,9657,1745190,9635,1741695,22,3495,2358,17,5406,41,7,70,229410.0,137640.0,-48.0,-35.0,-43.0,-46.0,-42.0,-36.0,-44.0,-49.0,-90.0,-92.0,-89.0,-91.0,42.0,57.0,46.0,45.0,1
4381,62:47:05:9D:EB:15,3851610,497083740,6677,12163142,3844933,484920598,1,6802,3782245,6752,3774587,50,7658,3260,0,6737,56,1,125,229410.0,137640.0,-45.0,-51.0,-44.0,-44.0,-45.0,-47.0,-39.0,-47.0,-90.0,-92.0,-89.0,-91.0,45.0,41.0,45.0,47.0,1
4382,92:69:1D:31:68:E9,3848961,488571327,4028,3650729,3844933,484920598,1,5321,1151231,5155,1113553,166,37678,2193,12,4274,102,1,60,216660.0,130000.0,-51.0,-48.0,-44.0,-46.0,-51.0,-50.0,-45.0,-48.0,-90.0,-92.0,-89.0,-91.0,39.0,44.0,45.0,45.0,1
4383,CC:2F:71:3F:1F:24,4963149,1755905429,1118214,1270984629,3844935,484920800,1730,933580,1047289792,932762,1047190902,818,98890,901774,15,1116839,118447,1727,733,144444.0,43333.0,-70.0,-67.0,-66.0,-72.0,-70.0,-67.0,-66.0,-72.0,-90.0,-92.0,-89.0,-91.0,20.0,25.0,23.0,19.0,1
4384,CC:2F:71:3E:C5:1F,3845902,485038928,967,118128,3844935,484920800,2,4203,350758,3497,266920,706,83838,1025,12,1391,26,2,53,130000.0,39000.0,-72.0,-71.0,-69.0,-61.0,-71.0,-71.0,-68.0,-60.0,-90.0,-92.0,-89.0,-91.0,18.0,21.0,20.0,30.0,1
4385,BA:8C:B9:54:50:24,3849851,491113178,4916,6192378,3844935,484920800,7,9657,1745190,9635,1741695,22,3495,2358,17,5406,41,7,70,229410.0,137640.0,-48.0,-35.0,-43.0,-46.0,-42.0,-36.0,-44.0,-49.0,-90.0,-92.0,-89.0,-91.0,42.0,57.0,46.0,45.0,1
4386,62:47:05:9D:EB:15,3851614,497084144,6677,12163142,3844937,484921002,1,6802,3782245,6752,3774587,50,7658,3260,0,6737,56,1,125,229410.0,137640.0,-45.0,-51.0,-44.0,-44.0,-45.0,-47.0,-39.0,-47.0,-90.0,-92.0,-89.0,-91.0,45.0,41.0,45.0,47.0,1
4387,92:69:1D:31:68:E9,3848965,488571731,4028,3650729,3844937,484921002,1,5321,1151231,5155,1113553,166,37678,2193,12,4274,102,1,60,216660.0,130000.0,-51.0,-48.0,-44.0,-46.0,-51.0,-50.0,-45.0,-48.0,-90.0,-92.0,-89.0,-91.0,39.0,44.0,45.0,45.0,1
4388,CC:2F:71:3F:1F:24,4963346,1756151757,1118409,1271230755,3844937,484921002,1730,933759,1047527660,932941,1047428770,818,98890,901945,15,1117034,118489,1727,733,130000.0,43333.0,-77.0,-75.0,-73.0,-77.0,-73.0,-71.0,-69.0,-73.0,-90.0,-92.0,-89.0,-91.0,13.0,17.0,16.0,14.0,1
4389,CC:2F:71:3E:C5:1F,3845904,485039130,967,118128,3844937,484921002,2,4203,350758,3497,266920,706,83838,1025,12,1391,26,2,53,130000.0,39000.0,-72.0,-71.0,-69.0,-61.0,-71.0,-71.0,-68.0,-60.0,-90.0,-92.0,-89.0,-91.0,18.0,21.0,20.0,30.0,1
4390,BA:8C:B9:54:50:24,3849853,491113380,4916,6192378,3844937,484921002,7,9657,1745190,9635,1741695,22,3495,2358,17,5406,41,7,70,229410.0,137640.0,-48.0,-35.0,-43.0,-46.0,-42.0,-36.0,-44.0,-49.0,-90.0,-92.0,-89.0,-91.0,42.0,57.0,46.0,45.0,1
4391,62:47:05:9D:EB:15,3851619,497084608,6677,12163142,3844942,484921466,1,6802,3782245,6752,3774587,50,7658,3260,0,6737,56,1,125,229410.0,137640.0,-45.0,-51.0,-44.0,-44.0,-45.0,-47.0,-39.0,-47.0,-90.0,-92.0,-89.0,-91.0,45.0,41.0,45.0,47.0,1
4392,92:69:1D:31:68:E9,3848972,488572397,4028,3650729,3844944,484921668,1,5321,1151231,5155,1113553,166,37678,2193,12,4274,102,1,60,216660.0,130000.0,-51.0,-48.0,-44.0,-46.0,-51.0,-50.0,-45.0,-48.0,-90.0,-92.0,-89.0,-92.0,39.0,44.0,45.0,46.0,1
4393,CC:2F:71:3F:1F:24,4963547,1756396939,1118603,1271475271,3844944,484921668,1730,933940,1047772638,933122,1047673748,818,98890,902117,15,1117228,118489,1727,733,144444.0,43333.0,-79.0,-74.0,-73.0,-78.0,-76.0,-72.0,-71.0,-76.0,-90.0,-92.0,-89.0,-92.0,11.0,18.0,16.0,14.0,1
4394,CC:2F:71:3E:C5:1F,3845911,485039796,967,118128,3844944,484921668,2,4203,350758,3497,266920,706,83838,1025,12,1391,26,2,53,130000.0,39000.0,-72.0,-71.0,-69.0,-61.0,-71.0,-71.0,-68.0,-60.0,-90.0,-92.0,-89.0,-92.0,18.0,21.0,20.0,31.0,1
4395,BA:8C:B9:54:50:24,3849861,491114106,4916,6192378,3844945,484921728,7,9657,1745190,9635,1741695,22,3495,2358,17,5406,41,7,70,229410.0,137640.0,-48.0,-35.0,-43.0,-46.0,-42.0,-36.0,-44.0,-49.0,-90.0,-92.0,-89.0,-92.0,42.0,57.0,46.0,46.0,1
4396,62:47:05:9D:EB:15,3851624,497085072,6677,12163142,3844947,484921930,1,6802,3782245,6752,3774587,50,7658,3260,0,6737,56,1,125,229410.0,137640.0,-45.0,-51.0,-44.0,-44.0,-45.0,-47.0,-39.0,-47.0,-90.0,-92.0,-89.0,-92.0,45.0,41.0,45.0,48.0,1
4397,92:69:1D:31:68:E9,3848975,488572659,4028,3650729,3844947,484921930,1,5321,1151231,5155,1113553,166,37678,2193,12,4274,102,1,60,216660.0,130000.0,-51.0,-48.0,-44.0,-46.0,-51.0,-50.0,-45.0,-48.0,-90.0,-92.0,-89.0,-92.0,39.0,44.0,45.0,46.0,1
4398,CC:2F:71:3F:1F:24,4963753,1756646858,1118805,1271724868,3844948,484921990,1730,934123,1048008360,933305,1047909470,818,98890,902296,15,1117430,118489,1727,733,144444.0,43333.0,-79.0,-74.0,-73.0,-78.0,-77.0,-73.0,-72.0,-77.0,-90.0,-92.0,-89.0,-92.0,11.0,18.0,16.0,14.0,1
4399,CC:2F:71:3E:C5:1F,3845915,485040118,967,118128,3844948,484921990,2,4203,350758,3497,266920,706,83838,1025,12,1391,26,2,53,130000.0,39000.0,-72.0,-71.0,-69.0,-61.0,-71.0,-71.0,-68.0,-60.0,-90.0,-92.0,-89.0,-92.0,18.0,21.0,20.0,31.0,1
4400,BA:8C:B9:54:50:24,3849864,491114368,4916,6192378,3844948,484921990,7,9657,1745190,9635,1741695,22,3495,2358,17,5406,41,7,70,229410.0,137640.0,-48.0,-35.0,-43.0,-46.0,-42.0,-36.0,-44.0,-49.0,-90.0,-93.0,-89.0,-92.0,42.0,58.0,46.0,46.0,1
4401,62:47:05:9D:EB:15,3851629,497085536,6677,12163142,3844952,484922394,1,6802,3782245,6752,3774587,50,7658,3260,0,6737,56,1,125,229410.0,137640.0,-45.0,-51.0,-44.0,-44.0,-45.0,-47.0,-39.0,-47.0,-90.0,-93.0,-89.0,-92.0,45.0,42.0,45.0,48.0,1
4402,92:69:1D:31:68:E9,3848982,488573325,4028,3650729,3844954,484922596,1,5321,1151231,5155,1113553,166,37678,2193,12,4274,102,1,60,216660.0,130000.0,-51.0,-48.0,-44.0,-46.0,-51.0,-50.0,-45.0,-48.0,-90.0,-93.0,-89.0,-92.0,39.0,45.0,45.0,46.0,1
4403,CC:2F:71:3F:1F:24,4963951,1756888984,1118997,1271966388,3844954,484922596,1730,934298,1048243988,933480,1048145098,818,98890,902465,15,1117622,118490,1727,733,144444.0,43333.0,-70.0,-68.0,-68.0,-73.0,-70.0,-68.0,-68.0,-72.0,-90.0,-93.0,-89.0,-92.0,20.0,25.0,21.0,19.0,1
4404,CC:2F:71:3E:C5:1F,3845921,485040724,967,118128,3844954,484922596,2,4203,350758,3497,266920,706,83838,1025,12,1391,26,2,53,130000.0,39000.0,-72.0,-71.0,-69.0,-61.0,-71.0,-71.0,-68.0,-60.0,-90.0,-93.0,-89.0,-92.0,18.0,22.0,20.0,31.0,1
4405,BA:8C:B9:54:50:24,3849870,491114974,4916,6192378,3844954,484922596,7,9657,1745190,9635,1741695,22,3495,2358,17,5406,41,7,70,229410.0,137640.0,-48.0,-35.0,-43.0,-46.0,-42.0,-36.0,-44.0,-49.0,-90.0,-93.0,-89.0,-92.0,42.0,58.0,46.0,46.0,1
4406,62:47:05:9D:EB:15,3851635,497086060,6677,12163142,3844958,484922918,1,6802,3782245,6752,3774587,50,7658,3260,0,6737,56,1,125,229410.0,137640.0,-45.0,-51.0,-44.0,-44.0,-45.0,-47.0,-39.0,-47.0,-90.0,-93.0,-89.0,-92.0,45.0,42.0,45.0,48.0,1
4407,92:69:1D:31:68:E9,3848986,488573647,4028,3650729,3844958,484922918,1,5322,1151299,5156,1113621,166,37678,2193,12,4274,102,1,60,216660.0,130000.0,-52.0,-49.0,-44.0,-47.0,-51.0,-50.0,-45.0,-48.0,-90.0,-93.0,-89.0,-92.0,38.0,44.0,45.0,45.0,1
4408,CC:2F:71:3F:1F:24,4964148,1757132396,1119190,1272209478,3844958,484922918,1730,934473,1048478262,933655,1048379372,818,98890,902636,15,1117815,118491,1727,733,144444.0,43333.0,-71.0,-68.0,-66.0,-72.0,-71.0,-68.0,-66.0,-71.0,-90.0,-93.0,-89.0,-92.0,19.0,25.0,23.0,20.0,1
4409,CC:2F:71:3E:C5:1F,3845925,485041046,967,118128,3844958,484922918,2,4203,350758,3497,266920,706,83838,1025,12,1391,26,2,53,130000.0,39000.0,-72.0,-71.0,-69.0,-61.0,-71.0,-71.0,-68.0,-60.0,-90.0,-93.0,-89.0,-92.0,18.0,22.0,20.0,31.0,1
4410,BA:8C:B9:54:50:24,3849874,491115296,4916,6192378,3844958,484922918,7,9657,1745190,9635,1741695,22,3495,2358,17,5406,41,7,70,229410.0,137640.0,-48.0,-35.0,-43.0,-46.0,-42.0,-36.0,-44.0,-49.0,-90.0,-93.0,-89.0,-92.0,42.0,58.0,46.0,46.0,1
4411,62:47:05:9D:EB:15,3851642,497086792,6677,12163142,3844965,484923650,1,6802,3782245,6752,3774587,50,7658,3260,0,6737,56,1,125,229410.0,137640.0,-45.0,-51.0,-44.0,-44.0,-45.0,-47.0,-39.0,-47.0,-90.0,-93.0,-90.0,-93.0,45.0,42.0,46.0,49.0,1
4412,92:69:1D:31:68:E9,3848993,488574379,4028,3650729,3844965,484923650,1,5322,1151299,5156,1113621,166,37678,2193,12,4274,102,1,60,216660.0,130000.0,-52.0,-49.0,-44.0,-47.0,-51.0,-50.0,-45.0,-48.0,-90.0,-93.0,-90.0,-93.0,38.0,44.0,46.0,46.0,1
4413,CC:2F:71:3F:1F:24,4964349,1757377716,1119384,1272454066,3844965,484923650,1730,934649,1048713950,933831,1048615060,818,98890,902808,15,1118009,118531,1727,733,130000.0,43333.0,-70.0,-68.0,-66.0,-70.0,-70.0,-68.0,-66.0,-70.0,-90.0,-93.0,-90.0,-93.0,20.0,25.0,24.0,23.0,1
4414,CC:2F:71:3E:C5:1F,3845934,485041980,967,118128,3844967,484923852,2,4203,350758,3497,266920,706,83838,1025,12,1391,26,2,53,130000.0,39000.0,-72.0,-71.0,-69.0,-61.0,-71.0,-71.0,-68.0,-60.0,-90.0,-93.0,-90.0,-93.0,18.0,22.0,21.0,32.0,1
4415,BA:8C:B9:54:50:24,3849883,491116230,4916,6192378,3844967,484923852,7,9657,1745190,9635,1741695,22,3495,2358,17,5406,41,7,70,229410.0,137640.0,-48.0,-35.0,-43.0,-46.0,-42.0,-36.0,-44.0,-49.0,-90.0,-93.0,-90.0,-93.0,42.0,58.0,47.0,47.0,1
4416,62:47:05:9D:EB:15,3851644,497086994,6677,12163142,3844967,484923852,1,6802,3782245,6752,3774587,50,7658,3260,0,6737,56,1,125,229410.0,137640.0,-45.0,-51.0,-44.0,-44.0,-45.0,-47.0,-39.0,-47.0,-90.0,-93.0,-90.0,-93.0,45.0,42.0,46.0,49.0,1
4417,92:69:1D:31:68:E9,3848995,488574581,4028,3650729,3844967,484923852,1,5322,1151299,5156,1113621,166,37678,2193,12,4274,102,1,60,216660.0,130000.0,-52.0,-49.0,-44.0,-47.0,-51.0,-50.0,-45.0,-48.0,-90.0,-93.0,-90.0,-93.0,38.0,44.0,46.0,46.0,1
4418,CC:2F:71:3F:1F:24,4964553,1757627715,1119586,1272703863,3844967,484923852,1730,934832,1048951095,934014,1048852205,818,98890,902988,15,1118211,118531,1727,733,130000.0,43333.0,-70.0,-68.0,-66.0,-71.0,-70.0,-68.0,-66.0,-71.0,-90.0,-93.0,-90.0,-93.0,20.0,25.0,24.0,22.0,1
4419,CC:2F:71:3E:C5:1F,3845935,485042040,967,118128,3844968,484923912,2,4203,350758,3497,266920,706,83838,1025,12,1391,26,2,53,130000.0,39000.0,-72.0,-71.0,-69.0,-61.0,-71.0,-71.0,-68.0,-60.0,-90.0,-93.0,-90.0,-93.0,18.0,22.0,21.0,32.0,1
4420,BA:8C:B9:54:50:24,3849886,491116492,4916,6192378,3844970,484924114,7,9657,1745190,9635,1741695,22,3495,2358,17,5406,41,7,70,229410.0,137640.0,-48.0,-35.0,-43.0,-46.0,-42.0,-36.0,-44.0,-49.0,-90.0,-93.0,-90.0,-93.0,42.0,58.0,47.0,47.0,1
4421,62:47:05:9D:EB:15,3851651,497087660,6677,12163142,3844974,484924518,1,6802,3782245,6752,3774587,50,7658,3260,0,6737,56,1,125,229410.0,137640.0,-45.0,-51.0,-44.0,-44.0,-45.0,-47.0,-39.0,-47.0,-90.0,-93.0,-90.0,-93.0,45.0,42.0,46.0,49.0,1
4422,92:69:1D:31:68:E9,3849004,488575449,4028,3650729,3844976,484924720,1,5322,1151299,5156,1113621,166,37678,2193,12,4274,102,1,60,216660.0,130000.0,-52.0,-49.0,-44.0,-47.0,-51.0,-50.0,-45.0,-48.0,-90.0,-93.0,-90.0,-93.0,38.0,44.0,46.0,46.0,1
4423,CC:2F:71:3F:1F:24,4964753,1757867127,1119777,1272942407,3844976,484924720,1730,935004,1049180623,934186,1049081733,818,98890,903156,15,1118402,118531,1727,733,130000.0,43333.0,-70.0,-68.0,-66.0,-71.0,-70.0,-68.0,-66.0,-70.0,-90.0,-93.0,-90.0,-93.0,20.0,25.0,24.0,22.0,1
4424,CC:2F:71:3E:C5:1F,3845944,485042964,968,118244,3844976,484924720,2,4204,350828,3498,266990,706,83838,1025,12,1392,26,2,53,130000.0,39000.0,-71.0,-72.0,-69.0,-60.0,-71.0,-71.0,-68.0,-60.0,-90.0,-93.0,-90.0,-93.0,19.0,21.0,21.0,33.0,1
4425,BA:8C:B9:54:50:24,3849893,491117158,4917,6192438,3844976,484924720,7,9662,1745530,9640,1742035,22,3495,2358,17,5407,41,7,70,216660.0,130000.0,-40.0,-37.0,-46.0,-52.0,-42.0,-35.0,-43.0,-48.0,-90.0,-93.0,-90.0,-93.0,50.0,56.0,44.0,41.0,1
4426,62:47:05:9D:EB:15,3851655,497087982,6678,12163202,3844977,484924780,1,6803,3782313,6753,3774655,50,7658,3260,0,6738,56,1,125,229410.0,137640.0,-42.0,-45.0,-36.0,-47.0,-44.0,-47.0,-38.0,-47.0,-90.0,-93.0,-90.0,-93.0,48.0,48.0,54.0,46.0,1
4427,92:69:1D:31:68:E9,3849008,488575909,4031,3651129,3844977,484924780,1,5330,1151979,5164,1114301,166,37678,2195,12,4277,102,1,60,216660.0,130000.0,-51.0,-48.0,-44.0,-47.0,-51.0,-48.0,-44.0,-48.0,-90.0,-93.0,-90.0,-93.0,39.0,45.0,46.0,46.0,1
4428,CC:2F:71:3F:1F:24,4964947,1758112661,1119970,1273187881,3844977,484924780,1730,935185,1049420089,934367,1049321199,818,98890,903327,15,1118594,118542,1727,734,130000.0,43333.0,-70.0,-68.0,-66.0,-70.0,-70.0,-68.0,-66.0,-70.0,-90.0,-93.0,-90.0,-93.0,20.0,25.0,24.0,23.0,1
4429,CC:2F:71:3E:C5:1F,3845947,485043226,968,118244,3844979,484924982,2,4205,350898,3499,267060,706,83838,1025,12,1392,26,2,53,130000.0,39000.0,-71.0,-71.0,-70.0,-60.0,-71.0,-71.0,-68.0,-60.0,-90.0,-93.0,-90.0,-93.0,19.0,22.0,20.0,33.0,1
4430,BA:8C:B9:54:50:24,3849896,491117420,4917,6192438,3844979,484924982,7,9662,1745530,9640,1742035,22,3495,2358,17,5407,41,7,70,216660.0,130000.0,-40.0,-37.0,-46.0,-52.0,-42.0,-35.0,-43.0,-48.0,-90.0,-93.0,-90.0,-93.0,50.0,56.0,44.0,41.0,1
4431,62:47:05:9D:EB:15,3851666,497088972,6678,12163202,3844988,484925770,1,6804,3782381,6754,3774723,50,7658,3260,0,6738,56,1,125,229410.0,137640.0,-43.0,-45.0,-36.0,-47.0,-44.0,-47.0,-38.0,-47.0,-90.0,-93.0,-90.0,-93.0,47.0,48.0,54.0,46.0,1
4432,92:69:1D:31:68:E9,3849019,488576899,4031,3651129,3844988,484925770,1,5330,1151979,5164,1114301,166,37678,2195,12,4277,102,1,60,216660.0,130000.0,-51.0,-48.0,-44.0,-47.0,-51.0,-48.0,-44.0,-48.0,-90.0,-93.0,-90.0,-93.0,39.0,45.0,46.0,46.0,1
4433,CC:2F:71:3F:1F:24,4965148,1758354911,1120160,1273429141,3844988,484925770,1730,935358,1049649927,934539,1049550919,819,99008,903496,15,1118785,118544,1727,734,130000.0,43333.0,-70.0,-68.0,-66.0,-70.0,-70.0,-68.0,-66.0,-70.0,-90.0,-93.0,-90.0,-93.0,20.0,25.0,24.0,23.0,1
4434,CC:2F:71:3E:C5:1F,3845956,485044014,968,118244,3844988,484925770,2,4205,350898,3499,267060,706,83838,1025,12,1392,26,2,53,130000.0,39000.0,-71.0,-71.0,-70.0,-60.0,-71.0,-71.0,-68.0,-60.0,-90.0,-93.0,-90.0,-93.0,19.0,22.0,20.0,33.0,1
4435,BA:8C:B9:54:50:24,3849905,491118208,4917,6192438,3844988,484925770,7,9662,1745530,9640,1742035,22,3495,2358,17,5407,41,7,70,216660.0,130000.0,-40.0,-37.0,-46.0,-52.0,-42.0,-35.0,-43.0,-48.0,-90.0,-93.0,-90.0,-93.0,50.0,56.0,44.0,41.0,1
4436,62:47:05:9D:EB:15,3851667,497089245,6678,12163202,3844989,484926043,1,6804,3782381,6754,3774723,50,7658,3260,0,6738,56,1,125,229410.0,137640.0,-43.0,-45.0,-36.0,-47.0,-44.0,-47.0,-38.0,-47.0,-90.0,-93.0,-90.0,-93.0,47.0,48.0,54.0,46.0,1
4437,92:69:1D:31:68:E9,3849023,488577434,4031,3651129,3844992,484926305,1,5330,1151979,5164,1114301,166,37678,2195,12,4277,102,1,60,216660.0,130000.0,-51.0,-48.0,-44.0,-47.0,-51.0,-48.0,-44.0,-48.0,-90.0,-93.0,-90.0,-93.0,39.0,45.0,46.0,46.0,1
4438,CC:2F:71:3F:1F:24,4965350,1758601493,1120358,1273675188,3844992,484926305,1730,935543,1049890016,934724,1049791008,819,99008,903675,15,1118982,118550,1727,734,130000.0,43333.0,-71.0,-68.0,-66.0,-70.0,-70.0,-68.0,-66.0,-70.0,-90.0,-93.0,-90.0,-93.0,19.0,25.0,24.0,23.0,1
4439,CC:2F:71:3E:C5:1F,3845960,485044549,968,118244,3844992,484926305,2,4205,350898,3499,267060,706,83838,1025,12,1392,26,2,53,130000.0,39000.0,-71.0,-71.0,-70.0,-60.0,-71.0,-71.0,-68.0,-60.0,-90.0,-93.0,-90.0,-93.0,19.0,22.0,20.0,33.0,1
4440,BA:8C:B9:54:50:24,3849909,491118743,4917,6192438,3844992,484926305,7,9662,1745530,9640,1742035,22,3495,2358,17,5407,41,7,70,216660.0,130000.0,-40.0,-37.0,-46.0,-52.0,-42.0,-35.0,-43.0,-48.0,-90.0,-93.0,-90.0,-93.0,50.0,56.0,44.0,41.0,1
4441,62:47:05:9D:EB:15,3851692,497095373,6694,12168462,3844998,484926911,1,6825,3788745,6775,3781087,50,7658,3274,0,6754,56,1,125,216660.0,130000.0,-46.0,-48.0,-42.0,-48.0,-46.0,-48.0,-40.0,-47.0,-90.0,-93.0,-90.0,-93.0,44.0,45.0,48.0,45.0,1
4442,92:69:1D:31:68:E9,3849029,488578040,4031,3651129,3844998,484926911,1,5330,1151979,5164,1114301,166,37678,2195,12,4277,102,1,60,216660.0,130000.0,-51.0,-48.0,-44.0,-47.0,-51.0,-48.0,-44.0,-48.0,-91.0,-93.0,-90.0,-93.0,40.0,45.0,46.0,46.0,1
4443,CC:2F:71:3F:1F:24,4965547,1758843505,1120549,1273916594,3844998,484926911,1730,935722,1050129126,934903,1050030118,819,99008,903843,15,1119174,118552,1727,734,130000.0,43333.0,-70.0,-68.0,-66.0,-70.0,-70.0,-68.0,-66.0,-70.0,-91.0,-93.0,-90.0,-93.0,21.0,25.0,24.0,23.0,1
4444,CC:2F:71:3E:C5:1F,3845966,485045155,968,118244,3844998,484926911,2,4205,350898,3499,267060,706,83838,1025,12,1392,26,2,53,130000.0,39000.0,-71.0,-71.0,-70.0,-60.0,-71.0,-71.0,-68.0,-60.0,-91.0,-93.0,-90.0,-93.0,20.0,22.0,20.0,33.0,1
4445,BA:8C:B9:54:50:24,3849916,491119409,4917,6192438,3844999,484926971,7,9662,1745530,9640,1742035,22,3495,2358,17,5407,41,7,70,216660.0,130000.0,-40.0,-37.0,-46.0,-52.0,-42.0,-35.0,-43.0,-48.0,-91.0,-93.0,-90.0,-93.0,51.0,56.0,44.0,41.0,1
4446,62:47:05:9D:EB:15,3851695,497095635,6694,12168462,3845001,484927173,1,6826,3788813,6776,3781155,50,7658,3274,0,6754,56,1,125,216660.0,130000.0,-45.0,-50.0,-42.0,-45.0,-46.0,-48.0,-41.0,-47.0,-91.0,-93.0,-90.0,-93.0,46.0,43.0,48.0,48.0,1
4447,92:69:1D:31:68:E9,3849032,488578302,4031,3651129,3845001,484927173,1,5330,1151979,5164,1114301,166,37678,2195,12,4277,102,1,60,216660.0,130000.0,-51.0,-48.0,-44.0,-47.0,-51.0,-48.0,-44.0,-48.0,-91.0,-93.0,-90.0,-93.0,40.0,45.0,46.0,46.0,1
4448,CC:2F:71:3F:1F:24,4965741,1759085157,1120740,1274157984,3845001,484927173,1730,935893,1050359948,935074,1050260940,819,99008,904011,15,1119365,118555,1727,734,130000.0,43333.0,-70.0,-68.0,-66.0,-70.0,-70.0,-68.0,-65.0,-70.0,-91.0,-93.0,-90.0,-93.0,21.0,25.0,24.0,23.0,1
4449,CC:2F:71:3E:C5:1F,3845971,485045619,968,118244,3845003,484927375,2,4205,350898,3499,267060,706,83838,1025,12,1392,26,2,53,130000.0,39000.0,-71.0,-71.0,-70.0,-60.0,-71.0,-71.0,-68.0,-60.0,-91.0,-93.0,-90.0,-93.0,20.0,22.0,20.0,33.0,1
4450,BA:8C:B9:54:50:24,3849920,491119813,4917,6192438,3845003,484927375,7,9662,1745530,9640,1742035,22,3495,2358,17,5407,41,7,70,216660.0,130000.0,-40.0,-37.0,-46.0,-52.0,-42.0,-35.0,-43.0,-48.0,-91.0,-93.0,-90.0,-93.0,51.0,56.0,44.0,41.0,1
4451,62:47:05:9D:EB:15,3851707,497098125,6697,12169918,3845010,484928207,1,6833,3789701,6783,3782043,50,7658,3278,0,6757,56,1,125,216660.0,130000.0,-46.0,-48.0,-40.0,-47.0,-45.0,-48.0,-40.0,-47.0,-91.0,-93.0,-90.0,-93.0,45.0,45.0,50.0,46.0,1
4452,92:69:1D:31:68:E9,3849041,488579336,4031,3651129,3845010,484928207,1,5330,1151979,5164,1114301,166,37678,2195,12,4277,102,1,60,216660.0,130000.0,-51.0,-48.0,-44.0,-47.0,-51.0,-48.0,-44.0,-48.0,-91.0,-93.0,-90.0,-93.0,40.0,45.0,46.0,46.0,1
4453,CC:2F:71:3F:1F:24,4965951,1759336930,1120941,1274408723,3845010,484928207,1730,936078,1050597157,935259,1050498149,819,99008,904193,15,1119566,118565,1727,734,130000.0,43333.0,-70.0,-68.0,-66.0,-70.0,-70.0,-68.0,-65.0,-70.0,-91.0,-93.0,-90.0,-93.0,21.0,25.0,24.0,23.0,1
4454,CC:2F:71:3E:C5:1F,3845978,485046451,968,118244,3845010,484928207,2,4205,350898,3499,267060,706,83838,1025,12,1392,26,2,53,130000.0,39000.0,-71.0,-71.0,-70.0,-60.0,-71.0,-71.0,-68.0,-60.0,-91.0,-93.0,-90.0,-93.0,20.0,22.0,20.0,33.0,1
4455,BA:8C:B9:54:50:24,3849927,491120645,4917,6192438,3845010,484928207,7,9662,1745530,9640,1742035,22,3495,2358,17,5407,41,7,70,216660.0,130000.0,-40.0,-37.0,-46.0,-52.0,-42.0,-35.0,-43.0,-48.0,-91.0,-93.0,-90.0,-93.0,51.0,56.0,44.0,41.0,1
4456,62:47:05:9D:EB:15,3851710,497098387,6697,12169918,3845013,484928469,1,6834,3789769,6784,3782111,50,7658,3278,0,6757,56,1,125,216660.0,130000.0,-44.0,-50.0,-42.0,-45.0,-45.0,-48.0,-40.0,-46.0,-90.0,-93.0,-90.0,-93.0,46.0,43.0,48.0,48.0,1
4457,92:69:1D:31:68:E9,3849046,488579830,4033,3651361,3845013,484928469,1,5336,1152467,5170,1114789,166,37678,2197,12,4279,102,1,60,216660.0,130000.0,-52.0,-48.0,-42.0,-49.0,-51.0,-48.0,-43.0,-48.0,-90.0,-93.0,-90.0,-93.0,38.0,45.0,48.0,44.0,1
4458,CC:2F:71:3F:1F:24,4966150,1759584646,1121135,1274655975,3845015,484928671,1730,936257,1050836131,935438,1050737123,819,99008,904365,15,1119759,118569,1727,734,130000.0,43333.0,-70.0,-68.0,-66.0,-70.0,-70.0,-68.0,-65.0,-70.0,-90.0,-93.0,-90.0,-93.0,20.0,25.0,24.0,23.0,1
4459,CC:2F:71:3E:C5:1F,3845983,485046915,968,118244,3845015,484928671,2,4205,350898,3499,267060,706,83838,1025,12,1392,26,2,53,130000.0,39000.0,-71.0,-71.0,-70.0,-60.0,-71.0,-71.0,-68.0,-60.0,-90.0,-93.0,-90.0,-93.0,19.0,22.0,20.0,33.0,1
4460,BA:8C:B9:54:50:24,3849933,491121169,4917,6192438,3845016,484928731,7,9662,1745530,9640,1742035,22,3495,2358,17,5407,41,7,70,216660.0,130000.0,-40.0,-37.0,-46.0,-52.0,-42.0,-35.0,-43.0,-48.0,-90.0,-93.0,-90.0,-93.0,50.0,56.0,44.0,41.0,1
4461,62:47:05:9D:EB:15,3851717,497099053,6697,12169918,3845020,484929135,1,6834,3789769,6784,3782111,50,7658,3278,0,6757,56,1,125,216660.0,130000.0,-44.0,-50.0,-42.0,-45.0,-45.0,-48.0,-40.0,-46.0,-90.0,-93.0,-90.0,-93.0,46.0,43.0,48.0,48.0,1
4462,92:69:1D:31:68:E9,3849053,488580496,4033,3651361,3845020,484929135,1,5336,1152467,5170,1114789,166,37678,2197,12,4279,102,1,60,216660.0,130000.0,-52.0,-48.0,-42.0,-49.0,-51.0,-48.0,-43.0,-48.0,-90.0,-93.0,-90.0,-93.0,38.0,45.0,48.0,44.0,1
4463,CC:2F:71:3F:1F:24,4966346,1759826276,1121326,1274897141,3845020,484929135,1730,936434,1051073515,935615,1050974507,819,99008,904536,15,1119951,118573,1727,734,130000.0,43333.0,-70.0,-68.0,-66.0,-70.0,-70.0,-68.0,-65.0,-70.0,-90.0,-93.0,-90.0,-93.0,20.0,25.0,24.0,23.0,1
4464,CC:2F:71:3E:C5:1F,3845988,485047379,968,118244,3845020,484929135,2,4205,350898,3499,267060,706,83838,1025,12,1392,26,2,53,130000.0,39000.0,-71.0,-71.0,-70.0,-60.0,-71.0,-71.0,-68.0,-60.0,-90.0,-93.0,-90.0,-93.0,19.0,22.0,20.0,33.0,1
4465,BA:8C:B9:54:50:24,3849937,491121573,4917,6192438,3845020,484929135,7,9662,1745530,9640,1742035,22,3495,2358,17,5407,41,7,70,216660.0,130000.0,-40.0,-37.0,-46.0,-52.0,-42.0,-35.0,-43.0,-48.0,-90.0,-93.0,-90.0,-93.0,50.0,56.0,44.0,41.0,1
4466,62:47:05:9D:EB:15,3851720,497099315,6697,12169918,3845023,484929397,1,6834,3789769,6784,3782111,50,7658,3278,0,6757,56,1,125,216660.0,130000.0,-44.0,-50.0,-42.0,-45.0,-45.0,-48.0,-40.0,-46.0,-90.0,-93.0,-90.0,-93.0,46.0,43.0,48.0,48.0,1
4467,92:69:1D:31:68:E9,3849058,488580960,4033,3651361,3845025,484929599,1,5336,1152467,5170,1114789,166,37678,2197,12,4279,102,1,60,216660.0,130000.0,-52.0,-48.0,-42.0,-49.0,-51.0,-48.0,-43.0,-48.0,-90.0,-93.0,-90.0,-93.0,38.0,45.0,48.0,44.0,1
4468,CC:2F:71:3F:1F:24,4966539,1760064892,1121514,1275135293,3845025,484929599,1730,936603,1051301257,935784,1051202249,819,99008,904702,15,1120139,118574,1727,734,130000.0,43333.0,-70.0,-68.0,-66.0,-70.0,-70.0,-68.0,-65.0,-70.0,-90.0,-93.0,-90.0,-93.0,20.0,25.0,24.0,23.0,1
4469,CC:2F:71:3E:C5:1F,3845994,485047903,968,118244,3845026,484929659,2,4205,350898,3499,267060,706,83838,1025,12,1392,26,2,53,130000.0,39000.0,-71.0,-71.0,-70.0,-60.0,-71.0,-71.0,-68.0,-60.0,-90.0,-93.0,-90.0,-93.0,19.0,22.0,20.0,33.0,1
4470,BA:8C:B9:54:50:24,3849943,491122097,4917,6192438,3845026,484929659,7,9662,1745530,9640,1742035,22,3495,2358,17,5407,41,7,70,216660.0,130000.0,-40.0,-37.0,-46.0,-52.0,-42.0,-35.0,-43.0,-48.0,-90.0,-93.0,-90.0,-93.0,50.0,56.0,44.0,41.0,1
4471,62:47:05:9D:EB:15,3851728,497100043,6697,12169918,3845031,484930125,1,6834,3789769,6784,3782111,50,7658,3278,0,6757,56,1,125,216660.0,130000.0,-44.0,-50.0,-42.0,-45.0,-45.0,-48.0,-40.0,-46.0,-90.0,-93.0,-90.0,-93.0,46.0,43.0,48.0,48.0,1
4472,92:69:1D:31:68:E9,3849064,488581486,4033,3651361,3845031,484930125,1,5336,1152467,5170,1114789,166,37678,2197,12,4279,102,1,60,216660.0,130000.0,-52.0,-48.0,-42.0,-49.0,-51.0,-48.0,-43.0,-48.0,-90.0,-93.0,-90.0,-93.0,38.0,45.0,48.0,44.0,1
4473,CC:2F:71:3F:1F:24,4966741,1760308595,1121710,1275378470,3845031,484930125,1730,936780,1051530418,935961,1051431410,819,99008,904876,15,1120335,118574,1727,734,130000.0,43333.0,-70.0,-68.0,-65.0,-70.0,-70.0,-68.0,-65.0,-70.0,-90.0,-93.0,-90.0,-93.0,20.0,25.0,25.0,23.0,1
4474,CC:2F:71:3E:C5:1F,3845999,485048369,968,118244,3845031,484930125,2,4207,351086,3500,267130,707,83956,1026,12,1392,26,2,53,130000.0,39000.0,-72.0,-72.0,-69.0,-60.0,-71.0,-71.0,-69.0,-60.0,-90.0,-93.0,-90.0,-93.0,18.0,21.0,21.0,33.0,1
4475,BA:8C:B9:54:50:24,3849948,491122563,4917,6192438,3845031,484930125,7,9662,1745530,9640,1742035,22,3495,2358,17,5407,41,7,70,216660.0,130000.0,-40.0,-37.0,-46.0,-52.0,-42.0,-35.0,-43.0,-48.0,-90.0,-93.0,-90.0,-93.0,50.0,56.0,44.0,41.0,1
4476,62:47:05:9D:EB:15,3851732,497100447,6697,12169918,3845035,484930529,1,6837,3789973,6787,3782315,50,7658,3278,0,6757,56,1,125,216660.0,130000.0,-42.0,-45.0,-36.0,-47.0,-44.0,-47.0,-39.0,-46.0,-90.0,-93.0,-90.0,-93.0,48.0,48.0,54.0,46.0,1
4477,92:69:1D:31:68:E9,3849068,488581890,4033,3651361,3845035,484930529,1,5336,1152467,5170,1114789,166,37678,2197,12,4279,102,1,60,216660.0,130000.0,-52.0,-48.0,-42.0,-49.0,-51.0,-48.0,-43.0,-48.0,-90.0,-93.0,-90.0,-93.0,38.0,45.0,48.0,44.0,1
4478,CC:2F:71:3F:1F:24,4966934,1760548481,1121899,1275617952,3845035,484930529,1730,936954,1051765902,936135,1051666894,819,99008,905044,15,1120524,118582,1727,734,130000.0,43333.0,-70.0,-68.0,-66.0,-70.0,-70.0,-68.0,-65.0,-70.0,-90.0,-93.0,-90.0,-93.0,20.0,25.0,24.0,23.0,1
4479,CC:2F:71:3E:C5:1F,3846003,485048773,968,118244,3845035,484930529,2,4207,351086,3500,267130,707,83956,1026,12,1392,26,2,53,130000.0,39000.0,-72.0,-72.0,-69.0,-60.0,-71.0,-71.0,-69.0,-60.0,-90.0,-93.0,-90.0,-93.0,18.0,21.0,21.0,33.0,1
4480,BA:8C:B9:54:50:24,3849952,491122967,4917,6192438,3845035,484930529,7,9662,1745530,9640,1742035,22,3495,2358,17,5407,41,7,70,216660.0,130000.0,-40.0,-37.0,-46.0,-52.0,-42.0,-35.0,-43.0,-48.0,-90.0,-93.0,-90.0,-93.0,50.0,56.0,44.0,41.0,1
4481,62:47:05:9D:EB:15,3851737,497100911,6697,12169918,3845040,484930993,1,6837,3789973,6787,3782315,50,7658,3278,0,6757,56,1,125,216660.0,130000.0,-42.0,-45.0,-36.0,-47.0,-44.0,-47.0,-39.0,-46.0,-90.0,-93.0,-90.0,-93.0,48.0,48.0,54.0,46.0,1
4482,92:69:1D:31:68:E9,3849073,488582354,4033,3651361,3845040,484930993,1,5336,1152467,5170,1114789,166,37678,2197,12,4279,102,1,60,216660.0,130000.0,-52.0,-48.0,-42.0,-49.0,-51.0,-48.0,-43.0,-48.0,-90.0,-93.0,-90.0,-93.0,38.0,45.0,48.0,44.0,1
4483,CC:2F:71:3F:1F:24,4967135,1760802377,1122095,1275871384,3845040,484930993,1730,937135,1052009352,936316,1051910344,819,99008,905220,15,1120719,118588,1727,734,130000.0,43333.0,-70.0,-68.0,-66.0,-70.0,-70.0,-68.0,-66.0,-70.0,-90.0,-93.0,-90.0,-93.0,20.0,25.0,24.0,23.0,1
4484,CC:2F:71:3E:C5:1F,3846008,485049237,968,118244,3845040,484930993,2,4207,351086,3500,267130,707,83956,1026,12,1392,26,2,53,130000.0,39000.0,-72.0,-72.0,-69.0,-60.0,-71.0,-71.0,-69.0,-60.0,-90.0,-93.0,-90.0,-93.0,18.0,21.0,21.0,33.0,1
4485,BA:8C:B9:54:50:24,3849957,491123431,4917,6192438,3845040,484930993,7,9664,1745666,9642,1742171,22,3495,2358,17,5408,41,7,70,216660.0,130000.0,-48.0,-35.0,-43.0,-46.0,-43.0,-35.0,-43.0,-47.0,-90.0,-93.0,-90.0,-93.0,42.0,58.0,47.0,47.0,1
4486,62:47:05:9D:EB:15,3851741,497101315,6697,12169918,3845044,484931397,1,6837,3789973,6787,3782315,50,7658,3278,0,6757,56,1,125,216660.0,130000.0,-42.0,-45.0,-36.0,-47.0,-44.0,-47.0,-39.0,-46.0,-90.0,-93.0,-90.0,-93.0,48.0,48.0,54.0,46.0,1
4487,92:69:1D:31:68:E9,3849077,488582758,4033,3651361,3845044,484931397,1,5336,1152467,5170,1114789,166,37678,2197,12,4279,102,1,60,216660.0,130000.0,-52.0,-48.0,-42.0,-49.0,-51.0,-48.0,-43.0,-48.0,-90.0,-93.0,-90.0,-93.0,38.0,45.0,48.0,44.0,1
4488,CC:2F:71:3F:1F:24,4967328,1761043687,1122284,1276112290,3845044,484931397,1730,937309,1052244850,936490,1052145842,819,99008,905389,15,1120909,118594,1727,734,130000.0,39000.0,-70.0,-68.0,-66.0,-70.0,-70.0,-68.0,-65.0,-70.0,-90.0,-93.0,-90.0,-93.0,20.0,25.0,24.0,23.0,1
4489,CC:2F:71:3E:C5:1F,3846014,485049843,968,118244,3845046,484931599,2,4207,351086,3500,267130,707,83956,1026,12,1392,26,2,53,130000.0,39000.0,-72.0,-72.0,-69.0,-60.0,-71.0,-71.0,-69.0,-60.0,-90.0,-93.0,-90.0,-93.0,18.0,21.0,21.0,33.0,1
4490,BA:8C:B9:54:50:24,3849963,491124037,4917,6192438,3845046,484931599,7,9664,1745666,9642,1742171,22,3495,2358,17,5408,41,7,70,216660.0,130000.0,-48.0,-35.0,-43.0,-46.0,-43.0,-35.0,-43.0,-47.0,-90.0,-93.0,-90.0,-93.0,42.0,58.0,47.0,47.0,1
4491,62:47:05:9D:EB:15,3851745,497101719,6697,12169918,3845048,484931801,1,6837,3789973,6787,3782315,50,7658,3278,0,6757,56,1,125,216660.0,130000.0,-42.0,-45.0,-36.0,-47.0,-44.0,-47.0,-39.0,-46.0,-90.0,-93.0,-90.0,-93.0,48.0,48.0,54.0,46.0,1
4492,92:69:1D:31:68:E9,3849081,488583162,4033,3651361,3845048,484931801,1,5336,1152467,5170,1114789,166,37678,2197,12,4279,102,1,60,216660.0,130000.0,-52.0,-48.0,-42.0,-49.0,-51.0,-48.0,-43.0,-48.0,-90.0,-93.0,-90.0,-93.0,38.0,45.0,48.0,44.0,1
4493,CC:2F:71:3F:1F:24,4967532,1761291766,1122483,1276359905,3845049,484931861,1730,937495,1052482421,936676,1052383413,819,99008,905570,15,1121108,118597,1727,737,130000.0,43333.0,-70.0,-68.0,-66.0,-70.0,-70.0,-68.0,-66.0,-70.0,-90.0,-93.0,-90.0,-93.0,20.0,25.0,24.0,23.0,1
4494,CC:2F:71:3E:C5:1F,3846017,485050105,968,118244,3845049,484931861,2,4207,351086,3500,267130,707,83956,1026,12,1392,26,2,53,130000.0,39000.0,-72.0,-72.0,-69.0,-60.0,-71.0,-71.0,-69.0,-60.0,-90.0,-93.0,-90.0,-93.0,18.0,21.0,21.0,33.0,1
4495,BA:8C:B9:54:50:24,3849967,491124359,4917,6192438,3845050,484931921,7,9664,1745666,9642,1742171,22,3495,2358,17,5408,41,7,70,216660.0,130000.0,-48.0,-35.0,-43.0,-46.0,-43.0,-35.0,-43.0,-47.0,-90.0,-93.0,-90.0,-93.0,42.0,58.0,47.0,47.0,1
4496,62:47:05:9D:EB:15,3851751,497102243,6697,12169918,3845054,484932325,1,6837,3789973,6787,3782315,50,7658,3278,0,6757,56,1,125,216660.0,130000.0,-42.0,-45.0,-36.0,-47.0,-44.0,-47.0,-39.0,-46.0,-90.0,-93.0,-90.0,-93.0,48.0,48.0,54.0,46.0,1
4497,92:69:1D:31:68:E9,3849087,488583686,4033,3651361,3845054,484932325,1,5336,1152467,5170,1114789,166,37678,2197,12,4279,102,1,60,216660.0,130000.0,-52.0,-48.0,-42.0,-49.0,-51.0,-48.0,-43.0,-48.0,-90.0,-93.0,-90.0,-93.0,38.0,45.0,48.0,44.0,1
4498,CC:2F:71:3F:1F:24,4967728,1761533562,1122672,1276601035,3845056,484932527,1730,937668,1052715023,936849,1052616015,819,99008,905738,15,1121296,118597,1727,737,130000.0,43333.0,-70.0,-68.0,-66.0,-70.0,-70.0,-68.0,-66.0,-70.0,-90.0,-93.0,-90.0,-93.0,20.0,25.0,24.0,23.0,1
4499,CC:2F:71:3E:C5:1F,3846024,485050771,968,118244,3845056,484932527,2,4207,351086,3500,267130,707,83956,1026,12,1392,26,2,53,130000.0,39000.0,-72.0,-72.0,-69.0,-60.0,-71.0,-71.0,-69.0,-60.0,-90.0,-93.0,-90.0,-93.0,18.0,21.0,21.0,33.0,1
4500,BA:8C:B9:54:50:24,3849973,491124965,4917,6192438,3845056,484932527,7,9665,1745734,9643,1742239,22,3495,2358,17,5408,41,7,70,216660.0,130000.0,-48.0,-35.0,-42.0,-45.0,-43.0,-35.0,-43.0,-47.0,-90.0,-93.0,-90.0,-93.0,42.0,58.0,48.0,48.0,1
4501,62:47:05:9D:EB:15,3851757,497102980,6697,12169918,3845060,484933062,1,6837,3789973,6787,3782315,50,7658,3278,0,6757,56,1,125,216660.0,130000.0,-42.0,-45.0,-36.0,-47.0,-44.0,-47.0,-39.0,-46.0,-90.0,-93.0,-90.0,-93.0,48.0,48.0,54.0,46.0,1
4502,92:69:1D:31:68:E9,3849093,488584423,4033,3651361,3845060,484933062,1,5336,1152467,5170,1114789,166,37678,2197,12,4279,102,1,60,216660.0,130000.0,-52.0,-48.0,-42.0,-49.0,-51.0,-48.0,-43.0,-48.0,-90.0,-93.0,-90.0,-93.0,38.0,45.0,48.0,44.0,1
4503,CC:2F:71:3F:1F:24,4967922,1761774909,1122862,1276841847,3845060,484933062,1730,937842,1052947645,937023,1052848637,819,99008,905907,15,1121487,118614,1727,737,130000.0,43333.0,-70.0,-68.0,-66.0,-70.0,-70.0,-68.0,-66.0,-70.0,-90.0,-93.0,-90.0,-93.0,20.0,25.0,24.0,23.0,1
4504,CC:2F:71:3E:C5:1F,3846028,485051306,968,118244,3845060,484933062,2,4207,351086,3500,267130,707,83956,1026,12,1392,26,2,53,130000.0,39000.0,-72.0,-72.0,-69.0,-60.0,-71.0,-71.0,-69.0,-60.0,-90.0,-93.0,-90.0,-93.0,18.0,21.0,21.0,33.0,1
4505,BA:8C:B9:54:50:24,3849977,491125500,4917,6192438,3845060,484933062,7,9665,1745734,9643,1742239,22,3495,2358,17,5408,41,7,70,216660.0,130000.0,-48.0,-35.0,-42.0,-45.0,-43.0,-35.0,-43.0,-47.0,-90.0,-93.0,-90.0,-93.0,42.0,58.0,48.0,48.0,1
4506,62:47:05:9D:EB:15,3851767,497104135,6699,12170347,3845068,484933788,1,6840,3790332,6790,3782674,50,7658,3280,0,6759,56,1,125,229410.0,130000.0,-46.0,-49.0,-40.0,-47.0,-44.0,-47.0,-39.0,-46.0,-90.0,-93.0,-90.0,-93.0,44.0,44.0,50.0,46.0,1
4507,92:69:1D:31:68:E9,3849101,488585149,4033,3651361,3845068,484933788,1,5336,1152467,5170,1114789,166,37678,2197,12,4279,102,1,60,216660.0,130000.0,-52.0,-48.0,-42.0,-49.0,-51.0,-48.0,-43.0,-48.0,-90.0,-93.0,-90.0,-93.0,38.0,45.0,48.0,44.0,1
4508,CC:2F:71:3F:1F:24,4968121,1762017041,1123053,1277083253,3845068,484933788,1730,938014,1053180021,937195,1053081013,819,99008,906075,15,1121678,118618,1727,737,130000.0,43333.0,-70.0,-68.0,-66.0,-70.0,-70.0,-68.0,-66.0,-70.0,-90.0,-93.0,-90.0,-93.0,20.0,25.0,24.0,23.0,1
4509,CC:2F:71:3E:C5:1F,3846036,485052032,968,118244,3845068,484933788,2,4207,351086,3500,267130,707,83956,1026,12,1392,26,2,53,130000.0,39000.0,-72.0,-72.0,-69.0,-60.0,-71.0,-71.0,-69.0,-60.0,-90.0,-93.0,-90.0,-93.0,18.0,21.0,21.0,33.0,1
4510,BA:8C:B9:54:50:24,3849985,491126226,4917,6192438,3845068,484933788,7,9665,1745734,9643,1742239,22,3495,2358,17,5408,41,7,70,216660.0,130000.0,-48.0,-35.0,-42.0,-45.0,-43.0,-35.0,-43.0,-47.0,-90.0,-93.0,-90.0,-93.0,42.0,58.0,48.0,48.0,1
4511,62:47:05:9D:EB:15,3851770,497104397,6699,12170347,3845071,484934050,1,6841,3790400,6791,3782742,50,7658,3280,0,6759,56,1,125,229410.0,130000.0,-42.0,-45.0,-36.0,-47.0,-43.0,-47.0,-38.0,-46.0,-90.0,-93.0,-90.0,-93.0,48.0,48.0,54.0,46.0,1
4512,92:69:1D:31:68:E9,3849104,488585411,4033,3651361,3845071,484934050,1,5336,1152467,5170,1114789,166,37678,2197,12,4279,102,1,60,216660.0,130000.0,-52.0,-48.0,-42.0,-49.0,-51.0,-48.0,-43.0,-48.0,-90.0,-93.0,-90.0,-93.0,38.0,45.0,48.0,44.0,1
4513,CC:2F:71:3F:1F:24,4968325,1762268026,1123254,1277333976,3845071,484934050,1730,938200,1053416364,937381,1053317356,819,99008,906257,15,1121879,118626,1727,740,130000.0,43333.0,-70.0,-68.0,-66.0,-70.0,-70.0,-68.0,-66.0,-70.0,-90.0,-93.0,-90.0,-93.0,20.0,25.0,24.0,23.0,1
4514,CC:2F:71:3E:C5:1F,3846039,485052294,968,118244,3845071,484934050,2,4207,351086,3500,267130,707,83956,1026,12,1392,26,2,53,130000.0,39000.0,-72.0,-72.0,-69.0,-60.0,-71.0,-71.0,-69.0,-60.0,-90.0,-93.0,-90.0,-93.0,18.0,21.0,21.0,33.0,1
4515,BA:8C:B9:54:50:24,3849988,491126488,4917,6192438,3845071,484934050,7,9665,1745734,9643,1742239,22,3495,2358,17,5408,41,7,70,216660.0,130000.0,-48.0,-35.0,-42.0,-45.0,-43.0,-35.0,-43.0,-47.0,-90.0,-93.0,-90.0,-93.0,42.0,58.0,48.0,48.0,1
4516,62:47:05:9D:EB:15,3851779,497105545,6702,12170889,3845077,484934656,1,6847,3791103,6797,3783445,50,7658,3282,0,6762,56,1,125,229410.0,130000.0,-42.0,-45.0,-36.0,-47.0,-43.0,-46.0,-38.0,-47.0,-90.0,-93.0,-90.0,-93.0,48.0,48.0,54.0,46.0,1
4517,92:69:1D:31:68:E9,3849110,488586017,4033,3651361,3845077,484934656,1,5336,1152467,5170,1114789,166,37678,2197,12,4279,102,1,60,216660.0,130000.0,-52.0,-48.0,-42.0,-49.0,-51.0,-48.0,-43.0,-48.0,-90.0,-93.0,-90.0,-93.0,38.0,45.0,48.0,44.0,1
4518,CC:2F:71:3F:1F:24,4968520,1762509762,1123443,1277575106,3845077,484934656,1730,938377,1053655214,937558,1053556206,819,99008,906425,15,1122068,118627,1727,740,130000.0,43333.0,-70.0,-68.0,-66.0,-70.0,-70.0,-68.0,-65.0,-70.0,-90.0,-93.0,-90.0,-93.0,20.0,25.0,24.0,23.0,1
4519,CC:2F:71:3E:C5:1F,3846047,485053020,968,118244,3845079,484934776,2,4207,351086,3500,267130,707,83956,1026,12,1392,26,2,53,130000.0,39000.0,-72.0,-72.0,-69.0,-60.0,-71.0,-71.0,-69.0,-60.0,-90.0,-93.0,-90.0,-93.0,18.0,21.0,21.0,33.0,1
4520,BA:8C:B9:54:50:24,3849998,491127416,4917,6192438,3845081,484934978,7,9665,1745734,9643,1742239,22,3495,2358,17,5408,41,7,70,216660.0,130000.0,-48.0,-35.0,-42.0,-45.0,-43.0,-35.0,-43.0,-47.0,-90.0,-93.0,-90.0,-93.0,42.0,58.0,48.0,48.0,1
4521,62:47:05:9D:EB:15,3851783,497105867,6702,12170889,3845081,484934978,1,6847,3791103,6797,3783445,50,7658,3282,0,6762,56,1,125,229410.0,130000.0,-42.0,-45.0,-36.0,-47.0,-43.0,-46.0,-38.0,-47.0,-90.0,-93.0,-90.0,-93.0,48.0,48.0,54.0,46.0,1
4522,92:69:1D:31:68:E9,3849114,488586339,4033,3651361,3845081,484934978,1,5336,1152467,5170,1114789,166,37678,2197,12,4279,102,1,60,216660.0,130000.0,-52.0,-48.0,-42.0,-49.0,-51.0,-48.0,-43.0,-48.0,-90.0,-93.0,-90.0,-93.0,38.0,45.0,48.0,44.0,1
4523,CC:2F:71:3F:1F:24,4968713,1762749566,1123632,1277814588,3845081,484934978,1730,938547,1053884510,937728,1053785502,819,99008,906591,15,1122257,118635,1727,740,130000.0,43333.0,-70.0,-68.0,-66.0,-70.0,-70.0,-68.0,-66.0,-70.0,-90.0,-93.0,-90.0,-93.0,20.0,25.0,24.0,23.0,1
4524,CC:2F:71:3E:C5:1F,3846049,485053222,968,118244,3845081,484934978,2,4207,351086,3500,267130,707,83956,1026,12,1392,26,2,53,130000.0,39000.0,-72.0,-72.0,-69.0,-60.0,-71.0,-71.0,-69.0,-60.0,-90.0,-93.0,-90.0,-93.0,18.0,21.0,21.0,33.0,1
4525,BA:8C:B9:54:50:24,3849998,491127416,4917,6192438,3845081,484934978,7,9665,1745734,9643,1742239,22,3495,2358,17,5408,41,7,70,216660.0,130000.0,-48.0,-35.0,-42.0,-45.0,-43.0,-35.0,-43.0,-47.0,-90.0,-93.0,-90.0,-93.0,42.0,58.0,48.0,48.0,1
4526,62:47:05:9D:EB:15,3851790,497106533,6702,12170889,3845088,484935644,1,6847,3791103,6797,3783445,50,7658,3282,0,6762,56,1,125,229410.0,130000.0,-42.0,-45.0,-36.0,-47.0,-43.0,-46.0,-38.0,-47.0,-90.0,-93.0,-90.0,-93.0,48.0,48.0,54.0,46.0,1
4527,92:69:1D:31:68:E9,3849121,488587005,4033,3651361,3845088,484935644,1,5336,1152467,5170,1114789,166,37678,2197,12,4279,102,1,60,216660.0,130000.0,-52.0,-48.0,-42.0,-49.0,-51.0,-48.0,-43.0,-48.0,-90.0,-93.0,-90.0,-93.0,38.0,45.0,48.0,44.0,1
4528,CC:2F:71:3F:1F:24,4968909,1762989938,1123821,1278054294,3845088,484935644,1730,938722,1054117262,937903,1054018254,819,99008,906762,15,1122446,118639,1727,741,130000.0,43333.0,-70.0,-68.0,-66.0,-70.0,-70.0,-68.0,-65.0,-70.0,-90.0,-93.0,-90.0,-93.0,20.0,25.0,24.0,23.0,1
4529,CC:2F:71:3E:C5:1F,3846056,485053888,968,118244,3845088,484935644,2,4207,351086,3500,267130,707,83956,1026,12,1392,26,2,53,130000.0,39000.0,-72.0,-72.0,-69.0,-60.0,-71.0,-71.0,-69.0,-60.0,-90.0,-93.0,-90.0,-93.0,18.0,21.0,21.0,33.0,1
4530,BA:8C:B9:54:50:24,3850007,491128284,4917,6192438,3845090,484935846,7,9669,1746006,9647,1742511,22,3495,2358,17,5408,41,7,70,216660.0,130000.0,-49.0,-35.0,-43.0,-46.0,-45.0,-35.0,-44.0,-48.0,-90.0,-93.0,-90.0,-93.0,41.0,58.0,47.0,47.0,1
4531,62:47:05:9D:EB:15,3851794,497106855,6702,12170889,3845092,484935966,1,6847,3791103,6797,3783445,50,7658,3282,0,6762,56,1,125,229410.0,130000.0,-42.0,-45.0,-36.0,-47.0,-43.0,-46.0,-38.0,-47.0,-90.0,-93.0,-90.0,-93.0,48.0,48.0,54.0,46.0,1
4532,92:69:1D:31:68:E9,3849125,488587327,4033,3651361,3845092,484935966,1,5336,1152467,5170,1114789,166,37678,2197,12,4279,102,1,60,216660.0,130000.0,-52.0,-48.0,-42.0,-49.0,-51.0,-48.0,-43.0,-48.0,-90.0,-93.0,-90.0,-93.0,38.0,45.0,48.0,44.0,1
4533,CC:2F:71:3F:1F:24,4969110,1763236191,1124018,1278300225,3845092,484935966,1730,938907,1054360279,938088,1054261271,819,99008,906938,15,1122643,118645,1727,742,130000.0,43333.0,-70.0,-68.0,-66.0,-70.0,-70.0,-68.0,-66.0,-70.0,-90.0,-93.0,-90.0,-93.0,20.0,25.0,24.0,23.0,1
4534,CC:2F:71:3E:C5:1F,3846060,485054210,968,118244,3845092,484935966,2,4207,351086,3500,267130,707,83956,1026,12,1392,26,2,53,130000.0,39000.0,-72.0,-72.0,-69.0,-60.0,-71.0,-71.0,-69.0,-60.0,-90.0,-93.0,-90.0,-93.0,18.0,21.0,21.0,33.0,1
4535,BA:8C:B9:54:50:24,3850009,491128404,4917,6192438,3845092,484935966,7,9669,1746006,9647,1742511,22,3495,2358,17,5408,41,7,70,216660.0,130000.0,-49.0,-35.0,-43.0,-46.0,-45.0,-35.0,-44.0,-48.0,-90.0,-93.0,-90.0,-93.0,41.0,58.0,47.0,47.0,1
4536,62:47:05:9D:EB:15,3851800,497107461,6702,12170889,3845098,484936572,1,6847,3791103,6797,3783445,50,7658,3282,0,6762,56,1,125,229410.0,130000.0,-42.0,-45.0,-36.0,-47.0,-43.0,-46.0,-38.0,-47.0,-90.0,-93.0,-90.0,-93.0,48.0,48.0,54.0,46.0,1
4537,92:69:1D:31:68:E9,3849132,488587993,4033,3651361,3845099,484936632,1,5336,1152467,5170,1114789,166,37678,2197,12,4279,102,1,60,216660.0,130000.0,-52.0,-48.0,-42.0,-49.0,-51.0,-48.0,-43.0,-48.0,-90.0,-93.0,-90.0,-93.0,38.0,45.0,48.0,44.0,1
4538,CC:2F:71:3F:1F:24,4969307,1763479557,1124208,1278542925,3845099,484936632,1730,939085,1054599103,938266,1054500095,819,99008,907108,15,1122833,118645,1727,742,130000.0,43333.0,-71.0,-69.0,-67.0,-71.0,-70.0,-69.0,-67.0,-71.0,-90.0,-93.0,-90.0,-93.0,19.0,24.0,23.0,22.0,1
4539,CC:2F:71:3E:C5:1F,3846069,485055078,968,118244,3845101,484936834,2,4207,351086,3500,267130,707,83956,1026,12,1392,26,2,53,130000.0,39000.0,-72.0,-72.0,-69.0,-60.0,-71.0,-71.0,-69.0,-60.0,-90.0,-93.0,-90.0,-93.0,18.0,21.0,21.0,33.0,1
4540,BA:8C:B9:54:50:24,3850018,491129272,4917,6192438,3845101,484936834,7,9669,1746006,9647,1742511,22,3495,2358,17,5408,41,7,70,216660.0,130000.0,-49.0,-35.0,-43.0,-46.0,-45.0,-35.0,-44.0,-48.0,-90.0,-93.0,-90.0,-93.0,41.0,58.0,47.0,47.0,1
4541,62:47:05:9D:EB:15,3851803,497107723,6702,12170889,3845101,484936834,1,6847,3791103,6797,3783445,50,7658,3282,0,6762,56,1,125,229410.0,130000.0,-42.0,-45.0,-36.0,-47.0,-43.0,-46.0,-38.0,-47.0,-90.0,-93.0,-90.0,-93.0,48.0,48.0,54.0,46.0,1
4542,92:69:1D:31:68:E9,3849134,488588195,4033,3651361,3845101,484936834,1,5336,1152467,5170,1114789,166,37678,2197,12,4279,102,1,60,216660.0,130000.0,-52.0,-48.0,-42.0,-49.0,-51.0,-48.0,-43.0,-48.0,-90.0,-93.0,-90.0,-93.0,38.0,45.0,48.0,44.0,1
4543,CC:2F:71:3F:1F:24,4969501,1763721127,1124400,1278784293,3845101,484936834,1730,939263,1054835189,938444,1054736181,819,99008,907277,15,1123024,118651,1727,742,130000.0,39000.0,-73.0,-71.0,-70.0,-74.0,-72.0,-70.0,-68.0,-72.0,-90.0,-93.0,-90.0,-93.0,17.0,22.0,20.0,19.0,1
4544,CC:2F:71:3E:C5:1F,3846069,485055078,968,118244,3845101,484936834,2,4207,351086,3500,267130,707,83956,1026,12,1392,26,2,53,130000.0,39000.0,-72.0,-72.0,-69.0,-60.0,-71.0,-71.0,-69.0,-60.0,-90.0,-93.0,-90.0,-93.0,18.0,21.0,21.0,33.0,1
4545,BA:8C:B9:54:50:24,3850021,491129534,4917,6192438,3845104,484937096,7,9669,1746006,9647,1742511,22,3495,2358,17,5408,41,7,70,216660.0,130000.0,-49.0,-35.0,-43.0,-46.0,-45.0,-35.0,-44.0,-48.0,-90.0,-93.0,-90.0,-93.0,41.0,58.0,47.0,47.0,1
4546,62:47:05:9D:EB:15,3851811,497108449,6702,12170889,3845109,484937560,1,6847,3791103,6797,3783445,50,7658,3282,0,6762,56,1,125,229410.0,130000.0,-42.0,-45.0,-36.0,-47.0,-43.0,-46.0,-38.0,-47.0,-90.0,-93.0,-90.0,-93.0,48.0,48.0,54.0,46.0,1
4547,92:69:1D:31:68:E9,3849145,488589239,4034,3651477,3845111,484937762,1,5337,1152535,5171,1114857,166,37678,2197,12,4280,102,1,60,216660.0,130000.0,-52.0,-48.0,-43.0,-47.0,-51.0,-48.0,-43.0,-48.0,-90.0,-93.0,-90.0,-93.0,38.0,45.0,47.0,46.0,1
4548,CC:2F:71:3F:1F:24,4969707,1763968313,1124596,1279030551,3845111,484937762,1730,939444,1055075895,938625,1054976887,819,99008,907452,15,1123221,118653,1727,742,130000.0,43333.0,-70.0,-68.0,-66.0,-70.0,-70.0,-68.0,-65.0,-70.0,-90.0,-93.0,-90.0,-93.0,20.0,25.0,24.0,23.0,1
4549,CC:2F:71:3E:C5:1F,3846080,485056122,969,118360,3845111,484937762,2,4209,351226,3502,267270,707,83956,1026,12,1393,26,2,53,130000.0,39000.0,-72.0,-72.0,-69.0,-60.0,-71.0,-71.0,-69.0,-60.0,-90.0,-93.0,-90.0,-93.0,18.0,21.0,21.0,33.0,1
4550,BA:8C:B9:54:50:24,3850029,491130260,4918,6192498,3845111,484937762,7,9673,1746278,9651,1742783,22,3495,2358,17,5409,41,7,70,216660.0,130000.0,-40.0,-37.0,-46.0,-52.0,-43.0,-35.0,-44.0,-48.0,-90.0,-93.0,-90.0,-93.0,50.0,56.0,44.0,41.0,1
4551,62:47:05:9D:EB:15,3851815,497108827,6703,12171005,3845112,484937822,1,6849,3791239,6799,3783581,50,7658,3282,0,6763,56,1,125,229410.0,130000.0,-44.0,-50.0,-43.0,-45.0,-44.0,-47.0,-38.0,-47.0,-90.0,-93.0,-90.0,-93.0,46.0,43.0,47.0,48.0,1
4552,92:69:1D:31:68:E9,3849146,488589299,4034,3651477,3845112,484937822,1,5338,1152603,5172,1114925,166,37678,2197,12,4280,102,1,60,216660.0,130000.0,-52.0,-47.0,-42.0,-49.0,-52.0,-48.0,-43.0,-48.0,-90.0,-93.0,-90.0,-93.0,38.0,46.0,48.0,44.0,1
4553,CC:2F:71:3F:1F:24,4969915,1764218896,1124803,1279281074,3845112,484937822,1730,939639,1055317340,938820,1055218332,819,99008,907643,15,1123428,118661,1727,742,130000.0,43333.0,-70.0,-68.0,-66.0,-70.0,-70.0,-68.0,-65.0,-70.0,-90.0,-93.0,-90.0,-93.0,20.0,25.0,24.0,23.0,1
4554,CC:2F:71:3E:C5:1F,3846085,485056586,969,118360,3845116,484938226,2,4209,351226,3502,267270,707,83956,1026,12,1393,26,2,53,130000.0,39000.0,-72.0,-72.0,-69.0,-60.0,-71.0,-71.0,-69.0,-60.0,-90.0,-93.0,-90.0,-93.0,18.0,21.0,21.0,33.0,1
4555,BA:8C:B9:54:50:24,3850034,491130724,4918,6192498,3845116,484938226,7,9673,1746278,9651,1742783,22,3495,2358,17,5409,41,7,70,216660.0,130000.0,-40.0,-37.0,-46.0,-52.0,-43.0,-35.0,-44.0,-48.0,-90.0,-93.0,-90.0,-93.0,50.0,56.0,44.0,41.0,1
4556,62:47:05:9D:EB:15,3851825,497109755,6703,12171005,3845122,484938750,1,6849,3791239,6799,3783581,50,7658,3282,0,6763,56,1,125,229410.0,130000.0,-44.0,-50.0,-43.0,-45.0,-44.0,-47.0,-38.0,-47.0,-90.0,-93.0,-90.0,-93.0,46.0,43.0,47.0,48.0,1
4557,92:69:1D:31:68:E9,3849156,488590227,4034,3651477,3845122,484938750,1,5338,1152603,5172,1114925,166,37678,2197,12,4280,102,1,60,216660.0,130000.0,-52.0,-47.0,-42.0,-49.0,-52.0,-48.0,-43.0,-48.0,-90.0,-93.0,-90.0,-93.0,38.0,46.0,48.0,44.0,1
4558,CC:2F:71:3F:1F:24,4970118,1764462898,1124996,1279524148,3845122,484938750,1730,939810,1055546710,938991,1055447702,819,99008,907813,15,1123621,118664,1727,742,130000.0,43333.0,-70.0,-68.0,-66.0,-70.0,-70.0,-68.0,-66.0,-70.0,-90.0,-93.0,-90.0,-93.0,20.0,25.0,24.0,23.0,1
4559,CC:2F:71:3E:C5:1F,3846091,485057110,969,118360,3845122,484938750,2,4209,351226,3502,267270,707,83956,1026,12,1393,26,2,53,130000.0,39000.0,-72.0,-72.0,-69.0,-60.0,-71.0,-71.0,-69.0,-60.0,-90.0,-93.0,-90.0,-93.0,18.0,21.0,21.0,33.0,1
4560,BA:8C:B9:54:50:24,3850040,491131248,4918,6192498,3845122,484938750,7,9673,1746278,9651,1742783,22,3495,2358,17,5409,41,7,70,216660.0,130000.0,-40.0,-37.0,-46.0,-52.0,-43.0,-35.0,-44.0,-48.0,-90.0,-93.0,-90.0,-93.0,50.0,56.0,44.0,41.0,1
4561,62:47:05:9D:EB:15,3851826,497110028,6703,12171005,3845123,484939023,1,6849,3791239,6799,3783581,50,7658,3282,0,6763,56,1,125,229410.0,130000.0,-44.0,-50.0,-43.0,-45.0,-44.0,-47.0,-38.0,-47.0,-90.0,-93.0,-90.0,-93.0,46.0,43.0,47.0,48.0,1
4562,92:69:1D:31:68:E9,3849157,488590500,4034,3651477,3845123,484939023,1,5338,1152603,5172,1114925,166,37678,2197,12,4280,102,1,60,216660.0,130000.0,-52.0,-47.0,-42.0,-49.0,-52.0,-48.0,-43.0,-48.0,-90.0,-93.0,-90.0,-93.0,38.0,46.0,48.0,44.0,1
4563,CC:2F:71:3F:1F:24,4970316,1764704931,1125188,1279765444,3845128,484939487,1730,939984,1055779332,939165,1055680324,819,99008,907982,15,1123813,118674,1727,742,130000.0,43333.0,-70.0,-68.0,-66.0,-70.0,-70.0,-68.0,-65.0,-70.0,-90.0,-93.0,-90.0,-93.0,20.0,25.0,24.0,23.0,1
4564,CC:2F:71:3E:C5:1F,3846097,485057847,969,118360,3845128,484939487,2,4209,351226,3502,267270,707,83956,1026,12,1393,26,2,53,130000.0,39000.0,-72.0,-72.0,-69.0,-60.0,-71.0,-71.0,-69.0,-60.0,-90.0,-93.0,-90.0,-93.0,18.0,21.0,21.0,33.0,1
4565,BA:8C:B9:54:50:24,3850048,491132187,4918,6192498,3845130,484939689,7,9673,1746278,9651,1742783,22,3495,2358,17,5409,41,7,70,216660.0,130000.0,-40.0,-37.0,-46.0,-52.0,-43.0,-35.0,-44.0,-48.0,-90.0,-93.0,-90.0,-93.0,50.0,56.0,44.0,41.0,1
4566,62:47:05:9D:EB:15,3851835,497110896,6703,12171005,3845132,484939891,1,6849,3791239,6799,3783581,50,7658,3282,0,6763,56,1,125,229410.0,130000.0,-44.0,-50.0,-43.0,-45.0,-44.0,-47.0,-38.0,-47.0,-90.0,-93.0,-90.0,-93.0,46.0,43.0,47.0,48.0,1
4567,92:69:1D:31:68:E9,3849166,488591368,4034,3651477,3845132,484939891,1,5338,1152603,5172,1114925,166,37678,2197,12,4280,102,1,60,216660.0,130000.0,-52.0,-47.0,-42.0,-49.0,-52.0,-48.0,-43.0,-48.0,-90.0,-93.0,-90.0,-93.0,38.0,46.0,48.0,44.0,1
4568,CC:2F:71:3F:1F:24,4970512,1764949521,1125380,1280009630,3845132,484939891,1730,940163,1056021124,939344,1055922116,819,99008,908154,15,1124005,118684,1727,742,130000.0,39000.0,-70.0,-68.0,-66.0,-71.0,-70.0,-68.0,-66.0,-71.0,-90.0,-93.0,-90.0,-93.0,20.0,25.0,24.0,22.0,1
4569,CC:2F:71:3E:C5:1F,3846102,485058311,969,118360,3845133,484939951,2,4209,351226,3502,267270,707,83956,1026,12,1393,26,2,53,130000.0,39000.0,-72.0,-72.0,-69.0,-60.0,-71.0,-71.0,-69.0,-60.0,-90.0,-93.0,-90.0,-93.0,18.0,21.0,21.0,33.0,1
4570,BA:8C:B9:54:50:24,3850051,491132449,4918,6192498,3845133,484939951,7,9673,1746278,9651,1742783,22,3495,2358,17,5409,41,7,70,216660.0,130000.0,-40.0,-37.0,-46.0,-52.0,-43.0,-35.0,-44.0,-48.0,-90.0,-93.0,-90.0,-93.0,50.0,56.0,44.0,41.0,1
4571,62:47:05:9D:EB:15,3851838,497111078,6703,12171005,3845135,484940073,1,6850,3791307,6800,3783649,50,7658,3282,0,6763,56,1,125,229410.0,130000.0,-42.0,-45.0,-36.0,-47.0,-43.0,-46.0,-38.0,-47.0,-90.0,-93.0,-90.0,-93.0,48.0,48.0,54.0,46.0,1
4572,92:69:1D:31:68:E9,3849169,488591550,4034,3651477,3845135,484940073,1,5338,1152603,5172,1114925,166,37678,2197,12,4280,102,1,60,216660.0,130000.0,-52.0,-47.0,-42.0,-49.0,-52.0,-48.0,-43.0,-48.0,-90.0,-93.0,-90.0,-93.0,38.0,46.0,48.0,44.0,1
4573,CC:2F:71:3F:1F:24,4970728,1765199420,1125587,1280258741,3845141,484940679,1730,940358,1056260179,939539,1056161171,819,99008,908344,15,1124212,118687,1727,742,130000.0,43333.0,-71.0,-69.0,-66.0,-71.0,-70.0,-69.0,-66.0,-71.0,-90.0,-93.0,-90.0,-93.0,19.0,24.0,24.0,22.0,1
4574,CC:2F:71:3E:C5:1F,3846110,485059039,969,118360,3845141,484940679,2,4211,351414,3503,267340,708,84074,1027,12,1393,26,2,53,130000.0,39000.0,-71.0,-72.0,-69.0,-60.0,-71.0,-71.0,-69.0,-60.0,-90.0,-93.0,-90.0,-93.0,19.0,21.0,21.0,33.0,1
4575,BA:8C:B9:54:50:24,3850059,491133177,4918,6192498,3845141,484940679,7,9673,1746278,9651,1742783,22,3495,2358,17,5409,41,7,70,216660.0,130000.0,-40.0,-37.0,-46.0,-52.0,-43.0,-35.0,-44.0,-48.0,-91.0,-94.0,-90.0,-94.0,51.0,57.0,44.0,42.0,1
4576,62:47:05:9D:EB:15,3851847,497111946,6703,12171005,3845144,484940941,1,6852,3791443,6802,3783785,50,7658,3282,0,6763,56,1,125,229410.0,130000.0,-42.0,-45.0,-36.0,-47.0,-43.0,-46.0,-38.0,-46.0,-91.0,-94.0,-90.0,-94.0,49.0,49.0,54.0,47.0,1
4577,92:69:1D:31:68:E9,3849178,488592418,4034,3651477,3845144,484940941,1,5338,1152603,5172,1114925,166,37678,2197,12,4280,102,1,60,216660.0,130000.0,-52.0,-47.0,-42.0,-49.0,-52.0,-48.0,-43.0,-48.0,-91.0,-94.0,-90.0,-94.0,39.0,47.0,48.0,45.0,1
4578,CC:2F:71:3F:1F:24,4970921,1765440928,1125777,1280499987,3845144,484940941,1730,940532,1056492839,939713,1056393831,819,99008,908513,15,1124402,118690,1727,742,130000.0,43333.0,-74.0,-72.0,-69.0,-74.0,-73.0,-71.0,-68.0,-73.0,-91.0,-94.0,-90.0,-94.0,17.0,22.0,21.0,20.0,1
4579,CC:2F:71:3E:C5:1F,3846113,485059301,969,118360,3845144,484940941,2,4211,351414,3503,267340,708,84074,1027,12,1393,26,2,53,130000.0,39000.0,-71.0,-72.0,-69.0,-60.0,-71.0,-71.0,-69.0,-60.0,-91.0,-94.0,-90.0,-94.0,20.0,22.0,21.0,34.0,1
4580,BA:8C:B9:54:50:24,3850062,491133439,4918,6192498,3845144,484940941,7,9673,1746278,9651,1742783,22,3495,2358,17,5409,41,7,70,216660.0,130000.0,-40.0,-37.0,-46.0,-52.0,-43.0,-35.0,-44.0,-48.0,-91.0,-94.0,-90.0,-94.0,51.0,57.0,44.0,42.0,1
4581,62:47:05:9D:EB:15,3851849,497112066,6703,12171005,3845146,484941061,1,6852,3791443,6802,3783785,50,7658,3282,0,6763,56,1,125,229410.0,130000.0,-42.0,-45.0,-36.0,-47.0,-43.0,-46.0,-38.0,-46.0,-91.0,-94.0,-90.0,-94.0,49.0,49.0,54.0,47.0,1
4582,92:69:1D:31:68:E9,3849184,488592942,4034,3651477,3845150,484941465,1,5338,1152603,5172,1114925,166,37678,2197,12,4280,102,1,60,216660.0,130000.0,-52.0,-47.0,-42.0,-49.0,-52.0,-48.0,-43.0,-48.0,-91.0,-94.0,-90.0,-94.0,39.0,47.0,48.0,45.0,1
4583,CC:2F:71:3F:1F:24,4971121,1765685798,1125969,1280744131,3845152,484941667,1730,940705,1056727021,939886,1056628013,819,99008,908683,15,1124594,118696,1727,742,130000.0,43333.0,-70.0,-68.0,-66.0,-70.0,-73.0,-70.0,-68.0,-73.0,-91.0,-94.0,-90.0,-94.0,21.0,26.0,24.0,24.0,1
4584,CC:2F:71:3E:C5:1F,3846121,485060027,969,118360,3845152,484941667,2,4211,351414,3503,267340,708,84074,1027,12,1393,26,2,53,130000.0,39000.0,-71.0,-72.0,-69.0,-60.0,-71.0,-71.0,-69.0,-60.0,-91.0,-94.0,-90.0,-94.0,20.0,22.0,21.0,34.0,1
4585,BA:8C:B9:54:50:24,3850070,491134165,4918,6192498,3845152,484941667,7,9673,1746278,9651,1742783,22,3495,2358,17,5409,41,7,70,216660.0,130000.0,-40.0,-37.0,-46.0,-52.0,-43.0,-35.0,-44.0,-48.0,-91.0,-94.0,-90.0,-94.0,51.0,57.0,44.0,42.0,1
4586,62:47:05:9D:EB:15,3851857,497112874,6703,12171005,3845154,484941869,1,6852,3791443,6802,3783785,50,7658,3282,0,6763,56,1,125,229410.0,130000.0,-42.0,-45.0,-36.0,-47.0,-43.0,-46.0,-38.0,-46.0,-91.0,-94.0,-90.0,-94.0,49.0,49.0,54.0,47.0,1
4587,92:69:1D:31:68:E9,3849188,488593346,4034,3651477,3845154,484941869,1,5338,1152603,5172,1114925,166,37678,2197,12,4280,102,1,60,216660.0,130000.0,-52.0,-47.0,-42.0,-49.0,-52.0,-48.0,-43.0,-48.0,-91.0,-94.0,-90.0,-94.0,39.0,47.0,48.0,45.0,1
4588,CC:2F:71:3F:1F:24,4971320,1765932155,1126166,1280990286,3845154,484941869,1730,940887,1056963972,940068,1056864964,819,99008,908859,15,1124791,118696,1727,742,130000.0,43333.0,-73.0,-72.0,-70.0,-74.0,-73.0,-71.0,-69.0,-73.0,-91.0,-94.0,-90.0,-94.0,18.0,22.0,20.0,20.0,1
4589,CC:2F:71:3E:C5:1F,3846123,485060229,969,118360,3845154,484941869,2,4211,351414,3503,267340,708,84074,1027,12,1393,26,2,53,130000.0,39000.0,-71.0,-72.0,-69.0,-60.0,-71.0,-71.0,-69.0,-60.0,-91.0,-94.0,-90.0,-94.0,20.0,22.0,21.0,34.0,1
4590,BA:8C:B9:54:50:24,3850073,491134427,4918,6192498,3845155,484941929,7,9673,1746278,9651,1742783,22,3495,2358,17,5409,41,7,70,216660.0,130000.0,-40.0,-37.0,-46.0,-52.0,-43.0,-35.0,-44.0,-48.0,-91.0,-94.0,-90.0,-94.0,51.0,57.0,44.0,42.0,1
4591,62:47:05:9D:EB:15,3851864,497113540,6703,12171005,3845161,484942535,1,6852,3791443,6802,3783785,50,7658,3282,0,6763,56,1,125,229410.0,130000.0,-42.0,-45.0,-36.0,-47.0,-43.0,-46.0,-38.0,-46.0,-91.0,-94.0,-90.0,-94.0,49.0,49.0,54.0,47.0,1
4592,92:69:1D:31:68:E9,3849195,488594012,4034,3651477,3845161,484942535,1,5338,1152603,5172,1114925,166,37678,2197,12,4280,102,1,60,216660.0,130000.0,-52.0,-47.0,-42.0,-49.0,-52.0,-48.0,-43.0,-48.0,-91.0,-94.0,-90.0,-94.0,39.0,47.0,48.0,45.0,1
4593,CC:2F:71:3F:1F:24,4971518,1766175467,1126357,1281232932,3845161,484942535,1730,941062,1057198134,940243,1057099126,819,99008,909029,15,1124982,118704,1727,742,130000.0,39000.0,-74.0,-72.0,-69.0,-74.0,-73.0,-71.0,-69.0,-73.0,-91.0,-94.0,-90.0,-94.0,17.0,22.0,21.0,20.0,1
4594,CC:2F:71:3E:C5:1F,3846131,485060955,969,118360,3845162,484942595,2,4211,351414,3503,267340,708,84074,1027,12,1393,26,2,53,130000.0,39000.0,-71.0,-72.0,-69.0,-60.0,-71.0,-71.0,-69.0,-60.0,-91.0,-94.0,-90.0,-94.0,20.0,22.0,21.0,34.0,1
4595,BA:8C:B9:54:50:24,3850080,491135093,4918,6192498,3845162,484942595,7,9673,1746278,9651,1742783,22,3495,2358,17,5409,41,7,70,216660.0,130000.0,-40.0,-37.0,-46.0,-52.0,-43.0,-35.0,-44.0,-48.0,-91.0,-94.0,-90.0,-94.0,51.0,57.0,44.0,42.0,1
4596,62:47:05:9D:EB:15,3851868,497113862,6703,12171005,3845165,484942857,1,6852,3791443,6802,3783785,50,7658,3282,0,6763,56,1,125,229410.0,130000.0,-42.0,-45.0,-36.0,-47.0,-43.0,-46.0,-38.0,-46.0,-91.0,-94.0,-90.0,-94.0,49.0,49.0,54.0,47.0,1
4597,92:69:1D:31:68:E9,3849199,488594334,4034,3651477,3845165,484942857,1,5339,1152671,5173,1114993,166,37678,2197,12,4280,102,1,60,216660.0,130000.0,-51.0,-48.0,-44.0,-47.0,-52.0,-48.0,-43.0,-48.0,-91.0,-94.0,-90.0,-94.0,40.0,46.0,46.0,47.0,1
4598,CC:2F:71:3F:1F:24,4971714,1766420101,1126549,1281477244,3845165,484942857,1730,941239,1057435504,940420,1057336496,819,99008,909201,15,1125174,118705,1727,742,130000.0,43333.0,-73.0,-72.0,-69.0,-74.0,-72.0,-71.0,-69.0,-73.0,-91.0,-94.0,-90.0,-94.0,18.0,22.0,21.0,20.0,1
4599,CC:2F:71:3E:C5:1F,3846134,485061217,969,118360,3845165,484942857,2,4211,351414,3503,267340,708,84074,1027,12,1393,26,2,53,130000.0,39000.0,-71.0,-72.0,-69.0,-60.0,-71.0,-71.0,-69.0,-60.0,-91.0,-94.0,-90.0,-94.0,20.0,22.0,21.0,34.0,1
4600,BA:8C:B9:54:50:24,3850083,491135355,4918,6192498,3845165,484942857,7,9673,1746278,9651,1742783,22,3495,2358,17,5409,41,7,70,216660.0,130000.0,-40.0,-37.0,-46.0,-52.0,-43.0,-35.0,-44.0,-48.0,-91.0,-94.0,-90.0,-94.0,51.0,57.0,44.0,42.0,1
4601,62:47:05:9D:EB:15,3851876,497114590,6703,12171005,3845173,484943585,1,6852,3791443,6802,3783785,50,7658,3282,0,6763,56,1,125,229410.0,130000.0,-42.0,-45.0,-36.0,-47.0,-43.0,-46.0,-38.0,-46.0,-91.0,-94.0,-90.0,-94.0,49.0,49.0,54.0,47.0,1
4602,92:69:1D:31:68:E9,3849207,488595062,4034,3651477,3845173,484943585,1,5339,1152671,5173,1114993,166,37678,2197,12,4280,102,1,60,216660.0,130000.0,-51.0,-48.0,-44.0,-47.0,-52.0,-48.0,-43.0,-48.0,-91.0,-94.0,-90.0,-94.0,40.0,46.0,46.0,47.0,1
4603,CC:2F:71:3F:1F:24,4971921,1766677627,1126748,1281734042,3845173,484943585,1730,941428,1057687268,940608,1057588142,820,99126,909382,15,1125373,118706,1727,743,130000.0,43333.0,-71.0,-69.0,-67.0,-71.0,-70.0,-69.0,-66.0,-71.0,-91.0,-94.0,-90.0,-94.0,20.0,25.0,23.0,23.0,1
4604,CC:2F:71:3E:C5:1F,3846142,485061945,969,118360,3845173,484943585,2,4211,351414,3503,267340,708,84074,1027,12,1393,26,2,53,130000.0,39000.0,-71.0,-72.0,-69.0,-60.0,-71.0,-71.0,-69.0,-60.0,-91.0,-94.0,-90.0,-94.0,20.0,22.0,21.0,34.0,1
4605,BA:8C:B9:54:50:24,3850091,491136083,4918,6192498,3845173,484943585,7,9673,1746278,9651,1742783,22,3495,2358,17,5409,41,7,70,216660.0,130000.0,-40.0,-37.0,-46.0,-52.0,-43.0,-35.0,-44.0,-48.0,-91.0,-94.0,-90.0,-94.0,51.0,57.0,44.0,42.0,1
4606,62:47:05:9D:EB:15,3851887,497117762,6703,12171005,3845184,484946757,1,6852,3791443,6802,3783785,50,7658,3282,0,6763,56,1,125,229410.0,130000.0,-42.0,-45.0,-36.0,-47.0,-43.0,-46.0,-38.0,-46.0,-91.0,-93.0,-90.0,-93.0,49.0,48.0,54.0,46.0,1
4607,92:69:1D:31:68:E9,3849219,488598294,4034,3651477,3845185,484946817,1,5339,1152671,5173,1114993,166,37678,2197,12,4280,102,1,60,216660.0,130000.0,-51.0,-48.0,-44.0,-47.0,-52.0,-48.0,-43.0,-48.0,-91.0,-93.0,-90.0,-93.0,40.0,45.0,46.0,46.0,1
4608,CC:2F:71:3F:1F:24,4972134,1766930158,1126949,1281983341,3845185,484946817,1730,941620,1057932492,940800,1057833366,820,99126,909565,15,1125574,118711,1727,743,130000.0,43333.0,-76.0,-75.0,-72.0,-77.0,-76.0,-74.0,-72.0,-77.0,-91.0,-93.0,-90.0,-93.0,15.0,18.0,18.0,16.0,1
4609,CC:2F:71:3E:C5:1F,3846154,485065177,969,118360,3845185,484946817,2,4213,351554,3505,267480,708,84074,1027,12,1394,26,2,53,130000.0,39000.0,-72.0,-72.0,-69.0,-61.0,-71.0,-72.0,-69.0,-60.0,-91.0,-93.0,-90.0,-93.0,19.0,21.0,21.0,32.0,1
4610,BA:8C:B9:54:50:24,3850103,491139315,4918,6192498,3845185,484946817,7,9675,1746414,9653,1742919,22,3495,2358,17,5410,41,7,70,216660.0,130000.0,-48.0,-35.0,-43.0,-45.0,-42.0,-35.0,-44.0,-48.0,-91.0,-93.0,-90.0,-93.0,43.0,58.0,47.0,48.0,1
4611,62:47:05:9D:EB:15,3851917,497129451,6703,12171005,3845214,484958446,1,6854,3791579,6804,3783921,50,7658,3282,0,6764,56,1,125,229410.0,130000.0,-42.0,-46.0,-35.0,-47.0,-43.0,-47.0,-38.0,-46.0,-91.0,-93.0,-90.0,-93.0,49.0,47.0,55.0,46.0,1
4612,92:69:1D:31:68:E9,3849248,488609923,4034,3651477,3845214,484958446,1,5342,1153042,5175,1115129,167,37913,2198,12,4280,102,1,60,216660.0,130000.0,-51.0,-48.0,-44.0,-47.0,-51.0,-48.0,-43.0,-48.0,-91.0,-93.0,-90.0,-93.0,40.0,45.0,46.0,46.0,1
4613,CC:2F:71:3F:1F:24,4972359,1767192371,1127145,1282233925,3845214,484958446,1730,941802,1058173344,940982,1058074218,820,99126,909745,15,1125770,118712,1727,743,130000.0,43333.0,-74.0,-72.0,-70.0,-74.0,-73.0,-71.0,-69.0,-73.0,-91.0,-93.0,-90.0,-93.0,17.0,21.0,20.0,19.0,1
4614,CC:2F:71:3E:C5:1F,3846183,485076806,969,118360,3845214,484958446,2,4213,351554,3505,267480,708,84074,1027,12,1394,26,2,53,130000.0,39000.0,-72.0,-72.0,-69.0,-61.0,-71.0,-72.0,-69.0,-60.0,-91.0,-93.0,-90.0,-93.0,19.0,21.0,21.0,32.0,1
4615,BA:8C:B9:54:50:24,3850135,491151206,4918,6192498,3845217,484958708,7,9675,1746414,9653,1742919,22,3495,2358,17,5410,41,7,70,216660.0,130000.0,-48.0,-35.0,-43.0,-45.0,-42.0,-35.0,-44.0,-48.0,-91.0,-93.0,-90.0,-93.0,43.0,58.0,47.0,48.0,1
4616,62:47:05:9D:EB:15,3851920,497129713,6703,12171005,3845217,484958708,1,6854,3791579,6804,3783921,50,7658,3282,0,6764,56,1,125,229410.0,130000.0,-42.0,-46.0,-35.0,-47.0,-43.0,-47.0,-38.0,-46.0,-91.0,-93.0,-90.0,-93.0,49.0,47.0,55.0,46.0,1
4617,92:69:1D:31:68:E9,3849252,488610245,4034,3651477,3845218,484958768,1,5342,1153042,5175,1115129,167,37913,2198,12,4280,102,1,60,216660.0,130000.0,-51.0,-48.0,-44.0,-47.0,-51.0,-48.0,-43.0,-48.0,-91.0,-93.0,-90.0,-93.0,40.0,45.0,46.0,46.0,1
4618,CC:2F:71:3F:1F:24,4972553,1767433673,1127335,1282474905,3845218,484958768,1730,941976,1058404780,941156,1058305654,820,99126,909915,15,1125959,118722,1727,743,130000.0,43333.0,-74.0,-72.0,-70.0,-74.0,-73.0,-71.0,-69.0,-73.0,-91.0,-93.0,-90.0,-93.0,17.0,21.0,20.0,19.0,1
4619,CC:2F:71:3E:C5:1F,3846187,485077128,969,118360,3845218,484958768,2,4213,351554,3505,267480,708,84074,1027,12,1394,26,2,53,130000.0,39000.0,-72.0,-72.0,-69.0,-61.0,-71.0,-72.0,-69.0,-60.0,-91.0,-93.0,-90.0,-93.0,19.0,21.0,21.0,32.0,1
4620,BA:8C:B9:54:50:24,3850136,491151266,4918,6192498,3845218,484958768,7,9675,1746414,9653,1742919,22,3495,2358,17,5410,41,7,70,216660.0,130000.0,-48.0,-35.0,-43.0,-45.0,-42.0,-35.0,-44.0,-48.0,-91.0,-93.0,-90.0,-93.0,43.0,58.0,47.0,48.0,1
4621,62:47:05:9D:EB:15,3851928,497130439,6703,12171005,3845225,484959434,1,6854,3791579,6804,3783921,50,7658,3282,0,6764,56,1,125,229410.0,130000.0,-42.0,-46.0,-35.0,-47.0,-43.0,-47.0,-38.0,-46.0,-91.0,-93.0,-90.0,-93.0,49.0,47.0,55.0,46.0,1
4622,92:69:1D:31:68:E9,3849259,488610911,4034,3651477,3845225,484959434,1,5342,1153042,5175,1115129,167,37913,2198,12,4280,102,1,60,216660.0,130000.0,-51.0,-48.0,-44.0,-47.0,-51.0,-48.0,-43.0,-48.0,-91.0,-93.0,-90.0,-93.0,40.0,45.0,46.0,46.0,1
4623,CC:2F:71:3F:1F:24,4972751,1767677153,1127526,1282717719,3845225,484959434,1730,942153,1058642194,941333,1058543068,820,99126,910085,15,1126151,118724,1727,743,130000.0,43333.0,-74.0,-72.0,-70.0,-74.0,-74.0,-71.0,-69.0,-74.0,-91.0,-93.0,-90.0,-93.0,17.0,21.0,20.0,19.0,1
4624,CC:2F:71:3E:C5:1F,3846197,485078269,969,118360,3845228,484959909,2,4213,351554,3505,267480,708,84074,1027,12,1394,26,2,53,130000.0,39000.0,-72.0,-72.0,-69.0,-61.0,-71.0,-72.0,-69.0,-60.0,-91.0,-93.0,-90.0,-93.0,19.0,21.0,21.0,32.0,1
4625,BA:8C:B9:54:50:24,3850146,491152407,4918,6192498,3845228,484959909,7,9675,1746414,9653,1742919,22,3495,2358,17,5410,41,7,70,216660.0,130000.0,-48.0,-35.0,-43.0,-45.0,-42.0,-35.0,-44.0,-48.0,-91.0,-93.0,-90.0,-93.0,43.0,58.0,47.0,48.0,1
4626,62:47:05:9D:EB:15,3851933,497131939,6704,12171970,3845229,484959969,1,6855,3791647,6805,3783989,50,7658,3282,0,6765,56,1,125,229410.0,130000.0,-42.0,-45.0,-36.0,-47.0,-43.0,-47.0,-38.0,-46.0,-91.0,-93.0,-90.0,-93.0,49.0,48.0,54.0,46.0,1
4627,92:69:1D:31:68:E9,3849263,488611446,4034,3651477,3845229,484959969,1,5342,1153042,5175,1115129,167,37913,2198,12,4280,102,1,60,216660.0,130000.0,-51.0,-48.0,-44.0,-47.0,-51.0,-48.0,-43.0,-48.0,-91.0,-93.0,-90.0,-93.0,40.0,45.0,46.0,46.0,1
4628,CC:2F:71:3F:1F:24,4972952,1767921971,1127723,1282962002,3845229,484959969,1730,942332,1058874435,941512,1058775309,820,99126,910261,15,1126348,118732,1727,743,130000.0,43333.0,-74.0,-72.0,-70.0,-74.0,-74.0,-71.0,-69.0,-73.0,-91.0,-93.0,-90.0,-93.0,17.0,21.0,20.0,19.0,1
4629,CC:2F:71:3E:C5:1F,3846198,485078329,969,118360,3845229,484959969,2,4213,351554,3505,267480,708,84074,1027,12,1394,26,2,53,130000.0,39000.0,-72.0,-72.0,-69.0,-61.0,-71.0,-72.0,-69.0,-60.0,-91.0,-93.0,-90.0,-93.0,19.0,21.0,21.0,32.0,1
4630,BA:8C:B9:54:50:24,3850147,491152467,4918,6192498,3845229,484959969,7,9675,1746414,9653,1742919,22,3495,2358,17,5410,41,7,70,216660.0,130000.0,-48.0,-35.0,-43.0,-45.0,-42.0,-35.0,-44.0,-48.0,-91.0,-93.0,-90.0,-93.0,43.0,58.0,47.0,48.0,1
4631,62:47:05:9D:EB:15,3851948,497136993,6712,12176358,3845236,484960635,1,6865,3792860,6815,3785202,50,7658,3290,0,6773,56,1,125,229410.0,137640.0,-46.0,-48.0,-40.0,-47.0,-45.0,-48.0,-39.0,-47.0,-91.0,-93.0,-90.0,-93.0,45.0,45.0,50.0,46.0,1
4632,92:69:1D:31:68:E9,3849270,488612112,4034,3651477,3845236,484960635,1,5342,1153042,5175,1115129,167,37913,2198,12,4280,102,1,60,216660.0,130000.0,-51.0,-48.0,-44.0,-47.0,-51.0,-48.0,-43.0,-48.0,-91.0,-93.0,-90.0,-93.0,40.0,45.0,46.0,46.0,1
4633,CC:2F:71:3F:1F:24,4973184,1768178449,1127945,1283217552,3845239,484960897,1730,942536,1059120275,941716,1059021149,820,99126,910457,15,1126570,118734,1727,743,130000.0,43333.0,-70.0,-68.0,-66.0,-70.0,-70.0,-68.0,-67.0,-70.0,-91.0,-93.0,-90.0,-93.0,21.0,25.0,24.0,23.0,1
4634,CC:2F:71:3E:C5:1F,3846208,485079257,969,118360,3845239,484960897,2,4213,351554,3505,267480,708,84074,1027,12,1394,26,2,53,130000.0,39000.0,-72.0,-72.0,-69.0,-61.0,-71.0,-72.0,-69.0,-60.0,-91.0,-93.0,-90.0,-93.0,19.0,21.0,21.0,32.0,1
4635,BA:8C:B9:54:50:24,3850157,491153395,4918,6192498,3845239,484960897,7,9675,1746414,9653,1742919,22,3495,2358,17,5410,41,7,70,216660.0,130000.0,-48.0,-35.0,-43.0,-45.0,-42.0,-35.0,-44.0,-48.0,-91.0,-93.0,-90.0,-93.0,43.0,58.0,47.0,48.0,1
4636,62:47:05:9D:EB:15,3851953,497137623,6712,12176358,3845241,484961265,1,6866,3792928,6816,3785270,50,7658,3290,0,6773,56,1,125,229410.0,137640.0,-42.0,-46.0,-35.0,-46.0,-44.0,-47.0,-39.0,-46.0,-90.0,-93.0,-90.0,-93.0,48.0,47.0,55.0,47.0,1
4637,92:69:1D:31:68:E9,3849275,488612742,4034,3651477,3845241,484961265,1,5342,1153042,5175,1115129,167,37913,2198,12,4280,102,1,60,216660.0,130000.0,-51.0,-48.0,-44.0,-47.0,-51.0,-48.0,-43.0,-48.0,-90.0,-93.0,-90.0,-93.0,39.0,45.0,46.0,46.0,1
4638,CC:2F:71:3F:1F:24,4973376,1768419853,1128135,1283458588,3845241,484961265,1730,942711,1059355875,941891,1059256749,820,99126,910626,15,1126760,118742,1727,743,130000.0,43333.0,-70.0,-68.0,-66.0,-70.0,-70.0,-68.0,-65.0,-70.0,-90.0,-93.0,-90.0,-93.0,20.0,25.0,24.0,23.0,1
4639,CC:2F:71:3E:C5:1F,3846212,485079827,969,118360,3845243,484961467,2,4213,351554,3505,267480,708,84074,1027,12,1394,26,2,53,130000.0,39000.0,-72.0,-72.0,-69.0,-61.0,-71.0,-72.0,-69.0,-60.0,-90.0,-93.0,-90.0,-93.0,18.0,21.0,21.0,32.0,1
4640,BA:8C:B9:54:50:24,3850161,491153965,4918,6192498,3845243,484961467,7,9675,1746414,9653,1742919,22,3495,2358,17,5410,41,7,70,216660.0,130000.0,-48.0,-35.0,-43.0,-45.0,-42.0,-35.0,-44.0,-48.0,-90.0,-93.0,-90.0,-93.0,42.0,58.0,47.0,48.0,1
4641,62:47:05:9D:EB:15,3851962,497138491,6712,12176358,3845250,484962133,1,6866,3792928,6816,3785270,50,7658,3290,0,6773,56,1,125,229410.0,137640.0,-42.0,-46.0,-35.0,-46.0,-44.0,-47.0,-39.0,-46.0,-90.0,-93.0,-90.0,-93.0,48.0,47.0,55.0,47.0,1
4642,92:69:1D:31:68:E9,3849284,488613610,4034,3651477,3845250,484962133,1,5342,1153042,5175,1115129,167,37913,2198,12,4280,102,1,60,216660.0,130000.0,-51.0,-48.0,-44.0,-47.0,-51.0,-48.0,-43.0,-48.0,-90.0,-93.0,-90.0,-93.0,39.0,45.0,46.0,46.0,1
4643,CC:2F:71:3F:1F:24,4973576,1768661817,1128325,1283699624,3845251,484962193,1730,942890,1059593391,942070,1059494265,820,99126,910797,15,1126950,118746,1727,743,130000.0,43333.0,-71.0,-69.0,-67.0,-71.0,-70.0,-69.0,-66.0,-71.0,-90.0,-93.0,-90.0,-93.0,19.0,24.0,23.0,22.0,1
4644,CC:2F:71:3E:C5:1F,3846220,485080553,969,118360,3845251,484962193,2,4213,351554,3505,267480,708,84074,1027,12,1394,26,2,53,130000.0,39000.0,-72.0,-72.0,-69.0,-61.0,-71.0,-72.0,-69.0,-60.0,-90.0,-93.0,-90.0,-93.0,18.0,21.0,21.0,32.0,1
4645,BA:8C:B9:54:50:24,3850169,491154691,4918,6192498,3845251,484962193,7,9675,1746414,9653,1742919,22,3495,2358,17,5410,41,7,70,216660.0,130000.0,-48.0,-35.0,-43.0,-45.0,-42.0,-35.0,-44.0,-48.0,-90.0,-93.0,-90.0,-93.0,42.0,58.0,47.0,48.0,1
4646,62:47:05:9D:EB:15,3851964,497138611,6712,12176358,3845252,484962253,1,6866,3792928,6816,3785270,50,7658,3290,0,6773,56,1,125,229410.0,137640.0,-42.0,-46.0,-35.0,-46.0,-44.0,-47.0,-39.0,-46.0,-90.0,-93.0,-90.0,-93.0,48.0,47.0,55.0,47.0,1
4647,92:69:1D:31:68:E9,3849286,488613730,4034,3651477,3845252,484962253,1,5342,1153042,5175,1115129,167,37913,2198,12,4280,102,1,60,216660.0,130000.0,-51.0,-48.0,-44.0,-47.0,-51.0,-48.0,-43.0,-48.0,-90.0,-93.0,-90.0,-93.0,39.0,45.0,46.0,46.0,1
4648,CC:2F:71:3F:1F:24,4973789,1768913271,1128535,1283950816,3845254,484962455,1730,943084,1059835559,942264,1059736433,820,99126,910982,15,1127160,118747,1727,743,130000.0,43333.0,-71.0,-69.0,-66.0,-71.0,-71.0,-69.0,-66.0,-71.0,-90.0,-93.0,-90.0,-93.0,19.0,24.0,24.0,22.0,1
4649,CC:2F:71:3E:C5:1F,3846223,485080815,969,118360,3845254,484962455,2,4213,351554,3505,267480,708,84074,1027,12,1394,26,2,53,130000.0,39000.0,-72.0,-72.0,-69.0,-61.0,-71.0,-72.0,-69.0,-60.0,-90.0,-93.0,-90.0,-93.0,18.0,21.0,21.0,32.0,1
4650,BA:8C:B9:54:50:24,3850174,491155155,4918,6192498,3845256,484962657,7,9675,1746414,9653,1742919,22,3495,2358,17,5410,41,7,70,216660.0,130000.0,-48.0,-35.0,-43.0,-45.0,-42.0,-35.0,-44.0,-48.0,-90.0,-93.0,-90.0,-93.0,42.0,58.0,47.0,48.0,1
4651,62:47:05:9D:EB:15,3851973,497139479,6712,12176358,3845261,484963121,1,6866,3792928,6816,3785270,50,7658,3290,0,6773,56,1,125,229410.0,137640.0,-42.0,-46.0,-35.0,-46.0,-44.0,-47.0,-39.0,-46.0,-90.0,-93.0,-90.0,-93.0,48.0,47.0,55.0,47.0,1
4652,92:69:1D:31:68:E9,3849295,488614598,4034,3651477,3845261,484963121,1,5342,1153042,5175,1115129,167,37913,2198,12,4280,102,1,60,216660.0,130000.0,-51.0,-48.0,-44.0,-47.0,-51.0,-48.0,-43.0,-48.0,-90.0,-93.0,-90.0,-93.0,39.0,45.0,46.0,46.0,1
4653,CC:2F:71:3F:1F:24,4973985,1769154843,1128724,1284191722,3845261,484963121,1730,943258,1060069619,942438,1059970493,820,99126,911150,15,1127349,118753,1727,743,130000.0,43333.0,-71.0,-69.0,-67.0,-71.0,-71.0,-69.0,-66.0,-70.0,-90.0,-93.0,-90.0,-93.0,19.0,24.0,23.0,22.0,1
4654,CC:2F:71:3E:C5:1F,3846230,485081481,969,118360,3845261,484963121,2,4213,351554,3505,267480,708,84074,1027,12,1394,26,2,53,130000.0,39000.0,-72.0,-72.0,-69.0,-61.0,-71.0,-72.0,-69.0,-60.0,-90.0,-93.0,-90.0,-93.0,18.0,21.0,21.0,32.0,1
4655,BA:8C:B9:54:50:24,3850179,491155619,4918,6192498,3845261,484963121,7,9675,1746414,9653,1742919,22,3495,2358,17,5410,41,7,70,216660.0,130000.0,-48.0,-35.0,-43.0,-45.0,-42.0,-35.0,-44.0,-48.0,-90.0,-93.0,-90.0,-93.0,42.0,58.0,47.0,48.0,1
4656,62:47:05:9D:EB:15,3851976,497139741,6712,12176358,3845264,484963383,1,6866,3792928,6816,3785270,50,7658,3290,0,6773,56,1,125,229410.0,137640.0,-42.0,-46.0,-35.0,-46.0,-44.0,-47.0,-39.0,-46.0,-90.0,-93.0,-90.0,-93.0,48.0,47.0,55.0,47.0,1
4657,92:69:1D:31:68:E9,3849298,488614860,4034,3651477,3845264,484963383,1,5342,1153042,5175,1115129,167,37913,2198,12,4280,102,1,60,216660.0,130000.0,-51.0,-48.0,-44.0,-47.0,-51.0,-48.0,-43.0,-48.0,-90.0,-93.0,-90.0,-93.0,39.0,45.0,46.0,46.0,1
4658,CC:2F:71:3F:1F:24,4974177,1769396235,1128913,1284432852,3845264,484963383,1730,943436,1060307019,942616,1060207893,820,99126,911322,15,1127538,118757,1727,743,130000.0,43333.0,-71.0,-69.0,-67.0,-71.0,-70.0,-68.0,-66.0,-70.0,-90.0,-93.0,-90.0,-93.0,19.0,24.0,23.0,22.0,1
4659,CC:2F:71:3E:C5:1F,3846235,485081945,969,118360,3845266,484963585,2,4213,351554,3505,267480,708,84074,1027,12,1394,26,2,53,130000.0,39000.0,-72.0,-72.0,-69.0,-61.0,-71.0,-72.0,-69.0,-60.0,-90.0,-93.0,-90.0,-93.0,18.0,21.0,21.0,32.0,1
4660,BA:8C:B9:54:50:24,3850185,491156143,4918,6192498,3845267,484963645,7,9675,1746414,9653,1742919,22,3495,2358,17,5410,41,7,70,216660.0,130000.0,-48.0,-35.0,-43.0,-45.0,-42.0,-35.0,-44.0,-48.0,-90.0,-93.0,-90.0,-93.0,42.0,58.0,47.0,48.0,1
4661,62:47:05:9D:EB:15,3851983,497140407,6712,12176358,3845271,484964049,1,6866,3792928,6816,3785270,50,7658,3290,0,6773,56,1,125,229410.0,137640.0,-42.0,-46.0,-35.0,-46.0,-44.0,-47.0,-39.0,-46.0,-90.0,-93.0,-90.0,-93.0,48.0,47.0,55.0,47.0,1
4662,92:69:1D:31:68:E9,3849305,488615526,4034,3651477,3845271,484964049,1,5342,1153042,5175,1115129,167,37913,2198,12,4280,102,1,60,216660.0,130000.0,-51.0,-48.0,-44.0,-47.0,-51.0,-48.0,-43.0,-48.0,-90.0,-93.0,-90.0,-93.0,39.0,45.0,46.0,46.0,1
4663,CC:2F:71:3F:1F:24,4974373,1769637807,1129102,1284673758,3845271,484964049,1730,943612,1060545625,942792,1060446499,820,99126,911489,15,1127727,118762,1727,743,130000.0,43333.0,-70.0,-69.0,-67.0,-71.0,-70.0,-68.0,-66.0,-70.0,-90.0,-93.0,-90.0,-93.0,20.0,24.0,23.0,22.0,1
4664,CC:2F:71:3E:C5:1F,3846240,485082409,969,118360,3845271,484964049,2,4213,351554,3505,267480,708,84074,1027,12,1394,26,2,53,130000.0,39000.0,-72.0,-72.0,-69.0,-61.0,-71.0,-72.0,-69.0,-60.0,-90.0,-93.0,-90.0,-93.0,18.0,21.0,21.0,32.0,1
4665,BA:8C:B9:54:50:24,3850189,491156547,4918,6192498,3845271,484964049,7,9675,1746414,9653,1742919,22,3495,2358,17,5410,41,7,70,216660.0,130000.0,-48.0,-35.0,-43.0,-45.0,-42.0,-35.0,-44.0,-48.0,-90.0,-93.0,-90.0,-93.0,42.0,58.0,47.0,48.0,1
4666,62:47:05:9D:EB:15,3851986,497140669,6712,12176358,3845274,484964311,1,6867,3792996,6817,3785338,50,7658,3290,0,6773,56,1,125,229410.0,137640.0,-42.0,-46.0,-35.0,-46.0,-44.0,-47.0,-38.0,-46.0,-90.0,-93.0,-90.0,-93.0,48.0,47.0,55.0,47.0,1
4667,92:69:1D:31:68:E9,3849308,488615788,4034,3651477,3845274,484964311,1,5342,1153042,5175,1115129,167,37913,2198,12,4280,102,1,60,216660.0,130000.0,-51.0,-48.0,-44.0,-47.0,-51.0,-48.0,-43.0,-48.0,-90.0,-93.0,-90.0,-93.0,39.0,45.0,46.0,46.0,1
4668,CC:2F:71:3F:1F:24,4974572,1769882600,1129297,1284918229,3845275,484964371,1730,943790,1060777736,942970,1060678610,820,99126,911665,15,1127922,118763,1727,743,130000.0,43333.0,-70.0,-68.0,-66.0,-70.0,-70.0,-68.0,-66.0,-70.0,-90.0,-93.0,-90.0,-93.0,20.0,25.0,24.0,23.0,1
4669,CC:2F:71:3E:C5:1F,3846246,485082933,969,118360,3845277,484964573,2,4213,351554,3505,267480,708,84074,1027,12,1394,26,2,53,130000.0,39000.0,-72.0,-72.0,-69.0,-61.0,-71.0,-72.0,-69.0,-60.0,-90.0,-93.0,-90.0,-93.0,18.0,21.0,21.0,32.0,1
4670,BA:8C:B9:54:50:24,3850197,491157273,4918,6192498,3845279,484964775,7,9675,1746414,9653,1742919,22,3495,2358,17,5410,41,7,70,216660.0,130000.0,-48.0,-35.0,-43.0,-45.0,-42.0,-35.0,-44.0,-48.0,-90.0,-93.0,-90.0,-93.0,42.0,58.0,47.0,48.0,1
4671,62:47:05:9D:EB:15,3851994,497141395,6712,12176358,3845282,484965037,1,6867,3792996,6817,3785338,50,7658,3290,0,6773,56,1,125,229410.0,137640.0,-42.0,-46.0,-35.0,-46.0,-44.0,-47.0,-38.0,-46.0,-90.0,-93.0,-90.0,-93.0,48.0,47.0,55.0,47.0,1
4672,92:69:1D:31:68:E9,3849316,488616514,4034,3651477,3845282,484965037,1,5342,1153042,5175,1115129,167,37913,2198,12,4280,102,1,60,216660.0,130000.0,-51.0,-48.0,-44.0,-47.0,-51.0,-48.0,-43.0,-48.0,-90.0,-93.0,-90.0,-93.0,39.0,45.0,46.0,46.0,1
4673,CC:2F:71:3F:1F:24,4974770,1770124658,1129488,1285159621,3845282,484965037,1730,943967,1061017896,943147,1060918770,820,99126,911832,15,1128113,118765,1727,743,130000.0,43333.0,-70.0,-68.0,-66.0,-70.0,-70.0,-68.0,-66.0,-70.0,-90.0,-93.0,-90.0,-93.0,20.0,25.0,24.0,23.0,1
4674,CC:2F:71:3E:C5:1F,3846256,485084230,974,119193,3845282,484965037,2,4219,352369,3511,268295,708,84074,1032,12,1399,27,2,54,144444.0,39000.0,-72.0,-72.0,-69.0,-60.0,-70.0,-71.0,-67.0,-61.0,-90.0,-93.0,-90.0,-93.0,18.0,21.0,21.0,33.0,1
4675,BA:8C:B9:54:50:24,3850201,491157651,4919,6192614,3845282,484965037,7,9677,1746550,9655,1743055,22,3495,2358,17,5411,41,7,70,216660.0,130000.0,-40.0,-37.0,-46.0,-52.0,-41.0,-36.0,-44.0,-49.0,-90.0,-93.0,-90.0,-93.0,50.0,56.0,44.0,41.0,1
4676,62:47:05:9D:EB:15,3851997,497141713,6713,12176474,3845284,484965239,1,6869,3793132,6819,3785474,50,7658,3290,0,6774,56,1,125,229410.0,137640.0,-42.0,-45.0,-35.0,-47.0,-43.0,-46.0,-37.0,-46.0,-90.0,-93.0,-90.0,-93.0,48.0,48.0,55.0,46.0,1
4677,92:69:1D:31:68:E9,3849321,488617034,4035,3651593,3845286,484965441,1,5344,1153178,5177,1115265,167,37913,2198,12,4281,102,1,60,216660.0,130000.0,-52.0,-48.0,-42.0,-49.0,-51.0,-48.0,-43.0,-48.0,-90.0,-93.0,-90.0,-93.0,38.0,45.0,48.0,44.0,1
4678,CC:2F:71:3F:1F:24,4974965,1770367582,1129678,1285402081,3845287,484965501,1730,944141,1061251914,943321,1061152788,820,99126,912003,15,1128303,118773,1727,743,130000.0,43333.0,-70.0,-68.0,-66.0,-70.0,-70.0,-68.0,-65.0,-70.0,-90.0,-93.0,-90.0,-93.0,20.0,25.0,24.0,23.0,1
4679,CC:2F:71:3E:C5:1F,3846263,485084896,974,119193,3845289,484965703,2,4219,352369,3511,268295,708,84074,1032,12,1399,27,2,54,144444.0,39000.0,-72.0,-72.0,-69.0,-60.0,-70.0,-71.0,-67.0,-61.0,-90.0,-93.0,-90.0,-93.0,18.0,21.0,21.0,33.0,1
4680,BA:8C:B9:54:50:24,3850208,491158317,4919,6192614,3845289,484965703,7,9677,1746550,9655,1743055,22,3495,2358,17,5411,41,7,70,216660.0,130000.0,-40.0,-37.0,-46.0,-52.0,-41.0,-36.0,-44.0,-49.0,-90.0,-93.0,-90.0,-93.0,50.0,56.0,44.0,41.0,1
4681,62:47:05:9D:EB:15,3852005,497142439,6713,12176474,3845292,484965965,1,6869,3793132,6819,3785474,50,7658,3290,0,6774,56,1,125,229410.0,137640.0,-42.0,-45.0,-35.0,-47.0,-43.0,-46.0,-37.0,-46.0,-90.0,-93.0,-90.0,-93.0,48.0,48.0,55.0,46.0,1
4682,92:69:1D:31:68:E9,3849327,488617558,4035,3651593,3845292,484965965,1,5344,1153178,5177,1115265,167,37913,2198,12,4281,102,1,60,216660.0,130000.0,-52.0,-48.0,-42.0,-49.0,-51.0,-48.0,-43.0,-48.0,-90.0,-93.0,-90.0,-93.0,38.0,45.0,48.0,44.0,1
4683,CC:2F:71:3F:1F:24,4975165,1770612517,1129873,1285646552,3845292,484965965,1730,944326,1061493621,943506,1061394495,820,99126,912178,15,1128498,118776,1727,743,130000.0,43333.0,-70.0,-68.0,-65.0,-70.0,-70.0,-68.0,-65.0,-70.0,-90.0,-93.0,-90.0,-93.0,20.0,25.0,25.0,23.0,1
4684,CC:2F:71:3E:C5:1F,3846266,485085158,974,119193,3845292,484965965,2,4219,352369,3511,268295,708,84074,1032,12,1399,27,2,54,144444.0,39000.0,-72.0,-72.0,-69.0,-60.0,-70.0,-71.0,-67.0,-61.0,-90.0,-93.0,-90.0,-93.0,18.0,21.0,21.0,33.0,1
4685,BA:8C:B9:54:50:24,3850211,491158579,4919,6192614,3845292,484965965,7,9678,1746618,9656,1743123,22,3495,2358,17,5411,41,7,70,216660.0,130000.0,-40.0,-37.0,-46.0,-52.0,-41.0,-36.0,-44.0,-49.0,-90.0,-93.0,-90.0,-93.0,50.0,56.0,44.0,41.0,1
4686,62:47:05:9D:EB:15,3852011,497143176,6713,12176474,3845298,484966702,1,6869,3793132,6819,3785474,50,7658,3290,0,6774,56,1,125,229410.0,137640.0,-42.0,-45.0,-35.0,-47.0,-43.0,-46.0,-37.0,-46.0,-90.0,-93.0,-90.0,-93.0,48.0,48.0,55.0,46.0,1
4687,92:69:1D:31:68:E9,3849333,488618295,4035,3651593,3845298,484966702,1,5344,1153178,5177,1115265,167,37913,2198,12,4281,102,1,60,216660.0,130000.0,-52.0,-48.0,-42.0,-49.0,-51.0,-48.0,-43.0,-48.0,-90.0,-93.0,-90.0,-93.0,38.0,45.0,48.0,44.0,1
4688,CC:2F:71:3F:1F:24,4975364,1770854622,1130064,1285887718,3845300,484966904,1730,944501,1061725123,943681,1061625997,820,99126,912348,15,1128689,118783,1727,744,130000.0,43333.0,-70.0,-68.0,-66.0,-70.0,-69.0,-68.0,-65.0,-70.0,-90.0,-93.0,-90.0,-93.0,20.0,25.0,24.0,23.0,1
4689,CC:2F:71:3E:C5:1F,3846274,485086097,974,119193,3845300,484966904,2,4219,352369,3511,268295,708,84074,1032,12,1399,27,2,54,144444.0,39000.0,-72.0,-72.0,-69.0,-60.0,-70.0,-71.0,-67.0,-61.0,-90.0,-93.0,-90.0,-93.0,18.0,21.0,21.0,33.0,1
4690,BA:8C:B9:54:50:24,3850219,491159518,4919,6192614,3845300,484966904,7,9678,1746618,9656,1743123,22,3495,2358,17,5411,41,7,70,216660.0,130000.0,-40.0,-37.0,-46.0,-52.0,-41.0,-36.0,-44.0,-49.0,-90.0,-93.0,-90.0,-93.0,50.0,56.0,44.0,41.0,1
4691,62:47:05:9D:EB:15,3852016,497143640,6713,12176474,3845303,484967166,1,6869,3793132,6819,3785474,50,7658,3290,0,6774,56,1,125,229410.0,137640.0,-42.0,-45.0,-35.0,-47.0,-43.0,-46.0,-37.0,-46.0,-90.0,-93.0,-90.0,-93.0,48.0,48.0,55.0,46.0,1
4692,92:69:1D:31:68:E9,3849338,488618759,4035,3651593,3845303,484967166,1,5344,1153178,5177,1115265,167,37913,2198,12,4281,102,1,60,216660.0,130000.0,-52.0,-48.0,-42.0,-49.0,-51.0,-48.0,-43.0,-48.0,-90.0,-93.0,-90.0,-93.0,38.0,45.0,48.0,44.0,1
4693,CC:2F:71:3F:1F:24,4975561,1771099162,1130257,1286131936,3845304,484967226,1730,944683,1061965729,943863,1061866603,820,99126,912521,15,1128882,118785,1727,744,130000.0,43333.0,-70.0,-69.0,-67.0,-71.0,-70.0,-68.0,-67.0,-71.0,-90.0,-93.0,-90.0,-93.0,20.0,24.0,23.0,22.0,1
4694,CC:2F:71:3E:C5:1F,3846278,485086419,974,119193,3845304,484967226,2,4219,352369,3511,268295,708,84074,1032,12,1399,27,2,54,144444.0,39000.0,-72.0,-72.0,-69.0,-60.0,-70.0,-71.0,-67.0,-61.0,-90.0,-93.0,-90.0,-93.0,18.0,21.0,21.0,33.0,1
4695,BA:8C:B9:54:50:24,3850223,491159840,4919,6192614,3845304,484967226,7,9678,1746618,9656,1743123,22,3495,2358,17,5411,41,7,70,216660.0,130000.0,-40.0,-37.0,-46.0,-52.0,-41.0,-36.0,-44.0,-49.0,-90.0,-93.0,-90.0,-93.0,50.0,56.0,44.0,41.0,1
4696,62:47:05:9D:EB:15,3852024,497144366,6713,12176474,3845311,484967892,1,6869,3793132,6819,3785474,50,7658,3290,0,6774,56,1,125,229410.0,137640.0,-42.0,-45.0,-35.0,-47.0,-43.0,-46.0,-37.0,-46.0,-90.0,-93.0,-90.0,-93.0,48.0,48.0,55.0,46.0,1
4697,92:69:1D:31:68:E9,3849346,488619485,4035,3651593,3845311,484967892,1,5344,1153178,5177,1115265,167,37913,2198,12,4281,102,1,60,216660.0,130000.0,-52.0,-48.0,-42.0,-49.0,-51.0,-48.0,-43.0,-48.0,-90.0,-93.0,-90.0,-93.0,38.0,45.0,48.0,44.0,1
4698,CC:2F:71:3F:1F:24,4975757,1771340958,1130446,1286373066,3845311,484967892,1730,944856,1062198221,944036,1062099095,820,99126,912690,15,1129071,118786,1727,744,130000.0,43333.0,-71.0,-67.0,-67.0,-72.0,-71.0,-67.0,-67.0,-71.0,-90.0,-93.0,-90.0,-93.0,19.0,26.0,23.0,21.0,1
4699,CC:2F:71:3E:C5:1F,3846286,485087147,974,119193,3845312,484967954,2,4219,352369,3511,268295,708,84074,1032,12,1399,27,2,54,144444.0,39000.0,-72.0,-72.0,-69.0,-60.0,-70.0,-71.0,-67.0,-61.0,-90.0,-93.0,-90.0,-93.0,18.0,21.0,21.0,33.0,1
4700,BA:8C:B9:54:50:24,3850231,491160568,4919,6192614,3845312,484967954,7,9678,1746618,9656,1743123,22,3495,2358,17,5411,41,7,70,216660.0,130000.0,-40.0,-37.0,-46.0,-52.0,-41.0,-36.0,-44.0,-49.0,-90.0,-93.0,-90.0,-93.0,50.0,56.0,44.0,41.0,1
4701,62:47:05:9D:EB:15,3852028,497144692,6713,12176474,3845315,484968218,1,6869,3793132,6819,3785474,50,7658,3290,0,6774,56,1,125,229410.0,137640.0,-42.0,-45.0,-35.0,-47.0,-43.0,-46.0,-37.0,-46.0,-90.0,-93.0,-90.0,-93.0,48.0,48.0,55.0,46.0,1
4702,92:69:1D:31:68:E9,3849350,488619811,4035,3651593,3845315,484968218,1,5344,1153178,5177,1115265,167,37913,2198,12,4281,102,1,60,216660.0,130000.0,-52.0,-48.0,-42.0,-49.0,-51.0,-48.0,-43.0,-48.0,-90.0,-93.0,-90.0,-93.0,38.0,45.0,48.0,44.0,1
4703,CC:2F:71:3F:1F:24,4976778,1772745218,1131463,1287777000,3845315,484968218,1730,945329,1062476506,944508,1062377262,821,99244,913161,15,1130088,118807,1727,744,144444.0,39000.0,-71.0,-68.0,-68.0,-72.0,-71.0,-68.0,-67.0,-72.0,-90.0,-93.0,-90.0,-93.0,19.0,25.0,22.0,21.0,1
4704,CC:2F:71:3E:C5:1F,3846291,485087531,975,119253,3845316,484968278,2,4223,352733,3514,268541,709,84192,1034,12,1400,27,2,54,144444.0,39000.0,-69.0,-67.0,-66.0,-60.0,-70.0,-70.0,-67.0,-60.0,-90.0,-93.0,-90.0,-93.0,21.0,26.0,24.0,33.0,1
4705,BA:8C:B9:54:50:24,3850235,491160892,4919,6192614,3845316,484968278,7,9678,1746618,9656,1743123,22,3495,2358,17,5411,41,7,70,216660.0,130000.0,-40.0,-37.0,-46.0,-52.0,-41.0,-36.0,-44.0,-49.0,-90.0,-93.0,-90.0,-93.0,50.0,56.0,44.0,41.0,1
4706,62:47:05:9D:EB:15,3852039,497145886,6716,12176942,3845323,484968944,1,6873,3793571,6823,3785913,50,7658,3291,0,6777,56,1,125,229410.0,137640.0,-44.0,-52.0,-44.0,-46.0,-43.0,-46.0,-37.0,-46.0,-90.0,-93.0,-90.0,-93.0,46.0,41.0,46.0,47.0,1
4707,92:69:1D:31:68:E9,3849358,488620537,4035,3651593,3845323,484968944,1,5344,1153178,5177,1115265,167,37913,2198,12,4281,102,1,60,216660.0,130000.0,-52.0,-48.0,-42.0,-49.0,-51.0,-48.0,-43.0,-48.0,-90.0,-93.0,-90.0,-93.0,38.0,45.0,48.0,44.0,1
4708,CC:2F:71:3F:1F:24,4977075,1773057032,1131752,1288088088,3845323,484968944,1730,945570,1062727748,944749,1062628504,821,99244,913399,15,1130376,118819,1727,744,130000.0,43333.0,-71.0,-68.0,-67.0,-72.0,-71.0,-68.0,-67.0,-71.0,-90.0,-93.0,-90.0,-93.0,19.0,25.0,23.0,21.0,1
4709,CC:2F:71:3E:C5:1F,3846299,485088313,976,119369,3845323,484968944,2,4226,352979,3517,268787,709,84192,1035,12,1401,27,2,54,144444.0,39000.0,-72.0,-72.0,-70.0,-60.0,-71.0,-71.0,-69.0,-60.0,-90.0,-93.0,-90.0,-93.0,18.0,21.0,20.0,33.0,1
4710,BA:8C:B9:54:50:24,3850244,491161760,4919,6192614,3845325,484969146,7,9678,1746618,9656,1743123,22,3495,2358,17,5411,41,7,70,216660.0,130000.0,-40.0,-37.0,-46.0,-52.0,-41.0,-36.0,-44.0,-49.0,-90.0,-93.0,-90.0,-93.0,50.0,56.0,44.0,41.0,1
4711,62:47:05:9D:EB:15,3852042,497146148,6716,12176942,3845326,484969206,1,6873,3793571,6823,3785913,50,7658,3291,0,6777,56,1,125,229410.0,137640.0,-44.0,-52.0,-44.0,-46.0,-43.0,-46.0,-37.0,-46.0,-90.0,-93.0,-90.0,-93.0,46.0,41.0,46.0,47.0,1
4712,92:69:1D:31:68:E9,3849361,488620799,4035,3651593,3845326,484969206,1,5344,1153178,5177,1115265,167,37913,2198,12,4281,102,1,60,216660.0,130000.0,-52.0,-48.0,-42.0,-49.0,-51.0,-48.0,-43.0,-48.0,-90.0,-93.0,-90.0,-93.0,38.0,45.0,48.0,44.0,1
4713,CC:2F:71:3F:1F:24,4977272,1773299230,1131946,1288330024,3845326,484969206,1730,945745,1062955388,944924,1062856144,821,99244,913574,15,1130571,118829,1727,744,130000.0,43333.0,-71.0,-68.0,-69.0,-71.0,-71.0,-68.0,-68.0,-71.0,-90.0,-93.0,-90.0,-93.0,19.0,25.0,21.0,22.0,1
4714,CC:2F:71:3E:C5:1F,3846302,485088575,976,119369,3845326,484969206,2,4226,352979,3517,268787,709,84192,1035,12,1401,27,2,54,144444.0,39000.0,-72.0,-72.0,-70.0,-60.0,-71.0,-71.0,-69.0,-60.0,-90.0,-93.0,-90.0,-93.0,18.0,21.0,20.0,33.0,1
4715,BA:8C:B9:54:50:24,3850247,491162022,4919,6192614,3845328,484969408,7,9678,1746618,9656,1743123,22,3495,2358,17,5411,41,7,70,216660.0,130000.0,-40.0,-37.0,-46.0,-52.0,-41.0,-36.0,-44.0,-49.0,-90.0,-93.0,-90.0,-93.0,50.0,56.0,44.0,41.0,1
4716,62:47:05:9D:EB:15,3852049,497146814,6716,12176942,3845333,484969872,1,6873,3793571,6823,3785913,50,7658,3291,0,6777,56,1,125,229410.0,137640.0,-44.0,-52.0,-44.0,-46.0,-43.0,-46.0,-37.0,-46.0,-90.0,-93.0,-90.0,-93.0,46.0,41.0,46.0,47.0,1
4717,92:69:1D:31:68:E9,3849369,488621525,4035,3651593,3845334,484969932,1,5344,1153178,5177,1115265,167,37913,2198,12,4281,102,1,60,216660.0,130000.0,-52.0,-48.0,-42.0,-49.0,-51.0,-48.0,-43.0,-48.0,-90.0,-93.0,-90.0,-93.0,38.0,45.0,48.0,44.0,1
4718,CC:2F:71:3F:1F:24,4977474,1773544384,1132140,1288574452,3845334,484969932,1730,945916,1063184772,945095,1063085528,821,99244,913745,15,1130765,118831,1727,744,130000.0,43333.0,-71.0,-68.0,-67.0,-72.0,-71.0,-68.0,-67.0,-71.0,-90.0,-93.0,-90.0,-93.0,19.0,25.0,23.0,21.0,1
4719,CC:2F:71:3E:C5:1F,3846312,485089503,976,119369,3845336,484970134,2,4226,352979,3517,268787,709,84192,1035,12,1401,27,2,54,144444.0,39000.0,-72.0,-72.0,-70.0,-60.0,-71.0,-71.0,-69.0,-60.0,-90.0,-93.0,-90.0,-93.0,18.0,21.0,20.0,33.0,1
4720,BA:8C:B9:54:50:24,3850255,491162748,4919,6192614,3845336,484970134,7,9678,1746618,9656,1743123,22,3495,2358,17,5411,41,7,70,216660.0,130000.0,-40.0,-37.0,-46.0,-52.0,-41.0,-36.0,-44.0,-49.0,-90.0,-93.0,-90.0,-93.0,50.0,56.0,44.0,41.0,1
4721,62:47:05:9D:EB:15,3852052,497147076,6716,12176942,3845336,484970134,1,6873,3793571,6823,3785913,50,7658,3291,0,6777,56,1,125,229410.0,137640.0,-44.0,-52.0,-44.0,-46.0,-43.0,-46.0,-37.0,-46.0,-90.0,-93.0,-90.0,-93.0,46.0,41.0,46.0,47.0,1
4722,92:69:1D:31:68:E9,3849372,488621787,4035,3651593,3845337,484970194,1,5344,1153178,5177,1115265,167,37913,2198,12,4281,102,1,60,216660.0,130000.0,-52.0,-48.0,-42.0,-49.0,-51.0,-48.0,-43.0,-48.0,-90.0,-93.0,-90.0,-93.0,38.0,45.0,48.0,44.0,1
4723,CC:2F:71:3F:1F:24,4977681,1773790563,1132342,1288820167,3845339,484970396,1730,946099,1063415451,945278,1063316207,821,99244,913926,15,1130967,118831,1727,746,130000.0,43333.0,-71.0,-68.0,-67.0,-72.0,-71.0,-68.0,-67.0,-72.0,-90.0,-93.0,-90.0,-93.0,19.0,25.0,23.0,21.0,1
4724,CC:2F:71:3E:C5:1F,3846315,485089765,976,119369,3845339,484970396,2,4226,352979,3517,268787,709,84192,1035,12,1401,27,2,54,144444.0,39000.0,-72.0,-72.0,-70.0,-60.0,-71.0,-71.0,-69.0,-60.0,-90.0,-93.0,-90.0,-93.0,18.0,21.0,20.0,33.0,1
4725,BA:8C:B9:54:50:24,3850258,491163010,4919,6192614,3845339,484970396,7,9678,1746618,9656,1743123,22,3495,2358,17,5411,41,7,70,216660.0,130000.0,-40.0,-37.0,-46.0,-52.0,-41.0,-36.0,-44.0,-49.0,-90.0,-93.0,-90.0,-93.0,50.0,56.0,44.0,41.0,1
